type octile
height 59
width 56
map
@@@@@@@@@@@@@@@@@@@@@@@@@@@@@@@@@@@@@@@@@@@@@@@@@@@@@@@@
@@@@@@@@@@@@@@@@@@@@@@@@@@@@@@@@@@@@@@@@@@@@@@@@@@@@@@@@
@@@@@@@@@@@@@@@@@@@@@@@@@@@@@@@@@@@@@@@@@@@@@@@@@@@@@@@@
@@@@@@@@@@@@@@@@@@@@@@@@@@@@@@@@@@@@@@@@@@@@@@@@@@@@@@@@
@@@@@@@@@@@@@@@@@@@@@@@@@@@@@@@@@@@@@@@@@@@@@@@@@@@@@@@@
@@@@@@@@@@@@@@@@@@@@@@@@@@@@@@@@@@@@@@@@@@@@@@@@@@@@@@@@
@@@@@@@@@@@@@@@@@@@@@@@@@@@@@@@@@@@@@@@@@@@@@@@@@@@@@@@@
@@@@@@@@@@@@@@@@@@@@@..@@@@@@@@@@@@@@@@@@@@@@@@@@@@@@@@@
@@@@@@@@@@@@@@@@@@@@T...@@@@@@@@@@@@@@@@@@@@@@@@@@@@@@@@
@@@@@@@@@@@@@@@@@@@...T.T@@@@@@@@@@@@@@@@@@@@@@@@@@@@@@@
@@@@@@@@@@@@@@@@@@.T.T.TT.@@@@@@@@@@@@@@@@@@@@@@@@@@@@@@
@@@@@@@@@@@@@@@@@..........@@@@@@@@@@@@@@@@@@@@@@@@@@@@@
@@@@@@@@@@@@@@@@.T........T@@@@@@@@@@@@@@@@@@@@@@@@@@@@@
@@@@@@@@@@@@@@@T......T...@@@@@@@@@@@@@@@@@@@@@@@@@@@@@@
@@@@@@@@@@@@@@@.....TTT..@@@@@@@@@@..T..@@@@@@@@@@@@@@@@
@@@@@@@@@@@@@@T.......T.@@@@@@@@@@.......@@@@@@@@@@@@@@@
@@@@@@@@@@@@@@.....TT..@@@@@@@@@@..T.TTT...@@@@@@@@@@@@@
@@@@@@@@@@@@@....T....@@@@@@@@@@..T.@...TT..@@@@@@@@@@@@
@@@@@@@@@@@@........T@@@@@@@@@@@@.T@@..T.T.@@@@@@@@@@@@@
@@@@@@@@@@@T........@@@@@@@@@@@@@@@@@@@@@....T@@@@@@@@@@
@@@@@@@@@@...T......@@@@@@T...@@@@@@@@@@@.T....@@@@@@@@@
@@@@@@@@@..........@@@@..T.....@@@@@@@@@T..TTT..@@@@@@@@
@@@@@@@@@..........@@TT..T...............T.......@@@@@@@
@@@@@@@@@...T....T.T.T.T...T.........T...T....T..@@@@@@@
@@@@@@@@@.......T....TTT.TT..............T.....@@@@@@@@@
@@@@@@@....T........TTT....TT...@@@@....TTT...@@@@@@@@@@
@@@@@@@.....T..T.T..TT...TT@@@@@@@@@@.........@@@@@@@@@@
@@@@@@@........T.T.....T@@@@@@@@@@@@@@.T......@@@@@@@@@@
@@@@@@@.........T...T@@@@@@@@@@@@@@@@@....T...@@@@@@@@@@
@@@@@@@T............@@@@@@@@@@@@@@@@@@@.......@@@@@@@@@@
@@@@@@@...T......TT@@@@@@@@@@@@@@@@@@@@......T@@@@@@@@@@
@@@@@@@.......@@...@@@@@@@@@@@@@@@@@@@@...T...T@@@@@@@@@
@@@@@@@.T.@@@@@@...@@@@@@@@@@@@@@@@@@@@@...T...@@@@@@@@@
@@@@@@@..@@@@@@@@T@@@@@@@@@@@@@@@@@@@@@@.......@@@@@@@@@
@@@@@@@TT.T@@@@@@.@@@@@@@@@@@@@@@@@@@@@@............@@@@
@@@@@@......@@@@@.@@@@@@@@@@@@@@@@@@@@@@....T.......@@@@
@@@@@@...TTT.@@@@.@@@@@@@@@@@@@@@@@@@@@@......T...TT@@@@
@@@@@@........@@@T@@@@@@@@@@@@@@@@@@@@@@....T.T...T.@@@@
@@@@@@.......T....T@@@@@@@@@@@@@@@@@@@@......T..T...@@@@
@@@@@.T.T....T.T..T@@@@@@@@@@@@@@@@@@@@TT......T....@@@@
@@@@@...T.T@@@...T..@@@@@@@@@@@@@@@@@@...TT.T....T..@@@@
@@@@@...T.T@@@@T..T..@@@@@@@@@@@@@@@@@...T.....T....@@@@
@@@@@.......@@@TT.T..@@@@@@@@@@@@@@@@@.TT.....T...T.@@@@
@@@@@@.....TT..T...T...@@@@@@@@@@@@@@@@...T.TT..T.T.@@@@
@@@@@@@.........T.T...T.@@@@@@@@@@@@@@....T.....TT..@@@@
@@@@@@@@T.TT.TT..T..TTTT.TT@@@@@@@@@.....T...T......@@@@
@@@@@@@@@T..T.T..T............@@.TT..T.....T...T..T@@@@@
@@@@@@@@@@...........T....T..T....T...T..T...TTT..@@@@@@
@@@@@@@@@@@..T...........T...T....T..TT..T.....@.@@@@@@@
@@@@@@@@@@@@@...T.T...............T......T....@@@@@@@@@@
@@@@@@@@@@@@@@@...TT............T..T..T.T.T.@@@@@@@@@@@@
@@@@@@@@@@@@@@@@..................T..TT...@@@@@@@@@@@@@@
@@@@@@@@@@@@@@@@@...T..T........T.TT....@@@@@@@@@@@@@@@@
@@@@@@@@@@@@@@@@@@@...T.T.T.....T...T.T@@@@@@@@@@@@@@@@@
@@@@@@@@@@@@@@@@@@@@@@.T....T.TTT....@@@@@@@@@@@@@@@@@@@
@@@@@@@@@@@@@@@@@@@@@@@@@@@@@@@@@@@@@@@@@@@@@@@@@@@@@@@@
@@@@@@@@@@@@@@@@@@@@@@@@@@@@@@@@@@@@@@@@@@@@@@@@@@@@@@@@
@@@@@@@@@@@@@@@@@@@@@@@@@@@@@@@@@@@@@@@@@@@@@@@@@@@@@@@@
@@@@@@@@@@@@@@@@@@@@@@@@@@@@@@@@@@@@@@@@@@@@@@@@@@@@@@@@
