type octile
height 64
width 64
map
@@@@@@@@@@@@@@@@@@@@@@@@@@@@@@@@@@@@@@@@@@@@@@@@@@@@@@@@@@@@@@@@
@@@@@@@@@@@@@@@@@@@@@@@@@@@@@@@@@@@@@@@@@@@@@@@@@@@@@@@@@@@@@@@@
@@@@@@@@@@@@@@@@@@@@@@@@@@@@@@@@@@@@@@@@@@@@@@@@@@@@@@@@@@@@@@@@
@@@@@@@@@@@@@@@@@@@@@@@@@@@@@@@@@@@@@@@@@@@@@@@@@@@@@@@@@@@@@@@@
@@@@@@@@@@@@@@@@@@@@@@@@@@@@@@@@@@@@@@@@@@@@@@@@@@@@@@@@@@@@@@@@
@@@@@@@@@@@@@@@@@@@@@@@@@@@@@@@@@@@@@@@@@@@@@@@@@@@@@@@@@@@@@@@@
@@@@@@@@@@@@@@@@@@@@@@@@@@@@@@@@@@@@@@@@@@@@@@@@@@@@@@@@@@@@@@@@
@@@@@@@@@@@@@@@@@@@@@@@@@@@@@@@@@@@@@@@@@@@@@@@@@@@@@@@@@@@@@@@@
@@@@@@@@@@@@@@@@@@@@@@@@@@@@@@@@@@@@@@@@@@@@@@@@@@@@@@@@@@@@@@@@
@@@@@@@@@@@@@@@@@@@@@@@@@@@@@@@@@@@@.@@@@@@@@@@@@@@@@@@@@@@@@@@@
@@@@@@@@@@@@@@@@@@@@@@@@@@@@@@@@@@@...@@@@@@@@@@@@@@@@@@@@@@@@@@
@@@@@@@@@@@@@@@@@@@@@@@@@@@@@@@@@@.....@@@@@@@@@@@@@@@@@@@@@@@@@
@@@@@@@@@@@@@@@@@@@@@@@@@@@@@@@@@..T..TT@@@@@@@@@@@@@@@@@@@@@@@@
@@@@@@@@@@@@@@@@@@@@@@@@@@@@@@@........T.@@@@@@@@@@@@@@@@@@@@@@@
@@@@@@@@@@@@@@@@@@@@@@@@@@@@@@T...@@TTT..T@@@@@@@@@@@@@@@@@@@@@@
@@@@@@@@@@@@@@@@@@@@@@@@@@@@@.T...@@@.@@..T@@@@@@@@@@@@@@@@@@@@@
@@@@@@@@@@@@@@@@@@@@@@@@@@@@..T@@@@@@@@@...T@@@@@@@@@@@@@@@@@@@@
@@@@@@@@@@@@@@@@@@@@@@@@@@@....@@@@@@@@T..T..@@@@@@@@@@@@@@@@@@@
@@@@@@@@@@@@@@@@@@@@@@@@@@......@@@@@@@..T....@@@@@@@@@@@@@@@@@@
@@@@@@@@@@@@@@@@@@@@@@@@@.....@@@@@@@@..T.TT...@@@@@@@@@@@@@@@@@
@@@@@@@@@@@@@@@@@@@@@@@@...T..@@@@@@..........T.@@@@@@@@@@@@@@@@
@@@@@@@@@@@@@@@@@@@@@@@@@.....@@@@@@.............@@@@@@@@@@@@@@@
@@@@@@@@@@@@@@@@@@@@@@@@@@T.T..@..@@.T...T........@@@@@@@@@@@@@@
@@@@@@@@@@@@@@@@@@@@@.@@@@@....T..TT.....T..........@@@@@@@@@@@@
@@@@@@@@@@@@@@@@@@@@..T@@@@@...T.....T..T...T.T.....@@@@@@@@@@@@
@@@@@@@@@@@@@@@@@@@T.TT..@@@@...T...T..........T...@@@@@@@@@@@@@
@@@@@@@@@@@@@@@@@@..T.....@@@@T........T........T.@@@@@@@@@@@@@@
@@@@@@@@@@@@@@@@@...@@.....@@@@..T..T.........T..@@@@@@@@@@@@@@@
@@@@@@@@@@@@@@@@..T@@@@T....@@@@....T..T........@@@@@@@@@@@@@@@@
@@@@@@@@@@@@@@@..T@@@@@@.....@@@@.T..T.........@@@@@@@@@@..@@@@@
@@@@@@@@@@@@@@....@@@@@@@..T.T@@@@..TT........@@@@@@@.....T..@@@
@@@@@@@@@@@@...T.@@@@@@@@....TT@@T......T...T..@@@@@T....T..T@@@
@@@@@@@@@@@....@..@@@@@@@@@.T.....T.............@@@..T.T.....@@@
@@@@@@@@@@....@@...@@@@@@@@....TT...@T..TT.T..T..@T..T.T.TT.@@@@
@@@@@@@@@T...@@@@T.T@@@@@@@..T...T.@@@.....T...T.T.....T...@@@@@
@@@@@@@@....@@@@@@...@@@@@@.....T..@@@@.......TT.......T..@@@@@@
@@@@@@@....@@@@@@@@....@@@.T..T.....@@@@..T...T..T...T...@@@@@@@
@@@@@@.....@@@@@@@@@........T........@@@@...TT.....T....@@@@@@@@
@@@@@T......@@@@@@@@@.T.T.T.T..T...T.T@@@@T.T..T.....T.@@@@@@@@@
@@@@...T..T..@@@@@@@@...T.TT..@@@@...T.@@@@..........T@@@@@@@@@@
@@@.........T.@@@@@@@......T.@@@@@@.....T@@@....T..T.@@@@@@@@@@@
@@@T..T....T...@@@@@@.T..T...@@@@@@@......@@@@...T..@@@@@@@@@@@@
@@@@...TTT.TT....TTTTT......T@@@@@@@@@.T...@@@@..T.@@@@@@@@@@@@@
@@@@@.......T......T.......T.@@@@@@@@@@.....@@@@T.@@@@@@@@@@@@@@
@@@@@@..T...............@@@..T.@@@@@@@...T.T.@@@@@@@@@@@@@@@@@@@
@@@@@@@.T.TT.TTTT....T.@@@@@....@@@@@..T.T.T..@@@@@@@@@@@@@@@@@@
@@@@@@@@T..T......T....@@@@@@@.T.@@@...T...T..T@@@@@@@@@@@@@@@@@
@@@@@@@@@..TTTT...T....@@@@@@@@T..@.....T.....@@@@@@@@@@@@@@@@@@
@@@@@@@@@@............T@@@@@@@@@.T..T....T...@@@@@@@@@@@@@@@@@@@
@@@@@@@@@@@.TTT..T.....T@@@@@@@@.....T......@@@@@@@@@@@@@@@@@@@@
@@@@@@@@@@@@....T........@@@@@@@.........T.@@@@@@@@@@@@@@@@@@@@@
@@@@@@@@@@@@@..........T..@@@@@........T..@@@@@@@@@@@@@@@@@@@@@@
@@@@@@@@@@@@@@.....T.......@@T......T....@@@@@@@@@@@@@@@@@@@@@@@
@@@@@@@@@@@@@@@.T.T.........TTT.TT.T..T.@@@@@@@@@@@@@@@@@@@@@@@@
@@@@@@@@@@@@@@@@..T..T..T...T.T....T..T@@@@@@@@@@@@@@@@@@@@@@@@@
@@@@@@@@@@@@@@@@@...T....T.TT.T....TT.@@@@@@@@@@@@@@@@@@@@@@@@@@
@@@@@@@@@@@@@@@@@@...T...........TTT.@@@@@@@@@@@@@@@@@@@@@@@@@@@
@@@@@@@@@@@@@@@@@@@..T.T.....T..T...@@@@@@@@@@@@@@@@@@@@@@@@@@@@
@@@@@@@@@@@@@@@@@@@@...........T...@@@@@@@@@@@@@@@@@@@@@@@@@@@@@
@@@@@@@@@@@@@@@@@@@@@T.T...T..T...@@@@@@@@@@@@@@@@@@@@@@@@@@@@@@
@@@@@@@@@@@@@@@@@@@@@@.T..T....T.@@@@@@@@@@@@@@@@@@@@@@@@@@@@@@@
@@@@@@@@@@@@@@@@@@@@@@@........T@@@@@@@@@@@@@@@@@@@@@@@@@@@@@@@@
@@@@@@@@@@@@@@@@@@@@@@@@....T.T@@@@@@@@@@@@@@@@@@@@@@@@@@@@@@@@@
@@@@@@@@@@@@@@@@@@@@@@@@@@@@@@@@@@@@@@@@@@@@@@@@@@@@@@@@@@@@@@@@
