type octile
height 118
width 112
map
@@@@@@@@@@@@@@@@@@@@@@@@@@@@@@@@@@@@@@@@@@@@@@@@@@@@@@@@@@@@@@@@@@@@@@@@@@@@@@@@@@@@@@@@@@@@@@@@@@@@@@@@@@@@@@@@
@@@@@@@@@@@@@@@@@@@@@@@@@@@@@@@@@@@@@@@@@@@@@@@@@@@@@@@@@@@@@@@@@@@@@@@@@@@@@@@@@@@@@@@@@@@@@@@@@@@@@@@@@@@@@@@@
@@@@@@@@@@@@@@@@@@@@@@@@@@@@@@@@@@@@@@@@@@@@@@@@@@@@@@@@@@@@@@@@@@@@@@@@@@@@@@@@@@@@@@@@@@@@@@@@@@@@@@@@@@@@@@@@
@@@@@@@@@@@@@@@@@@@@@@@@@@@@@@@@@@@@@@@@@@@@@@@@@@@@@@@@@@@@@@@@@@@@@@@@@@@@@@@@@@@@@@@@@@@@@@@@@@@@@@@@@@@@@@@@
@@@@@@@@@@@@@@@@@@@@@@@@@@@@@@@@@@@@@@@@@@@@@@@@@@@@@@@@@@@@@@@@@@@@@@@@@@@@@@@@@@@@@@@@@@@@@@@@@@@@@@@@@@@@@@@@
@@@@@@@@@@@@@@@@@@@@@@@@@@@@@@@@@@@@@@@@@@@@@@@@@@@@@@@@@@@@@@@@@@@@@@@@@@@@@@@@@@@@@@@@@@@@@@@@@@@@@@@@@@@@@@@@
@@@@@@@@@@@@@@@@@@@@@@@@@@@@@@@@@@@@@@@@@@@@@@@@@@@@@@@@@@@@@@@@@@@@@@@@@@@@@@@@@@@@@@@@@@@@@@@@@@@@@@@@@@@@@@@@
@@@@@@@@@@@@@@@@@@@@@@@@@@@@@@@@@@@@@@@@@@@@@@@@@@@@@@@@@@@@@@@@@@@@@@@@@@@@@@@@@@@@@@@@@@@@@@@@@@@@@@@@@@@@@@@@
@@@@@@@@@@@@@@@@@@@@@@@@@@@@@@@@@@@@@@@@@@@@@@@@@@@@@@@@@@@@@@@@@@@@@@@@@@@@@@@@@@@@@@@@@@@@@@@@@@@@@@@@@@@@@@@@
@@@@@@@@@@@@@@@@@@@@@@@@@@@@@@@@@@@@@@@@@@@@@@@@@@@@@@@@@@@@@@@@@@@@@@@@@@@@@@@@@@@@@@@@@@@@@@@@@@@@@@@@@@@@@@@@
@@@@@@@@@@@@@@@@@@@@@@@@@@@@@@@@@@@@@@@@@@@@@@@@@@@@@@@@@@@@@@@@@@@@..@@@@@@@@@@@@@@@@@@@@@@@@@@@@@@@@@@@@@@@@@@
@@@@@@@@@@@@@@@@@@@@@@@@@@@@@@@@@@@@@@@@@@@@@@@@@@@@@@@@@@@@@@@@@@@.T..@@@@@@@@@@@@@@@@@@@@@@@@@@@@@@@@@@@@@@@@@
@@@@@@@@@@@@@@@@@@@@@@@@@@@@@@@@@@@@@@@@@@@@@@@@@@@@@@@@@@@@@@@@@@.....T@@@@@@@@@@@@@@@@@@@@@@@@@@@@@@@@@@@@@@@@
@@@@@@@@@@@@@@@@@@@@@@@@@@@@@@@@@@@@@@@@@@@@@@@@@@@@@@@@@@@@@@@@@........@@@@@@@@@@@@@@@@@@@@@@@@@@@@@@@@@@@@@@@
@@@@@@@@@@@@@@@@@@@@@@@@@@@@@@@@@@@@@@@@@@@@@@@@@@@@@@@@@@@@@@@@....T.....@@@@@@@@@@@@@@@@@@@@@@@@@@@@@@@@@@@@@@
@@@@@@@@@@@@@@@@@@@@@@@@@@@@@@@@@@@@@@@@@@@@@@@@@@@@@@@@@@@@@@@.TT...T.T...@@@@@@@@@@@@@@@@@@@@@@@@@@@@@@@@@@@@@
@@@@@@@@@@@@@@@@@@@@@@@@@@@@@@@@@@@@@@@@@@@@@@@@@@@@@@@@@@@@@@...TTT@...T...@@@@@@@@@@@@@@@@@@@@@@@@@@@@@@@@@@@@
@@@@@@@@@@@@@@@@@@@@@@@@@@@@@@@@@@@@@@@@@@@@@@@@@@@@@@@@@@@@@T.T...@@@......T@@@@@@@@@@@@@@@@@@@@@@@@@@@@@@@@@@@
@@@@@@@@@@@@@@@@@@@@@@@@@@@@@@@@@@@@@@@@@@@@@@@@@@@@@@@@@@@@TT....@@@@@....T.T@@@@@@@@@@@@@@@@@@@@@@@@@@@@@@@@@@
@@@@@@@@@@@@@@@@@@@@@@@@@@@@@@@@@@@@@@@@@@@@@@@@@@@@@@@@@@@..TTT.@@@@@@@.......@@@@@@@@@@@@@@@@@@@@@@@@@@@@@@@@@
@@@@@@@@@@@@@@@@@@@@@@@@@@@@@@@@@@@@@@@@@@@@@@@@@@@@@@@@@@.....T@@@@@@@@@T......@@@@@@@@@@@@@@@@@@@@@@@@@@@@@@@@
@@@@@@@@@@@@@@@@@@@@@@@@@@@@@@@@@@@@@@@@@@@@@@@@@@@@@@@@@.T.T.T@@@@@@@@@@@..T.T.T.@@@@@@@@@@@@@@@@@@@@@@@@@@@@@@
@@@@@@@@@@@@@@@@@@@@@@@@@@@@@@@@@@@@@@@@@@@@@@@@@@@@@@@@..T...@@@@@@@@@@@@@..T.T...@@@@@@@@@@@@@@@@@@@@@@@@@@@@@
@@@@@@@@@@@@@@@@@@@@@@@@@@@@@@@@@@@@@@@@@@@@@@@@@@@@@@@......@@@@@@@@..@@@@@T....TT.@@@@@@@@@@@@@@@@@@@@@@@@@@@@
@@@@@@@@@@@@@@@@@@@@@@@@@@@@@@@@@@@@@@@@@@@@@@@@@@@@@@T.....@@@@@@@T...@@@@@@T.......@@@@@@@@@@@@@@@@@@@@@@@@@@@
@@@@@@@@@@@@@@@@@@@@@@@@@@@@@@@@@@@@@@@@@@@@@@@@@@@@@...T..@@@@@@@.T..T.@@@@@@.TT.T...@@@@@@@@@@@@@@@@@@@@@@@@@@
@@@@@@@@@@@@@@@@@@@@@@@@@@@@@@@@@@@@@@@@@@@@@@@@@@@@......@@@@@@@........@@@@@@....T...@@@@@@@@@@@@@@@@@@@@@@@@@
@@@@@@@@@@@@@@@@@@@@@@@@@@@@@@@@@@@@@@@@@@@@@@@@@@..T..T.@@@@@@@@T........@@@@@@......T.@@@@@@@@@@@@@@@@@@@@@@@@
@@@@@@@@@@@@@@@@@@@@@@@@@@@@@@@@@@@@@@@@@@@@@@@@@T....T.@@@@@@@@..T..@@....T@@@@@..T...T.@@@@@@@@@@@@@@@@@@@@@@@
@@@@@@@@@@@@@@@@@@@@@@@@@@@@@@@@@@@@@@@@@@@@@@@@.......@@@@@@@.T....@@@@.....@@@@@..T..T..@@@@@@@@@@@@@@@@@@@@@@
@@@@@@@@@@@@@@@@@@@@@@@@@@@@@@@@@@@@@@@@@@@@@@@..T.T..@@@@@...T....@@@@@@....T@@@@@........@@@@@@@@@@@@@@@@@@@@@
@@@@@@@@@@@@@@@@@@@@@@@@@@@@@@@@@@@@@@@@@@T@@@...T...@@@@@........@@@@@@@@...T.@@@@@...T....@@@@@@@@@@@@@@@@@@@@
@@@@@@@@@@@@@@@@@@@@@@@@@@@@@@@@@@@@@@@@@...@@........@@@@@.....T@@@@@@@@@......@@@@@........@@@@@@@@@@@@@@@@@@@
@@@@@@@@@@@@@@@@@@@@@@@@@@@@@@@@@@@@@@@@.....@...T.....@@@@@.T..@@@@@@@@.T....T..@@@@@@..T....@@@@@@@@@@@@@@@@@@
@@@@@@@@@@@@@@@@@@@@@@@@@@@@@@@@@@@@@@@..T..@@.@@@T..T..@@@@@..@@@@@@@@@.........T@@@@@@.T..T..@@@@@@@@@@@@@@@@@
@@@@@@@@@@@@@@@@@@@@@@@@@.....TT..@@@@.T...@@@@@@@@.T...T@@@@@@@@@@@@@@@..T...T.T.T@@@@@@.....T.@@@@@@@@@@@@@@@@
@@@@@@@@@@@@@@@@@@@@@@......T......@@@.....@@@@@@@.......T@@@@@@@@@@@T.T.....T@@T.T@@@@@@@TT.T.T.@@@@@@@@@@@@@@@
@@@@@@@@@@@@@@@@@@@@T..T...........@@@..T.@@@@.@@T...T.T...@@@@@@@@@...T.....@@@@..T.@@@@@@TT..TTT@@@@@@@@@@@@@@
@@@@@@@@@@@@@@@@@@@....T...T......@@@@.T..@@@@...T....T....T@@@@@@@..T.T.TTT@@@@@......@@@@@.......@@@@@@@@@@@@@
@@@@@@@@@@@@@@@@@@......T...TTT....@@....@@@@@......@T.....TT@@@@@@TT..T.T.@@@@@@.....T.@@@@.TT.T.T.@@@@@@@@@@@@
@@@@@@@@@@@@@@@@@.......T.T.T......T.....@@@@@...T.@@@.T...T..@@@@@@.T....@@@@@@@...T....@@@@....T..T@@@@@@T.@@@
@@@@@@@@@@@@@@@@...........TTT...T....T.T@@@@@....T....T.....T.@@@@@@....@@@@@@@@T...T....@@@@........@@@@...@@@
@@@@@@@@@@@@@@@.........T...T...........@@@@@.T.T.T..T.@@@.....T@@@@@@..@@@@@@@@..........@@@@@.T.T...T@@....@@@
@@@@@@@@@@@@@@.T.T..............T.....T@@@@@..T....T..@@@@@...T..@@@@@@@@@@@@@....T.T......@@@@@..T..T.....T@@@@
@@@@@@@@@@@@@@.TT......@@@@@@@..T.......@@@..T.........@@@@.......@@@@@@@@@@@.T.....T.@@@...@@@@@T......T..@@@@@
@@@@@@@@@@@@@..T.T.TT.@@@@@@@@@......T.T.@@.............@@TT.......@@@@@@@@.........T@@@@..T@@@@@@T.T......@@@@@
@@@@@@@@@@@@@.TT.TT.T.@@@@@@@@@@T..T.T....@........T......T.TT......@@@@@@...TTT...T@@@@@@.T.@@@@@@......T..@@@@
@@@@@@@@@@@@@.....TT..@@@@@...@@@TT.......@.TT...T...T..T.T.@@.......@@@@@@.T......@@@@@@@...T.@@@@@@...T....@@@
@@@@@@@@@@@@@...T.....@@@@@@.T.@@@..T...T.@@.T.T..........T@@@........@@@@@@...TT.@@@@@@@@...T..@@@@@........@@@
@@@@@@@@@@@@@@..T.....@@@@@@..T.@@@.....T..@@.T......T.....T...T..T....@@@@@@T...@@@@@@@@....TT.@@@@.......T.@@@
@@@@@@@@@@@@@@......T..@@@@@...T.@@@T......T@.T@@.T.............@@......T@@@@@.T@@@@@@@@T......@@@@..T......@@@@
@@@@@@@@@@@@@@@.T......@@@@.T.T...@@@.....TT@TT@@@...T..T..T.T.@@@@.......@@@@@@@@@@@@@.......@@@@........T@@@@@
@@@@@@@@@@@@@@@..T.T....@@@T....T..@@@.T......T@@@........T....@@@@..T.TT..@@@@@@@@@@@...T.TT.@@@..TT...T.@@@@@@
@@@@@@@@@@@@@@@@.TTT.T..@@@.......T.@@.TT.............T.....T...@@..........@@@@@@@...T....TTT@@....T....@@@@@@@
@@@@@@@@@@@@@@@@.......T.T@@........T@@.......T....T.....T.T..T...T.....T....@@@@@T..T.........@...T....@@@@@@@@
@@@@@@@@@@@@@@@@@....T...T.@@.........@...T......TTT............T....@...T....@@@@@...T..@@@..T........@@@@@@@@@
@@@@@@@@@@@@@@@@@@....TT...T@@..T.....@@T......T..T..T...T...TT.....@@@..T.....@@@@@T..T@@@@.....TTT..@@@@@@@@@@
@@@@@@@@@@@@@@@@@@@T...TTTT..@@...T...T....T..T..TT.TTT...T.....T...TT..T.T....T@@@@@..@@@@@T..T.....@@@@@@@@@@@
@@@@@@@@@@@@@@@@@@@@...TT.....@....T....T........T...TT.@@.T..T.T.T.....@@@TT....@@@@@@@@@@.........@@@@@@@@@@@@
@@@@@@@@@@@@@@@@@@@@@....TT...@...T.....T....T....T....@@@.....T.......@@@@@T...T.@@@@@@@@..T.TT...@@@@@@@@@@@@@
@@@@@@@@@@@@@@@@@@@@@@T.T.....@@.........T.T...T...T...@@@.T..........T.@@@T..T.T..@@@@@@.....TT.T@@@@@@@@@@@@@@
@@@@@@@@@@@@@@.@@..@@@@........@..T.T....T..T....T...T.TTT.........T.....@T.TT..T...@@@@.....T...@@@@@@@@@@@@@@@
@@@@@@@@@@@@@....T.T@@@@.T..T..@@T........T...T........T...T...TT..TT.......T........@@T..T..T..@@@@@@@@@@@@@@@@
@@@@@@@@@@@@..T....T.@@@@....T..@.TT...T....T...T....T.T..TTT......T..T..T...@@.......T..T...T.@@@@@@@@@@@@@@@@@
@@@@@@@@@@@T..T...T...@@@@......T.T..T.T.........T...T............TTT.....T.@@@....T..T.....T.@@@@@@@@@@@@@@@@@@
@@@@@@@@@@.....T.T.T...@@@..............T........TT.T..........T...TT........TT....T......T..@@@@@@@@@@@@@@@@@@@
@@@@@@@@@........T.T.T..@@....T....T...T.T..T.......T.....T......@....T........T@@@....T....@@@@@@@@@@@@@@@@@@@@
@@@@@@@@...T....T........@@.......T....T...TT...T...T...........@@@T...T.......@@@@@....T..@@@@@@@@@@@@@@@@@@@@@
@@@@@@@T................T.@......T.T..T....T.TT..T...T...TT...T.@@@T.TT.......T.@@@@......@@@@@@@@@@@@@@@@@@@@@@
@@@@@@....@T..........T.T.....T.T..T......T..T.TTT....TT..............T..T.T....T@@....T.@@@@@@@@@@@@@@@@@@@@@@@
@@@@@...T@@@T.T...T..TT...@@.........T..TTT....T.......T.....T......T.T......T.T..TTT...T@@@@@@@@@@@@@@@@@@@@@@@
@@@@T...@@@@@T...TT.T....@@@....T........T...T.T......T...........T...T.TT.........T.....@@@@@@@@@@@@@@@@@@@@@@@
@@@..TT.@@@@T..TT..T...T.@@@@T.TT.....T.....T.........T...T........TTT....T........T.....@@@@@@@@@@@@@@@@@@@@@@@
@@@@....T@@........T..T............T......T.T...T.T....TT.....T...TTT..T........T..T..T.@@@@@@@@@@@@@@@@@@@@@@@@
@@@@@.......T............T...T.......TT.TT....T.T.T.T.T..T.........T..T..@@T........T...@@@@@@@@@@@@@@@@@@@@@@@@
@@@@@@T.T.....@.........TT...................T.T.T.T..T....TTT....T.T...@@@T.TT.....TT..@@@@@@@@@@@@@@@@@@@@@@@@
@@@@@@@...T..@@@..T....T..T.......T............T.T.......T....T.........@@@@............@@@@@@@@@@@@@@@@@@@@@@@@
@@@@@@@@TTTT.....T...T....T.TT....T..T..............T......T....T......T....T.......TT.@@@@@@@@@@@@@@@@@@@@@@@@@
@@@@@@@@@........@@@....T....T....@@@T.....T........T..T...T..............T....T.T....@@@@@@@@@@@@@@@@@@@@@@@@@@
@@@@@@@@@@..T...@@@@@..T...T..T..T@@@.....T..T.TT........T.T.TTT.T.......T........T.@@@@@@@@@@@@@@@@@@@@@@@@@@@@
@@@@@@@@@@@......@@@@...T.T....T..@@@TT.........T.TTTT..T.........T.......T.....T..@@@@@@@@@@@@@@@@@@@@@@@@@@@@@
@@@@@@@@@@@@..T...@@....T....T...T........T.T...T......T...................T...T..@@@@@@@@@@@@@@@@@@@@@@@@@@@@@@
@@@@@@@@@@@@@.T......T..T...T.....T.....T....T..T....T....T.TTT.TTT.T.....T.T.....@@@@@@@@@@@@@@@@@@@@@@@@@@@@@@
@@@@@@@@@@@@@@T.......@@.T.T..TT.T......TT.T..T...T..T.....T.......TT.....T...T.T@@@@@@@@@@@@@@@@@@@@@@@@@@@@@@@
@@@@@@@@@@@@@@@.......@@.....T...TTT.T...TT....T.....T.T.........T.....T....T..T.@@@@@@@@@@@@@@@@@@@@@@@@@@@@@@@
@@@@@@@@@@@@@@@@............T.......TT..........T..T......T.T..T........T.T.....@@@@@@@@@@@@@@@@@@@@@@@@@@@@@@@@
@@@@@@@@@@@@@@@@@.........@@...T......T....@@..........TT....T...T.T....T.......@@@@@@@@@@@@@@@@@@@@@@@@@@@@@@@@
@@@@@@@@@@@@@@@@@@.T......@@@T.....T...T.T@@@@T.T......T.T............T..T..T..@@@@@@@@@@@@@@@@@@@@@@@@@@@@@@@@@
@@@@@@@@@@@@@@@@@@@T.......T............T.@@@@.T...T.T....T...TT..........TT.@@@@@@@@@@@@@@@@@@@@@@@@@@@@@@@@@@@
@@@@@@@@@@@@@@@@@@@@..TT...........T..T....TT....TTT..T.......T............T@@@@@@@@@@@@@@@@@@@@@@@@@@@@@@@@@@@@
@@@@@@@@@@@@@@@@@@@@@T...T.T.....T..T.T.......T..TT....T.............T.....@@@@@@@@@@@@@@@@@@@@@@@@@@@@@@@@@@@@@
@@@@@@@@@@@@@@@@@@@@@@T....T...@...T...T.......T.........T..T.....T.T.....@@@@@@@@@@@@@@@@@@@@@@@@@@@@@@@@@@@@@@
@@@@@@@@@@@@@@@@@@@@@@@.....T.@@@T..T........T....T...........T.T....T...@@@@@@@@@@@@@@@@@@@@@@@@@@@@@@@@@@@@@@@
@@@@@@@@@@@@@@@@@@@@@@@@.........TT.....T..TT.T........................T@@@@@@@@@@@@@@@@@@@@@@@@@@@@@@@@@@@@@@@@
@@@@@@@@@@@@@@@@@@@@@@@@@T....T...@@@....T.....T..T.@......T......T....@@@@@@@@@@@@@@@@@@@@@@@@@@@@@@@@@@@@@@@@@
@@@@@@@@@@@@@@@@@@@@@@@@@@.T..T.T.@@@......T.T.....@@@T....T..T.....T@@@@@@@@@@@@@@@@@@@@@@@@@@@@@@@@@@@@@@@@@@@
@@@@@@@@@@@@@@@@@@@@@@@@@@@T..T..T.................@@@.......T...@@@@@@@@@@@@@@@@@@@@@@@@@@@@@@@@@@@@@@@@@@@@@@@
@@@@@@@@@@@@@@@@@@@@@@@@@@@@..T........T...T...T......TTT...TT..@@@@@@@@@@@@@@@@@@@@@@@@@@@@@@@@@@@@@@@@@@@@@@@@
@@@@@@@@@@@@@@@@@@@@@@@@@@@@@.T...TT..........TTT..T.....T.....@@@@@@@@@@@@@@@@@@@@@@@@@@@@@@@@@@@@@@@@@@@@@@@@@
@@@@@@@@@@@@@@@@@@@@@@@@@@@@@@T........@......TT.....T........@@@@@@@@@@@@@@@@@@@@@@@@@@@@@@@@@@@@@@@@@@@@@@@@@@
@@@@@@@@@@@@@@@@@@@@@@@@@@@@@@@T..T....@@..................T@@@@@@@@@@@@@@@@@@@@@@@@@@@@@@@@@@@@@@@@@@@@@@@@@@@@
@@@@@@@@@@@@@@@@@@@@@@@@@@@@@@@@....TT..T.T...T..T...T....@@@@@@@@@@@@@@@@@@@@@@@@@@@@@@@@@@@@@@@@@@@@@@@@@@@@@@
@@@@@@@@@@@@@@@@@@@@@@@@@@@@@@@@@.........@@@..T........@@@@@@@@@@@@@@@@@@@@@@@@@@@@@@@@@@@@@@@@@@@@@@@@@@@@@@@@
@@@@@@@@@@@@@@@@@@@@@@@@@@@@@@@@@@.TT.....@@@...T.T..@@@@@@@@@@@@@@@@@@@@@@@@@@@@@@@@@@@@@@@@@@@@@@@@@@@@@@@@@@@
@@@@@@@@@@@@@@@@@@@@@@@@@@@@@@@@@@@.T....T...T.....@@@@@@@@@@@@@@@@@@@@@@@@@@@@@@@@@@@@@@@@@@@@@@@@@@@@@@@@@@@@@
@@@@@@@@@@@@@@@@@@@@@@@@@@@@@@@@@@@@@...T..TTT....@@@@@@@@@@@@@@@@@@@@@@@@@@@@@@@@@@@@@@@@@@@@@@@@@@@@@@@@@@@@@@
@@@@@@@@@@@@@@@@@@@@@@@@@@@@@@@@@@@@@@@..........@@@@@@@@@@@@@@@@@@@@@@@@@@@@@@@@@@@@@@@@@@@@@@@@@@@@@@@@@@@@@@@
@@@@@@@@@@@@@@@@@@@@@@@@@@@@@@@@@@@@@@@@........@@@@@@@@@@@@@@@@@@@@@@@@@@@@@@@@@@@@@@@@@@@@@@@@@@@@@@@@@@@@@@@@
@@@@@@@@@@@@@@@@@@@@@@@@@@@@@@@@@@@@@@@@@T.T.T@@@@@@@@@@@@@@@@@@@@@@@@@@@@@@@@@@@@@@@@@@@@@@@@@@@@@@@@@@@@@@@@@@
@@@@@@@@@@@@@@@@@@@@@@@@@@@@@@@@@@@@@@@@@@...@@@@@@@@@@@@@@@@@@@@@@@@@@@@@@@@@@@@@@@@@@@@@@@@@@@@@@@@@@@@@@@@@@@
@@@@@@@@@@@@@@@@@@@@@@@@@@@@@@@@@@@@@@@@@@@@@@@@@@@@@@@@@@@@@@@@@@@@@@@@@@@@@@@@@@@@@@@@@@@@@@@@@@@@@@@@@@@@@@@@
@@@@@@@@@@@@@@@@@@@@@@@@@@@@@@@@@@@@@@@@@@@@@@@@@@@@@@@@@@@@@@@@@@@@@@@@@@@@@@@@@@@@@@@@@@@@@@@@@@@@@@@@@@@@@@@@
@@@@@@@@@@@@@@@@@@@@@@@@@@@@@@@@@@@@@@@@@@@@@@@@@@@@@@@@@@@@@@@@@@@@@@@@@@@@@@@@@@@@@@@@@@@@@@@@@@@@@@@@@@@@@@@@
@@@@@@@@@@@@@@@@@@@@@@@@@@@@@@@@@@@@@@@@@@@@@@@@@@@@@@@@@@@@@@@@@@@@@@@@@@@@@@@@@@@@@@@@@@@@@@@@@@@@@@@@@@@@@@@@
@@@@@@@@@@@@@@@@@@@@@@@@@@@@@@@@@@@@@@@@@@@@@@@@@@@@@@@@@@@@@@@@@@@@@@@@@@@@@@@@@@@@@@@@@@@@@@@@@@@@@@@@@@@@@@@@
@@@@@@@@@@@@@@@@@@@@@@@@@@@@@@@@@@@@@@@@@@@@@@@@@@@@@@@@@@@@@@@@@@@@@@@@@@@@@@@@@@@@@@@@@@@@@@@@@@@@@@@@@@@@@@@@
@@@@@@@@@@@@@@@@@@@@@@@@@@@@@@@@@@@@@@@@@@@@@@@@@@@@@@@@@@@@@@@@@@@@@@@@@@@@@@@@@@@@@@@@@@@@@@@@@@@@@@@@@@@@@@@@
@@@@@@@@@@@@@@@@@@@@@@@@@@@@@@@@@@@@@@@@@@@@@@@@@@@@@@@@@@@@@@@@@@@@@@@@@@@@@@@@@@@@@@@@@@@@@@@@@@@@@@@@@@@@@@@@
