type octile
height 150
width 140
map
@@@@@@@@@@@@@@@@@@@@@@@@@@@@@@@@@@@@@@@@@@@@@@@@@@@@@@@@@@@@@@@@@@@@@@@@@@@@@@@@@@@@@@@@@@@@@@@@@@@@@@@@@@@@@@@@@@@@@@@@@@@@@@@@@@@@@@@@@@@@
@...T.T@@@@@@@@@@@@@@@@@@@@@@@@@@@@@@@@@@@@@@@@@@@@@@@@@@@@@@@@@@@@@@@@@@@@@@@@@@@@@@@@@@@@@@@@@@@@@@@@@@@@@@@@@@@@@@@@@@@@@@@@@@@@@@@@@@@@@
@......@@@@@@@@@@@@@@@@@@@@@@@@@@@@@@@@@@@@@@@@@@@@@@@@@@@@@@@@@@@@@@@@@@@@@@@@@@@@@@@@@@@@@@@@@@@@@@@@@@@@@@@@@@@@@@@@@@@@@@@@@@@@@@@@@@@@@
@..T..T@@@@@@@@@@@@@@@@@@@@@@@@@@@@@@@@@@@@@@@@@@@@@@@@@@@@@@@@@@@@@@@@@@@@@@@@@@@@@@@@@@@@@@@@@@@@@@@@@@@@@@@@@@@@@@@@@@@@@@@@@@@@@@@@@@@@@
@..T...@@@@@@@@@@@@@@@@@@@@@@@@@@@@@@@@@@@@@@@@@@@@@@@@@@@@@@@@@@@@@@@@@@@@@@@@@@@@@@@@@@@@@@@@@@@@@@@@@@@@@@@@@@@@@@@@@@@@@@@@@@@@@@@@@@@@@
@T.....@@@@@@@@@@@@@@@@@@@@@@@@@@@@@@@@@@@@@@@@@@@@@@@@@@@@@@@@@@@@@@@@@@@@@@@@@@@@@@@@@@@@@@@@@@@@@@@@@@@@@@@@@@@@@@@@@@@@@@@@@@@@@@@@@@@@@
@...T..@@@@@@@@@@@@@@@@@@@@@@@@@@@@@@@@@@@@@@@@@@@@@@@@@@@@@@@@@@@@@@@@@@@@@@@@@@@@@@@@@@@@@@@@@@@@@@@@@@@@@@@@@@@@@@@@@@@@@@@@@@@@@@@@@@@@@
@@@@@@@@@@@@@@@@@@@@@@@@@@@@@@@@@@@@@@@@@@@@@@@@@@@@@@@@@@@@@@@@@@@@@@@@@@@@@@@@@@@@@@@@@@@@@@@@@@@@@@@@@@@@@@@@@@@@@@@@@@@@@@@@@@@@@@@@@@@@
@@@@@@@@@@@@@@@@@@@@@@@@@@@@@@@@@@@@@@@@@@@@@@@@@@@@@@@@@@@@@@@@@@@@@@@@@@@@@@@@@@@@@@@@@@@@@@@@@@@@@@@@@@@@@@@@@@@@@@@@@@@@@@@@@@@@@@@@@@@@
@@@@@@@@@@@@@@@@@@@@@@@@@@@@@@@@@@@@@@@@@@@@@@@@@@@@@@@@@@@@@@@@@@@@@@@@@@@@@@@@@@@@@@@@@@@@@@@@@@@@@@@@@@@@@@@@@@@@@@@@@@@@@@@@@@@@@@@@@@@@
@@@@@@@@@@@@@@@@@@@@@@@@@@@@@@@@@@@@@@@@@@@@@@@@@@@@@@@@@@@@@@@@@@@@@@@@@@@@@@@@@@@@@@@@@@@@@@@@@@@@@@@@@@@@@@@@@@@@@@@@@@@@@@@@@@@@@@@@@@@@
@@@@@@@@@@@@@@@@@@@@@@@@@@@@@@@@@@@@@@@@@@@@@@@@@@@@@@@@@@@@@@@@@@@@@@@@@@@@@@@@@@@@@@@@@@@@@@@@@@@@@@@@@@@@@@@@@@@@@@@@@@@@@@@@@@@@@@@@@@@@
@@@@@@@@@@@@@@@@@@@@@@@@@@@@@@@@@@@@@@@@@@@@@@@@@@@@@@@@@@@@@@@@@@@@@@@@@@@@@@@@@@@@@@@.@@@@@@@@@@@@@@@@@@@@@@@@@@@@@@@@@@@@@@@@@@@@@@@@@@@@
@@@@@@@@@@@@@@@@@@@@@@@@@@@@@@@@@@@@@@@@@@@@@@@@@@@@@@@@@@@@@@@@@@@@@@@@@@@@@@@@@@@@@@TT@@@@@@@@@@@@@@@@@@@@@@@@@@@@@@@@@@@@@@@@@@@@@@@@@@@@
@@@@@@@@@@@@@@@@@@@@@@@@@@@@@@@@@@@@@@@@@@@@@@@@@@@@@@@@@@@@@@@@@@@@@@@@@@@@@@@@@@@@@..T.@@@@@@@@@@@@@@@@@@@@@@@@@@@@@@@@@@@@@@@@@@@@@@@@@@@
@@@@@@@@@@@@@@@@@@@@@@@@@@@@@@@@@@@@@@@@@@@@@@@@@@@@@@@@@@@@@@@@@@@@@@@@@@@@@@@@@@@@.T..T.@@@@@@@@@@@@@@@@@@@@@@@@@@@@@@@@@@@@@@@@@@@@@@@@@@
@@@@@@@@@@@@@@@@@@@@@@@@@@@@@@@@@@@@@@@@@@@@@@@@@@@@@@@@@@@@@@@@@@@@@@@@@@@@@@@@@@@.T..T...@@@@@@@@@@@@@@@@@@@@@@@@@@@@@@@@@@@@@@@@@@@@@@@@@
@@@@@@@@@@@@@@@@@@@@@@@@@@@@@@@@@@@@@@@@@@@@@@@@@@@@@@@@@@@@@@@@@@@@@@@@@@@@@@@@@@@@.......@@@@@@@@@@@@@@@@@@@@@@@@@@@@@@@@@@@@@@@@@@@@@@@@@
@@@@@@@@@@@@@@@@@@@@@@@@@@@@@@@@@@@@@@@@@@@@@@@@@@@@@@@@@@@@@@@@@@@@@@@@@@@@@@@@@@@@@.T.TT.T.@@@@@@@@@@@@@@@@@@@@@@@@@@@@@@@@@@@@@@@@@@@@@@@
@@@@@@@@@@@@@@@@@@@@@@@@@@@@@@@@@@@@@@@@@@@@@@@@@@@@@@@@@@@@@@@@@@@@@@@@@@@@@@@@@@@@@@..T..T..@@@@@@@@@@@@@@@@@@@@@@@@@@@@@@@@@@@@@@@@@@@@@@
@@@@@@@@@@@@@@@@@@@@@@@@@@@@@@@@@@@@@@@@@@@@@@@@@@@@@@@@@@@@@@@@.@@@@@@@@@@@@@@@@@@@@@@.......T@@@@@@@@@@@@@@@@@@@@@@@@@@@@@@@@@@@@@@@@@@@@@
@@@@@@@@@@@@@@@@@@@@@@@@@@@@@@@@@@@@@@@@@@@@@@@@@@@@@@@@@@@@@@@....@@@@@@@@@@@@@@@@@@@@@...T..T.@@@@@@@@@@@@@@@@@@@@@@@@@@@@@@@@@@@@@@@@@@@@
@@@@@@@@@@@@@@@@@@@@@@@@@@@@@@@@@@@@@@@@@@@@@@@@@@@@@@@@@@@@@@@.....@@@@@@@@@@@@@@@@@@@@@T.......T@@@@@@@@@@@@@@@@@@@@@@@@@@@@@@@@@@@@@@@@@@
@@@@@@@@@@@@@@@@@@@@@@@@@@@@@@@@@@@@@@@@@@@@@@@@@@@@@@@@@@@@@@....T.T@@@@@@@@@@@@@@@@@@@@@........T@@@@@@@@@@@@@@@@@@@@@@@@@@@@@@@@@@@@@@@@@
@@@@@@@@@@@@@@@@@@@@@@@@@@@@@@@@@@@@@@@@@@@@@@@@@@@@@@@@@@@@.T.T@@....@@@@@@@@@@@@@@@@@@@@@.....T...@@@@@@@@@@@@@@@@@@@@@@@@@@@@@@@@@@@@@@@@
@@@@@@@@@@@@@@@@@@@@@@@@@@@@@@@@@@@@@@@@@@@@@@@@@@@@@@@@@@@..T.@@@@...T.@@@@@@@@@@@@@@@@@@@@...T.....@@@@@@@@@@@@@@@@@@@@@@@@@@@@@@@@@@@@@@@
@@@@@@@@@@@@@@@@@@@@@@@@@@@@@@@@@@@@@@@@@@@@@@@@@@@@@@@@@@....@@@@@@..T..@@@@@@@@@@@@@@@@@@@@.T..T....@@@@@@@@@@@@@@@@@@@@@@@@@@@@@@@@@@@@@@
@@@@@@@@@@@@@@@@@@@@@@@@@@@@@@@@@@@@@@@@@@@@@@@@@@@@@@@@@....@@@@@@@@T.T..@@@@@@@@@@@@@@@@@@@@T..T...T.@@@@@@@@@@@@@@@@@@@@@@@@@@@@@@@@@@@@@
@@@@@@@@@@@@@@@@@@@@@@@@@@@@@@@@@@@@@@@@@@@@@@@@@@@@@@@@...T@@@@@@@@@@...T.@@@@@@@@@@@@@@@@@@@@..TT.....@@@@@@@@@@@@@@@@@@@@@@@@@@@@@@@@@@@@
@@@@@@@@@@@@@@@@@@@@@@@@@@@@@@@@@@@@@@@@@@@@@@@@@@@@@@@..TT@@@@@@@@@@@@.....@@@@@@@@@@@@@@@@@@......T..T@@@@@@@@@@@@@@@@@@@@@@@@@@@@@@@@@@@@
@@@@@@@@@@@@@@@@@@@@@@@@@@@@@@@@@@@@@@@@@@@@@@@@@@@@@TT...@@@@@@@@@@@@@..T...@@@@@@@@@@@@@@@@..T.....TT@@@@@@@@@@@@@@@@@@@@@@@@@@@@@@@@@@@@@
@@@@@@@@@@@@@@@@@@@@@@@@@@@@@@@@@@@@@@@@@@@@@@@@@@@@...TT@@@@@@@@@@@@@@T......@@@@@@@@@@@@@@T.T...T..T@@@@@@@@@@@@@@@@@@@@@@@@@@@@@@@@@@@@@@
@@@@@@@@@@@@@@@@@@@@@@@@@@@@@@@@@@@@@@@@@@@@@@@@@@@.....@@@@@@@@@@@@@@@...T....@@@@@@@@@@@@T..T....T.@@@@@@@@@@@@@@@@@@@@@@@@@@@@@@@@@@@@@@@
@@@@@@@@@@@@@@@@@@@@@@@@@@@@@@@@@@@@@@@@@@@@@@@@@@.TT..@@@@@@@@.T@@@@@@.T.......@@@@@@@@@@..T.....T.@@@@@@@@@@@@@@@@@@@@@@@@@@@@@@@@@@@@@@@@
@@@@@@@@@@@@@@@@@@@@@@@@@@@@@@@@@@@@@@@@@@@@@@@@@.....@@@@@@@@@...T@@@@..T....T.@@@@@@@@@.T........@@@@@@@@@@@@@@@@@@@@@@@@@@@@@@@@@@@@@@@@@
@@@@@@@@@@@@@@@@@@@@@@@@@@@@@@@@@@@@@@@@@@@@@@@@.....@@@@@@@@@@...TT........@@T.T@@@@@@@TT....T..T@@@@@@@@@@@@@@@@@@@@@@@@@@@@@@@@@@@@@@@@@@
@@@@@@@@@@@@@@@@@@@@@@@@@@@@@@@@@@@@@@@@@@@@@@@....@@@@@@@@@@@.........T..@@@@@....@@@@.T........@@@@@@@@@@@@@@@@@@@@@@@@@@@@@@@@@@@@@@@@@@@
@@@@@@@@@@@@@@@@@@@@@@@@@@@@@@@@@@@@@@@@@@@@@@.T..@@@@@@@@@@@...T...TT...@@@@@@@T...@@....T...T.@@@@@@@@@@@@@@@@@@@@@@@@@@@@@@@@@@@@@@@@@@@@
@@@@@@@@@@@@@@@@@@@@@@@@@@@@@@@@@@@@@@@@@@@@@...T@@@@@@@@@@@....T......T.@@@@@@@@....T....T..T@@@@@@@@@@@@@@@@@@@@@@@@@@@@@@@@@@@@@@@@@@@@@@
@@@@@@@@@@@@@@@@@@@@@@@@@@@@@@@@@@@@@@@@@@@@..T.@@@@@@@@@@@......T..T.T..@@@@@@@@@.....T...T.@@@@@@@@@@@@@@@@@@@@@@@@@@@@@@@@@@@@@@@@@@@@@@@
@@@@@@@@@@@@@@@@@@@@@@@@@@@@@@@@@@@@@@@@@@@....@@@@@@@@@@@@T.T..T..T.....T@@@@@@@@@.......T.@@@@@@@@@@@@@@@@@@@@@@@@@@@@@@@@@@@@@@@@@@@@@@@@
@@@@@@@@@@@@@@@@@@@@@@@@@@@@@@@@@@@@@@@@@@....@@@@@@@@@@@@@@......T....T..@@@@@@@@@@.......@@@@@@@@@@@@@@@@@@@@..@@@@@@@@@@@@@@@@@@@@@@@@@@@
@@@@@@@@@@@@@@@@@@@@@@@@@@@@@@@@@@@@@@@@@....@@@@@@@@@@@@@@@@.TT...........@@@@@@@@@@T..T.@@@@@@@@@@@@@@@@@@@@.T..@@@@@@@@@@@@@@@@@@@@@@@@@@
@@@@@@@@@@@@@@@@@@@@@@@@@@@@@@@@@@@@@@@@..T.@@@@@@@@@@@@@@@@@@TT...........@@@@@@@@@@@.T...@@@@@@@@@@@@@@@@@@..T...@@@@@@@@@@@@@@@@@@@@@@@@@
@@@@@@@@@@@@@@@@@@@@@@@@@@@@@@@@@@@@@@@TT..@@@@@@@@@@@@@@@@@@@@.T........T.@@@@@@@@@@@@T...@@@@@@@@@@@@@@@@@...T..T.@@@@@@@@@@@@@@@@@@@@@@@@
@@@@@@@@@@@@@@@@@@@@@@@@@@@@@@@@@@@@@@T...@@@@@@@@@@@@@@@@@@@@@@.....T....@@@@@@@@@@@@@...T.@@@@@@@@@@@@@@@.T........@@@@@@@@@@@@@@@@@@@@@@@
@@@@@@@@@@@@@@@@@@@@@@@@@@@@@@@@@@@@@T...@@@@@@@@@@@@@@@@@@@@@@@@T.......@@@@@@@@@@@@@@@.....@@@@@@@@@@@@@.TT......T.T@@@@@@@@@@@@@@@@@@@@@@
@@@@@@@@@@@@@@@@@@@@@@@@@@@@@@@@@@@....T@@@@@@@@@@@@@@@@@@@@@@@@@@T.....@@@@@@@@@@@@@@@@......@@@@@@@@@@@......T.TT....@@@@@@@@@@@@@@@@@@@@@
@@@@@@@@@@@@@@@@@@@@@@@@@@@@@@@@@@.T...@@@@@@@@@@@@@@@@@@@@@@@@@@@@....@@@@@@@@@@@@@@@@@........@@@@@@@@T.......TT.T.T..@@@@@@@@@@@@@@@@@@@@
@@@@@@@@@@@@@@@@@@@@@@@@@@@@@@@@@T....@@@@@@@@@@@@@@@@@@@@@@@@@@@@@@..@@@@@@@@@@..@@@@@@T.......T@@@@@@..T...............@@@@@@@@@@@@@@@@@@@
@@@@@@@@@@@@@@@@@@@@@@@@@@@@@@@@T.T..@@@@@@@@@@@@@@@@@@@@@@@@@@@@@@@@@@@@@@@@@@.....@@@T.T...@....@@@@T.T..T......T......T@@@@@@@@@@@@@@@@@@
@@@@@@@@@@@@@@@@@@@@@@@@@@@@@@@@....@@@@@@@@@@@@@@@@@@@@@..@@@@@@@@@@@@@@@@@@@...T......T...@@@.T.T@@@...T@......T......T..@@@@@@@@@@@@@@@@@
@@@@@@@@@@@@@@@@@@@@@@@@@@@@@@@@...@@@@@@@@@@@@@@@@@@@@@...T@@@@@@@@@@@@@@@@@TT.T.T......T.@@@@@.T.T@@...@@@.....T.TT..T.T..@@@@@@@@@@@@@@@@
@@@@@@@@@@@@@@@@@@@@@@@@@@@@@@@.T@@@@@@@@@@@@@@@@@@@@@@@.T..@@@@@@@@@@@@@@@@..T..T....TT..@@@@@@@.T.....@@@@@@T........T.....@@@@@@@@@@@@@@@
@@@@@@@@@@@@@@@@@@@@@@@@@@@@@@..@@@@@@@@@@@@@...T@@@@@@@...T@@@@@@@@@@@@@@@.T..T.....T...@@@@@@@@@......@@@@@@@..T.TT..T..T.T.@@@@@@@@@@@@@@
@@@@@@@@@@@@@@@@@@@@@@@@@@@@@..@@@@@@@@@@@@@......T@@@@@@..@@@@@@@@@@@@@@@@..............T@@@@@@@@@.T.T.@@@@@@@@........TTT..@@@@@@@@@@@@@@@
@@@@@@@@@@@@@@@@@@@@@@@@@@@T..@@@@@@@@@@@@@@......T@@@@@@@@@@@@@@@@@@@@@@@@@..............@@@@@@@@@@....T@@@@@@@@..TTT.T....@@@@@@@@@@@@@@@@
@@@@@@@@@@@@@@@@@@@@@@@@@@..T@@@@@@@@@@@@@@@.......@@@@@@@@@@@@@@@@@@@@@@@@@@.......T....T.@@@@@@@@@@.....@@@@@@@@.T.......@@@@@@@@@@@@@@@@@
@@@@@@@@@@@@@@@@@@@@@@@@@@.T@@@@@@@@@@@@@@@@...TT.@@@@@@@@@@@@@@@@@@@@@@@@@@@@T.....TT...T..@@@@@@@@@@@TTTT@@@@@@@@..T....@@@@@@@@@@@@@@@@@@
@@@@@@@@@@@@@@@@@@@@@@@....@@@@@@@@@@@@@@@@@@..T.@@@@@@@@@@@@@@@@@@@@@@@@@@@@@@.............@@@@@@@@@@@@T..T@@@@@@@@@..TT@@@@@@@@@@@@@@@@@@@
@@@@@@@@@@@@@@@@@@@@@@T...@@@@@@@@@@@@@@@@@@@@@@@@@@@@@@@@@@@@@@@@@@@@@@@@@@@@@@......T..TT@@@@@@@@@@@@@@..TT@@@@@@@@@..@@@@@@@@@@@@@@@@@@@@
@@@@@@@@@@@@@@@@@@@@@....@@@@@@@@@@@@@@@@@@@@@@@@@@@@@@@@@@@@@@@@@.TT.@@@@@@@@@@@.T.......@@@@@@@@@@@@@@@@....@@@@@@@@@@@@@@@@@@@@@@@@@@@@@@
@@@@@@@@@@@@@@@@@@@@.T..@@@@@@@@@@@@@@@@@@@@@@@@@@@@T@@@@@@@@@@@@@T.TT@@@@@@@@@@@@.......@@@@@@@@@@@@@@@@@..T..@@@@@@@@@@@@@@@@@@@@@@@@@@@@@
@@@@@@@@@@@@@@@@@@@..TT@@@@@@@@@@@@@@@@@@@@@@@@@@@@..T@@@@@@@@@@@@T....@@@@@@@@@@@@.T..T@@@@@@@@@@@@@@@@@@..T...@@@@@@@@@@@@@@@@@@@@@@@@@@@@
@@@@@@@@@@@@@@@@@@...T@@@@@@@@@@@@@@@@@@@@@@@@@@@......@@@@@@@@@@@@.T.@@@@@@@@@@@@@@...@@@@@@@@@@@@@@@@@@@.......@@@@@@@@@@@@@@@@@@@@@@@@@@@
@@@@@@@@@@@@@@@@@T.T.T@@@@@@@@@@@@@@@@@@@@@@@@....TT..TT@@@@@@@@@@@@@@@@@@@@@@@@@@@@@@@@@@@@@@@@@..T@@@@@@.......T@@@@@@@@@@@@@@@@@@@@@@@@@@
@@@@@@@@@@@@@@@@......@@@@@@@@@@@@@@@@@@@@@@@@@..........@@@@@@@@@@@@@@@@@@@@@@@@@@@@@@@@@@@@@@@.....@@@@@...T.....@@@@@@@@@@@@@@@@@@@@@@@@@
@@@@@@@@@@@@@@@.T....@@@@@@@@@@@@@@@@@@@@@@@@@@.T....T.T.T@@@@@@@@@@@@@@@@@@@@@@@@@@@@@@@@@@@@@TT......@@@.....@....@@@@@@@@@@@@@@@@@@@@@@@@
@@@@@@@@@@@@@@T......@@@@@@@@@@@@@@@@@@@@@@@@@@@@@@@T..T..T@@@@@@@@@@@@@@@@@@@@@@@@@@@@@@@@@@.T.T.T.....T.....@@@T.T.@@@@@@@@@@@@@@@@@@@@@@@
@@@@@@@@@@@@@........@@@@@@@@@@@@@@@@@@@@@@@@@@@@@@@@T...T..@@@@@@@@@@@@@@@@@@@@@@@@@@@@@@@@T..T......TT...T.@@@@@....@@@@@@@@@@@@@@@@@@@@@@
@@@@@@@@@@@@.........@@@@@@@@@@@@@@@@@@@@@@@@@@@@@@@@@TT.......@@@@@@@@@@@@@@.T@@@@@@@@@@@@..T..T...........@@@@@@@....@@@@@@@@@@@@@@@@@@@@@
@@@@@@@@@@@..........T@@@@@@@@@@@@@@@@@@@@@@@@@@@@@@@@@@@T..TT.@@@@@@@@@@@@@...T@@@@@@@@@@@.TT......T...T...@@@@@@@@.T.T@@@@@@@@@@@@@@@@@@@@
@@@@@@@@@@.......@.....@@@@@.@@@@@@@@@@@@@@@@@@@@@@@@@@@@.T...T.@@@@@@@@@@@@.TT.@@@@@@@@@@@@.....T.......T....@@@@@@@.T..@@@@@@@@@@@@@@@@@@@
@@@@@@@@@.......@@@..TT.@@@...@@@@@@@.@@@@@@@@T..@@@@@@@.........@@@T@@@@@@@.T..@@@@@@@@@@@@@..T..T...T......T@@@@@@@@....@@@@@@@@@@@@@@@@@@
@@@@@@@@.......@@@@@.....@@T.........@@@@@@@@T..T.@@@@@@@T.T....T..TT@@@@@@@...@@@@@@@@@@@@@@@.......T....T..T@@@@@@@@@....@@@@@@@@@@@@@@@@@
@@@@@@@T.T....@@@@@@@..T...TT...T....@@@@@@@@.T...@@@@@@@@.....T.TT@@@@@@@@@@@@@@@@@@@@@@@@@@@@..............@@@@@@@@@@@TT.T@@@@@@@@@@@@@@@@
@@@@@@T.....TT@@@@@@@@.......T..T...T@@@@@@@@....@@@@@@@@@....T....@@@@@@@@@@@@@@@@@@@@@@@@@@@@@......TT....@@@@@@@@@@@@@T...@@@@@@@@@@@@@@@
@@@@@T....TT...@@@@@@@@..............@@@@@@@@@@@@@..@@@@@@.T.T......@@@@@@@@@@@@@@@@@@@@@@@@@@@@@..TT...T..@@@@@@@@@@@@@@@..T.@@@@@@@@@@@@@@
@@@@@TT.......T.@@@@@@@@......T......@@@@@@@@@@@@....@@@@@T..........@@@..@@@@@@@@@@@@@@@@@@@@@@@@....T...@@@@@@@@@@@@@@@@@.....@@@@@@@@@@@@
@@@@@@T.........@@@@@@@@@...T.TT...T.@@@@@@@@@@@T.TT..@@@@..T.........@..@@@@@@@@@@@@@@@@@@@@@@@@@@@.....@@@@@@@@..T@@@@@@@@.T...@@@@@@@@@@@
@@@@@@@..........@@@@@@@@@T.....T...@@@@@@@@@@@@@.....@@@.......TTT......@@@@@@@@@@@@@@...@@@@@@@@@@@..T@@@@@@@@@..T@@@@@@@@@T..T.@@@@@@@@@@
@@@@@@@@.......TT..@@@@@@@@..........@@@@@@@@@@@@@...T.@@.........T.......@@@@@@@@@@@@T..T@@@@@@@@@@@@@@@@@@@@@@@...@@@@@@@@@@..T..@@@@@@@@@
@@@@@@@@@.......TTT.@@@@@@@@.....TTTT@@@@@@@@@@@@@.T...@T....TT......T..T.@@@@@@@@@@@@T...@@@@@@@@@@@@@@@@@@@@@@@.T..@@@@@@@@@TT..T.@@@@@@@@
@@@@@@@@@@....T.T....@@@@@@@@.......TTT@@@@@@@@@@@@.....T.......T..TT.......@@@@@@@@@@.TTT@@@@@@@@@@@@@@@@@@@@@..T..T.T@@@@@@@.TT....@@@@@@@
@@@@@@@@@@@..........T@@@@@@@@......T..@@@@@@@@@@@@@.....T...T.......TT.T.T..@@@@@@@@@@@@@@@@@@@@@@@@@@@@@@@@@....T.T.T@@.@@@@@TTT....@@@@@@
@@@@@@@@@@@@..T...T..TT@@@@@@@@........@@@@@@@@@@@@@.............T............@@@@@@@@@@@@@@@@@@@@@@@@@@@@@...........T....T@@@......TT@@@@@
@@@@@@@@@@@@@....T......@@@@@@@@..T...T@@@@@@@@@@@@@...TT.T.......TT......TTT.@@@@@@@@@@@@@@@@@@@@@@@@@@@@@@.T......T..T..T.@@@..T...T.T@@@@
@@@@@@@@@@@@@@...........@@@@@@@@...T.T.......@@@@@...........T..TT......T...T.@@@@@@@@@@@@@@@@@@@@@@@@@@@@@@...T.......T...@@@......TT@@@@@
@@@@@@@@@@@@@@@.T.....T..T@@@@@@@@TT..............................T......TT........@@@@@@@@@@@@@@@@@@@@@@@@@@@......@@@@.T..@@..T.....@@@@@@
@@@@@@@@@@@@@@@@TTTTT..T...@@@@@@@@@........T.......T...................T......T...@@@@@@@@@@@@@@@@@@@@@@@@@@@@...T@@@@@@.T.........T@@@@@@@
@@@@@@@@@@@@@@@@@T.........T@@@@@@@@@..T.TT.T.....T..T..T.............T...T........@@@@@@@@@@@@@@@@@@@@@@@@@@@@@..@@@@@@@@...T.T.T.T@@@@@@@@
@@@@@@@@@@@@@@@@@@.T....T....@@@@@@@@@......T..T...T...........T.T.TT....T..T..T.T.@@@@@@@@@@@@@@@@@@..@@@@@@@@@@@@@@@@@@........TT@@@@@@@@@
@@@@@@@@@@@@@@@@@@@..........T@@@@@@@@@.................TTT........T.T.T.T....T..T....@@@@@@@@@@@@@@.T.T@@@@@@@@@@@@@@@@@..T.....T@@@@@@@@@@
@@@@@@@@@@@@@@@@@@@@...........@@@@@@@@@.T.................T.........T.........T...T..@@@@@@@@@@@@@@@...@@@@@@@@@@@@@@@@T....T..T@@@@@@@@@@@
@@@@@@@@@@@@@@@@@@@@@....T....T.@@@@@@@@@..TT............T....TT.................T...@@@@@@@@@@@@@@@...T.@@@@@@@@@@@@@@T.TT.....@@@@@@@@@@@@
@@@@@@@@@@@@@@@@@@@@@@T...T..T..T@@@@@@@@@.....T.............T.............TTTT...T.@@@@@@@@@@@@@@@T.....@@@@@@@@@@@@@T........@@@@@@@@@@@@@
@@@@@@@@@@@@@@@@@@@@@@@@T...T.....@@@@@@@@@....T..............TT....T..T.T...T....T@@@@@@@@@@@@.@@TT....T....@@@@@@@@.....TT..@@@@@@@@@@@@@@
@@@@@@@@@@@@@@@@@@@@@@@@@....T......@@@@@@@@......T.......TT...TT.T.............T.T.@@@@@@@@@@@..TT.T.T.....@@@@@@@@.....T...@@@@@@@@@@@@@@@
@@@@@@@@@@@@@@@@@@@@@@@@@@.T........T@@@@@@@@.........TTT...TT.T.T.T...T.....T..T...@@@@@@@@@@@.....T...T...@@@@@@@TT....T..@@@@@@@@@@@@@@@@
@@@@@@@@@@@@@@@@@@@@@@@@@@.........T.T@@@@@@@@.......T.T...T.......T..T...T.....@TT.@@@@@@@@@@@@..T.....TT..@@@@@@..TT.....@@@@@@@@@@@@@@@@@
@@@@@@@@@@@@@@@@@@@@@@@@@@@.....T.T....@@@@@@@@@............T...T.............T@@..@@@@@@@@@@@@@@.TT.....TT.@@@@@.....T.TT@@@@@@@@@@@@@@@@@@
@@@@@@@@@@@@@@@@@@@@@@@@@@@T.T..T.....T.@@@@@@@@@...T.....................T..T@@@@@@@@@@@@@@@@@@@@TT.T.......@@...TT.....@@@@@@@@@@@@@@@@@@@
@@@@@@@@@@@@@@@@@@@@@@@@@@@..............@@@@@@@@....T...T.TTT...........T.T.@@@@@@@@@@@@@.T@@@@@@@T.TT@@.T..@.......T.T@@@@@@@@@@@@@@@@@@@@
@@@@@@@@@@@@@@@@@@@@@@@@@.T...T..T.......T@@@@@@@@..TT...........T.......T..@@@@@@@@@@@@@..@@@@@@@@@..@@@T.....T......T@@@@@@@@@@@@@@@@@@@@@
@@@@@@@@@@@@@@@@@@@@@@@@..T.T.....T....T..T@@@@@@@@T..T....TT.....T........@@@@@@@@@@@@@.T.@@@@@@@@@@@@@@@TT......T...@@@@@@@@@@@@@@@@@@@@@@
@@@@@@@@@@@@@@@@@@@@@@@..T.....T....T.....T.@@@@@@@@@@@@...T........T...T.@@@@@@@@@@@@@@T...@@@@@@@@@@@@@@....T......@@@@@@@@@@@@@@@@@@@@@@@
@@@@@@@@@@@@@@@@@@@@@@....T......@@..........@@@@@@@@@@T.......T.......T..@@@@@@@@@@@@@@.....@@@@@@@@@@@@@.T...T....@@@@@@@@@@@@@@@@@@@@@@@@
@@@@@@@@@@@@@@@@@@@@@..T........@@@@T.T........@@@@............T...T.......@@@@@@@@@@@@..TT...@@@@@@@@@@@TT.T...T.T@@@@@@@@@@@@@@@@@@@@@@@@@
@@@@@@@@@@@@@@@@@@@.T.TT..T...@@@@@@@.T.T....T.@@@@.T....T........T..TT...@@@@@@@@@@@@..T........@@@@@@@........T.@@@@@@@@@@@@@@@@@@@@@@@@@@
@@@@@@@@@@@@@@@@@@.T...TT...T@@@@@@@@@.T....T...T@@T...T@@@@..T..TTT..@T.@@@@@@@@@@......T.T.....@@@@@@..........@@@@@@@@@@@@@@@@@@@@@@@@@@@
@@@@@@@@@@@@@@@@@.....TT...@@@@@@@@@@@@.....TT..T@@.....@@@@@@......T@@@@@@@@@@@@@@...TT.........@@@@@........T.@@@@@@@@@@@@@@@@@@@@@@@@@@@@
@@@@@@@@@@@@@@@@.......T..@@@@@@@@@@@@@@T..........TTT@@@@@@@@T.TT..@@@@@@@@@@@@@@@@.............@@@@.....T.T..@@@@@@@@@@@@@@@@@@@@@@@@@@@@@
@@@@@@@@@@@@@@@T..TT....T@@@@@@@@@@@@@@@@T.T...TTT...@@@@@@@..TT...@@@@@@@@@@@@@@@@@@...........T@@@....T.T...@@@@@@@@@@@@@@@@@@@@@@@@@@@@@@
@@@@@@@@@@@@@@...T....T.@@@@....@@@@@@@@@@........T..@@@@@@@@..T..@@@@@@@@@@@@@@@@@@@@.....@T....@@.TT.......T@@@@@@@@@@@@@@@@@@@@@@@@@@@@@@
@@@@@@@@@@@@@@.....T...T...T...T.@@@@@@@@@@......T....@@@@@@@@...@@@@@@@@@@@@..@@@@@@@@..T@@@.T........T......@@@@@@@@@@@@@@@@@@@@@@@@@@@@@@
@@@@@@@@@@@@@@@T...T......T......@@@@@@@@@@@.....T.T...@@@@@@@@.@@@@@@@@@@@@.T..@@@@@@@@@@@@@@.......TTT..TT...@@@@@@@@@@@@@@@@@@@@@@@@.@@@@
@@@@@@@@@@@@@@@@.........T......@@@@@@@@@@@@@....T....T.@@@@@@@@@@@@@@@@@@@@...@@@@@@@@@@@@@@@@............T.T..@@@@@@@@@@@@@@@@@@@@@@..@@@@
@@@@@@@@@@@@@@@@@.T............@@@@@@@@@@@@@@@T.T........@@@@@@@@@@@@@@@@@@@....@@@@@@@@@@@@@@@TTT....T.T.......T@@@@@@@@@@@@@@@@@@@...@@@@@
@@@@@@@@@@@@@@@@@@@@@..T..T..T@@@@@@@@@@@@@@@@@T..T.T..TT.@@@@@@@@@@@@@@@@@...TT.@@@@@@@@@@@@@......T............T@@@@@@@@....T.......@@@@@@
@@@@@@@@@@@@@@@@@@@@@@@@...TT@@@@@@@@@@@@@@@@@@@TT....T...T@@@@@@@@@@@@@@@T.....T.@@@@@@@@@@@.T....T..@@..T..T.T....@@@@@.......TT...@@@@@@@
@@@@@@@@@@@@@@@@@@@@@@@@@@@@@@@@@@@@@@@@@@@@@@@@@...........@@@@@@@@@@@@@.........T.@@@@@@@@.........@@@@T.TT........@@@............@@@@@@@@
@@@@@@@@@@@@@@@@@@@@@@@@@@@@@@@@@@@@@@@@@@@@@@@@@@.T.........@@@@@@@@@..T.T..T..T.T.@@@@@@@.T.......@@@@@@...TT......@@@...T.T.T...@@@@@@@@@
@@@@@@@@@@@@@@@@@@@@@@@@@@@@@@@@@@@@@@@@@@@@@@@@@@@T...T.TT...@@@@@@@@@T.T.........@@@@@@@..T...T.T@@@@@@@@......T.....T.T...T..T.@@@@@@@@@@
@@@@@@@@@@@@@@@@@@@@@@@@@@@@@@@@@@@@@@@@@@@@@@@@@@@@....T....T.@@@@@@@@@T......T.T@@@@@@@..TT..T..@@@@@@@@@@.....T............T..@@@@@@@@@@@
@@@@@@@@@@@@@@@@@@@@@@@@@@@@@@@@@@@@@@@@@@@@@@@@@@@@@..T.TT..TT.@@@@@@@@@.T.......@@@@@@.T..T.T..@@@@@@@@@@@@........T.........T@@@@@@@@@@@@
@@@@@@@@@@@@@@@@@@@@@@@@@@@@@@@@@@@@@@@@@@@@@@@@@@@@@@T........T.@@@@@@@@@..T......@@@....T.....@@@@@@@@@@@@@@TTT.T......T.....@@@@@@@@@@@@@
@@@@@@@@@@@@@@@@@@@@@@@@@@@@@@@@@@@@@@@@@@@@@@@@@@@@@@@T.........T@@@@@@@@@..@@@....@....T..T..@@@@@@@@@@@@@@@@.TT..T.T....T..@@@@@@@@@@@@@@
@@@@@@@@@@@@@@@@@@@@@@@@@@@@@@@@@@@@@@@@@@@@@@@@@@@@@@@@..T....TT...@@@@@@@@@@@@.T............@@@@@@@@@@@@@@@@@@T.T....T.T...@@@@@@@@@@@@@@@
@@@@@@@@@@@@@@@@@@@@@@@@@@@@@@@@@@@@@@@@@@@@@@@@@@@@@@@@@........T...@@@@@@@@@@@@@T...T......@@@@@@@@@@@@@@@@@@@@.......T.T.@@@@@@@@@@@@@@@@
@@@@@@@@@@@@@@@@@@@@@@@@@@@@@@@@@@@@@@@@@@@@@@@@@@@@@@@@@@.....TT..T..@@@@@@@@@@@@....T....T@@@@@@@@@@@@@@@@@@@@@@T...T....@@@@@@@@@@@@@@@@@
@@@@@@@@@@@@@@@@@@@@@@@@@@@@@@@@@@@@@@@@@@@@@@@@@@@@@@@@@@@...........T@@@@@@@@@@....T...TT@@@@@@@@@@@@@@@@@@@@@@@@.......@@@@@@@@@@@@@@@@@@
@@@@@@@@@@@@@@@@@@@@@@@@@@@@@@@@@@@@@@@@@@@@@@@@@@@@@@@@@@@@T.......T...@@@@@@@@..T.T....T@@@@@@@@@@@@@@@@@@@@@@@@@@.T..T@@@@@@@@@@@@@@@@@@@
@@@@@@@@@@@@@@@@@@@@@@@@@@@@@@@@@@@@@@@@@@@@@@@@@@@@@@@@@@@@@......T.T...@@@@@@.....T..T.@@@@@@@@@@@@@@@@@@@@@@@@@@@@...@@@@@@@@@@@@@@@@@@@@
@@@@@@@@@@@@@@@@@@@@@@@@@@@@@@@@@@@@@@@@@@@@@@@@@@@@@@@@@@@@@@...T........@@@@.T..T....T@@@@@@@@@@@@@@@@@@@@@@@@@@@@@@.@@@@@@@@@@@@@@@@@@@@@
@@@@@@@@@@@@@@@@@@@@@@@@@@@@@@@@@@@@@@@@@@@@@@@@@@@@@@@@@@@@@@@.T.......T.@@@.....T....@@@@@@@@@@@@@@@@@@@@@@@@@@@@@@@@@@@@@@@@@@@@@@@@@@@@@
@@@@@@@@@@@@@@@@@@@@@@@@@@@@@@@@@@@@@@@@@@@@@@@@@@@@@@@@@@@@@@@@..T.T.......T.......T.@@@@@@@@@@@@@@@@@@@@@@@@@@@@@@@@@@@@@@@@@@@@@@@@@@@@@@
@@@@@@@@@@@@@@@@@@@@@@@@@@@@@@@@@@@@@@@@@@@@@@@@@@@@@@@@@@@@@@@@@..T....T...TT...T...@@@@@@@@@@@@@@@@@@@@@@@@@@@@@@@@@@@@@@@@@@@@@@@@@@@@@@@
@@@@@@@@@@@@@@@@@@@@@@@@@@@@@@@@@@@@@@@@@@@@@@@@@@@@@@@@@@@@@@@@@@..T...TT.....T....@@@@@@@@@@@@@@@@@@@@@@@@@@@@@@@@@@@@@@@@@@@@@@@@@@@@@@@@
@@@@@@@@@@@@@@@@@@@@@@@@@@@@@@@@@@@@@@@@@@@@@@@@@@@@@@@@@@@@@@@@@@@.....T....T.....@@@@@@@@@@@@@@@@@@@@@@@@@@@@@@@@@@@@@@@@@@@@@@@@@@@@@@@@@
@@@@@@@@@@@@@@@@@@@@@@@@@@@@@@@@@@@@@@@@@@@@@@@@@@@@@@@@@@@@@@@@@@@@.......T.....T@@@@@@@@@@@@@@@@@@@@@@@@@@@@@@@@@@@@@@@@@@@@@@@@@@@@@@@@@@
@@@@@@@@@@@@@@@@@@@@@@@@@@@@@@@@@@@@@@@@@@@@@@@@@@@@@@@@@@@@@@@@@@@@@...........T@@@@@@@@@@@@@@@@@@@@@@@@@@@@@@@@@@@@@@@@@@@@@@@@@@@@@@@@@@@
@@@@@@@@@@@@@@@@@@@@@@@@@@@@@@@@@@@@@@@@@@@@@@@@@@@@@@@@@@@@@@@@@@@@@@..TT......@@@@@@@@@@@@@@@@@@@@@@@@@@@@@@@@@@@@@@@@@@@@@@@@@@@@@@@@@@@@
@@@@@@@@@@@@@@@@@@@@@@@@@@@@@@@@@@@@@@@@@@@@@@@@@@@@@@@@@@@@@@@@@@@@@@@.T.TT..T@@@@@@@@@@@@@@@@@@@@@@@@@@@@@@@@@@@@@@@@@@@@@@@@@@@@@@@@@@@@@
@@@@@@@@@@@@@@@@@@@@@@@@@@@@@@@@@@@@@@@@@@@@@@@@@@@@@@@@@@@@@@@@@@@@@@@@T.....@@@@@@@@@@@@@@@@@@@@@@@@@@@@@@@@@@@@@@@@@@@@@@@@@@@@@@@@@@@@@@
@@@@@@@@@@@@@@@@@@@@@@@@@@@@@@@@@@@@@@@@@@@@@@@@@@@@@@@@@@@@@@@@@@@@@@@@@.T.T@@@@@@@@@@@@@@@@@@@@@@@@@@@@@@@@@@@@@@@@@@@@@@@@@@@@@@@@@@@@@@@
@@@@@@@@@@@@@@@@@@@@@@@@@@@@@@@@@@@@@@@@@@@@@@@@@@@@@@@@@@@@@@@@@@@@@@@@@@..@@@@@@@@@@@@@@@@@@@@@@@@@@@@@@@@@@@@@@@@@@@@@@@@@@@@@@@@@@@@@@@@
@@@@@@@@@@@@@@@@@@@@@@@@@@@@@@@@@@@@@@@@@@@@@@@@@@@@@@@@@@@@@@@@@@@@@@@@@@@@@@@@@@@@@@@@@@@@@@@@@@@@@@@@@@@@@@@@@@@@@@@@@@@@@@@@@@@@@@@@@@@@
@@@@@@@@@@@@@@@@@@@@@@@@@@@@@@@@@@@@@@@@@@@@@@@@@@@@@@@@@@@@@@@@@@@@@@@@@@@@@@@@@@@@@@@@@@@@@@@@@@@@@@@@@@@@@@@@@@@@@@@@@@@@@@@@@@@@@@@@@@@@
@@@@@@@@@@@@@@@@@@@@@@@@@@@@@@@@@@@@@@@@@@@@@@@@@@@@@@@@@@@@@@@@@@@@@@@@@@@@@@@@@@@@@@@@@@@@@@@@@@@@@@@@@@@@@@@@@@@@@@@@@@@@@@@@@@@@@@@@@@@@
@@@@@@@@@@@@@@@@@@@@@@@@@@@@@@@@@@@@@@@@@@@@@@@@@@@@@@@@@@@@@@@@@@@@@@@@@@@@@@@@@@@@@@@@@@@@@@@@@@@@@@@@@@@@@@@@@@@@@@@@@@@@@@@@@@@@@@@@@@@@
