type octile
height 118
width 120
map
@@@@@@@@@@@@@@@@@@@@@@@@@@@@@@@@@@@@@@@@@@@@@@@@@@@@@@@@@@@@@@@@@@@@@@@@@@@@@@@@@@@@@@@@@@@@@@@@@@@@@@@@@@@@@@@@@@@@@@@@
@@@@@@@@@@@@@@@@@@@@@@@@@@@@@@@@@@@@@@@@@@@@@@@@@@@@@@@@@@@@@@@@@@@@@@@@@@@@@@@@@@@@@@@@@@@@@@@@@@@@@@@@@@@@@@@@@@@@@@@@
@@@@@@@@@@@@@@@@@@@@@@@@@@@@@@@@@@@@@@@@@@@@@@@@@@@@@@@@@@@@@@@@@@@@@@@@@@@@@@@@@@@@@@@@@@@@@@@@@@@@@@@@@@@@@@@@@@@@@@@@
@@@@@@@@@@@@@@@@@@@@@@@@@@@@@@@@@@@@@@@@@@@@@@@@@@@@@@@@@@@@@@@@@@@@@@@@@@@@@@@@@@@@@@@@@@@@@@@@@@@@@@@@@@@@@@@@@@@@@@@@
@@@@@@@@@@@@@@@@@@@@@@@@@@@@@@@@@@@@@@@@@@@@@@@@@@@@@@@@@@@@@@@@@@@@@@@@@@@@@@@@@@@@@@@@@@@@@@@@@@@@@@@@@@@@@@@@@@@@@@@@
@@@@@@@@@@@@@@@@@@@@@@@@@@@@@@@@@@@@@@@@@@@@@@@@@@@@@@@@@@@@@@@@@@@@@@@@@@@@@@@@@@@@@@@@@@@@@@@@@@@@@@@@@@@@@@@@@@@@@@@@
@@@@@@@@@@@@@@@@@@@@@@@@@@@@@@@@@@@@@@@@@@@@@@@@@@@@@@@@@@@@@@@@@@@@@@@@@@@@@@@@@@@@@@@@@@@@@@@@@@@@@@@@@@@@@@@@@@@@@@@@
@@@@@@@@@@@@@@@@@@@@@@@@@@@@@@@@@@@@@@@@@@@@@@@@@@@@@@@@@@@@@@@@@@@@@@@@@@@@@@@@@@@@@@@@@@@@@@@@@@@@@@@@@@@@@@@@@@@@@@@@
@@@@@@@@@@@@@@@@@@@@@@@@@@@@@@@@@@@@@@@@@@@@@@@@@@@@@@@@@@@@@@@@@@@@@@@@@@@@@@@@@@@@@@@@@@@@@@@@@@@@@@@@@@@@@@@@@@@@@@@@
@@@@@@@@@@@@@@@@@@@@@@@@@@@@@@@@@@@@@@@@@@@@@@@@@@@@@@@@@@@@@@@@@@@@@@@@@@@@@@@@@@@@@@@@@@@@@@@@@@@@@@@@@@@@@@@@@@@@@@@@
@@@@@@@@@@@@@@@@@@@@@@@@@@@@@@@@@@@@@@@@@@@@@@@@@@@@@@@@@@@@@@@@@@@@@@@@.T@@@@@@@@@@@@@@@@@@@@@@@@@@@@@@@@@@@@@@@@@@@@@@
@@@@@@@@@@@@@@@@@@@@@@@@@@@@@@@@@@@@@@@@@@@@@@@@@@@@@@@@@@@@@@@@@@@@@@@T....@@@@@@@@@@@@@@@@@@@@@@@@@@@@@@@@@@@@@@@@@@@@
@@@@@@@@@@@@@@@@@@@@@@@@@@@@@@@@@@@@@@@@@@@@@@@@@@@@@@@@@@@@@@@@@@@@@@......T@@@@@@@@@@@@@@@@@@@@@@@@@@@@@@@@@@@@@@@@@@@
@@@@@@@@@@@@@@@@@@@@@@@@@@@@@@@@@@@@@@@@@@@@@@@@@@@@@@@@@@@@@@@@@@@@..........@@@@@@@@@@@@@@@@@@@@@@@@@@@@@@@@@@@@@@@@@@
@@@@@@@@@@@@@@@@@@@@@@@@@@@@@@@@@@@@@@@@@@@@@@@@@@@@@@@@@@@@@@@@@@@...T@@@.T.T.@@@@@@@@@@@@@@@@@@@@@@@@@@@@@@@@@@@@@@@@@
@@@@@@@@@@@@@@@@@@@@@@@@@@@@@@@@@@@@@@@@@@@@@@@@@@@@@@@@@@@@@@@@@@T.TT@@@@@....T@@@@@@@@@@@@@@@@@@@@@@@@@@@@@@@@@@@@@@@@
@@@@@@@@@@@@@@@@@@@@@@@@@@@@@@@@@@@@@@@@@@@@@@@@@@@@@@@@@@@@@@@@@.T..@@@@@@@...T.@@@@@@@@@@@@@@@@@@@@@@@@@@@@@@@@@@@@@@@
@@@@@@@@@@@@@@@@@@@@@@@@@@@@@@@@@@@@@@@@@@@@@@@@@@@@@@@@@@@@@@@@....@@@@@@@@@.....@@@@@@@@@@@@@@@@@@@@@@@@@@@@@@@@@@@@@@
@@@@@@@@@@@@@@@@@@@@@@@@@@@@@@@@@@@@@@@@@@@@@@@@@@@@@@@@@@@@@@@@...@@@@@@@@@@@..T..@@@@@@@@@@@@@@@@@@@@@@@@@@@@@@@@@@@@@
@@@@@@@@@@@@@@@@@@@@@@@@@@@@@@@@@@@@@@@@@@@@@@@@@@@@@@@@@@@@@@@@@T@@@@@@@@@@@@@....T@@@@@@@@@@@@@@@@@@@@@@@@@@@@@@@@@@@@
@@@@@@@@@@@@@@@@@@@@@@@@@@@@@@@@@@@@@@@@@@@@@@@@@@@@@@@@@@@@@@@@@@@@@@@@..@@@@@@..T..@@@@@@@@@@@@@@@@@@@@@@@@@@@@@@@@@@@
@@@@@@@@@@@@@@@@@@@@@@@@@@@@@@@@@@@@@@@@@@@@@@@@@@@@@@@@@@@@@@@@@@@@@@@@T..@@@@@@.....@@@@@@@@@@@@@@@@@@@@@@@@@@@@@@@@@@
@@@@@@@@@@@@@@@@@@@@@@@@@@@@@@@@@@@@@@@@@@@@@@@@@@@@@@@@@@@@@@@@@@@@@@.T....@@@@@@....T@@@@@@@@@@@@@@@@@@@@@@@@@@@@@@@@@
@@@@@@@@@@@@@@@@@@@@@@@@@@@@@@@@@@@@@@@@@@@@@@@@@@@@@@@@@@@@@@@@@@..@@.......@@@@@@T...T@@@@@@@@@@@@@@@@@@@@@@@@@@@@@@@@
@@@@@@@@@@@@@@@@@@@@@@@@@@@@@@@@@@@@@@@@@@@@@@@@@@@@@@@@@@@@@@@@@@....TT......@@@@@@.....@@@@@@@@@@@@@@@@@@@@@@@@@@@@@@@
@@@@@@@@@@@@@@@@@@@@@@@@@@@@@@@@@@@@@@@@@@@@@@@@@@@@@@@@@@@@@@@@@@T....T...@.TT@@@@@@@.TT.@@@@@@@@@@@@@@@@@@@@@@@@@@@@@@
@@@@@@@@@@@@@@@@@@@@@@@@@@@@@@@@@@@@@@@@@@@@@@@@@@@@@@@@TTT...@@@@@...T..@@@..TT@@@@@@T..T@@@@@@@@@@@@@@@@@@@@@@@@@@@@@@
@@@@@@@@@@@@@@@@@@@@@@@@@@@@@@@@@@@@@@@@@@@@@@@@@@@@@@@........@@@@T...@@@@@@..@@@@@@..T.@@@@@@@@@@@@@@@@@@@@@@@@@@@@@@@
@@@@@@@@@@@@@@@@@@@@@@@@@@@@@@@@@@@@@@@@@@@@@@@@@@@@@@T....@@@...@@....@@@@@@@.@@@@@@.T.@@@@@@@@@@@@@@@@@@@@@@@@@@@@@@@@
@@@@@@@@@@@@@@@@@@@@@@@@@@@@@@@@@@@@@@@@@@@@@@@@@@@@@......@@@.@@@@@...@@@@@@..@@@@@...T@@@@@@@@@@@@@@@@@@@@@@@@@@@@@@@@
@@@@@@@@@@@@@@@@@@@@@@@@@@@@@@@@@@@@@@@@@@@T@@@@@@@@..@@@@..T..@@@@@...@@@.@@..@@@@@T..@@@@@@@@@@@@@@@@@@@@@@@@@@@@@@@@@
@@@@@@@@@@@@@@@@@@@@@@@@@@@@@@@@@@@@@@@@@@.T.@@@@@@@..@@@@@...@@@@@@..T......T.@@@@.T..@@@@@@@@@@@@@@@@@@@@@@@@@@@@@@@@@
@@@@@@@@@@@@@@@@@@@@@@@@@@@@@@@@@@@@@@@@@....T@@@@@@..T@@.@..TT@@@@@....TTT....@@@@..T@@@@@@@@@@@@@@@@@@@@@@@@@@@@@@@@@@
@@@@@@@@@@@@@@@@@@@@@@@@@@@@@@@@@@@@@@@@TT....@@@@@@.T.T....@@.@@@@@T.T.......@@@@...T@@@@@@@@@@@@@@@@@@@@@@@@@@@@@@@@@@
@@@@@@@@@@@@@@@@@@@@@@@@@@@@@@@@@@@@@@@.T...T@@@@@@@.T.T@@@.@@....@@.T.T.....@@@@@T..@@@@@@@...@@@@@@@@@@@@@@@@@@@@@@@@@
@@@@@@@@@@@@@@@@@@@@@@@@@@@@@@@@@@@@@@......@@@@@@@@@..T@@@...TT..@@...T....T@@@@....@@@@@@@.T@@@@@@@@@@@@@@@@@@@@@@@@@@
@@@@@@@@@@@@@@@@@@@@@@@@@@@@@@@@@@@@@T....T@@.@@@@@@@..T@@@....T..@.T.....T...@.@...@@@@@@@@..@@@@@@@@@@@@@@@@@@@@@@@@@@
@@@@@@@@@@@@@@@@@@@@@@@@@@@@@@@@@@@@.....T@@.T@@@@@@@@..T.TT.............T.......T..@@@@@@@....T@@@@@@@@@@@@@@@@@@@@@@@@
@@@@@@@@@@@@@@@@@@@@@@@@@@@@@@@@@@@T.T...T@..T@@@@@@@@@T.T..T.T@..T...........TT...@@@@@@@..T..@@@@@@@@@@@@@@@@@@@@@@@@@
@@@@@@@@@@@@@@@@@@@@@@@@@@@@@@@@@@T.T..T..@...@.@@@@@@@@@@@@@@@@..TT...T...TT.T....@@@@@@...T.@@@@@@@@@@@@@@@@@@@@@@@@@@
@@@@@@@@@@@@@@@@@@@@@@@@@@@@@@@@@@.......T@@.....@@@@@@@@@@@@@@T..........T.@@@...@@@@@@T.T..@@@@@@@@@@@@@@@@@@@@@@@@@@@
@@@@@@@@@@@@@@@@@@@@@@@@@@@@@@@@@....@@.T.T@.TT...@@@@@@..T...T........T...@@@@@T@@@@@@..T.@@@@@@..@@@@@@@@@@@@@@@@@@@@@
@@@@@@@@@@@@@@@@@@@@@@@@@@@@@@@....T@@@....@@.T...T@.@@@@.............T.T.@@@@@@@@@@@@.TT...@@@@...T@@@@@@@@@@@@@@@@@@@@
@@@@@@@@@@@@@@@@@@@@@@@@@@@@@@....T@@@@@TTT.@T.T......@@@.T........TT..T.@@@@@@@@@@.@.T....T.@@...T@@@@@@@@@@@@@@@@@@@@@
@@@@@@@@@@@@@@@@@@@@@@@@@@@@@T....@@@@@@....@@.........@....TT.TT....TT@@@@@@@@@@@@....T......@@T.@@@@@@@@@@@@@@@@@@@@@@
@@@@@@@@@@@@@@@@@@@@@@@@@@@@..T..@@@@@@@.....@.....T....T.T@@...T.......@@@@@@@@@@@......T......T@@@@@@@@@@@@@@@@@@@@@@@
@@@@@@@@@@@@@@@@@@@@@@@@@@..T...@@@@@@@@@...T@@T......T..@@@@@T.T....T...@@@@@@@@@......T......@@@@@@@T.@@@@@@.@@@@@@@@@
@@@@@@@@@@@@@@@@@@@@@@@@@....T.@@@@@@@@@@@....@........T.T@@@@@....T.T.TT@@@@@@@.T....TTTT.....@@@@@@..TT@@@@@..@@@@@@@@
@@@@@@@@@@@@@@@@@@@@@@@@.....T@@@@@@@@@@.@.TT.@....T......@@@@@@........@@@@@@@T.T.@.........TT...@@.T..@@@@@TT.@@@@@@@@
@@@@@@@@@@@@@@@@@@@@@@@......@@@@@@@@@@..@@.T.@.T......T..@@@@@@@.T.T..@@@@@.@@...@@@@...T........T....@@@@@@.T.@@@@@@@@
@@@@@@@@@@@@@@@@@@@@@@T.....@@@@@@@@@@....@...T.T.....T.@@@@@@@@@@....@@@@@..@@T.@@@@@@T....TT.....T.T@@@@@@.T.@@@@@@@@@
@@@@@@@@@@@@@@@@@@@@@....TT@@@@@@@@@@.T...@@..T..T....T@@@@@@@@@@@@..@@@@@@.T@@@@@@@@@@.............T.@@@@@@.T.@@@@@@@@@
@@@@@@@@@@@@@@@@@@@@@T....@@@@@@@@@@.....T..........T..@@@@@@@@@@@@@@@@@@@@T..@@@@@@@.....T...........@@@@@..T@@@@@@@@@@
@@@@@@@@@@@@@@@@@@@@T....@@@@@@@@@@T......T......T.T....@@@@@@@@@@@@@@@@@@@@.T@@@@@@...T@@..T....TT...@@@@@T..@@@@@@@@@@
@@@@@@@@@@@@@@@@@@.....T@@@@@@@@@@@.....................T..@@@@@@@@@@@@@@@@@.T.@@@@...T@@@@TT..T.....@@@@@T..@@@@@@@@@@@
@@@@@@@@@@@@@@@@@......@@@@@@@@@@@@@.T.....T...T..........T.@@@@@@@@@@@@@@@@..T@@@@@..@@@@@T...T....@@@@@@..@@@@@@@@@@@@
@@@@@@@@@@@@@@@@..T...@@@@@@@@@@..@@@.........TT.T.T......T..@@@@@@@@@@@@@@@@..@@@@@@@@@@@@@.T.T..T.@@.@..TT@@@@@@@@@@@@
@@@@@@@@@@@@@@@..T..T@@@@@@@@@@....@@@T....T....T.......T...TT@@@@@@@@@@@@@@@...@@@@@@@@@@@@T@TT....@.......@@@@@@@@@@@@
@@@@@@@@@@@@@@T.....@@@@@@@@@@..T...@@@T....TT..TT.....T..T.T...@@@@@@@@@@.@@T.T.@@@@@@@@...@@@.............@@@@@@@@@@@@
@@@@@@@@@@@@....TT.@@@@@@@@@@......T.@@@...........@@........TT.@@@@@@@@@@..@@...@@@@@@@...@@@@@.T...TT...TT@@@@@@@@@@@@
@@@@@@@@@@@..TT....@@@@@@@@@..........@@......T...T@@@.TT..T....T.@@.@@@..T.@@..T.@@@@@...@@@@@@.TT....T.....@@@@@@@@@@@
@@@@@@@@@@........@@@@@@@@@@....T..........T...T...@@@@.T..T..T......@@@..T.@@....@@@@T..@@@@@@TT.T..T......@@@@@@@@@@@@
@@@@@@@@@.T..T....@@@@@@@.@@@.......T..T...T...T....@@@@.......TT..T.T....T..@@T..@@@@@@@@@@@@....TT.......@@@@@@@@@@@@@
@@@@@@@@..T.....T..@@@@@...@@@TT...T...TTT...T.....T.@@@@...T.T.T...........TT.....@@@@@@@@@@.............@@@@@@@@@@@@@@
@@@@@@@@......@@TT.@@@@.....@@@...........T.T.......T.@@@......T.T.....T.......@@T.T@@@@@@@@...T.....T...@@@@@@@@@@@@@@@
@@@@@@@......@@@..TT@@.......@@@..T....T.T.............T..TT.......T....T.....@@@@...@@@@@@..T..T...T...@@@@@@@@@@@@@@@@
@@@@@@..T..T@@@@....@@........@@@..TTT.@@@@@@T.....TT......T............T...T@@@@@@...@@@@@@T....T.T...@@@@@@@@@@@@@@@@@
@@@@@@..T.T@@@@@@..T.@..T......@@T...T@@@@@@@.....TT..@@@.T....TTT.T........@@@@@@@@...@@@@.....T...TT@@@@@@@@@@@@@@@@@@
@@@@@@@..T@@@@@@@@T..@.TTTT.T.....T..@@@@@@@@.......T.@@@...........T.T.T...@@@@@@@@@..@@@....T.TTT..@@@@@@@@@@@@@@@@@@@
@@@@@@@@.@@@@@@@@@...@@........T.....@@@@@@@@.......T.....T.TT....T..T.....@@@@@@@@@@T.......@@.T...@@@@@@@@@@@@@@@@@@@@
@@@@@@@@@@@@@@@@@@@T..@.............T@@@@@@@@..T..T..T...T...@@.........TT..@@@@@@@@@..T..T.@@@@.TT@@@@@@@@@@@@@@@@@@@@@
@@@@@@@@@@@@@@@@..@..T@@....T.T.T...TT.@@.@@@........T......@@@@@......TT....@@@@@@@@@@@.....@@@@.@@@@@@@@@@@@@@@@@@@@@@
@@@@@@@@@@@@@@@..T@@T.......T........T..T.@@@@............@@@@@@@@T....TT..TT.@@@@@@T@@@.T....@@@@@@@@@@@@@@@@@@@@@@@@@@
@@@@@@@@@@@@@@..T.@@@...T...........T.TT..@@@@..T......TTT@@@@@@.........T..TT.@@@@T.....TT..T.@@@@@@@@@@@@@@@@@@@@@@@@@
@@@@@@@@@@@@@T..T.@@@....T..TT......T.T...@@@................@@@..T.............@@@..T.T.....TT@@@@@@@@@@@@@@@@@@@@@@@@@
@@@@@@@@@@@@T.T.T.T............@@@....T.....T............T...@@@TT..TT.....T.T..T@@.T..T....T.@@@@@@@@@@@@@@@@@@@@@@@@@@
@@@@@@@@@@T.....T.......T.T....@@@.T......TTT.T..T.TT...TTT..@@@.TTT.........T..T..T.........@@@@@@@@@@@@@@@@@@@@@@@@@@@
@@@@@@@@@@..T...T...T.........@@@.T.........T...T...T..T@@.T.@@@TT.T.T.........T..T..T..T...@@@@@@@@@@@@@@@@@@@@@@@@@@@@
@@@@@@@@@@@....T..T....TT..T.@@@@........T.T......T.....@@@...TTT..TT............T.....T...@@@@@@@@@@@@@@@@@@@@@@@@@@@@@
@@@@@@@@@@@@T.....T......T.@@@@@@@@....T.....T.T.......@@@@@......T...T....T.....T..T.T...@@@@@@@@@@@@@@@@@@@@@@@@@@@@@@
@@@@@@@@@@@@@....TTT..T....@@@@@@@@@T..@@@@@TTT..T.TT..@@@@@@.T....@@@....T.....TTTTT...T@@@@@@@@@@@@@@@@@@@@@@@@@@@@@@@
@@@@@@@@@@@@@@T............@@@@@@@@@..@@@@@@@...T...TT.@@@@@@T....@@@@@T.......TTT......@@@@@@@@@@@@@@@@@@@@@@@@@@@@@@@@
@@@@@@@@@@@@@@@......T...T.TT.TT.TT..@@@@.@@@@.........@@@@@..T.T@@@@@@@........T...T..@@@@@@@@@@@@@@@@@@@@@@@@@@@@@@@@@
@@@@@@@@@@@@@@@@......T...........T.@@@@...@@@@@T......T@@@..T..@@@@@@@@@T.T.....TTT..@@@@@@@@@@@@@@@@@@@@@@@@@@@@@@@@@@
@@@@@@@@@@@@@@@@@...T...........T..@@@@.....@@@...T.....@@.....@@@@@@@@@@............@@@@@@@@@@@@@@@@@@@@@@@@@@@@@@@@@@@
@@@@@@@@@@@@@@@@@@.T..T..T........@@@@@@@@...@T......TT...T...@@@@@@@@@@..T.........@@@@@@@@@@@@@@@@@@@@@@@@@@@@@@@@@@@@
@@@@@@@@@@@@@@@@@@@T....TT...T...@@@@@@@@@@@T.T..@......T.T..@@@@@@@@@.T..@T.T.....@@@@@@@@@@@@@@@@@@@@@@@@@@@@@@@@@@@@@
@@@@@@@@@@@@@@@@@@@@..T.....T..T@@@@@@@@@@@....T@@@@..TT....@@@@@@@@@....@@@T..T.T@@@@@@@@@@@@@@@@@@@@@@@@@@@@@@@@@@@@@@
@@@@@@@@@@@@@@@@@@@@@.TT..T....@@@@@@@@@@@@..T..@@@@@......@@@@@@@@@......@@@....@@@@@@@@@@@@@@@@@@@@@@@@@@@@@@@@@@@@@@@
@@@@@@@@@@@@@@@@@@@@@@T....TT.@@@@T@@@@@@@@....T.@@@@@....@@@@@@@@@.T..T...@@@..@@@@@@@@@@@@@@@@@@@@@@@@@@@@@@@@@@@@@@@@
@@@@@@@@@@@@@@@@@@@@@@@......@@@@.T@@@@@@@@....TT.@@@@@..@@@@@@@@@@......TT.@@@@@@@@@@@@@@@@@@@@@@@@@@@@@@@@@@@@@@@@@@@@
@@@@@@@@@@@@@@@@@@@@@@@@.T..@@@@.T.@@@@@@....T...T.@@@@@@@@@@@@@@@@TT..T.T...@@@@@@@@@@@@@@@@@@@@@@@@@@@@@@@@@@@@@@@@@@@
@@@@@@@@@@@@@@@@@@@@@@@@@..@@@@...@@@@@@@.T....T...@@@@@@@@@@@@@@@........T..@@@@@@@@@@@@@@@@@@@@@@@@@@@@@@@@@@@@@@@@@@@
@@@@@@@@@@@@@@@@@@@@@@@@@@@@@@..T..@@@@@.T........@@@.@@@@@@@@@@.......T..T.@@@@@@@@@@@@@@@@@@@@@@@@@@@@@@@@@@@@@@@@@@@@
@@@@@@@@@@@@@@@@@@@@@@@@@@@@@................T...@@@...@@@@@@@@@T......T...@@@@@@@@@@@@@@@@@@@@@@@@@@@@@@@@@@@@@@@@@@@@@
@@@@@@@@@@@@@@@@@@@@@@@@@@@@.......TT.TT........@@@.....@@@@@@@.T.T.T.....@@@@@@@@@@@@@@@@@@@@@@@@@@@@@@@@@@@@@@@@@@@@@@
@@@@@@@@@@@@@@@@@@@@@@@@@@@@@.........T........@@@TT.....@@@@.......T.TT.@@@@@@@@@@@@@@@@@@@@@@@@@@@@@@@@@@@@@@@@@@@@@@@
@@@@@@@@@@@@@@@@@@@@@@@@@@@@@@.TT...T..T.......T@.........@@@@T..TT.....@@@@@@@@@@@@@@@@@@@@@@@@@@@@@@@@@@@@@@@@@@@@@@@@
@@@@@@@@@@@@@@@@@@@@@@@@@@@@@@@@T.......T...@@.TT.@@@@@@@..@@@@....TT..@@@@@@@@@@@@@@@@@@@@@@@@@@@@@@@@@@@@@@@@@@@@@@@@@
@@@@@@@@@@@@@@@@@@@@@@@@@@@@@@@@@TT....T...@@@..T.@@@@@@@...@@@@T.....@@@@@@@@@@@@@@@@@@@@@@@@@@@@@@@@@@@@@@@@@@@@@@@@@@
@@@@@@@@@@@@@@@@@@@@@@@@@@@@@@@@@@T..TT...@@@@....@@@@@@TT...@@@@.T.T@@@@@@@@@@@@@@@@@@@@@@@@@@@@@@@@@@@@@@@@@@@@@@@@@@@
@@@@@@@@@@@@@@@@@@@@@@@@@@@@@@@@@@@.TT...@@@@@...@@@@@@@T.....@@@@..@@@@@@@@@@@@@@@@@@@@@@@@@@@@@@@@@@@@@@@@@@@@@@@@@@@@
@@@@@@@@@@@@@@@@@@@@@@@@@@@@@@@@@@@@.TT.@@@@@@TT.@@@@@@@TT....T@@@@@@@@@@@@@@@@@@@@@@@@@@@@@@@@@@@@@@@@@@@@@@@@@@@@@@@@@
@@@@@@@@@@@@@@@@@@@@@@@@@@@@@@@@@@@@@..@@@@@@@.TT@@@@@@@@..T....@@@@@@@@@@@@@@@@@@@@@@@@@@@@@@@@@@@@@@@@@@@@@@@@@@@@@@@@
@@@@@@@@@@@@@@@@@@@@@@@@@@@@@@@@@@@@@@@@@@@@@.....@@..@@...TT.T.T@@@@@@@@@@@@@@@@@@@@@@@@@@@@@@@@@@@@@@@@@@@@@@@@@@@@@@@
@@@@@@@@@@@@@@@@@@@@@@@@@@@@@@@@@@@@@@@@@.T.....TT.T...T....TT.T@@@@@@@@@@@@@@@@@@@@@@@@@@@@@@@@@@@@@@@@@@@@@@@@@@@@@@@@
@@@@@@@@@@@@@@@@@@@@@@@@@@@@@@@@@@@@@@@@...................T...@@@@@@@@@@@@@@@@@@@@@@@@@@@@@@@@@@@@@@@@@@@@@@@@@@@@@@@@@
@@@@@@@@@@@@@@@@@@@@@@@@@@@@@@@@@@@@@@@@@T......T......T.....T@@@@@@@@@@@@@@@@@@@@@@@@@@@@@@@@@@@@@@@@@@@@@@@@@@@@@@@@@@
@@@@@@@@@@@@@@@@@@@@@@@@@@@@@@@@@@@@@@@@@@.T..TT.TT.....T...T@@@@@@@@@@@@@@@@@@@@@@@@@@@@@@@@@@@@@@@@@@@@@@@@@@@@@@@@@@@
@@@@@@@@@@@@@@@@@@@@@@@@@@@@@@@@@@@@@@@@@@@...T.T........T..@@@@@@@@@@@@@@@@@@@@@@@@@@@@@@@@@@@@@@@@@@@@@@@@@@@@@@@@@@@@
@@@@@@@@@@@@@@@@@@@@@@@@@@@@@@@@@@@@@@@@@@@@.....TT......TT@@@@@@@@@@@@@@@@@@@@@@@@@@@@@@@@@@@@@@@@@@@@@@@@@@@@@@@@@@@@@
@@@@@@@@@@@@@@@@@@@@@@@@@@@@@@@@@@@@@@@@@@@@@...T.........@@@@@@@@@@@@@@@@@@@@@@@@@@@@@@@@@@@@@@@@@@@@@@@@@@@@@@@@@@@@@@
@@@@@@@@@@@@@@@@@@@@@@@@@@@@@@@@@@@@@@@@@@@@@@......T....@@@@@@@@@@@@@@@@@@@@@@@@@@@@@@@@@@@@@@@@@@@@@@@@@@@@@@@@@@@@@@@
@@@@@@@@@@@@@@@@@@@@@@@@@@@@@@@@@@@@@@@@@@@@@@@.........@@@@@@@@@@@@@@@@@@@@@@@@@@@@@@@@@@@@@@@@@@@@@@@@@@@@@@@@@@@@@@@@
@@@@@@@@@@@@@@@@@@@@@@@@@@@@@@@@@@@@@@@@@@@@@@@@.....T.@@@@@@@@@@@@@@@@@@@@@@@@@@@@@@@@@@@@@@@@@@@@@@@@@@@@@@@@@@@@@@@@@
@@@@@@@@@@@@@@@@@@@@@@@@@@@@@@@@@@@@@@@@@@@@@@@@@@...@@@@@@@@@@@@@@@@@@@@@@@@@@@@@@@@@@@@@@@@@@@@@@@@@@@@@@@@@@@@@@@@@@@
@@@@@@@@@@@@@@@@@@@@@@@@@@@@@@@@@@@@@@@@@@@@@@@@@@@@@@@@@@@@@@@@@@@@@@@@@@@@@@@@@@@@@@@@@@@@@@@@@@@@@@@@@@@@@@@@@@@@@@@@
@@@@@@@@@@@@@@@@@@@@@@@@@@@@@@@@@@@@@@@@@@@@@@@@@@@@@@@@@@@@@@@@@@@@@@@@@@@@@@@@@@@@@@@@@@@@@@@@@@@@@@@@@@@@@@@@@@@@@@@@
