type octile
height 80
width 80
map
@@@@@@@@@@@@@@@@@@@@@@@@@@@@@@@@@@@@@@@@@@@@@@@@@@@@@@@@@@@@@@@@@@@@@@@@@@@@@@@@
@@@@@@@@@@@@@@@@@@@@@@@@@@@@@@@@@@@@@@@@@@@@@@@@@@@@@@@@@@@@@@@@@@@@@@@@@@@@@@@@
@@@@@@@@@@@@@@@@@@@@@@@@@@@@@@@@@@@@@@@....T.............T....T...TT.....T..T.@@
@@@@@@@@@@@@@@@@@@@@@@@@@@@@@@@@@@@@@.....T..T......TT...T.T.TT....T.TT...TT..@@
@@@@@@@@@@@@@@@@@@@@@@@@@@@@@@@@@@@@T............T....T..T...........T......T@@@
@@@@@@@@@@@@@@@@@@@@@@@@@@@@@@@@@@..T...........T.......T.....TT.T.....T.....@@@
@@@@@@@@@@@@@@@@@@@@@@@@@@@@@@@@@...T.....TT.TTT.............TT.T............@@@
@@@@@@@@@@@@@@@@@@@@@@@@@@@@@@@@.T.....TTTT.TTTT...TT.T.........T........TT.@@@@
@@@@@@@@@@@@@@@@@@@@@@@@@@@@@@@.TT......T.............T.........T........T.T@@@@
@@@@@@@@@@@@@@@@@@@@@@@@@@@@@@..T..T.....T..T.......TT.......T..T..T.......@@@@@
@@@@@@@@@@@@@@@@@@@@@@@@@@@@@....T.T...TT.T......TT...........T..........T.@@@@@
@@@@@@@@@@@@@@@@@@@@@@@@@@@@T......TTT.T..........T...T..T....T..T...TT....@@@@@
@@@@@@@@@@@@@@@@@@@@@@@@@@@..T....TTT....T..TT..TT.TT...T..T..T.....T..T..@@@@@@
@@@@@@@@@@@@@@@@@@@@@@@@@@.T...T@@@.TT....T......T....T...T.....T...T.....@@@@@@
@@@@@@@@@@@@@@@@@@@@@@@@@..T...@@@@@.....T.......T.T....T.T..........T...@@@@@@@
@@@@@@@@@@@@@@@@@@@@@@@@......@@@@@@.TT...T.T.......T...TT........TT.....@@@@@@@
@@@@@@@@@@@@@@@@@@@@@@@.TT.....@@@@@..T....T............T....T..TT..T.T.@@@@@@@@
@@@@@@@@@@@@@@@@@@@@@@.....T...................TT....T..T..T.....T......@@@@@@@@
@@@@@@@@@@@@@@@@@@@@@.....T...............T......TT......T......TT......@@@@@@@@
@@@@@@@@@@@@@@@@@@@@@T.......T.......T..........T..............T...T.TT@@@@@@@@@
@@@@@@@@@@@@@@@@@@@@@T.TT............T...T.T.T..........T.T.........T..@@@@@@@@@
@@@@@@@@@@@@@@@@@@@@..T....@@@@T..T.........TTT..T.T....TT............@@@@@@@@@@
@@@@@@@@@@@@@@@@@@@@.....T.@@@@..T.............T........T..T.....TT...@@@@@@@@@@
@@@@@@@@@@@@@@@@@@@@T.T....@@@@.T...T..T....T..T..........T..T.T......@@@@@@@@@@
@@@@@@@@@@@@@@@@@@@.....T..@@@@T...T.T....TTT.......T.............T.T.@@@@@@@@@@
@@@@@@@@@@@@@@@@@@@.T....T........T.TT......TT........TT...T......TT..@@@@@@@@@@
@@@@@@@@@@@@@@@@@@...T...........T.T.....TT..T.TT........T.T..T.......@@@@@@@@@@
@@@@@@@@@@@@@@@@@@...T.TT.....T.TT.......T........T..T.T....T.......T.@@@@@@@@@@
@@@@@@@@@@@@@@@@@@TT...............T.................T..T............T@@@@@@@@@@
@@@@@@@@@@@@@@@@@...T.........T............TT.TT.....T..T.....T.......@@@@@@@@@@
@@@@@@@@@@@@@@@@@...........T.TTT.....T.T.T..T...T.....T...T....T....T@@@@@@@@@@
@@@@@@@@@@@@@@@@@..T...T..TT....T.......T.....T......TT.T.........T...@@@@@@@@@@
@@@@@@@@@@@@@@@@.TT........T......T...T..T..............TT..T.........@@@@@@@@@@
@@@@@@@@@@@@@@@@....T............T..T..T..............T...T..........T@@@@@@@@@@
@@@@@@@@@@@@@@@.T.T......T....T.T.....T.T.TT....T.............T...T...@@@@@@@@@@
@@@@@@@@@@@@@@@.....T........T.........T....T.....T.TT.T.T.T........TT@@@@@@@@@@
@@@@@@@@@@@@@@...T......T.T.T.T.....TTTT...T.........TTTT......TT..T.@@@@@@@@@@@
@@@@@@@@@@@@@T.T..T........T.......T...T.T.....................TT...T@@@@@@@@@@@
@@@@@@@@@@@@.............TT.T.TTTT....T..T......T..T........T.......T@@@@@@@@@@@
@@@@@@@@@@@.T.T...T...T.T..T......T......T........T...T...TT...T..TT.@@@@@@@@@@@
@@@@@@@@@.TT...............TT..............T........T..TT...........T@@@@@@@@@@@
@@@@@@@....T...TT.....TT.......................T.T.....T...........@@@@@@@@@@@@@
@@@@@...........T.T.......T.T.T......TT....T.......T.T...TT..T..T..@@@@@@@@@@@@@
@@@@@@TT.T........T.T..T..T..T..........T..T......TTT....TT...T...@@@@@@@@@@@@@@
@@@@@@@..@@@@@...........T......TTT.T..T.T...T.TT...T......TTT...@@@@@@@@@@@@@@@
@@@@@@@.@@@@@@...T.......T.TT......T.....T.T....T............T.T@@@@@@@@@@@@@@@@
@@@@@@..@@@@@@@T..........TT........TTT.T....T..T....T.TTTT....@@@@@@@@@@@@@@@@@
@@@@@@...@@@@@@.....TTT............T.T...........T....T.......@@@@@@@@@@@@@@@@@@
@@.......@@@@@@T........T..T......TT............TT....T.T...@@@@@@@@@@@@@@@@@@@@
@@.T.............T..T...........................T.T..T....@@@@@@@@@@@@@@@@@@@@@@
@@..T..T..........T.T..T.............T....T.T..T....T....@@@@@@@@@@@@@@@@@@@@@@@
@@...T....T.T........T......T.T.....T.....T..T.TT....T.@@@@@@@@@@@@@@@@@@@@@@@@@
@@...T.T..........TT.......T.T...................T...@@@@@@@@@@@@@@@@@@@@@@@@@@@
@@....TT.....................T.T.......T.T.T.T..T..@@@@@@@@@@@@@@@@@@@@@@@@@@@@@
@@..T...T.T.T...T......TT.....T...........TT......@@@@@@@@@@@@@@@@@@@@@@@@@@@@@@
@@.........T.T.....T..TT....T........T.TT.....T..@@@@@@@@@@@@@@@@@@@@@@@@@@@@@@@
@@.T....T...T..T..T....T...T..............TT.T..@@@@@@@@@@@@@@@@@@@@@@@@@@@@@@@@
@@....T.....T..TTT......TT......T.........TTT..@@@@@@@@@@@@@@@@@@@@@@@@@@@@@@@@@
@@.......T............T.TT..T....T.....TT...T.@@@@@@@@@@@@@@@@@@@@@@@@@@@@@@@@@@
@@...T.......TTT..............T...TTT...T..T.@@@@@@@@@@@@@@@@@@@@@@@@@@@@@@@@@@@
@@.T...T..T.T.....TT.T.....T......T..T.T..TT@@@@@@@@@@@@@@@@@@@@@@@@@@@@@@@@@@@@
@@T.T......T.........T.............T.....T..@@@@@@@@@@@@@@@@@@@@@@@@@@@@@@@@@@@@
@@.T....T..T...TT..T..T...TT.T......T...T..@@@@@@@@@@@@@@@@@@@@@@@@@@@@@@@@@@@@@
@@...........TTTT..TTT..T........T.........@@@@@@@@@@@@@@@@@@@@@@@@@@@@@@@@@@@@@
@@.T...TT.T..T.....T....................T.@@@@@@@@@@@@@@@@@@@@@@@@@@@@@@@@@@@@@@
@@..T..TT..TT........T.........T.........@@@@@@@@@@@@@@@@@@@@@@@@@@@@@@@@@@@@@@@
@@.....T...T..TT..TTT.....T....TT.T......@@@@@@@@@@@@@@@@@@@@@@@@@@@@@@@@@@@@@@@
@@.T......TT..................T..........@@@@@@@@@@@@@@@@@@@@@@@@@@@@@@@@@@@@@@@
@@.....T....T..........T.T...T...T....T.@@@@@@@@@@@@@@@@@@@@@@@@@@@@@@@@@@@@@@@@
@@...T..T..T..T.........T...T.......T...@@@@@@@@@@@@@@@@@@@@@@@@@@@@@@@@@@@@@@@@
@@..TT...T...T.....T....................@@@@@@@@@@@@@@@@@@@@@@@@@@@@@@@@@@@@@@@@
@@.....T......T..T....TT.TT............@@@@@@@@@@@@@@@@@@@@@@@@@@@@@@@@@@@@@@@@@
@@...........T....TT.........T........T@@@@@@@@@@@@@@@@@@@@@@@@@@@@@@@@@@@@@@@@@
@@.........T..T.T..T.T.T..TT...........@@@@@@@@@@@@@@@@@@@@@@@@@@@@@@@@@@@@@@@@@
@@.T.......T..........T.T.........T....@@@@@@@@@@@@@@@@@@@@@@@@@@@@@@@@@@@@@@@@@
@@..T.T..T...TT.........T...T....T.....@@@@@@@@@@@@@@@@@@@@@@@@@@@@@@@@@@@@@@@@@
@@..T..T.............T..............T..@@@@@@@@@@@@@@@@@@@@@@@@@@@@@@@@@@@@@@@@@
@@.T...T.........T...T.......T..T...T..@@@@@@@@@@@@@@@@@@@@@@@@@@@@@@@@@@@@@@@@@
@@@@@@@@@@@@@@@@@@@@@@@@@@@@@@@@@@@@@@@@@@@@@@@@@@@@@@@@@@@@@@@@@@@@@@@@@@@@@@@@
@@@@@@@@@@@@@@@@@@@@@@@@@@@@@@@@@@@@@@@@@@@@@@@@@@@@@@@@@@@@@@@@@@@@@@@@@@@@@@@@
