type octile
height 54
width 52
map
@@@@@@@@@@@@@@@@@@@@@@@@@@@@@@@@@@@@@@@@@@@@@@@@@@@@
@@@@@@@@@@@@@@@@@@@@@@@@@@@@@@@@@@@@@@@@@@@@@@@@@@@@
@@@@@@@@@@@@@@@@@@@@@@@@@@@@@@@@@@@@@@@@@@@@@@@@@@@@
@@@@@@@@@@@@@@@@@@@@@@@@@@@@@@@@@@@@@@@@@@@@@@@@@@@@
@@@@@@@@@@@@@@@@@@@@@@@@@@@@@@@@@@@@@@@@@@@@@@@@@@@@
@@@@@@@@@@@@@@@@@@@@@@@@@@@@@@@@@@@@@@@@@@@@@@@@@@@@
@@@@@@@@@@@@@@@@@@@@@@@@@@@@@@@@@@@@@@@@@@@@@@@@@@@@
@@@@@@@@@@@@@@@@@@@@@@@@@@@@@@@@@@@@@@@@@@@@@@@@@@@@
@@@@@@@@@@@@@@@@@@@@@@@@@@@@@@@@@@@@@@@@@@@@@@@@@@@@
@@@@@@@@@@@@@@@@@@@@@@@@@@@@@@@@@@@@@@@@@@@@@@@@@@@@
@@@@@@@@@@@@@@@@@@@@@@@@@@@@@@@@@@@@@@@@@@@@@@@@@@@@
@@@@@@@@@@@@@@@@@@@@@@@@@@@@@@@.@@@@@@@@@@@@@@@@@@@@
@@@@@@@@@@@@@@@@@@@@@@@@@@@@@@@..@@@@@@@@@@@@@@@@@@@
@@@@@@@@@@@@@@@@@@@@@@@@@@@@@@@..T@@@@@@@@@@@@@@@@@@
@@@@@@@@@@@@@@@@@@@@@@@@@@@@@@@@...@@@@@@@@@@@@@@@@@
@@@@@@@@@@@@@@@@@@@@@@@@@@@.@@@T...@@@@@@@@@@@@@@@@@
@@@@@@@@@@@@@@@@@@@@@@@@@@.T..TTT.@@@@@@@@@@@@@@@@@@
@@@@@@@@@@@@@@@@@@@@@@@@@.T.T....@@@@@@@@@@@@@@@@@@@
@@@@@@@@@@@@@@@@@@@@@@@@T.......@@@@@@@@@@@@@@@@@@@@
@@@@@@@@@@@@@@@@@@@@@@@...TT...@@@@@@@@@@@@@@@@@@@@@
@@@@@@@@@@@@@@@@@@@@@@.T......@@@@@@@@T@.@@@@@@@@@@@
@@@@@@@@@@@@@@@@@@@@@@..TT....@@@@@@@T.T.T@@@@@@@@@@
@@@@@@@@@@@@@@@@@@@@@@.TTT.T..T@@@@@.T..TT.@@@@@@@@@
@@@@@@@@@@@@@@@@@@@@..TT........@@@.T..TT...@@@@@@@@
@@@@@@@@@@@@@@@@@@@.TT....TT..T.......T......@@@@@@@
@@@@@@@@@@@@@@@@@@......TT...T.......T.......@@@@@@@
@@@@@@@@@@@@@@@@TT......@@@..TT......TTT....@@@@@@@@
@@@@@@@@@@@@@@@..T......@@@@@........T...TT@@@@@@@@@
@@@@@@@@@@@@@@.T..T....T.@@@@@..T........T@@@@@@@@@@
@@@@@@@@@@@@@.TT.T.@.T....T@@@......T....@@@@@@@@@@@
@@@@@@@@@@@....T.@@@@T@@@@T@@.T...T..T..@@@@@@@@@@@@
@@@@@@@@@@T.......@@@@@@@@T.......T.T..@@@@@@@@@@@@@
@@@@@@@@@@@@......@@@@@@@@.T.........T@@@@@@@@@@@@@@
@@@@@@@@@@@@@......@@@@@@T.......T...@@@@@@@@@@@@@@@
@@@@@@@@@@@@@@TT...T@@@@@@.TT......T@@@@@@@@@@@@@@@@
@@@@@@@@@@@@@@T.....T@@@@@......TT.@@@@@@@@@@@@@@@@@
@@@@@@@@@@@@@.....T...@@@...T....T@@@@@@@@@@@@@@@@@@
@@@@@@@.T.....T....T............T@@@@@@@@@@@@@@@@@@@
@@@@@@@@T..T......T....TT....T..@@@@@@@@@@@@@@@@@@@@
@@@@@@@@@..T..T....T...TT.....T@@@@@@@@@@@@@@@@@@@@@
@@@@@@@@@@.T.T.T...T..T..T....@@@@@@@@@@@@@@@@@@@@@@
@@@@@@@@@@@.T...T.T....T...T.@@@@@@@@@@@@@@@@@@@@@@@
@@@@@@@@@@@@........T....T..@@@@@@@@@@@@@@@@@@@@@@@@
@@@@@@@@@@@@@..T........T.T@@@@@@@@@@@@@@@@@@@@@@@@@
@@@@@@@@@@@@@@...T......T.@@@@@@@@@@@@@@@@@@@@@@@@@@
@@@@@@@@@@@@@@@..T.......@@@@@@@@@@@@@@@@@@@@@@@@@@@
@@@@@@@@@@@@@@@@......T.@@@@@@@@@@@@@@@@@@@@@@@@@@@@
@@@@@@@@@@@@@@@@@.T....@@@@@@@@@@@@@@@@@@@@@@@@@@@@@
@@@@@@@@@@@@@@@@@@T...@@@@@@@@@@@@@@@@@@@@@@@@@@@@@@
@@@@@@@@@@@@@@@@@@@T.@@@@@@@@@@@@@@@@@@@@@@@@@@@@@@@
@@@@@@@@@@@@@@@@@@@@@@@@@@@@@@@@@@@@@@@@@@@@@@@@@@@@
@@@@@@@@@@@@@@@@@@@@@@@@@@@@@@@@@@@@@@@@@@@@@@@@@@@@
@@@@@@@@@@@@@@@@@@@@@@@@@@@@@@@@@@@@@@@@@@@@@@@@@@@@
@@@@@@@@@@@@@@@@@@@@@@@@@@@@@@@@@@@@@@@@@@@@@@@@@@@@
