type octile
height 54
width 52
map
@@@@@@@@@@@@@@@@@@@@@@@@@@@@@@@@@@@@@@@@@@@@@@@@@@@@
@@@@@@@@@@@@@@@@@@@@@@@@@@@@@@@@@@@@@@@@@@@@@@@@@@@@
@@@@@@@@@@@@@@@@@@@@@@@@@@@@@@@@@@@@@@@@@@@@@@@@@@@@
@@@@@@@@@@@@@@@@@@@@@@@@@@@@@@@@@@@@@@@@@@@@@@@@@@@@
@@@@@@@@@@@@@@@@@@@@@@@@@@@@@@@@@@@@@@@@@@@@@@@@@@@@
@@@@@@@@@@@@@@@@@@@@@@@@@@@@@@@@@@@@@@@@@@@@@@@@@@@@
@@@@@@@@@@@@@@@@@@@@@@@@@@@@@@@@@@@@@@@@@@@@@@@@@@@@
@@@@@@@@@@@@@@@@@@@@@@@@@@@@@@@@@@@@@@@@@@@@@@@@@@@@
@@@@@@@@@@@@@@@@@@@@@@@@@@@@@@@@@@@@@@@@@@@@@@@@@@@@
@@@@@@@@@@@@@@@@@@@@@@@@@@@@@@@@@@@@@@@@@@@@@@@@@@@@
@@@@@@@@@@@@@@@@@@@@@@@@@@@@@@@@@@@@@@@@@@@@@@@@@@@@
@@@@@@@@@@@@@@@@@@@@@@@@@@@@@@@@@@@@@@@@@@@@@@@@@@@@
@@@@@@@@@@@@@@@@@@@@@@@@@@@@@@@@@@@@@@@@@@@@@@@@@@@@
@@@@@@@@@@@@@@@@@@@@@@@@@@@@@.@@@@@@@@@@@@@@@@@@@@@@
@@@@@@@@@@@@@@@@@@@@@@@@@@@@TT..@@@@@@@@@@@@@@@@@@@@
@@@@@@@@@@@@@@@@@@@@@@@@@@@@@T..T.@@@@@@@@@@@@@@@@@@
@@@@@@@@@@@@@@@@@@@@@@@@@@@@@@....@@@@@@@@@@@@@@@@@@
@@@@@@@@@@@@@@@@@@@@@@@@@@@@@.......T@@@@@@@@@@@@@@@
@@@@@@@@@@@@@@@@@@@@@@@@@@.T.........@@@@@@@@@@@@@@@
@@@@@@@@@@@@@@@@@@@@@@@@@@........TT.T.@@@@@@@@@@@@@
@@@@@@@@@@@@@@@@@@@@@@@@@@T.......T.....@@@@@@@@@@@@
@@@@@@@@@@@@@@@@@@@@@@@@..TT.....T.T......@@@@@@@@@@
@@@@@@@@@@@@@@@@@@@@@@@.T.T...TTT.....T.T..@@@@@@@@@
@@@@@@@@@@@@@@@@@@@@@@..T...TTT....T......T.@@@@@@@@
@@@@@@@@@@@@@@@@@.@@@@...T..T......T.........@@@@@@@
@@@@@@@@@@@@@@@@T.T@@@T.@@@@T............T.T..@@@@@@
@@@@@@@@@@@@@@@.........@@@@@.....T.TT.......T@@@@@@
@@@@@@@@@@@@@@T.TT.T.T.@@@@@@@...T........T...@@@@@@
@@@@@@@@@@@@@....TT..T@@@@@@@@@.....TT.T...TT@@@@@@@
@@@@@@@@@@@@@....TTT.@@@@@@@@@@.....T....T..@@@@@@@@
@@@@@@@@@@@@@@.......@@@@@@@@@.T.....T.....@@@@@@@@@
@@@@@@@@@@@@@@@T.....@@@@@@@@T...T..TT..T.@@@@@@@@@@
@@@@@@@@@@@@@@.T....T@@@@@@@@.......TT...@@@@@@@@@@@
@@@@@@@@@@@@@TT....T.@@@@@@T.....T......@@@@@@@@@@@@
@@@@@@@@@@@@......T.......T.....TT.T..T@@@@@@@@@@@@@
@@@@@@@@@@@.T............T....TTT.T...@@@@@@@@@@@@@@
@@@@@@.@@@.T......T..TT.....T........@@@@@@@@@@@@@@@
@@@@@@..@...TT......T...T..T.......T@@@@@@@@@@@@@@@@
@@@@@@...TT.T....TT............T..T@@@@@@@@@@@@@@@@@
@@@@@@.T....T.T.T....T..T...T.T.T.@@@@@@@@@@@@@@@@@@
@@@@@@.T.T..T...........T......T.@@@@@@@@@@@@@@@@@@@
@@@@@@...TT..T............T.T...@@@@@@@@@@@@@@@@@@@@
@@@@@@@.......TTTT...T...T.T...@@@@@@@@@@@@@@@@@@@@@
@@@@@@@@.T........T.T......T..@@@@@@@@@@@@@@@@@@@@@@
@@@@@@@@@..T...............T.@@@@@@@@@@@@@@@@@@@@@@@
@@@@@@@@@@.....T...T........@@@@@@@@@@@@@@@@@@@@@@@@
@@@@@@@@@@@...T............@@@@@@@@@@@@@@@@@@@@@@@@@
@@@@@@@@@@@@...T........T.@@@@@@@@@@@@@@@@@@@@@@@@@@
@@@@@@@@@@@@@.T..T.......@@@@@@@@@@@@@@@@@@@@@@@@@@@
@@@@@@@@@@@@@@..T.T....T@@@@@@@@@@@@@@@@@@@@@@@@@@@@
@@@@@@@@@@@@@@@........@@@@@@@@@@@@@@@@@@@@@@@@@@@@@
@@@@@@@@@@@@@@@@.TT...@@@@@@@@@@@@@@@@@@@@@@@@@@@@@@
@@@@@@@@@@@@@@@@@..T.@@@@@@@@@@@@@@@@@@@@@@@@@@@@@@@
@@@@@@@@@@@@@@@@@@@@@@@@@@@@@@@@@@@@@@@@@@@@@@@@@@@@
