type octile
height 50
width 50
map
@@@@@@@@@@@@@@@@@@@@@@@@@@@@@@@@@@@@@@@@@@@@@@@@@@
@@@@@@@@@@@@@@@@@@@@@@@@@@@@@@@@@@@@@@@@@@@@@@@@@@
@@@@@@@@@@@@@@@@@@@@@@@@@@@@@@@@@@@@@@@@@@@@@@@@@@
@@@@@@@@@@@@@@@@@@@@@@@@@@@@@@@@@@@@@@@@@@@@@@@@@@
@@@@@@@@@@@@@@@@@@@@@@@@@@@@@@@@@@@@@@@@@@@@@@@@@@
@@@@@@@@@@@@@@@@@@@@@@@@@@@@@@@@@@@@@@@@@@@@@@@@@@
@@@@@@@@@@@@@@@@@@@@@@@@@@@@@@@@@@@@@@@@@@@@@@@@@@
@@@@@@@@@@@@@@@@@@@@@@@@@@@@@@@@@@@@@@@@@@@@@@@@@@
@@@@@@@@@@@@@@@@@@@@@@@@@@@@@@@@@@@@@@@@@@@@@@@@@@
@@@@@@@@@@@@@@@@@@@@@@@@@@@@@@@@@@@@@@@@@@@@@@@@@@
@@@@@@@@@@@@@@@@@@@@@@@@@@@@@@@@@@@@@@@@@@@@@@@@@@
@@@@@@@@@@@@@@@@@@@@@@@@@@@@@@@@@@@@@@@@@@@@@@@@@@
@@@@@@@@@@@@@@@@@@@@@@@@@@@@@@@@@@@@@@@@@@@@@@@@@@
@@@@@@@@@@@@@@@@@@@@@@@@@@@@@@@@@@@@@@@@@@@@@@@@@@
@@@@@@@@@@@@@@@@@@@@@@@@@@@@@@@@@@@@@@@@@@@@@@@@@@
@@@@@@@@@@@@@@@@@@@@@@@@@@@@@@@@@@@@@@@@@@@@@@@@@@
@@@@@@@@@@@@@@@@@@@@@@@@@@@@@@@@@@@@@@@@@@@@@@@@@@
@@@@@@@@@@@@@@@@@@@@@@@@@@@@@@@@@@@@@@@@@@@@@@@@@@
@@@@@@@@@@@@@@@@@@@@@@@@@@@@@@@@@@@@@@@@@@@@@@@@@@
@@@@@@@@@@@@@@@@@@@@@@@@@@@@@@@@@@@@@@@@@@@@@@@@@@
@@@@@@@@@@@@@@@@@@@@@@@@@@@@@@@@@@@@@@@@@@@@@@@@@@
@@@@@@@@@@@@@@@@@@@@@@@@@@@@@@@@@@@@@@@@@@@@@@@@@@
@@@@@@@@@@@@@@@@@@@@@@@@@@@.@@@@@@@@@@@@@@@@@@@@@@
@@@@@@@@@@@@@@@@@@@@@@@@@....@@@@@@@@@@@@@@@@@@@@@
@@@@@@@@@@@@@@@@@@@@@@@@......@@@@@@@@@@@@@@@@@@@@
@@@@@@@@@@@@@@@@@@@@@@@..@..T..@@@@@@@@@@@@@@@@@@@
@@@@@@@@@@@@@@@@@@@@@@..@@@TT.@@@@@@@@@@@@@@@@@@@@
@@@@@@@@@@@@@@@@@@@@@..@@@@@@.....@@@@@@@@@@@@@@@@
@@@@@@@@@@@@@@@@@@@@..@@@@@@@@..TT.@@@@@@@@@@@@@@@
@@@@@@@@@@@@@@@@@@@T...@@@@@@@@T.....@@@@@@@@@@@@@
@@@@@@@@@@@@@@@@@@..T@...@@@@@@T....T.@@@@@@@@@@@@
@@@@@@@@@@@@@@@@@..T@@@T..@@@@.........@@@@@@@@@@@
@@@@@@@@@@@@@@@@@...@@@@@..@@T....T...@@@@@@@@@@@@
@@@@@@@@@@@@@@@@.T...@@@@@.T..T......@@@@@@@@@@@@@
@@@@@@@@@@@@@@@..T..T.@@@@..T.......@@@@@@@@@@@@@@
@@@@@@@@@@@@@@....T..T.@@T.........@@@@@@@@@@@@@@@
@@@@@@@@@@@@.........T.T......TT..@@@@@@@@@@@@@@@@
@@@@@@@@@@@.......TT......T......@@@@@@@@@@@@@@@@@
@@@@@@@@@@...T..................@@@@@@@@@@@@@@@@@@
@@@@@@@@@@.T..........T........@@@@@@@@@@@@@@@@@@@
@@@@@@@@@........TT.T...TT.....@@@@@@@@@@@@@@@@@@@
@@@@@@@@@@T...T.......T.....T.@@@@@@@@@@@@@@@@@@@@
@@@@@@@@@@@......T.TT..T...T.@@@@@@@@@@@@@@@@@@@@@
@@@@@@@@@@@@TT...T.TT..T..T.@@@@@@@@@@@@@@@@@@@@@@
@@@@@@@@@@@@@.T.T...T.T....@@@@@@@@@@@@@@@@@@@@@@@
@@@@@@@@@@@@@@...........T@@@@@@@@@@@@@@@@@@@@@@@@
@@@@@@@@@@@@@@@....T.....@@@@@@@@@@@@@@@@@@@@@@@@@
@@@@@@@@@@@@@@@@....T...@@@@@@@@@@@@@@@@@@@@@@@@@@
@@@@@@@@@@@@@@@@@.T.T..@@@@@@@@@@@@@@@@@@@@@@@@@@@
@@@@@@@@@@@@@@@@@@@@@@@@@@@@@@@@@@@@@@@@@@@@@@@@@@
