type octile
height 59
width 56
map
@@@@@@@@@@@@@@@@@@@@@@@@@@@@@@@@@@@@@@@@@@@@@@@@@@@@@@@@
@@@@@@@@@@@@@@@@@@@@@@@@@@@@@@@@@@@@@@@@@@@@@@@@@@@@@@@@
@@@@@@@@@@@@@@@@@@@@@@@@@@@@@@@@@@@@@@@@@@@@@@@@@@@@@@@@
@@@@@@@@@@@@@@@@@@@@@@@@@@@@@@@@@@@@@@@@@@@@@@@@@@@@@@@@
@@@@@@@@@@@@@@@@@@@@@@@@@@@@@@@@@@@@@@@@@@@@@@@@@@@@@@@@
@@@@@@@@@@@@@@@@@@@@@@@@@@@@@@@@@@@@@@@@@@@@@@@@@@@@@@@@
@@@@@@@@@@@@@@@@@@@@@@@@@@@@@@@@@@@@@@@@@@@@@@@@@@@@@@@@
@@@@@@@@@@@@@@@@@@@@@@@@@@@@@@@@@@@@@@@@@@@@@@@@@@@@@@@@
@@@@@@@@@@@@@@@@@@@@@@@@@@@@@@@@@@@@@@@@@@@@@@@@@@@@@@@@
@@@@@@@@@@@@@@@@@@@@@@@@@@@@@@@@@@@@@@@@@@@@@@@@@@@@@@@@
@@@@@@@@@@@@@@@@@@@@@@@@@@@@@TT@@@@@@@@@@@@@@@@@@@@@@@@@
@@@@@@@@@@@@@@@@@@@@@@@@@@@@@@..@@@@@@@@@@@@@@@@@@@@@@@@
@@@@@@@@@@@@@@@@@@@@@@@@@@@@@@@.T@@@@@@@@@@@@@@@@@@@@@@@
@@@@@@@@@@@@@@@@@@@@@@@@@@@@@@@@TT..@@@@@@@@@@@@@@@@@@@@
@@@@@@@@@@@@@@@@@@@@@@@@@@@@@@@@@....@@@@@@@@@@@@@@@@@@@
@@@@@@@@@@@@@@@@@@@@@@@@@@@@@@@@@@T...@@@@@T@@@@@@@@@@@@
@@@@@@@@@@@@@@@@@@@@@@@..@@@@@@@@@.....@@@.T.@@@@@@@@@@@
@@@@@@@@@@@@@@@@@@@@@@.T.@@@@@@@@@T.....@T..@@@@@@@@@@@@
@@@@@@@@@@@@@@@@@@@@@.T....@@@@@@..T.TT...T@@@@@@@@@@@@@
@@@@@@@@@@@@@@@@@@@@..T..T@@@@@@...T.T.....@@@@@@@@@@@@@
@@@@@@@@@@@@@@@@@@@@@.....@@@@@......T......@@@@@@@@@@@@
@@@@@@@@@@@@@@@@@@@@@@.....@@@.........T.T..T@@@@@@@@@@@
@@@@@@@@@@@@@@@@@@@@@@@.TT..T...T.T..TT.T....@@@@@@@@@@@
@@@@@@@@@@@@@@@@@@@@@@@@.................@@@@@@@@@@@@@@@
@@@@@@@@@@@@@@@@@@@@@@@@@................@@@@@@@@@@@@@@@
@@@@@@@@@@@@@@@@@@@@@@@@@.T.........T.T.T@..T..@@@@@@@@@
@@@@@@@@@@@@@@@..@@@@@@.T.....T......TTT.@.....T.T@@@@@@
@@@@@@@@@@@@T.T..@@@@@@.T..T.T..T........T....@@@.T@@@@@
@@@@@@@@@@@..T...@@@@...TTT.T.......TT.T.T....@@@@..@@@@
@@@@@@@@@@..T....@@@@.....T...TTTT.....T@@T.T.@@@@..@@@@
@@@@@@@@@@.T.........T.T......T...T.....@@.TT@@@@@.@@@@@
@@@@@@@@@@@.T.........TT.T.T..T........T@@.T.@@@@@@@@@@@
@@@@@@@@@@@@@T.......TT....T.........TT.@@..T.@@@@@@@@@@
@@@@@@@@@@@@@@..T...........T...........@@......@@@@@@@@
@@@@.@@@@@@@@@@..................T....T@@T..TTTT@@@@@@@@
@@@...@@@@@@@@@T..T.T.T.......T...T...T@@@...T.@@@@@@@@@
@@.....@@@@@@.......T....T......T.......@@....@@@@@@@@@@
@@.T...@@@@@.....T............T.@@...T.T.@...@@@@@@@@@@@
@@......@@...T...T....TT...T....@@..T...T...@@@@@@@@@@@@
@@.........T.....T.............@@@@T...TT..@@@@@@@@@@@@@
@@@.....T................TT.T@@@@@@@@.....@@@@@@@@@@@@@@
@@@@.T........T..T.....TT....@@@@@@@@T...@@@@@@@@@@@@@@@
@@@@@.........T......T.T.....@@@@@@@TT..@@@@@@@@@@@@@@@@
@@@@@@...T..T...........T.....T@@@@...@@@@@@@@@@@@@@@@@@
@@@@@@@T.....T.T.........TT..TT.T....@@@@@@@@@@@@@@@@@@@
@@@@@@@@T..T...........@@........T..@@@@@@@@@@@@@@@@@@@@
@@@@@@@@@T.T.T.........@@@T.T..TT..@@@@@@@@@@@@@@@@@@@@@
@@@@@@@@@@.T..........@@@@........@@@@@@@@@@@@@@@@@@@@@@
@@@@@@@@@@@.......T.@@@@@@T..T.T.@@@@@@@@@@@@@@@@@@@@@@@
@@@@@@@@@@@@.T.....T@@@@@@@....T@@@@@@@@@@@@@@@@@@@@@@@@
@@@@@@@@@@@@@.T.T.....@@@@@....@@@@@@@@@@@@@@@@@@@@@@@@@
@@@@@@@@@@@@@@..TT..T..@@@@...@@@@@@@@@@@@@@@@@@@@@@@@@@
@@@@@@@@@@@@@@@.T.......T....@@@@@@@@@@@@@@@@@@@@@@@@@@@
@@@@@@@@@@@@@@@@TT..T.....T.@@@@@@@@@@@@@@@@@@@@@@@@@@@@
@@@@@@@@@@@@@@@@@....TTT...@@@@@@@@@@@@@@@@@@@@@@@@@@@@@
@@@@@@@@@@@@@@@@@@.T....T.@@@@@@@@@@@@@@@@@@@@@@@@@@@@@@
@@@@@@@@@@@@@@@@@@@T.....@@@@@@@@@@@@@@@@@@@@@@@@@@@@@@@
@@@@@@@@@@@@@@@@@@@@.T..@@@@@@@@@@@@@@@@@@@@@@@@@@@@@@@@
@@@@@@@@@@@@@@@@@@@@@@@@@@@@@@@@@@@@@@@@@@@@@@@@@@@@@@@@
