type octile
height 59
width 56
map
@@@@@@@@@@@@@@@@@@@@@@@@@@@@@@@@@@@@@@@@@@@@@@@@@@@@@@@@
@@@@@@@@@@@@@@@@@@@@@@@@@@@@@@@@@@@@@@@@@@@@@@@@@@@@@@@@
@@@@@@@@@@@@@@@@@@@@@@@@@@@@@@@@@@@@@@@@@@@@@@@@@@@@@@@@
@@@@@@@@@@@@@@@@@@@@@@@@@@@@@@@@@@@@@@@@@@@@@@@@@@@@@@@@
@@@@@@@@@@@@@@@@@@@@@@@@@@@@@@@@@@@@@@@@@@@@@@@@@@@@@@@@
@@@@@@@@@@@@@@@@@@@@@@@@@@@@@@@@@@@@@@@@@@@@@@@@@@@@@@@@
@@@@@@@@@@@@@@@@@@@@@@@@@@@@@@@@@@@@@@@@@@@@@@@@@@@@@@@@
@@@@@@@@@@@@@@@@@@@@@@@@@@@@@@@@@@@@@@@@@@@@@@@@@@@@@@@@
@@@@@@@@@@@@@@@@@@@@@@@@@@@@@@@@@@@@@@@@@@@@@@@@@@@@@@@@
@@@@@@@@@@@@@@@@@@@@@@@@@@@@@@@@@@@@@@@@@@@@@@@@@@@@@@@@
@@@@@@@@@@@@@@@@@@@@@@@@@@@@@@@@@@@@@@@@@@@@@@@@@@@@@@@@
@@@@@@@@@@@@@@@@@@@@@@@@@@@@@@@@@@@@@@@@@@@@@@@@@@@@@@@@
@@@@@@@@@@@@@@@@@@@@@@@@@@@@@@@@@@@@@@@@@@@@@@@@@@@@@@@@
@@@@@@@@@@@@@@@@@@@@@@@@@@@@@@@@.@@@@@@@@@@@@@@@@@@@@@@@
@@@@@@@@@@@@@@@@@@@@@@@@@@@@@@@T.....@@@@@@@@@@@@@@@@@@@
@@@@@@@@@@@@@@@@@@@@@@@@@@@@@@.......@@@@@@@@@@@@@@@@@@@
@@@@@@@@@@@@@@@@@@@@@@@@@@@@......@@@@@@@@@@@@@@@@@@@@@@
@@@@@@@@@@@@@@@@@@@@@@@@@@@..T.T.@@@@@.@@@@@@@@@@@@@@@@@
@@@@@@@@@@@@@@@@@@@@@@@@@@...@@.T@@@@@...T@@@@@@@@@@@@@@
@@@@@@@@@@@@@@@@@@@@@@@@@@..@@@..@@@@@T...T.@@@@@@@@@@@@
@@@@@@@@@@@@@@@@@@@@@@@@@T.@@@@TT@@@@@.T@@..@@@@@@@@@@@@
@@@@@@@@@@@@@@@@@@@@@@@@T.@@@....T.@@@..@@@@@@@@@@@@@@@@
@@@@@@@@@@@@@@@@@@@@@@@@.T@@@T..........@@@@@@@@@@@@@@@@
@@@@@@@@@@@@@@@@@@@@@.........TT.T......T.@@@@@@@@@@@@@@
@@@@@@@@@@@@@@@@@@@@.T.@..T.T....T.....T..T@@@@@@@@@@@@@
@@@@@@@@@@@@@@@@@@@...@@@..TT.........T.....@@.@@@@@@@@@
@@@@@@@@@@@@@@@@@@@@.@@@@@..T......TT.T......T.T.@@@@@@@
@@@@@@@@@@@@@@@@@@@@T@@@@@@...........T.....T..T..T@@@@@
@@@@@@@@@@@@@@@@@@@T.@@@@@@@T.......T..TT....T....T.@@@@
@@@@@@@@@@@@@@@@@....@@@@@.T...........TT..T........@@@@
@@@@@@@@@@@@@@@@@@@T..T@@......T...T.......T.TT....@@@@@
@@@@@@@@@@@@@@@@@@@@..TT.........TT...............@@@@@@
@@@@@@@@@@@@@@@@@@@@T.....@....T.............T...@@@@@@@
@@@@@@@@@@@@@@@@@@@......@@@.....T...T..T.......@@@@@@@@
@@@@@@@@@.@@@T.@@@...T.@@@@@......T.TT.........@@@@@@@@@
@@@@@@@@.T@@@T.T@..TT..@@@@@@...T....T...T..T.@@@@@@@@@@
@@@@@@@..T.@@...TT....T@@@@@.................@@@@@@@@@@@
@@@@@.T...T.@.T@@...T..T.@...T......TTT.....@@@@@@@@@@@@
@@@@.TT..T..T.@@@@T.....T..T........T...T..@@@@@@@@@@@@@
@@@T.T.....T..@@@@@............T......T.TT@@@@@@@@@@@@@@
@@..T..TT..T...@@@@TT..T......T..TT......@@@@@@@@@@@@@@@
@TTTT....TT..T.T@@@...T..T....T.........@@@@@@@@@@@@@@@@
@@..TTT.....TT...@..TT.................@@@@@@@@@@@@@@@@@
@@@T.TT....T..T......T................@@@@@@@@@@@@@@@@@@
@@@@....TT.......T.T..T..T.....T.....@@@@@@@@@@@@@@@@@@@
@@@@@..T......T..T..T....T.....TT...@@@@@@@@@@@@@@@@@@@@
@@@@@@.T...T...T..T......T.T..T....@@@@@@@@@@@@@@@@@@@@@
@@@@@@@.....TT.T..T.T.....TT......@@@@@@@@@@@@@@@@@@@@@@
@@@@@@@@..............T...T..TTT.@@@@@@@@@@@@@@@@@@@@@@@
@@@@@@@@@.....TT.T.....T..T.T...@@@@@@@@@@@@@@@@@@@@@@@@
@@@@@@@@@@T.T....TT.....T...T..@@@@@@@@@@@@@@@@@@@@@@@@@
@@@@@@@@@@@.TT.T......T.T....T@@@@@@@@@@@@@@@@@@@@@@@@@@
@@@@@@@@@@@@..........T......@@@@@@@@@@@@@@@@@@@@@@@@@@@
@@@@@@@@@@@@@T...........T..@@@@@@@@@@@@@@@@@@@@@@@@@@@@
@@@@@@@@@@@@@@......T..T...@@@@@@@@@@@@@@@@@@@@@@@@@@@@@
@@@@@@@@@@@@@@@....T......@@@@@@@@@@@@@@@@@@@@@@@@@@@@@@
@@@@@@@@@@@@@@@@..T....TT@@@@@@@@@@@@@@@@@@@@@@@@@@@@@@@
@@@@@@@@@@@@@@@@@....T..@@@@@@@@@@@@@@@@@@@@@@@@@@@@@@@@
@@@@@@@@@@@@@@@@@@@@@@@@@@@@@@@@@@@@@@@@@@@@@@@@@@@@@@@@
