type octile
height 54
width 52
map
@@@@@@@@@@@@@@@@@@@@@@@@@@@@@@@@@@@@@@@@@@@@@@@@@@@@
@@@@@@@@@@@@@@@@@@@@@@@@@@@@@@@@@@@@@@@@@@@@@@@@@@@@
@@@@@@@@@@@@@@@@@@@@@@@@@@@@@@@@@@@@@@@@@@@@@@@@@@@@
@@@@@@@@@@@@@@@@@@@@@@@@@@@@@@@@@@@@@@@@@@@@@@@@@@@@
@@@@@@@@@@@@@@@@@@@@@@@@@@@@@@@@@@@@@@@@@@@@@@@@@@@@
@@@@@@@@@@@@@@@@@@@@@@@@@@@@@@@@@@@@@@@@@@@@@@@@@@@@
@@@@@@@@@@@@@@@@@@@@@@@@@@@@@@@@@@@@@@@@@@@@@@@@@@@@
@@@@@@@@@@@@@@@@@@@@@@@@@@@@@@@@@@@@@@@@@@@@@@@@@@@@
@@@@@@@@@@@@@@@@@@@@@@@@@@@@@@@@@@@@@@@@@@@@@@@@@@@@
@@@@@@@@@@@@@@@@@@@@@@@@@@@@@@@@@@@@@@@@@@@@@@@@@@@@
@@@@@@@@@@@@@@@@@@@@@@@@@@@@@@@@@@@@@@@@@@@@@@@@@@@@
@@@@@@@@@@@@@@@@@@@@@@@@@@@@@@@.@@@@@@@@@@@@@@@@@@@@
@@@@@@@@@@@@@@@@@@@@@@@@@@@@@@@..@@@@@@@@@@@@@@@@@@@
@@@@@@@@@@@@@@@@@@@@@@@@@@@@@@@...@@@@@@@@@@@@@@@@@@
@@@@@@@@@@@@@@@@@@@@@@@@@@@@@@@@...@@@@@@@@@@@@@@@@@
@@@@@@@@@@@@@@@@@@@@@@@@@@@.@@@.TT.@@@@@@@@@@@@@@@@@
@@@@@@@@@@@@@@@@@@@@@@@@@@.TT..T..@@@@@@@@@@@@@@@@@@
@@@@@@@@@@@@@@@@@@@@@@@@@...T..T.@@@@@@@@@@@@@@@@@@@
@@@@@@@@@@@@@@@@@@@@@@@@..T.T...@@@@@@@@@@@@@@@@@@@@
@@@@@@@@@@@@@@@@@@@@@@@.T.T..T.@@@@@@@@@@@@@@@@@@@@@
@@@@@@@@@@@@@@@@@@@@@@T..T...T@@@@@@@@T@.@@@@@@@@@@@
@@@@@@@@@@@@@@@@@@@@@@T.TT...T@@@@@@@.....@@@@@@@@@@
@@@@@@@@@@@@@@@@@@@@@@....T..T.@@@@@..T....@@@@@@@@@
@@@@@@@@@@@@@@@@@@@@....T....T..@@@..T...T..@@@@@@@@
@@@@@@@@@@@@@@@@@@@...T.T......T..T.T....T...@@@@@@@
@@@@@@@@@@@@@@@@@@T...T.......T............T.@@@@@@@
@@@@@@@@@@@@@@@@...TT...@@@....T.......TT.T.@@@@@@@@
@@@@@@@@@@@@@@@TT.T.T..T@@@@@..T..T..T.....@@@@@@@@@
@@@@@@@@@@@@@@....T......@@@@@..T.T..T....@@@@@@@@@@
@@@@@@@@@@@@@TT.T..@..T.TT.@@@...T.......@@@@@@@@@@@
@@@@@@@@@@@.T...T@@@@.@@@@.@@.T.T...T...@@@@@@@@@@@@
@@@@@@@@@@T......T@@@@@@@@..T..T.......@@@@@@@@@@@@@
@@@@@@@@@@@@......@@@@@@@@T....T....TT@@@@@@@@@@@@@@
@@@@@@@@@@@@@......@@@@@@.....TTT....@@@@@@@@@@@@@@@
@@@@@@@@@@@@@@T.TT..@@@@@@.....T....@@@@@@@@@@@@@@@@
@@@@@@@@@@@@@@......T@@@@@T.....T.T@@@@@@@@@@@@@@@@@
@@@@@@@@@@@@@...TT....@@@.T.T...T.@@@@@@@@@@@@@@@@@@
@@@@@@@.......T..................@@@@@@@@@@@@@@@@@@@
@@@@@@@@......TT..T..TT..T...TT.@@@@@@@@@@@@@@@@@@@@
@@@@@@@@@.....T..T.TT.......T..@@@@@@@@@@@@@@@@@@@@@
@@@@@@@@@@T........T....T.....@@@@@@@@@@@@@@@@@@@@@@
@@@@@@@@@@@...T...T.T......T.@@@@@@@@@@@@@@@@@@@@@@@
@@@@@@@@@@@@....T..........T@@@@@@@@@@@@@@@@@@@@@@@@
@@@@@@@@@@@@@.......T.T....@@@@@@@@@@@@@@@@@@@@@@@@@
@@@@@@@@@@@@@@TT....T.....@@@@@@@@@@@@@@@@@@@@@@@@@@
@@@@@@@@@@@@@@@..........@@@@@@@@@@@@@@@@@@@@@@@@@@@
@@@@@@@@@@@@@@@@T..T....@@@@@@@@@@@@@@@@@@@@@@@@@@@@
@@@@@@@@@@@@@@@@@....T.@@@@@@@@@@@@@@@@@@@@@@@@@@@@@
@@@@@@@@@@@@@@@@@@T...@@@@@@@@@@@@@@@@@@@@@@@@@@@@@@
@@@@@@@@@@@@@@@@@@@..@@@@@@@@@@@@@@@@@@@@@@@@@@@@@@@
@@@@@@@@@@@@@@@@@@@@@@@@@@@@@@@@@@@@@@@@@@@@@@@@@@@@
@@@@@@@@@@@@@@@@@@@@@@@@@@@@@@@@@@@@@@@@@@@@@@@@@@@@
@@@@@@@@@@@@@@@@@@@@@@@@@@@@@@@@@@@@@@@@@@@@@@@@@@@@
@@@@@@@@@@@@@@@@@@@@@@@@@@@@@@@@@@@@@@@@@@@@@@@@@@@@
