type octile
height 54
width 52
map
@@@@@@@@@@@@@@@@@@@@@@@@@@@@@@@@@@@@@@@@@@@@@@@@@@@@
@@@@@@@@@@@@@@@@@@@@@@@@@@@@@@@@@@@@@@@@@@@@@@@@@@@@
@@@@@@@@@@@@@@@@@@@@@@@@@@@@@@@@@@@@@@@@@@@@@@@@@@@@
@@@@@@@@@@@@@@@@@@@@@@@@@@@@@@@@@@@@@@@@@@@@@@@@@@@@
@@@@@@@@@@@@@@@@@@@@@@@@@@@@@@@@@@@@@@@@@@@@@@@@@@@@
@@@@@@@@@@@@@@@@@@@@@@@@@@@@@@@@@@@@@@@@@@@@@@@@@@@@
@@@@@@@@@@@@@@@@@@@@@@@@@@@@@@@@@@@@@@@@@@@@@@@@@@@@
@@@@@@@@@@@@@@@@@@@@@@@@@@@@@@@@@@@@@@@@@@@@@@@@@@@@
@@@@@@@@@@@@@@@@@@@@@@@@@@@@@@@@@@@@@@@@@@@@@@@@@@@@
@@@@@@@@@@@@@@@@@@@@@@@@@@@@@@@@@@@@@@@@@@@@@@@@@@@@
@@@@@@@@@@@@@@@@@@@@@@@@@@@@@@@@@@@@@@@@@@@@@@@@@@@@
@@@@@@@@@@@@@@@@@@@@@@@@@@@@@.@@@@@@@@@@@@@@@@@@@@@@
@@@@@@@@@@@@@@@@@@@@@@@@@@@@@..@@@@@@@@@@@@@@@@@@@@@
@@@@@@@@@@@@@@@@@@@@@@@@@@@@@...@@@@@@@@@@@@@@@@@@@@
@@@@@@@@@@@@@@@@@@@@@@@@@@@@@@.T.@@@@@@@@@@@@@@@@@@@
@@@@@@@@@@@@@@@@@@@@@@@@@@@@@@....@@@@@@@@@@@@@@@@@@
@@@@@@@@@@@@@@@@@@@@@@@@@@@@@......@@.@@@@@@@@@@@@@@
@@@@@@@@@@@@@@@@@@@@@@@@@@@@..T..T..T.@@@@@@@@@@@@@@
@@@@@@@@@@@@@@@@@@@@@@@@@@@....T...TTT@@@@@@@@@@@@@@
@@@@@@@@@@@@@@@@@@@@@@@@@@...T.T.....@@@@@@@@@@@@@@@
@@@@@@@@@@@@@@@@@@@@@@@@@...T..@.......@@@@@@@@@@@@@
@@@@@@@@@@@@@@@@@@@T@@@@T....T@@@@TTTT....@@@@@@@@@@
@@@@@@@@@@@@@@@@@@@......T@@.@@@@@@......@@@@@@@@@@@
@@@@@@@@@@@@@@@@@@@T....T@@@T.@@@@@.....T@@@@@@@@@@@
@@@@@@@@@@@@@@@@@@@@.....@@@..T.@@@@.TT.T@@@@@@@@@@@
@@@@@@@@@@@@@@@@@@@....T.....@@..@@@.TTT..@@@@@@@@@@
@@@@@@@@@@@@@@@@@..T.T......@@@T.T@......TT@@@@@@@@@
@@@@@@@@@@@@@@@@@...T..@@@..@@@.T...T.TTT...@@@@@@@@
@@@@@@@@@@@@@@@@T......@@@@...T.@@....T......@@@@@@@
@@@@@@@@@@@@@@@.T..T....@@@@...@@@.........TT.@@@@@@
@@@@@@@@@@@@@........T...@@@@..@@@.............@@@@@
@@@@@@@@@@@...TTTT........@@@@TT@T..T..........@@@@@
@@@@@@@@@@@.T..T.....TT....@@.T.TT..TT...T.T.T@@@@@@
@@@@@@@@@@@..................T.......T.....T.@@@@@@@
@@@@@@@@@@.....T@@T.T.TTT...................@@@@@@@@
@@@@@@@@@.TT....@@@..TT.T.............T..T.@@@@@@@@@
@@@@@TT.T.......@@@......TT..T.TT..T...T..@@@@@@@@@@
@@@@.........T@..@@............T.........@@@@@@@@@@@
@@@....T..TT.@@T..@..TT...TT......TT....@@@@@@@@@@@@
@@..........T@@@..T..T............TTTTT@@@@@@@@@@@@@
@@...T..T.....@@.T....T..T..........T.@@@@@@@@@@@@@@
@@@....T....T.@@.......T.....TT...T.T@@@@@@@@@@@@@@@
@@@@.T...T.T..T....TT.....T.........@@@@@@@@@@@@@@@@
@@@@@.....T....T.T.T....T..T..TTT.T@@@@@@@@@@@@@@@@@
@@@@@@..........T...T.........T...@@@@@@@@@@@@@@@@@@
@@@@@@@...T.........T........T..T@@@@@@@@@@@@@@@@@@@
@@@@@@@@T....T.....T...TTT......@@@@@@@@@@@@@@@@@@@@
@@@@@@@@@.......T......TT.....T@@@@@@@@@@@@@@@@@@@@@
@@@@@@@@@@....T..TT..T...T..T.@@@@@@@@@@@@@@@@@@@@@@
@@@@@@@@@@@.T...........T....@@@@@@@@@@@@@@@@@@@@@@@
@@@@@@@@@@@@T.T......T.....T@@@@@@@@@@@@@@@@@@@@@@@@
@@@@@@@@@@@@@.....T...T...T@@@@@@@@@@@@@@@@@@@@@@@@@
@@@@@@@@@@@@@@....T.T.....@@@@@@@@@@@@@@@@@@@@@@@@@@
@@@@@@@@@@@@@@@@@@@@@@@@@@@@@@@@@@@@@@@@@@@@@@@@@@@@
