type octile
height 80
width 80
map
@@@@@@@@@@@@@@@@@@@@@@@@@@@@@@@@@@@@@@@@@@@@@@@@@@@@@@@@@@@@@@@@@@@@@@@@@@@@@@@@
@@@@@@@@@@@@@@@@@@@@@@@@@@@@@@@@@@@@@@@@@@@@@@@@@@@@@@@@@@@@@@@@@@@@@@@@@@@@@@@@
@@@@@@@@@@@@@@@@@@@@@@@@@@@@@@@@@@@@@@@@@@@@@@@@@@@@@@@@@@@@@@@@@@@@@@@@@@@@@@@@
@@@@@@@@@@@@@@@@@@@@@@@@@@@@@@@@@@@@@@@@@@@@@@@@@@@@@@@@@@@@@@@@@@@@@@@@@@@@@@@@
@@@@@@@@@@@@@@@@@@@@@@@@@@@@@@@@@@@@@@@@@@@@@@@@@@@@@@@@@@@@@@@@@@@@@@@@@@@@@@@@
@@@@@@@@@@@@@@@@@@@@@@@@@@@@@@@@@@@@@@@@@@@@@@@@@@@@@@@@@@@@@@@@@@@@@@@@@@@@@@@@
@@@@@@@@@@@@@@@@@@@@@@@@@@@@@@@@@@@@@@@@@@@@@@@@@@@@@@@@@@@@@@@@@@@@@@@@@@@@@@@@
@@@@@@@@@@@@@@@@@@@@@@@@@@@@@@@@@@@@@@@@@@@@@@@@@@@@@@@@@@@@@@@@@@@@@@@@@@@@@@@@
@@@@@@@@@@@@@@@@@@@@@@@@@@@@@@@@@@@@@@@@@@@@@@@@@@@@@@@@@@@@@@@@@@@@@@@@@@@@@@@@
@@@@@@@@@@@@@@@@@@@@@@@@@@@@@@@@@@@@@@@@@@@@@@@@@@@@@@@@@@@@@@@@@@@@@@@@@@@@@@@@
@@@@@@@@@@@@@@@@@@@@@@@@@@@@@@@@@@@@@@@@@@@@@@@@@@@@@@@@@@@@@@@@@@@@@@@@@@@@@@@@
@@@@@@@@@@@@@@@@@@@@@@@@@@@@@@@@@@@@@@@@@@@@@@@@@@@@@@@@@@@@@@@@@@@@@@@@@@@@@@@@
@@@@@@@@@@@@@@@@@@@@@@@@@@@@@@@@@@@@@@@@@@@@@@@@@@@@@@@@@@@@@@@@@@@@@@@@@@@@@@@@
@@@@@@@@@@@@@@@@@@@@@@@@@@@@@@@@@@@@@@@@@@@@@@@@@@@@@@@@@@@@@@@@@@@@@@@@@@@@@@@@
@@@@@@@@@@@@@@@@@@@@@@@@@@@@@@@@@@@@@@@@@@@@@@@@@@@@@@@@@@@@@@@@@@@@@@@@@@@@@@@@
@@@@@@@@@@@@@@@@@@@@@@@@@@@@@@@@@@@@@@@@@@@@@@@@@@@@@@@@@@@@@@@@@@@@@@@@@@@@@@@@
@@@@@@@@@@@@@@@@@@@@@@@@@@@@@@@@@@@@@@@@@@@@@@@@@@@@@@@@@@@@@@@@@@@@@@@@@@@@@@@@
@@@@@@@@@@@@@@@@@@@@@@@@@@@@@@@@@@@@@@@@@@@@@@@@@@@@@@@@@@@@@@@@@@@@@@@@@@@@@@@@
@@@@@@@@@@@@@@@@@@@@@@@@@@@@@@@@@@@@@@@.@@@@@@@@@@@@@@@@@@@@@@@@@@@@@@@@@@@@@@@@
@@@@@@@@@@@@@@@@@@@@@@@@@@@@@@@@@@@@@@@.@@@@@@@@@@@@@@@@@@@@@@@@@@@@@@@@@@@@@@@@
@@@@@@@@@@@@@@@@@@@@@@@@@@@@@@@@@@@@@@....@@@@@@@@@@@@@@@@@@@@@@@@@@@@@@@@@@@@@@
@@@@@@@@@@@@@@@@@@@@@@@@@@@@@@@@@@@@@@...T@@@@@@@@@@@.@@@@@@@@@@@@@@@@@@@@@@@@@@
@@@@@@@@@@@@@@@@@@@@@@@@@@@@@@@@@@@@@@....@@@@@@@@@....@@@@@@@@@@@@@@@@@@@@@@@@@
@@@@@@@@@@@@@@@@@@@@@@@@@@@@@@@@@@@@@@T...@@@@@@@@@..T.@@@@@@@@@@@@@@@@@@@@@@@@@
@@@@@@@@@@@@@@@@@@@@@@@@@@@@@@@@@@@@@@@....@@@@@@@..T.@@@@@@@@@@@@@@@@@@@@@@@@@@
@@@@@@@@@@@@@@@@@@@@@@@@@@@@@@@@@@@@@@T......T@@@....@@@@@@@@@@@@@@@@@@@@@@@@@@@
@@@@@@@@@@@@@@@@@@@@@@@@@@@@@@@@@@@@@T.....T..T.....@@@@@@@@@@@@@@@@@@@@@@@@@@@@
@@@@@@@@@@@@@@@@@@@@@@@@@@@@@@@@@@@@@TTT.T.T...TT..@@@@@@@@@@@@@@@@@@@@@@@@@@@@@
@@@@@@@@@@@@@@@@@@@@@@@@@@@@@@@@@.......T....T.....@@@@@@@@@@@@@@@@@@@@@@@@@@@@@
@@@@@@@@@@@@@@@@@@@@@@@@@@@@.@@.T...T.T....T......@@@@@@@@@@@@@..@@@@@@@@@@@@@@@
@@@@@@@@@@@@@@@@@@@@@@@@@@@@.@@...T....TT.........@@@@@@@@@@@@@TT.@@@@@@@@@@@@@@
@@@@@@@@@@@@@@@@@@@@@@@@@@@@..@...T.T.T.......T...T@@@@@@@@@@@...@@@@@@@@@@@@@@@
@@@@@@@@@@@@@@@@@@@@@@@@@@@@.T@@T.T.T......T..T....@@@@@@@@@@@T.T@@@@@@@@@@@@@@@
@@@@@@@@@@@@@@@@@@@@@@@@@@@@@.@@..T..T...T...T....T.@@@@@@@@@...@@@@@@@@@@@@@@@@
@@@@@@@@@@@@@@@@@@@@@@@@@@@@@.@@.T.........T..T...T.@@@@@@@@...@@@@@@@@@@@@@@@@@
@@@@@@@@@@@@@@@@@@@@@@@@@@@...@@T....T.......T.T....T.@@@@@....@@@@@@@@@@@@@@@@@
@@@@@@@@@@@@@@@@@@@@@@...@@....T..................T..TT...T....@@@@@@@@@@@@@@@@@
@@@@@@@@@@@@@@@@@@@@@....T@........T..T.T......T......T..T..T.T.@@@@@@@@@@@@@@@@
@@@@@@@@@@@@@@@@@@@@@.....T.....T.T.......T................T@@@@@@@@@@@@@@@@@@@@
@@@@@@@@@@@@@@@@@@@@@TT..T..T..T.T...T....T.......T........@@@@@@@@@@@@@@@@@@@@@
@@@@@@@@@@@@@@@@@@@@@@...T..............T..T.....T........@@@@@@@@@@@@@@@@@@@@@@
@@@@@@@@@@@@@@@@@@@@@@@......T....T........T...T......T.TT@@@@@@@@@@@@@@@@@@@@@@
@@@@@@@@@@@@@@@@@@@@@@@.....T....T......T.T.........T....@@@@@@@@@@@@@@@@@@@@@@@
@@@@@@@@@@@@@@@@@@@@@@@@T...................T........T...@@@@@@@@@@..@@@@@@@@@@@
@@@@@@@@@@@@@@@@@@@@@@@@@..T.T...........T...T.T.........@@@@@@@@@@..@@@@@@@@@@@
@@@@@@@@@@@@@@@@@@@@@@@@@..............T..T...........T...@@@@@@@@@...@@@@@@@@@@
@@@@@@@@@@@@@@@@@@@@@@@@@.T.......T...T....T........T......@@@@@@@....@@@@@@@@@@
@@@@@@@@@@@@@@@@@@@@@@@@@...T.........TT.T..T..TT..TTTT....T.@@@....T.@@@@@@@@@@
@@@@@@@@@@@@@@@@@@@@@@@@.TT............T......T....................T..@@@@@@@@@@
@@@@@@@@@@@@@@@@@@@@@@@TT...TTTT....T..T...T.T......T...........T..T..@@@@@@@@@@
@@@@@@@@@@@@@@@@@@@@@.T..T.TT..T..T....TT..................T.TTTT...TT@@@@@@@@@@
@@@@@@@@@@@@@@@@@@@@.TT.TT...T.................T.T.....@@@@.T........@@@@@@@@@@@
@@@@@@@@@@@@@@@@@@@@.T..TT...T........T....T.T........@@@@@@....T....@@@@@@@@@@@
@@@@@@@@@@@@@@@@@@@..T...T..T....T..........TT....T...@@@@@@...T.....@@@@@@@@@@@
@@@@@@@@@@@@@@@.@@..........T......T........T....T....@@@@@@.....T..@@@@@@@@@@@@
@@@@@@@@@@@@@@@.@@.............T................TT....@@@@@@T....T.T@@@@@@@@@@@@
@@@@@@@@@@@@@@@.@@T..TT.....T............T.....T.TTT...@@@@@.....T.@@@@@@@@@@@@@
@@@@@@@@@@@@@@...@........................T.T..........T.T....T.T..@@@@@@@@@@@@@
@@@@@@@@@@@@@....T..........................@@@@...............T..@@@@@@@@@@@@@@
@@@@@@@@@@@@@T..T..........T....TT...T.....@@@@@@........T..T..T.@@@@@@@@@@@@@@@
@@@@@@@@@@@@@T....T.T....T.T.........T....@@@@@@@@.T..........T.@@@@@@@@@@@@@@@@
@@@@@@@@@@@@@@T...T.T.....................@@@@@@@@T...........T@@@@@@@@@@@@@@@@@
@@@@@@@@@@@@@@T.T.T.TT.T.T.T...T....T...TT@@@@@@@@T.T....T...T@@@@@@@@@@@@@@@@@@
@@@@@@@@@@@@@@..T.....T....TT..T....T...@@@@@@@@@....T.......@@@@@@@@@@@@@@@@@@@
@@@@@@@@@@@@@..........T....T......T..@@@@@@@@@@..T.....TTT.@@@@@@@@@@@@@@@@@@@@
@@@@@@@@@@@@@....T...........T.......@@@@@@@@@@.T.T.T....T@@@@@@@@@@@@@@@@@@@@@@
@@@@@@@@@@@@.........TT....TTT....T.T@@@@@@@@@TT....T.T.@@@@@@@@@@@@@@@@@@@@@@@@
@@@@@@@@@@@@.T..TTT.TT...T..........T@@@@@@@..T.......@@@@@@@@@@@@@@@@@@@@@@@@@@
@@@@@@@@@@@@.........T......TT..T.....@@@@.TT......@@@@@@@@@@@@@@@@@@@@@@@@@@@@@
@@@@@@@@@@@@.......T.T..T.........T.....T........@@@@@@@@@@@@@@@@@@@@@@@@@@@@@@@
@@@@@@@@@@@@..T............T...TT............T..@@@@@@@@@@@@@@@@@@@@@@@@@@@@@@@@
@@@@@@@@@@@@.T..T..T....T...TT...T............@@@@@@@@@@@@@@@@@@@@@@@@@@@@@@@@@@
@@@@@@@@@@@@@...............T.......TTT......@@@@@@@@@@@@@@@@@@@@@@@@@@@@@@@@@@@
@@@@@@@@@@@@@@T..T.....T..............TT....@@@@@@@@@@@@@@@@@@@@@@@@@@@@@@@@@@@@
@@@@@@@@@@@@@@@.....T.....TTTT......T...T.@@@@@@@@@@@@@@@@@@@@@@@@@@@@@@@@@@@@@@
@@@@@@@@@@@@@@@@@T.T.T...T...T.T....T....@@@@@@@@@@@@@@@@@@@@@@@@@@@@@@@@@@@@@@@
@@@@@@@@@@@@@@@@@@....T......T..TT.TTT..@@@@@@@@@@@@@@@@@@@@@@@@@@@@@@@@@@@@@@@@
@@@@@@@@@@@@@@@@@@@....T....TT...T..T.@@@@@@@@@@@@@@@@@@@@@@@@@@@@@@@@@@@@@@@@@@
@@@@@@@@@@@@@@@@@@@@@@..TT...........@@@@@@@@@@@@@@@@@@@@@@@@@@@@@@@@@@@@@@@@@@@
@@@@@@@@@@@@@@@@@@@@@@@@@@@@@@@@@@@@@@@@@@@@@@@@@@@@@@@@@@@@@@@@@@@@@@@@@@@@@@@@
