type octile
height 50
width 50
map
@@@@@@@@@@@@@@@@@@@@@@@@@@@@@@@@@@@@@@@@@@@@@@@@@@
@@@@@@@@@@@@@@@@@@@@@@@@@@@@@@@@@@@@@@@@@@@@@@@@@@
@@@@@@@@@@@@@@@@@@@@@@@@@@@@@@@@@@@@@@@@@@@@@@@@@@
@@@@@@@@@@@@@@@@@@@@@@@@@@@@@@@@@@@@@@@@@@@@@@@@@@
@@@@@@@@@@@@@@@@@@@@@@@@@@@@@@@@@@@@@@@@@@@@@@@@@@
@@@@@@@@@@@@@@@@@@@@@@@@@@@@@@@@@@@@@@@@@@@@@@@@@@
@@@@@@@@@@@@@@@@@@@@@@@@@@@@@@@@@@@@@@@@@@@@@@@@@@
@@@@@@@@@@@@@@@@@@@@@@@@@@@@@@@@@@@@@@@@@@@@@@@@@@
@@@@@@@@@@@@@@@@@@@@@@@@@@@@@@@@@@@@@@@@@@@@@@@@@@
@@@@@@@@@@@@@@@@@@@@@@@@@@@@@@@@@@@@@@@@@@@@@@@@@@
@@@@@@@@@@@@@@@@@@@@@@@@@@@@@@@@@@@@@@@@@@@@@@@@@@
@@@@@@@@@@@@@@@@@@@@@@@@@@@@@@@@@@@@@@@@@@@@@@@@@@
@@@@@@@@@@@@@@@@@@@@@@@@@@@@@@@@@@@@@@@@@@@@@@@@@@
@@@@@@@@@@@@@@@@@@@@@@@@@@@@@@@@@@@@@@@@@@@@@@@@@@
@@@@@@@@@@@@@@@@@@@@@@@@@@@@@@@@@@@@@@@@@@@@@@@@@@
@@@@@@@@@@@@@@@@@@@@@@@@@@@@@@@@@@@@@@@@@@@@@@@@@@
@@@@@@@@@@@@@@@@@@@@@@@@@@@@@@@@@@@@@@@@@@@@@@@@@@
@@@@@@@@@@@@@@@@@@@@@@@@@@@@@@@@@@@@@@@@@@@@@@@@@@
@@@@@@@@@@@@@@@@@@@@@@@@@@@@@@@@@@@@@@@@@@@@@@@@@@
@@@@@@@@@@@@@@@@@@@@@@@@@@@@@@@@@@@@@@@@@@@@@@@@@@
@@@@@@@@@@@@@@@@@@@@@@@@@@@@@@@@@@@@@@@@@@@@@@@@@@
@@@@@@@@@@@@@@@@@@@@@@@@@@@@@@@@@@@@@@@@@@@@@@@@@@
@@@@@@@@@@@@@@@@@@@@@@@@@@@T@@@@@@@@@@@@@@@@@@@@@@
@@@@@@@@@@@@@@@@@@@@@@@@@..T.@@@@@@@@@@@@@@@@@@@@@
@@@@@@@@@@@@@@@@@@@@@@@@...T..@@@@@@@@@@@@@@@@@@@@
@@@@@@@@@@@@@@@@@@@@@@@..@.T.T.@@@@@@@@@@@@@@@@@@@
@@@@@@@@@@@@@@@@@@@@@@T.@@@...@@@@@@@@@@@@@@@@@@@@
@@@@@@@@@@@@@@@@@@@@@..@@@@@@.....@@@@@@@@@@@@@@@@
@@@@@@@@@@@@@@@@@@@@..@@@@@@@@.....@@@@@@@@@@@@@@@
@@@@@@@@@@@@@@@@@@@..T.@@@@@@@@....T.@@@@@@@@@@@@@
@@@@@@@@@@@@@@@@@@.T.@TT.@@@@@@..T....@@@@@@@@@@@@
@@@@@@@@@@@@@@@@@.T.@@@...@@@@........T@@@@@@@@@@@
@@@@@@@@@@@@@@@@@...@@@@@..@@..T.T....@@@@@@@@@@@@
@@@@@@@@@@@@@@@@T.TTT@@@@@.T......T..@@@@@@@@@@@@@
@@@@@@@@@@@@@@@T......@@@@.......T..@@@@@@@@@@@@@@
@@@@@@@@@@@@@@.....T.TT@@...T......@@@@@@@@@@@@@@@
@@@@@@@@@@@@.....TT....T....T.....@@@@@@@@@@@@@@@@
@@@@@@@@@@@.....TT......T...T.T.T@@@@@@@@@@@@@@@@@
@@@@@@@@@@..T..TT.....T.........@@@@@@@@@@@@@@@@@@
@@@@@@@@@@.T..T.T....T..T.TT...@@@@@@@@@@@@@@@@@@@
@@@@@@@@@....TT.TTTT..T........@@@@@@@@@@@@@@@@@@@
@@@@@@@@@@.....T........T...TT@@@@@@@@@@@@@@@@@@@@
@@@@@@@@@@@.T................@@@@@@@@@@@@@@@@@@@@@
@@@@@@@@@@@@..........TT....@@@@@@@@@@@@@@@@@@@@@@
@@@@@@@@@@@@@.T.....T......@@@@@@@@@@@@@@@@@@@@@@@
@@@@@@@@@@@@@@T..T..T.....@@@@@@@@@@@@@@@@@@@@@@@@
@@@@@@@@@@@@@@@.T..T.....@@@@@@@@@@@@@@@@@@@@@@@@@
@@@@@@@@@@@@@@@@T.......@@@@@@@@@@@@@@@@@@@@@@@@@@
@@@@@@@@@@@@@@@@@....TT@@@@@@@@@@@@@@@@@@@@@@@@@@@
@@@@@@@@@@@@@@@@@@@@@@@@@@@@@@@@@@@@@@@@@@@@@@@@@@
