type octile
height 86
width 88
map
@@@@@@@@@@@@@@@@@@@@@@@@@@@@@@@@@@@@@@@@@@@@@@@@@@@@@@@@@@@@@@@@@@@@@@@@@@@@@@@@@@@@@@@@
@@@@@@@@@@@@@@@@@@@@@@@@@@@@@@@@@@@@@@@@@@@@@@@@@@@@@@@@@@@@@@@@@@@@@@@@@@@@@@@@@@@@@@@@
@@@@@@@@@@@@@@@@@@@@@@@@@@@@@@@@@@@@@@@@@@@@@@@@@@@@@@@@@@@@@@@@@@@@@@@@@@@@@@@@@@@@@@@@
@@@@@@@@@@@@@@@@@@@@@@@@@@@@@@@@@@@@@@@@@@@@@@@@@@@@@@@@@@@@@@@@@@@@@@@@@@@@@@@@@@@@@@@@
@@@@@@@@@@@@@@@@@@@@@@@@@@@@@@@@@@@@@@@@@@@@@@@@@@@@@@@@@@@@@@@@@@@@@@@@@@@@@@@@@@@@@@@@
@@@@@@@@@@@@@@@@@@@@@@@@@@@@@@@@@@@@@@@@@@@@@@@@@@@@@@@@@@@@@@@@@@@@@@@@@@@@@@@@@@@@@@@@
@@@@@@@@@@@@@@@@@@@@@@@@@@@@@@@@@@@@@@@@@@@@@@@@@@@@@@@@@@@@@@@@@@@@@@@@@@@@@@@@@@@@@@@@
@@@@@@@@@@@@@@@@@@@@@@@@@@@@@@@@@@@@@@@@@@@@@@@@@@@@@@@@@@@@@@@@@@@@@@@@@@@@@@@@@@@@@@@@
@@@@@@@@@@@@@@@@@@@@@@@@@@@@@..T@@@@@@.@@@@@@@@@@@@@@@@@@@@@@@@@@@@@@@@@@@@@@@@@@@@@@@@@
@@@@@@@@@@@@@@@@@@@@@@@@@@@@.....@@@@TT@@@@@@@@@@@@@@@@@@@@@@@@@@@@@@@@@@@@@@@@@@@@@@@@@
@@@@@@@@@@@@@@@@@@@@@@@@@@@..T..@@@@TT..@@@@@@@@@@@@@@@@@@@@@@@@@@@@@@@@@@@@@@@@@@@@@@@@
@@@@@@@@@@@@@@@@@@@@@@@@@@T..T.@@@@.....@@@@@@@@@@@@@@@@@@@@@@@@@@@@@@@@@@@@@@@@@@@@@@@@
@@@@@@@@@@@@@@@@@@@@@@@@@.....@@@@@@T...@@@@@@@@@@@@@@@@@@@@@@@@@@@@@@@@@@@@@@@@@@@@@@@@
@@@@@@@@@@@@@@@@@@@@@@@@.T...@@@@@@@@...@@@@@@@@@@@@@@@@@@@@@@@@@@@@@@@@@@@@@@@@@@@@@@@@
@@@@@@@@@@@@@@@@@@@@@@@.....@@@@@@@@@...@@@@@@@@@@@@@@@@@@@@@@@@@@@@@@@@@@@@@@@@@@@@@@@@
@@@@@@@@@@@@@@@@@@@@@@@..T.@@@@@@@@@@.T.@@@@@@@@@@@@@@@@@@@@@@@@@@@@@@@@@@@@@@@@@@@@@@@@
@@@@@@@@@@@@@@@@@@@@@@....@@@@@@@@@@T...@@@@@@@@@@@@@@@@@@@@@@@@@@@@@@@@@@@@@@@@@@@@@@@@
@@@@@@@@@@@@@@@@@@@@@.TT.@@@@@@@@@@T.T.TT.@@@@@@@@@@@@@@@@@@@@@@@@@@@@@@@@@@@@@@@@@@@@@@
@@@@@@@@@@@@@@@@@@@@@...@@@@@@@@@@.........@@@@@@@@@@@@@@@@@@@@@@@@@@@@@@@@@@@@@@@@@@@@@
@@@@@@@@@@@@@@@@@@@.....@@@@@@@@@........T..@@@@@@@@@@@@@@@@@@@@@@@@@@@@@@@@@@@@@@@@@@@@
@@@@@@@@@@@@@@@@@@@...T@@@@@@@@@........T.T..@@@@@@@@@@@@@@@@@@@@@@@@@@@@@@@@@@@@@@@@@@@
@@@@@@@@@@@@@@@@@@@....@@@@@@@@.T..T...T..T...@@@@@@@@@@@@@@@@@@@@@@@@@@@@@@@@@@@@@@@@@@
@@@@@@@@@@@@@@@@@@@....@@@@@@@................T@@@@@@@@@@@@@@@@@@@@@@@@@@@@@@@@@@@@@@@@@
@@@@@@@@@@@@@@@@@@T.....@@@@@....T......T.T...TT@@@@@@@@@@@@@@@@@@@@@@@@@@@@@@@@@@@@@@@@
@@@@@@@@@@@@@@@@@@..T...@@@@.....T...T..T........@@@@@@@@@@@@@@@@@@@@@@@@@@@@@@@@@@@@@@@
@@@@@@@@@@@@@@@@@@@.....T@@@@...............T.T...T@@@@@@@@@@@@@@@@@@@@@@@@@@@@@@@@@@@@@
@@@@@@@@@@@@@@@@@@@@......@@@@..T..T...........T....@@@@@@@@@@@@@@@@@@@@@@@@@@@@@@@@@@@@
@@@@@@@@@@@@@@@@@@@@@T.T.T@@@@T.TT..T..T@@....T...T..@@@@@@@@@@@@@@@@@@@@@@@@@@@@@@@@@@@
@@@@@@@@@@@@@@@@@@@@@@.....@@@@T...T..T.@@@@@...T...TT@@@@@@@@@@@@@@@@@@@@@@@@@@@@@@@@@@
@@@@@@@@@@@@@@@@@@@@@@@T....@@@@..T......@@@@@T....TT...@@@@@@@@@@@@@@@@@@@@@@@@@@@@@@@@
@@@@@@@@@@@@@@@..@@@@@@@@....@@@..T....T@@@@@@@@..T.T...T.@@@@@@@@@@@@@@@@@@@@@@@@@@@@@@
@@@@@@@@@@@@@.....@@@@@@@@..TT@@T....T..@@@@@@@@.......T...@@@@@@@@@@@@@@@@@@@@@@@@@@@@@
@@@@@@@@@@@@..T....@@@@@@@@...@.T...T....@@@@@@@@...........@@@@@@@@@@@@@@@@@@@@@@@@@@@@
@@@@@@@@@@@T..TTT...T.@@@@@@T..T..........@@@@@@@@.....T.T...@@@@@@@@@@@@@@@@@@@@@@@@@@@
@@@@@@@@@@............@@@@@@....T...T......@@@@@@@@.T....T.....@@@@@@@@@@@@@@@@@@@@@@@@@
@@@@@@@@@T........T...@@T@@@..............T.@@@@@@@@.T...TT....@@@@@@@@@@@@@@@@@@@@@@@@@
@@@@@@T........@T.....T...@@TT.T.......T.....@@@@@@@@..T.T..TT.@@@@@@@@@@@@@@@@@@@@@@@@@
@@@@@.........@@@...T....TT@..@@@....T.....T..@@@@@@@@..T.......@@@@@@@@@@@@@@@@@@@@@@@@
@@@@T.......T@@@@@..T.........@@@T...T.T...T..T@@@@@@@@.....T...@@@@@@@@@@@@@@@@@@@@@@@@
@@@@.........@@@@@...T..TTT...T@@@@..T..........@@@@@@@@.T.T.T...@@@@@@@@@@@@@@@@@@@@@@@
@@@@@T.TT...T.@@@@T...........@@@@@@@.......T..TT@@@@@@@@....T.T...@@@@@@@@@@@@@@@@@@@@@
@@@@@@....T...T@...T..T......@@@@@@@@@....T....T.T@@@@@@@@.......T...@@@@@@@@@@@@@@@@@@@
@@@@@@@..........T...........@@@@@@@@@@....TT..T.T.@@@@@@@@TT....T..T@@@@@@@@@@@@@@@@@@@
@@@@@@@@T..T..T.......T.....@@@@@@@@@@@@............@@@@@@@@T.......T@@@@@@@@@@@@@@@@@@@
@@@@@@@@@TT....T......T..@@@@@@@@@@@@@@@@.T.....TTT...@@@@@@@..T.T...@@@@@@@@@@@@@@@@@@@
@@@@@@@@@@............TT.@@@@@@@@@@@@@@@@@.T.........T.@@@@@@..T......@@@@@@@@@@@@@@@@@@
@@@@@@@@@@@..T............@@@@@@@@@@@@@@@@T.T.......T...@@@@@.....T...T@@@@@@@@@@@@@@@@@
@@@@@@@@@@@@.T.......@@.......T.@@@@..@@@..TT.........T.T@@@@T.......T...@@@@@@@@@@@@@@@
@@@@@@@@@@@@@....T..@@@@.......T.@@T..T@...@@T.........T....T.T.TTTT......@@@@@@@@@@@@@@
@@@@@@@@@@@@@@...TT@@@@@@.................@@@@.TT...T......T.....TT..T.TT..@@@@@@@@@@@@@
@@@@@@@@@@@@@@@..T@@@@@@@..T..T.T.......TT@@@@@.T..T....T....T........TT..T..@@@@@@@@@@@
@@@@@@@@@@@@@@@@.@@@@@@@TT...TT....T......@@@@@..T..............@@@@T.....T...@@@@@@@@@@
@@@@@@@@@@@@@@@@@@@@@@@TTT....T...T......T.@@@@@..T.......TT..T.@@@@@T........T@@@@@@@@@
@@@@@@@@@@@@@@@@@@@@@@......T...T....T...T..@@@@@.....TTTT.....T@@@@@...T@@...@@@@@@@@@@
@@@@@@@@@@@@@@@@@@@@@..TT.T....T........T...@@@@@@T...T........@@@@@.....@@@.@@@@@@@@@@@
@@@@@@@@@@@@@@@@@@@@.T.......T....T...T.....@@@@@@@.......T...T@@@@@.T.T@@@@@@@@@@@@@@@@
@@@@@@@@@@@@@@@@@@@@T....T......T.T.T.......@@@@@@@T..T.T.TT....@@@T...@@@@@@@@@@@@@@@@@
@@@@@@@@@@@@@@@@@@@@@......T...T......T...T...@@@@@@TT...........T.....@@@@@@@@@@@@@@@@@
@@@@@@@@@@@@@@@@@@@@@@............T...T.......@@@@@@@TTTT.TTT...TT.T.@@@@T@@@@@@@@@@@@@@
@@@@@@@@@@@@@@@@@@@@@@@....T............TT...@@@@@@@@@@...TT@@@@.....@@@....@@@@@@@@@@@@
@@@@@@@@@@@@@@@@@@@@@@@@....T..T.T.......TT.@@@@@@@@@@..T..T.@@@@@..@@@...T..@@@@@@@@@@@
@@@@@@@@@@@@@@@@@@@@@@@@@...T...TT.....T....@@@@@@..@..@...T..T@@@@@@@....T..T@@@@@@@@@@
@@@@@@@@@@@@@@@@@@@@@@@@@@T.T...........T....@@@@.....@@@.T.T...@@@@@@.T.....@@@@@@@@@@@
@@@@@@@@@@@@@@@@@@@@@@@@@@@.T.....T......@T...@@@.T...@@@@........@@@..T....@@@@@@@@@@@@
@@@@@@@@@@@@@@@@@@@@@@@@@@@@.TT....T....@@@@TT.@.TTT...@@@@T....T....T...T.@@@@@@@@@@@@@
@@@@@@@@@@@@@@@@@@@@@@@@@@@@@.T.T......@@@@@..T..T......@@@@...TT....T....@@@@@@@@@@@@@@
@@@@@@@@@@@@@@@@@@@@@@@@@@@@@@.T..TT.T@@@@@T.T.....T.....@@@@.......T.T..@@@@@@@@@@@@@@@
@@@@@@@@@@@@@@@@@@@@@@@@@@@@@@@.....T@@@@@..T......T......@@@@...T......@@@@@@@@@@@@@@@@
@@@@@@@@@@@@@@@@@@@@@@@@@@@@@@@@..TT@@@@@T.TT...T.......T.@@@@@....T.T.@@@@@@@@@@@@@@@@@
@@@@@@@@@@@@@@@@@@@@@@@@@@@@@@@@@@.@@@@@@.T........@@@@...@@@@@@....T.@@@@@@@@@@@@@@@@@@
@@@@@@@@@@@@@@@@@@@@@@@@@@@@@@@@@@@@@@@@T.......T.@@@@@...@@@@@@@....@@@@@@@@@@@@@@@@@@@
@@@@@@@@@@@@@@@@@@@@@@@@@@@@@@@@@@@@@@@...T.....TT@@@@@....@@@@@@@..@@@@@@@@@@@@@@@@@@@@
@@@@@@@@@@@@@@@@@@@@@@@@@@@@@@@@@@@@@@...........@@@@@.TT..@@@@@@@@@@@@@@@@@@@@@@@@@@@@@
@@@@@@@@@@@@@@@@@@@@@@@@@@@@@@@@@@@@@@..T......TT@@@@@....@@@@@@@@@@@@@@@@@@@@@@@@@@@@@@
@@@@@@@@@@@@@@@@@@@@@@@@@@@@@@@@@@@@@@@T...T....@@@@@.TT.@@@@@@@@@@@@@@@@@@@@@@@@@@@@@@@
@@@@@@@@@@@@@@@@@@@@@@@@@@@@@@@@@@@@@@@@.T....T.@@@@TTT.@@@@@@@@@@@@@@@@@@@@@@@@@@@@@@@@
@@@@@@@@@@@@@@@@@@@@@@@@@@@@@@@@@@@@@@@@@.....T.@@@....@@@@@@@@@@@@@@@@@@@@@@@@@@@@@@@@@
@@@@@@@@@@@@@@@@@@@@@@@@@@@@@@@@@@@@@@@@@@T..........T.@@@@@@@@@@@@@@@@@@@@@@@@@@@@@@@@@
@@@@@@@@@@@@@@@@@@@@@@@@@@@@@@@@@@@@@@@@@@@....TTT.....@@@@@@@@@@@@@@@@@@@@@@@@@@@@@@@@@
@@@@@@@@@@@@@@@@@@@@@@@@@@@@@@@@@@@@@@@@@@@@....T...T...@@@@@@@@@@@@@@@@@@@@@@@@@@@@@@@@
@@@@@@@@@@@@@@@@@@@@@@@@@@@@@@@@@@@@@@@@@@@@@.T..T.......@@@@@@@@@@@@@@@@@@@@@@@@@@@@@@@
@@@@@@@@@@@@@@@@@@@@@@@@@@@@@@@@@@@@@@@@@@@@@@T...T.T...@@@@@@@@@@@@@@@@@@@@@@@@@@@@@@@@
@@@@@@@@@@@@@@@@@@@@@@@@@@@@@@@@@@@@@@@@@@@@@@@T.......@@@@@@@@@@@@@@@@@@@@@@@@@@@@@@@@@
@@@@@@@@@@@@@@@@@@@@@@@@@@@@@@@@@@@@@@@@@@@@@@@@@.T..@@@@@@@@@@@@@@@@@@@@@@@@@@@@@@@@@@@
@@@@@@@@@@@@@@@@@@@@@@@@@@@@@@@@@@@@@@@@@@@@@@@@@@..@@@@@@@@@@@@@@@@@@@@@@@@@@@@@@@@@@@@
@@@@@@@@@@@@@@@@@@@@@@@@@@@@@@@@@@@@@@@@@@@@@@@@@@@@@@@@@@@@@@@@@@@@@@@@@@@@@@@@@@@@@@@@
