type octile
height 80
width 80
map
@@@@@@@@@@@@@@@@@@@@@@@@@@@@@@@@@@@@@@@@@@@@@@@@@@@@@@@@@@@@@@@@@@@@@@@@@@@@@@@@
@@@@@@@@@@@@@@@@@@@@@@@@@@@@@@@@@@@@@@@@@@@@@@@@@@@@@@@@@@@@@@@@@@@@@@@@@@@@@@@@
@@.T.TT....T............TT.......T........T....T.T.......T...T..T......TT....T@@
@@................TTT........T.............T.T......T.T...................T..T@@
@@.....T.............T..T...TT.T.....T.T....TT....TT.........TT..TT.........T.@@
@@..T...T.......TT.....T..T..T...T.TT.....TT....T..T.T...........TT..T....TT..@@
@@.TT................................T.T...T.........TT......T...TTT..........@@
@@.............T.T.T..T....TT.T.......T..T....T...T......T.......T.......TT...@@
@@......T.......T..................T.T.....T.T......T...T...T..........TT.....@@
@@...T..T.............T..............T..T......TTT...T.T...T......T..T.T.T..T.@@
@@.TT......T..T.....TT.T.T.T.TT.T.........T..TT.T....TT.....TT.....T....T.....@@
@@......................T..TTT.......T..T@@@.....T...............TT.T..T......@@
@@.T........T.........T.T.......T.......@@@@@............TT...T...TT....T.....@@
@@..T....T.....T.......T...........TT...@@@@@......................T..T.......@@
@@...T.T...TT.......T..T.T..T.....T......@@@.T..T....@@@@.....TT......T.......@@
@@T.......TT........T.....T...T.............T..T.....@@@@..T.............T....@@
@@.T.......T..T....T.T...TT....T......T..T......T.....@@......TT.T..........T.@@
@@...T........T...................@@@@@......TT....TT..........T.......T...T..@@
@@.TT...T.T.....T..TT.............@@@@@....TTT...TT..T....T......T@@@@@....T..@@
@@..T.....TT.....T...TTT.....T.....@@@T..T.T.T.....T..T.T......T..@@@@@.......@@
@@TT.T.....T....TT...T....T...T.........T.......T..T.T..T..........@@@T.....TT@@
@@.............T.........T.T..T.....T.........T.....TTT.........T.........TT.T@@
@@..T.T...T....T..T.....T...........T...T.....T..TT.T.......TT....T.....T...T.@@
@@..TT.....T..T...T.T.........TT..T.....T....T..T..T....TT.....T.T.....T.T.T..@@
@@...........T......T.......T.....T.TT...................TT......T.....T....T.@@
@@...T............T.....T....T.......T...T..........TT...T.....T.............T@@
@@.......T...T......T....T..T..TTT......T.........................TT......TT..@@
@@...T......T.T......TT.TT.TT.........................T.....TT........T.T.T...@@
@@.......TTTT...T..T...........T......T...T.TT...T............T..T..........T.@@
@@.TT...T.....T.T....T...T...T.....T....T...TT.....TT...T.........T...........@@
@@.T..........T...T.T..T....T...TTT..................T.T..T...TTT..T...T....@@@@
@@.......TT..TT................................T.............T.....T.T..T..T@@@@
@@..T.....T..T......T...T.....T...............T...T..T.T.T..T......T....TTTT@@@@
@@T.....TT..TT..T...T.T.......T......T.....T..T..T...T................TTT.....@@
@@..........TTT.....T.....TTTT.....T..T......T........T..TT.......T...T....TT.@@
@@...................TT.............T.T.T......T..TT..T..TT........T..T......T@@
@@...TT...T.T..T...T..T.T.........TT...............T....T...T....TT.T.....T...@@
@@.T..........T............T.....T.TT........T.T..TT......................T...@@
@@.TT........T.......T..TT....T..............TT.........T..T..........T.......@@
@@T..T.T..T........T.............T......T...T......T..T....T.T...T....T.TTT...@@
@@.TT.T........T....TT.T.....T........T............T.....TT............T.T.T..@@
@@....T.T..T...T...T....T...T.TT.T...T...T.............T.T.........T....TT....@@
@@..T..TT.........TT..T..T..T..T....T..T.T.T...TT.T...........................@@
@@......TT.....T.........T........T......T.TTT....T.............TT...T.T...T..@@
@@.T..TT...T...TT........T...T..........T...........TT@@@@...T.........T......@@
@@T......TT...T.....T..............TT..........T....@@@@@@@.T....T....T.......@@
@@TTT..TT...T....T.T........T...T...T.T....T..T.T..@@@@@@@@@....TTT...T..TT...@@
@@T.....T..............T...T......T.....T..........@@@@@@@@@T.........TT.....T@@
@@T..T.T...T@@.......T..T...T.......TTT..T.......T...@@@@@@...TT....TT........@@
@@TT..T.T..@@@@....T......T...TTT....T.........T...T....T...T.T.....TT.......T@@
@@.......T.@@@@T..TT...T...T.....TTT.T...........T.T....TT...T...T....T...T...@@
@@T.........@@....T......T...T........TT....T..T....T..T..TT.........TT......T@@
@@...T...T.........T....T.TT....T..TT...TT.TT.T.........T...TT.T.....T....T..T@@
@@T......T.T......TT..................T.......TT....TTT...T..............TT...@@
@@...TT....T.TTT...T..T..T.............T.....T...........................TT...@@
@@.@@@T...T...........T.........T......T.......TT.TT...TT...TT....T........T..@@
@@.@@@.................T...........T.........T......T........T..T..TT.T......T@@
@@T@@@..T..TT..TT..T....T..TTT...............T.........T......T...........TT.T@@
@@T@@@.T................T......TT..............T.T..................T...T..T.T@@
@@.T..T..........T.T.............T....T..T..........TT..TT......TT.T....T..T..@@
@@..TT..TT.......T......T.T....T....T.....T.....T.T....T......T.......TTT.....@@
@@..T...T........................T....T........T...T......T..T....T....T......@@
@@..T......T.T.......T....T..........T....T......TT.....T.T.....T.T.....T.TT..@@
@@........T.T..........T......................T..T.T...T.T................T...@@
@@......T..................T.T....T..........T.....T.........T.T............T.@@
@@.T.........T.........TT........T.T....T..T.........T.T..T........T..........@@
@@.....................TT..T.........T...T.....T...T.....T.T.......TT.T...T.T.@@
@@.T.........T...T.T...............T.........T.T....T....T.TT......TTT.T.T....@@
@@......T...TT..T.........T..............T..TT...TT..........T............T.T.@@
@@T..TT..T.......T...T.....TT.TT....T....TT....T....T.........T..T......TT....@@
@@TTT...T.T....T..TT...TTT......T...T.TT.T.T..................T..TT..T......T.@@
@@...T.T..T.....T.......T..................T....T.............T...T........T..@@
@@........T.TTT.........T....T...T...T.T........T........TT.TT.TT.T..........T@@
@@..T...T..T..TTT..T........T........T......T..TTTTT.......T........T.T....TT.@@
@@...T.....TT.T.T...T...T..T...TTTT....T.....T........TT......T........T..TT..@@
@@....T.........T...T....T....T..........T...........T..T.T.........T.....T...@@
@@........T.........@@@..T..T......TTTTT.....T.........TT...T.................@@
@@.........T@@@@@@@@@@@@@@@@@@.T............T..TT.........T...........T...T...@@
@@@@@@@@@@@@@@@@@@@@@@@@@@@@@@@@@@@@@@@@@@@@@@@@@@@@@@@@@@@@@@@@@@@@@@@@@@@@@@@@
@@@@@@@@@@@@@@@@@@@@@@@@@@@@@@@@@@@@@@@@@@@@@@@@@@@@@@@@@@@@@@@@@@@@@@@@@@@@@@@@
