type octile
height 54
width 56
map
@@@@@@@@@@@@@@@@@@@@@@@@@@@@@@@@@@@@@@@@@@@@@@@@@@@@@@@@
@@@@@@@@@@@@@@@@@@@@@@@@@@@@@@@@@@@@@@@@@@@@@@@@@@@@@@@@
@@@@@@@@@@@@@@@@@@@@@@@@@@@@@@@@@@@@@@@@@@@@@@@@@@@@@@@@
@@@@@@@@@@@@@@@@@@@@@@@@@@@@@@@@@@@@@@@@@@@@@@@@@@@@@@@@
@@@@@@@@@@@@@@@@@@@@@@@@@@@@@@@@@@@@@@@@@@@@@@@@@@@@@@@@
@@@@@@@@@@@@@@@@@@@@@@@@@@@@@@@@@@@@@@@@@@@@@@@@@@@@@@@@
@@@@@@@@@@@@@@@@@@@@@@@@@@@@@@@@@@@@@@@@@@@@@@@@@@@@@@@@
@@@@@@@@@@@@@@@@@@@@@@@@@@@@@@@@@@@@@@@@@@@@@@@@@@@@@@@@
@@@@@@@@@@@@@@@@@@@@@@@@@@@@@@@@@@@@@@@@@@@@@@@@@@@@@@@@
@@@@@@@@@@@@@@@@@@@@@@@@@@@@@@@@@@@@@@@@@@@@@@@@@@@@@@@@
@@@@@@@@@@@@@@@@@@@@@..@@@@@@@@@@@@@@@@@@@@@@@@@@@@@@@@@
@@@@@@@@@@@@@@@@@@@@....@@@@@@@@@@@@@@@@@@@@@@@@@@@@@@@@
@@@@@@@@@@@@@@@@@@@T.....@@@@@@@@@@@@@@@T@@@@@@@@@@@@@@@
@@@@@@@@@@@@@@@@@@........@@@@@@@@@@@@@.T.@@@@@@@@@@@@@@
@@@@@@@@@@@@@@@@@..........@@@@@@@@@@@T....@@@@@@@@@@@@@
@@@@@@@@@@@@@@@@....@@.T....@@@@@@@@@@.....@@@@@@@@@@@@@
@@@@@@@@@@@@@@@.T..@@@T......@@@@@@@@......@@@@@@@@@@@@@
@@@@@@@@@@@@@@T...@@@@....T...@@@@@@.......@@@@@@@@@@@@@
@@@@@@@@@@@@@.....@@@..TT......@@@@........@@@@@@@@@@@@@
@@@@@@@@@@@@.T.....@............@@..T...@@@@@@@@@@@@@@@@
@@@@@@@@@@.......T..T..................@@@@@@@@@@@@@@@@@
@@@@@@@@@........T.T...................@@@@@@@@@@@@@@@@@
@@@@@@@@........T........@@@@T.TTT.T.T..@@....@@@@@@@@@@
@@@@@@@@@......T.T.......@@@@@...............@@@@@@@@@@@
@@@@@@@@@@.........T.T..@@@@@@@.T...........@@@@@@@@@@@@
@@@@@@@@@@@..........T..@@@@@@@@...........@@@@@@@@@@@@@
@@@@@@@@@@@@@....@......@@@@@@@@@........@@@@@@@@@@@@@@@
@@@@@@@@@@@@@@@..@@T.....@@@@@@@@@T.T...@@@@@@@@@@@@@@@@
@@@@@@@@@@@@@@@...@@T.....@@@@@@@@@..T.@@@@@@@@@@@@@@@@@
@@@@@@@@@@@@@@@@..@@@.....T@@@@@@@@.....@@@@@@@@@@@@@@@@
@@@@@@@@@@@@@@@@..@@@@T.....@@@@@@..T.T.T@@@@@@@@@@@@@@@
@@@@@@@@@@@@@@@@@.@@@@@T.....@@@@.........@@@@@@@@@@@@@@
@@@@@@@@@@@@@@@@@@@@@@@@.....@@@.........T.@@@@@@@@@@@@@
@@@@@@@@@@@@@@@@@@@@@@@@...T....T...T....TT.@@@@@@@@@@@@
@@@@@@@@@@@@@@@@@@@@@@@@...................T.@@@@@@@@@@@
@@@@@@@@@@@@@@@.@@@@@@@@...T.....T............@@@@@@@@@@
@@@@@@@@@@@@......T...............T...........@@@@@@@@@@
@@@@@@@@@@........T..................@.......@@@@@@@@@@@
@@@@@@@@.........T.T.........TT.....@@@.T...@@@@@@@@@@@@
@@@@@@@....@@.......................@@@@..T@@@@@@@@@@@@@
@@@@@@..T.@@........................T@@@@.@@@@@@@@@@@@@@
@@@@@@...................@............@@@@@@@@@@@@@@@@@@
@@@@@@...............T..@@@......T.T...@@@@@@@@@@@@@@@@@
@@@@@@.T.....T.........@@@@@...........@@@@@@@@@@@@@@@@@
@@@@@@@...............@@@@@@@.....TT..@@@@@@@@@@@@@@@@@@
@@@@@@@@.............@@@@@@@@@.......@@@@@@@@@@@@@@@@@@@
@@@@@@@@@T..T..T....@@@@@@@@@@@@....@@@@@@@@@@@@@@@@@@@@
@@@@@@@@@@.........@@@@@@@@@@@@@@.@@@@@@@@@@@@@@@@@@@@@@
@@@@@@@@@@@......T@@@@@@@@@@@@@@@@@@@@@@@@@@@@@@@@@@@@@@
@@@@@@@@@@@@....@@@@@@@@@@@@@@@@@@@@@@@@@@@@@@@@@@@@@@@@
@@@@@@@@@@@@@@.@@@@@@@@@@@@@@@@@@@@@@@@@@@@@@@@@@@@@@@@@
@@@@@@@@@@@@@@@@@@@@@@@@@@@@@@@@@@@@@@@@@@@@@@@@@@@@@@@@
@@@@@@@@@@@@@@@@@@@@@@@@@@@@@@@@@@@@@@@@@@@@@@@@@@@@@@@@
@@@@@@@@@@@@@@@@@@@@@@@@@@@@@@@@@@@@@@@@@@@@@@@@@@@@@@@@
