type octile
height 134
width 124
map
@@@@@@@@@@@@@@@@@@@@@@@@@@@@@@@@@@@@@@@@@@@@@@@@@@@@@@@@@@@@@@@@@@@@@@@@@@@@@@@@@@@@@@@@@@@@@@@@@@@@@@@@@@@@@@@@@@@@@@@@@@@@
@T......@@@@@@@@@@@@@@@@@@@@@@@@@@@@@@@@@@@@@@@@@@@@@@@@@@@@@@@@@@@@@@@@@@@@@@@@@@@@@@@@@@@@@@@@@@@@@@@@@@@@@@@@@@@@@@@@@@@@
@.......@@@@@@@@@@@@@@@@@@@@@@@@@@@@@@@@@@@@@@@@@@@@@@@@@@@@@@@@@@@@@@@@@@@@@@@@@@@@@@@@@@@@@@@@@@@@@@@@@@@@@@@@@@@@@@@@@@@@
@T......@@@@@@@@@@@@@@@@@@@@@@@@@@@@@@@@@@@@@@@@@@@@@@@@@@@@@@@@@@@@@@@@@@@@@@@@@@@@@@@@@@@@@@@@@@@@@@@@@@@@@@@@@@@@@@@@@@@@
@.......@@@@@@@@@@@@@@@@@@@@@@@@@@@@@@@@@@@@@@@@@@@@@@@@@@@@@@@@@@@@@@@@@@@@@@@@@@@@@@@@@@@@@@@@@@@@@@@@@@@@@@@@@@@@@@@@@@@@
@T......@@@@@@@@@@@@@@@@@@@@@@@@@@@@@@@@@@@@@@@@@@@@@@@@@@@@@@@@@@@@@@@@@@@@@@@@@@@@@@@@@@@@@@@@@@@@@@@@@@@@@@@@@@@@@@@@@@@@
@..TT...@@@@@@@@@@@@@@@@@@@@@@@@@@@@@@@@@@@@@@@@@@@@@@@@@@@@@@@@@@@@@@@@@@@@@@@@@@@@@@@@@@@@@@@@@@@@@@@@@@@@@@@@@@@@@@@@@@@@
@.......@@@@@@@@@@@@@@@@@@@@@@@@@@@@@@@@@@@@@@@@@@@@@@@@@@@@@@@@@@@@@@@@@@@@@@@@@@@@@@@@@@@@@@@@@@@@@@@@@@@@@@@@@@@@@@@@@@@@
@@@@@@@@@@@@@@@@@@@@@@@@@@@@@@@@@@@@@@@@@@@@@@@@@@@@@@@@@@@@@@@@@@@@@@@@@@@@@@@@@@@@@@@@@@@@@@@@@@@@@@@@@@@@@@@@@@@@@@@@@@@@
@@@@@@@@@@@@@@@@@@@@@@@@@@@@@@@@@@@@@@@@@@@@@@@@@@@@@@@@@@@@@@@@@@@@@@@@@@@@@@@@@@@@@@@@@@@@@@@@@@@@@@@@@@@@@@@@@@@@@@@@@@@@
@@@@@@@@@@@@@@@@@@@@@@@@@@@@@@@@@@@@@@@@@@@@@@@@@@@@@@@@@@@@@@@@@@@@@@@@@@@@@@@@@@@@@@@@@@@@@@@@@@@@@@@@@@@@@@@@@@@@@@@@@@@@
@@@@@@@@@@@@@@@@@@@@@@@@@@@@@@@@@@@@@@@@@@@@@@@@@.@@@@@@@@@@@@@@@@@@@@@@@@@@@@@@@@@@@@@@@@@@@@@@@@@@@@@@@@@@@@@@@@@@@@@@@@@@
@@@@@@@@@@@@@@@@@@@@@@@@@@@@@@@@@@@@@@@@@@@@@@@@...@@@@@@@@@@@@@@@@@@@@@@@@@@@@@@@@@@@@@@@@@@@@@@@@@@@@@@@@@@@@@@@@@@@@@@@@@
@@@@@@@@@@@@@@@@@@@@@@@@@@@@@@@@@@@@@@@@@@@@@@......@@@@@@@@@@@@@@@@@@@@@@@@@@@@@@@@@@@@@@@@@@@@@@@@@@@@@@@@@@@@@@@@@@@@@@@@
@@@@@@@@@@@@@@@@@@@@@@@@@@@@@@@@@@@@@@@@@@@@@..T.....@@@@@@@@@@@@@@@@@@@@@@@@@@@@@@@@@@@@@@@@@@@@@@@@@@@@@@@@@@@@@@@@@@@@@@@
@@@@@@@@@@@@@@@@@@@@@@@@@@@@@@@@@@@@@@@@@@@@T......TT.@@@@@@@@@@@@@@@@@@@@@@@@@@@@@@@@@@@@@@@@@@@@@@@@@@@@@@@@@@@@@@@@@@@@@@
@@@@@@@@@@@@@@@@@@@@@@@@@@@@@@@@@@@@@@@@@@@..T.........@@@@@@@@@@@@@@@@@@@@@@@@@@@@@@@@@@@@@@@@@@@@@@@@@@@@@@@@@@@@@@@@@@@@@
@@@@@@@@@@@@@@@@@@@@@@@@@@@@@@@@@@@@@@@@@@......@@......@@@@@@@@@@@@@@@@@@@@@@@@@@@@@@@@@@@@@@@@@@@@@@@@@@@@@@@@@@@@@@@@@@@@
@@@@@@@@@@@@@@@@@@@@@@@@@@@@@@@@@@@@@@@@@......@@@@T.T...@@@@@@@@@@@@@@@@@@@@@@@@@@@@@@@@@@@@@@@@@@@@@@@@@@@@@@@@@@@@@@@@@@@
@@@@@@@@@@@@@@@@@@@@@@@@@@@@@@@@@@@@@@@@......@@@@@....T..@@@@@@@@@@@@@@@@@@@@@@@@@@@@@@@@@@@@@@@@@@@@@@@@@@@@@@@@@@@@@@@@@@
@@@@@@@@@@@@@@@@@@@@@@@@@@@@@@@@@@@@@@@.T..T.@@@@@@@T.....T@@@@@@@@@@@@@@@@@@@@@@@@@@@@@@@@@@@@@@@@@@@@@@@@@@@@@@@@@@@@@@@@@
@@@@@@@@@@@@@@@@@@@@@@@@@@@@@@@@@@@@@@......@@@@@@@@.........@@@@@@@@@@@@@@@@@@@@@@@@@@@@@@@@@@@@@@@@@@@@@@@@@@@@@@@@@@@@@@@
@@@@@@@@@@@@@@@@@@@@@@@@@@@@@@@@@@@@@......@@@@@@@@@..........@@@@@@@@@@@@@@@@@@@@@@@@@@@@@@@@@@@@@@@@@@@@@@@@@@@@@@@@@@@@@@
@@@@@@@@@@@@@@@@@@@@@@@@@@@@@@@@@@@@......@@@@@@@@@@@..........@@@@@@@@@@@@@@@@@@@@@@@@@@@@@@@@@@@@@@@@@@@@@@@@@@@@@@@@@@@@@
@@@@@@@@@@@@@@@@@@@@@@@@@@@@@@@@@@.......@@@@@@@..@@@.T.........@@@@@@@@@@@@@@@@@@@@@@@@@@@@@@@@@@@@@@@@@@@@@@@@@@@@@@@@@@@@
@@@@@@@@@@@@@@@@@@@@@@@@@@@@@@@@@.T.....@@@@@@@....@@...........@@@@@@@@@@@@@@@@@@@@@@@@@@@@@@@@@@@@@@@@@@@@@@@@@@@@@@@@@@@@
@@@@@@@@@@@@@@@@@@@@@@@@@@@@@@@@.......@@@@@@@.T.....T.@@@@.......@@@@@@@@@@@@@@@@@@@@@@@@@@@@@@@@@@@@@@@@@@@@@@@@@@@@@@@@@@
@@@@@@@@@@@@@@@@@@@@@@@@@@@@@@@.....T.@@@@@@@..........@@@@@.......@@@@@@@@@@@@@@@@@@@@@@@@@@@@@@@@@@@@@@@@@@@@@@@@@@@@@@@@@
@@@@@@@@@@@@@@@@@@@@@@@@@@@@@@@......@@@@@@@...T........@@@@@..T..T.@@@@@@@@@@@@@@@@@@@@@@@@@@@@@@@@@@@@@@@@@@@@@@@@@@@@@@@@
@@@@@@@@@@@@@@@@@@@@@@@@@@@@@..TT...@@@@@@@.........T..@@@@@@........@@@@@@@@@@@@@@@@@@@@@@@@@@@@@@@@@@@@@@@@@@@@@@@@@@@@@@@
@@@@@@@@@@@@@@@@@@@@@@@@@@@@.......@@@@@@@@.T.........@@@@@@@.........@@@@@@@@@@@@@@@@@@@@@@@@@@@@@@@@@@@@@@@@@@@@@@@@@@@@@@
@@@@@@@@@@@@@@@@@@@@@@@@@@@.......@@@@@@@@@@...T.....@@@@@@@@..........@@@@@@@@@@@@@@@@@@@@@@@@@@@@@@@@@@@@@@@@@@@@@@@@@@@@@
@@@@@@@@@@@@@@@@@@@@@@@@@@.....TT.@@@@@@@@@@@.T.....@@@@@@@@@...........@@@@@@@@@@@@@@@@@@@@@@@@@@@@@@@@@@@@@@@@@@@@@@@@@@@@
@@@@@@@@@@@@@@@@@@@@@@@@@....T....@@@@@@@@@@@@.....@@@@@@@T.@...........T@@@@@@@@@@@@@@@@@@@@@@@@@@@@@@@@@@@@@@@@@@@@@@@@@@@
@@@@@@@@@@@@@@@@@@@@@@@@.T........@@@.T@@@@@@@@...@@@@@@@......T@@........@@@@@@@@@@@@@@@@@@@@@@@@@@@@@@@@@@@@@@@@@@@@@@@@@@
@@@@@@@@@@@@@@@@@@@@@@@......T@...@@...@@@@@@@@@.@@@@@@@@......@@@@@.......@@@@@@@@@@@@@@@@@@@@@@@@@@@@@@@@@@@@@@@@@@@@@@@@@
@@@@@@@@@@@@@@@@@@@@@@.......@@@.T@.....@@@@@@@@@@@@@@@@@......T@@@@.....T.T@@@@@@@@@@@@@@@@@@@@@@@@@@@@@@@@@@@@@@@@@@@@@@@@
@@@@@@@@@@@@@@@@@@@@@.T.....@@@@.........@@@@@@@@@@@@@@@.......@@@@@@....T...@@@@@@@@@@@@@@@@@@@@@@@@@@@@@@@@@@@@@@@@@@@@@@@
@@@@@@@@@@@@@@@@@@@@....T..@@@@@.T....T...@@@@@@@@@@@@@T......@@@@@@@.T...TT...@@@@@@@@@@@@@@@@@@@@@@@@@@@@@@@@@@@@@@@@@@@@@
@@@@@@@@@@@@@@@@@@@.......@@@@@.T...T..T...@@@@@@@@@@@@T.....@@@@@@@@@..........@@@@@@@@@@@@@@@@@@@@@@@@@@@@@@@@@@@@@@@@@@@@
@@@@@@@@@@@@@@@@@@.T.....@@@@@@.......T....@@@@@@@@@@.T.T...@@@@@@@@@@...........@@@@@@@@@@@@@@@@@@@@@@@@@@@@@@@@@@@@@@@@@@@
@@@@@@@@@@@@@@@@@.......@@@@@@@@....TT....@@@@@@@@@@@@...T.@@@@@@@...@.........T..@@@@@@@@@@@@@@@@@@@@@@@@@@@@@@@@@@@@@@@@@@
@@@@@@@@@@@@@@@@.....T..@@@@@@@@@........@@@@@@@@@@@@@@..T@@@@@@@.................@@@@@@@@@@@@@@@@@@@@@@@@@@@@@@@@@@@@@@@@@@
@@@@@@@@@@@@@@@.T......@@@@@@@@@@@......@@@@@@@@@@@@@@@@.@@@@@@@...T....@@..........@@@@@@@@@@@@@@@@@@@@@@@@@@@@@@@@@@@@@@@@
@@@@@@@@@@@@@@.........@@@@@@@@@@@@....@@@@@@@@.@@@@@@@@@@@@@@@@@T.......@@...T....TT@@@@@@@@@@@@@@@@@@@@@@@@@@@@@@@@@@@@@@@
@@@@@@@@@@@@@..........@@@.@@@@@@@@@@.@@@@@@@@@....@@@@@@@@@@@@@........@@@@.........T@@@@@@@@@@@@@@@@@@@@@@@@@@@@@@@@@@@@@@
@@@@@@@@@@@............@@...@@@@@@@@@@@@@@@@@@.....@@@@@@@@@@@@......T.@@@@@@...TT...@@@@@@@@@@@@@@@@@@@@@@@@@@@@@@@@@@@@@@@
@@@@@@@@@@....T...@@.........@@@@@@@@@@@@@@@.....T...@@@@@@@@@...T....@@@@@@@.......@@@@@@@@@@@@@@@@@@@@@@@@@@@@@@@@@@@@@@@@
@@@@@@@@@@......T@@@@.........@@@@@@@@@@@@@........T.@@@@@@@@..T.....@@@@@@@.......@@@@@@@@@@@@@@@@@@@@@@@@@@@@@@@@@@@@@@@@@
@@@@@@@@@.T......@@@@..........@@@@@@@@@@@T...T.....T.@@@@@@@@.....T@@@@@@@.......@@@@@@@@@@@@@@@@@@@@@@@@@@@@@@@@@@@@@@@@@@
@@@@@@@@.......T@@@..T..........@@@@@@@@@....T..........@@@@@@@....@@@@@@@@.TT...@@@@@@@@@@@@@@@@@@@@@@@@@@@@@@@@@@@@@@@@@@@
@@@@@@@........@@@@@............@@@@@@@@T........T.......@@@@@@@..@@@@@@@@......@@@@@@@@@@@@@@@@@@@@@@@@@@@@@@@@@@@@@@@@@@@@
@@@@@@......T.@@@@@@@..T....T..@@@@@@@@.T...T........T....@@@@@@@@@@@@@@@...T..@@@@@@@@@@@@@@@@@@@@@@@@@@@@@@@@@@@@@@@@@@@@@
@@@@@.........@@@@@@@@....T...@@@@@@@@......T.........T...@@@@@@@@@@@@@@......@@@@@@@@@@@@@@@@@@@@@@@@@@@@@@@@@@@@@@@@@@@@@@
@@@@..T.......@@@@@@@@@....T.@@@@@@@@..........@@...........@@@@@@@@@@@@.....@@@@@@@@@@@@@..@@@@@@@@@@@@@@@@@@@@@@@@@@@@@@@@
@@@..........T.@@@@@@@@@.T..@@@@@@@@..........@@@@...........@@@@@@@@@@.....@@@@@@@@@@@@@@...@@@@@@@@@@@@@@@@@@@@@@@@@@@@@@@
@@@@............@@@@@@@@@..@@@@@@@@........T.@@@@@@.TT..TT..@@@@@@@@@@@..T.@@@@@@@@@@@@@@@@T..@@@@@@@@@@@@@@@@@@@@@@@@@@@@@@
@@@@@...TT.......@@@@@@@@@@@@@@@@@...T.T.T..@@@@@@@@.......@@@@@@@@@@@.....@@@@@@@@@@@@@@@@@...@@@@@@@@@@@@@@@@@@@@@@@@@@@@@
@@@@@@...TT.......@@@@@@@@@@@@@@@..........@@@@@@@@@......@@@@@@@@@@@T...T.@@@@@@@@@@@@@@@@@@...@@@@@@@@@@@@@@@@@@@@@@@@@@@@
@@@@@@@..........T.@@@@@@@@@@@@@T.........@@@@@@@@@....T.@@@@@@@@@@@@......@@@@@@@@@@.@@@@@@@...@@@@@@@@@@@@@@@@@@@@@@@@@@@@
@@@@@@@@....T.....T.@@@@@@@@@@@..........@@@@@@@@@@.....@@@@@@@@@@@@@......@@@@@@@@@...@@@@@...@@@@@@@@@@@@@@@@@@@@@@@@@@@@@
@@@@@@@@@.........T..@@@@@@@@@@T..T......@@@@@@@@@..TT.@@@@@@@@@@@@........@@@@@@@@@....@@......@@@@@@@@@@@@@@@@@@@@@@@@@@@@
@@@@@@@@@@.....T......@@@@@@@@@.....T...T.@@@@@@@T....@@@@@@@@@@@@........@@@@@@@@@.....@@.......T...@@@@@@@@@@@@@@@@@@@@@@@
@@@@@@@@@@@.T.......T..@@@@@@@@............@@@@@.....@@@@@@@@@@@@........@@@@@@@@@@...................@@@@@@@@@@@@@@@@@@@@@@
@@@@@@@@@@@@.........T.T@@@@@@@@...........@@@@.....@@@@@@@@@@@@..T.....@@@@@@@@@@@@T.........T@.......@@@@@@@@@@@@@@@@@@@@@
@@@@@@@@@@@@@.T..........@@@@@@@..................T@@@@@@@@@@@@..TT.....T@@@@@@@@@@@@.........@@@......@@@@@@@@@@@@@@@@@@@@@
@@@@@@@@@@@@@@..T.T.......@@@@@@..T..T............@@@@@@@@@@@...........@@@@@@@@@@@@@@@T....T@@@@@.....@@@@@@@@@@@@@@@@@@@@@
@@@@@@@@@@@@@@@.T.T..T.....@@@@@.......T..T......@@@@@@@@@@@..T........@@@@@@@@@@@@@@@@@....@@@@@@@....@@@@@@@@@@@@@@@@@@@@@
@@@@@@@@@@@@@@@@........T...@@@@..........T.....@@@@@@@@@@@@TT.........@@@@@@@@@@@@@@@@@@..@@@@@@@@@....@@.@@@@@@@@@@@@@@@@@
@@@@@@@@@@@@@@@@@.........T..T@@...............@@@@@@@@@@@@....TT......@@@@@@@@@@@@@@@@@@@@@@@@@@@@@........@@@@@@@@@@@@@@@@
@@@@@@@@@@@@@@@@@@.................T@@@@......@@@@@@@@@@@.......T........@@@@@@@@@@@@@@@@@@@@@@@@@@@.......@@@@@@@@@@@@@@@@@
@@@@@@@@@@@@@@@@@@@@@@@@@..........@@@@@@...@@@@@@@@@@@@....T.............@@@@@@@@@@@@@@@@@@@@@@@@@@.......@@@@@@@@@@@@@@@@@
@@@@@@@@@@@@@@@@@@@@@@@@@@...T.....@@@@@@@.@@@@@@@@@@@@.........T.........@@@@@@@@@@@@@@@@@@@@@@@@@@.........@@@@@@@@@@@@@@@
@@@@@@@@@@@@@@@@@@@@@@@@@@@.......T.@@@@@@@@@@@@@@@@@@@......................@@@@@@@@@@@@@@@@@@@@@@@..........@@@@@@@@@@@@@@
@@@@@@@@@@@@@@@@@@@@@@@@@@@@.........@@@@@@@@@@@@@@@@T......T......T...T.....@@@@@@@@@@@@@@@@@@@@@@@........@.T@@@@@@@@@@@@@
@@@@@@@@@@@@@@@@@@@@@@@@@@@@@....T..T.@@@@@@@@@@@@@@.....T..T....T..T...T.....@@@@@@@@@@@@@@@@@@@@@@..T....@@@....@@@@@@@@@@
@@@@@@@@@@@@@@@@@@@@@@@@@@@@@.........@@@@@@@@@@@@@.T......T...........T........@@@@@@@@@@@@@@@@@@@@......@@@@@.TT.@@@@@@@@@
@@@@@@@@@@@@@@@@@@@@@@@@@@@@@.....T....@@@@@@@@@@@............................T..@@@@@@@@@@@@@@@@@@......@@@@@@@....@@@@@@@@
@@@@@@@@@@@@@@@@@@@@@@@@@@@@@.......TT..@@@@@@@@@@.....................T..T.....TT@@@@@@@@@@@@@@@@T.T....@@@@@@@.....@@@@@@@
@@@@@@@@@@@@@@@@@@@@@@@@@.@@@...T.......@@@@@@@@@......T....T..T..................@@@@@@@@@@@@@.........T..@@@@@....T.@@@@@@
@@@@@@@@@@@@@@@@@@@@@@@@...@@............@@@@@@@@@.T...T..........T.......TT..T....T@@@@@@@@@@@...........@@@@@T.T.....@@@@@
@@@@@@@@@@@@@@@@@@@@@@@........TT.........@@@@@@@@@..T...T......T.....T..TT.T.....T..@@@@@@@@@@.......T...@@@@.....T..T@@@@@
@@@@@@@@@@@@@@@@@@@@@@...........@........@@@@@@@@@@..T.T...T...............T....T.T.@@@@@@@@@@......@@...@@@T..TT..T.@@@@@@
@@@@@@@@@@@@@@@@@@@@@...TT..T...@@@T.....T@@@@@@@@@@@........T.T......T....T.T.........@@@@@@@@T....@@@@@............@@@@@@@
@@@@@@@@@@@@@@@@@@@@..........T..@@@.T..T.@@@@@@@@@@@@.TT...T.TT.......T..............T.@@@@.@@....@@@@@@@....T....T@@@@@@@@
@@@@@@@@@@@@@@@@@@......T....T..@@@@T......@@@@@@@@@@@@............................T....@@@......T.@@@@@@@@......T.@@@@@@@@@
@@@@@@@@@@@@@@@@@.............T@@@@@..T.....@@@@@@@@@@@@........TTT...T.........................T.@@@@@@@@@@.TT...@@@@@@@@@@
@@@@@@@@@@@@@@@@...........T..@@@@@@@...T....@@@@@@@@@@@@..T.T..........T.....................T...@@@@@@@@@@@....@@@@@@@@@@@
@@@@@@@@@@@@@@@.T............@@@@@@@@.........@@@@@@@@@@@@...T.........T..............T......T....@@@@@@@@@@@@..@@@@@@@@@@@@
@@@@@@@@@@@@@@@.T......T...T@@@@@@@@@@...T.....@@@@@@@@@@@@T......T........................T......@@@@@@@@@@@@@@@@@@@@@@@@@@
@@@@@@@@@@@@@@@@...........@@@@@@@@@@@..........@@@@@@@@@@@@...T..........T......................@@@@@@@@@@@@@@@@@@@@@@@@@@@
@@@@@@@@@@@@@@@@@........@@@@@@@@@@@@.......T....@@@@@@@@@@@@.....T..................T......TT.T@@@@@@@@@@@@@@@@@@@@@@@@@@@@
@@@@@@@@@@@@@@@@@@...T..@@@@@@@@@@@@...T.T........@@@@@@@@@@@@.T..................T..T......T...@@@@@@@@@@@@@@@@@@@@@@@@@@@@
@@@@@@@@@@@@@@@@@@@....@@@@@@@@@@@@...T.....T...TT..@@@@@@@@@@@T.......T................T....T...@@@@@@@@@@@@@@@@@@@@@@@@@@@
@@@@@@@@@@@@@@@@@@@@.T@@@@@@@@@@@@.........T.........@@@@@@@@@@@......T....T.............T......T..@@@@@@@@@@@@@@@@@@@@@@@@@
@@@@@@@@@@@@@@@@@@@@@@@@@@@@@@@@@.T...T......@@T......@@@@@@@@@@@....T.....T..............T....T...@@@@@@@@@@@@@@@@@@@@@@@@@
@@@@@@@@@@@@@@@@@@@@@@@@@@@@@@@@.............@@@.......@@@@@@@@@@@........T..T...............T......@@@@@@@@@@@@@@@@@@@@@@@@
@@@@@@@@@@@@@@@@@@@@@@@@@@@@@@@............T@@@@........@@@@@@@@@@@.............................T.....@@@@@@@@@@@@@@@@@@@@@@
@@@@@@@@@@@@@@@@@@@@@@@@@@@@@@........T.....@@@@....T....@@@@@@@@@@@T...................T..T........T..@@@@@@@@@@@@@@@@@@@@@
@@@@@@@@@@@@@@@@@@@@@@@@@@@@@...........T@@@@@@@...T......@@@@@@@@@@@.....T.T.TT..T.....T.T...T.........@@@@@@@@@@@@@@@@@@@@
@@@@@@@@@@@@@@@@@@@@@@@@@@@@.T.....T.....@@@@@@@@@@@@@@....@@@@@@@@@@@........T.......T..T.........T..T..@@@@@@@@@@@@@@@@@@@
@@@@@@@@@@@@@@@@@@@@@@@@@@@..............@@@@@@@@@@@@@@@..TT@@@@@@@@@@@....T...TT......T....T...........@@@@@@@@@@@@@@@@@@@@
@@@@@@@@@@@@@@@@@@@@@@@@@@@.....T........@@@@@@@@@@@@@@@.....@@@@@@@@@@@...T.....T...........T......T..@@@@@@@@@@@@@@@@@@@@@
@@@@@@@@@@@@@@@@@@@@@@@@@@@@...........T.@@@@@@@@@@@@@@@......@@@@@@@@@@@...T..T.................T....@@@@@@@@@@@@@@@@@@@@@@
@@@@@@@@@@@@@@@@@@@@@@@@@@@@@.....T.......@@@@@@@@@@@@@@.......@@@@@@@@@@@........T..T.................@@@@@@@@@@@@@@@@@@@@@
@@@@@@@@@@@@@@@@@@@@@@@@@@@@@@.T..............@@@@@@@@@@........@@@@@@@@@@@......T..T...T..T...T....T..@@@@@@@@@@@@@@@@@@@@@
@@@@@@@@@@@@@@@@@@@@@@@@@@@@@@@.T.TT..T...........@@@@@@@.T.T...T@@@@@@@@@@@..T......T.................@@@@@@@@@@@@@@@@@@@@@
@@@@@@@@@@@@@@@@@@@@@@@@@@@@@@@@..........T..T.T...@@@@@@..T.....T@@@@@@@@@@@.........................@@@@@@@@@@@@@@@@@@@@@@
@@@@@@@@@@@@@@@@@@@@@@@@@@@@@@@@@.......T.......T...@@@@@........T.@@@@@@@@@@.......T.............T..@@@@@@@@@@@@@@@@@@@@@@@
@@@@@@@@@@@@@@@@@@@@@@@@@@@@@@@@@@....T......T......@@@@@...@TT.....@@@@@@@@@@T.....T...T......T..T.@@@@@@@@@@@@@@@@@@@@@@@@
@@@@@@@@@@@@@@@@@@@@@@@@@@@@@@@@@@@.......T...........@@@..@@@@......@@@@@@@@@@..T.T...............@@@@@@@@@@@@@@@@@@@@@@@@@
@@@@@@@@@@@@@@@@@@@@@@@@@@@@@@@@@@@@..T...T...T.....@@@@@.T@@@@.......@@@@@@@@@................@..@@@@@@@@@@@@@@@@@@@@@@@@@@
@@@@@@@@@@@@@@@@@@@@@@@@@@@@@@@@@@@@@.......TT.....@@@@@..T@@@@T..T....@@@@@@@@@..............@@@@@@@@@@@@@@@@@@@@@@@@@@@@@@
@@@@@@@@@@@@@@@@@@@@@@@@@@@@@@@@@@@@@@....TT........@@@@...@@.T.........@@@@@@@@@...........T@@@@@@@@@@@@@@@@@@@@@@@@@@@@@@@
@@@@@@@@@@@@@@@@@@@@@@@@@@@@@@@@@@@@@@@..........T...@@@......T...T.....@@@@@@@@@@..........@@@@@@@@@@@@@@@@@@@@@@@@@@@@@@@@
@@@@@@@@@@@@@@@@@@@@@@@@@@@@@@@@@@@@@@@@......T...T...@@.T............T@@@@@@@@@@@@........@@@@@@@@@@@@@@@@@@@@@@@@@@@@@@@@@
@@@@@@@@@@@@@@@@@@@@@@@@@@@@@@@@@@@@@@@@@......T.TTT..........T.......@@@@@@@@@@@@@@......@@@@@@@@@@@@@@@@@@@@@@@@@@@@@@@@@@
@@@@@@@@@@@@@@@@@@@@@@@@@@@@@@@@@@@@@@@@@@...........................@@@@@@@@@@@@@@@@....@@@@@@@@@@@@@@@@@@@@@@@@@@@@@@@@@@@
@@@@@@@@@@@@@@@@@@@@@@@@@@@@@@@@@@@@@@@@@@@........T...T............@@@@@@@@@@@@@@@@@@..@@@@@@@@@@@@@@@@@@@@@@@@@@@@@@@@@@@@
@@@@@@@@@@@@@@@@@@@@@@@@@@@@@@@@@@@@@@@@@@@@.T.....................@@@@@@@@@@@@@@@@@@@@@@@@@@@@@@@@@@@@@@@@@@@@@@@@@@@@@@@@@
@@@@@@@@@@@@@@@@@@@@@@@@@@@@@@@@@@@@@@@@@@@@@T..........T.........@@@@@@@@@@@@@@@@@@@@@@@@@@@@@@@@@@@@@@@@@@@@@@@@@@@@@@@@@@
@@@@@@@@@@@@@@@@@@@@@@@@@@@@@@@@@@@@@@@@@@@@@@...........T.......@@@@@@@@@@@@@@@@@@@@@@@@@@@@@@@@@@@@@@@@@@@@@@@@@@@@@@@@@@@
@@@@@@@@@@@@@@@@@@@@@@@@@@@@@@@@@@@@@@@@@@@@@@@.........T....T..@@@@@@@@@@@@@@@@@@@@@@@@@@@@@@@@@@@@@@@@@@@@@@@@@@@@@@@@@@@@
@@@@@@@@@@@@@@@@@@@@@@@@@@@@@@@@@@@@@@@@@@@@@@@@.T...T.T.......@@@@@@@@@@@@@@@@@@@@@@@@@@@@@@@@@@@@@@@@@@@@@@@@@@@@@@@@@@@@@
@@@@@@@@@@@@@@@@@@@@@@@@@@@@@@@@@@@@@@@@@@@@@@@@@.....T.......@@@@@@@@@@@@@@@@@@@@@@@@@@@@@@@@@@@@@@@@@@@@@@@@@@@@@@@@@@@@@@
@@@@@@@@@@@@@@@@@@@@@@@@@@@@@@@@@@@@@@@@@@@@@@@@@@...........@@@@@@@@@@@@@@@@@@@@@@@@@@@@@@@@@@@@@@@@@@@@@@@@@@@@@@@@@@@@@@@
@@@@@@@@@@@@@@@@@@@@@@@@@@@@@@@@@@@@@@@@@@@@@@@@@@@.......T.@@@@@@@@@@@@@@@@@@@@@@@@@@@@@@@@@@@@@@@@@@@@@@@@@@@@@@@@@@@@@@@@
@@@@@@@@@@@@@@@@@@@@@@@@@@@@@@@@@@@@@@@@@@@@@@@@@@@@....T..@@@@@@@@@@@@@@@@@@@@@@@@@@@@@@@@@@@@@@@@@@@@@@@@@@@@@@@@@@@@@@@@@
@@@@@@@@@@@@@@@@@@@@@@@@@@@@@@@@@@@@@@@@@@@@@@@@@@@@@T....@@@@@@@@@@@@@@@@@@@@@@@@@@@@@@@@@@@@@@@@@@@@@@@@@@@@@@@@@@@@@@@@@@
@@@@@@@@@@@@@@@@@@@@@@@@@@@@@@@@@@@@@@@@@@@@@@@@@@@@@@..T@@@@@@@@@@@@@@@@@@@@@@@@@@@@@@@@@@@@@@@@@@@@@@@@@@@@@@@@@@@@@@@@@@@
@@@@@@@@@@@@@@@@@@@@@@@@@@@@@@@@@@@@@@@@@@@@@@@@@@@@@@@.@@@@@@@@@@@@@@@@@@@@@@@@@@@@@@@@@@@@@@@@@@@@@@@@@@@@@@@@@@@@@@@@@@@@
@@@@@@@@@@@@@@@@@@@@@@@@@@@@@@@@@@@@@@@@@@@@@@@@@@@@@@@@@@@@@@@@@@@@@@@@@@@@@@@@@@@@@@@@@@@@@@@@@@@@@@@@@@@@@@@@@@@@@@@@@@@@
@@@@@@@@@@@@@@@@@@@@@@@@@@@@@@@@@@@@@@@@@@@@@@@@@@@@@@@@@@@@@@@@@@@@@@@@@@@@@@@@@@@@@@@@@@@@@@@@@@@@@@@@@@@@@@@@@@@@@@@@@@@@
@@@@@@@@@@@@@@@@@@@@@@@@@@@@@@@@@@@@@@@@@@@@@@@@@@@@@@@@@@@@@@@@@@@@@@@@@@@@@@@@@@@@@@@@@@@@@@@@@@@@@@@@@@@@@@@@@@@@@@@@@@@@
