type octile
height 54
width 52
map
@@@@@@@@@@@@@@@@@@@@@@@@@@@@@@@@@@@@@@@@@@@@@@@@@@@@
@@@@@@@@@@@@@@@@@@@@@@@@@@@@@@@@@@@@@@@@@@@@@@@@@@@@
@@@@@@@@@@@@@@@@@@@@@@@@@@@@@@@@@@@@@@@@@@@@@@@@@@@@
@@@@@@@@@@@@@@@@@@@@@@@@@@@@@@@@@@@@@@@@@@@@@@@@@@@@
@@@@@@@@@@@@@@@@@@@@@@@@@@@@@@@@@@@@@@@@@@@@@@@@@@@@
@@@@@@@@@@@@@@@@@@@@@@@@@@@@@@@@@@@@@@@@@@@@@@@@@@@@
@@@@@@@@@@@@@@@@@@@@@@@@@@@@@@@@@@@@@@@@@@@@@@@@@@@@
@@@@@@@@@@@@@@@@@@@@@@@@@@@@@@@@@@@@@@@@@@@@@@@@@@@@
@@@@@@@@@@@@@@@@@@@@@@@@@@@@@@@@@@@@@@@@@@@@@@@@@@@@
@@@@@@@@@@@@@@@@@@@@@@@@@@@@@@@@@@@@@@@@@@@@@@@@@@@@
@@@@@@@@@@@@@@@@@@@@@@@@@@@@@@@@@@@@@@@@@@@@@@@@@@@@
@@@@@@@@@@@@@@@@@@@@@@@@@@@@@@@.@@@@@@@@@@@@@@@@@@@@
@@@@@@@@@@@@@@@@@@@@@@@@@@@@@@@..@@@@@@@@@@@@@@@@@@@
@@@@@@@@@@@@@@@@@@@@@@@@@@@@@@@..T@@@@@@@@@@@@@@@@@@
@@@@@@@@@@@@@@@@@@@@@@@@@@@@@@@@...@@@@@@@@@@@@@@@@@
@@@@@@@@@@@@@@@@@@@@@@@@@@@.@@@....@@@@@@@@@@@@@@@@@
@@@@@@@@@@@@@@@@@@@@@@@@@@.......T@@@@@@@@@@@@@@@@@@
@@@@@@@@@@@@@@@@@@@@@@@@@..TT....@@@@@@@@@@@@@@@@@@@
@@@@@@@@@@@@@@@@@@@@@@@@..T.....@@@@@@@@@@@@@@@@@@@@
@@@@@@@@@@@@@@@@@@@@@@@........@@@@@@@@@@@@@@@@@@@@@
@@@@@@@@@@@@@@@@@@@@@@......T.@@@@@@@@.@.@@@@@@@@@@@
@@@@@@@@@@@@@@@@@@@@@@...T....@@@@@@@.....@@@@@@@@@@
@@@@@@@@@@@@@@@@@@@@@@..T......@@@@@.......@@@@@@@@@
@@@@@@@@@@@@@@@@@@@@.....T.....T@@@....T.T..@@@@@@@@
@@@@@@@@@@@@@@@@@@@....T.....................@@@@@@@
@@@@@@@@@@@@@@@@@@......................T....@@@@@@@
@@@@@@@@@@@@@@@@T.......@@@T.TT....T........@@@@@@@@
@@@@@@@@@@@@@@@..T..T...@@@@@.T...T..T....T@@@@@@@@@
@@@@@@@@@@@@@@.........T.@@@@@.......T....@@@@@@@@@@
@@@@@@@@@@@@@....T.@.......@@@...........@@@@@@@@@@@
@@@@@@@@@@@.T....@@@@.@@@@.@@......T....@@@@@@@@@@@@
@@@@@@@@@@....T...@@@@@@@@....T......T.@@@@@@@@@@@@@
@@@@@@@@@@@@.T....@@@@@@@@......T....T@@@@@@@@@@@@@@
@@@@@@@@@@@@@.....T@@@@@@............@@@@@@@@@@@@@@@
@@@@@@@@@@@@@@T.....@@@@@@..........@@@@@@@@@@@@@@@@
@@@@@@@@@@@@@@T...T..@@@@@...T..T..@@@@@@@@@@@@@@@@@
@@@@@@@@@@@@@.........@@@T........@@@@@@@@@@@@@@@@@@
@@@@@@@..............T.......TT..@@@@@@@@@@@@@@@@@@@
@@@@@@@@........................@@@@@@@@@@@@@@@@@@@@
@@@@@@@@@....T.....T.....T.T...@@@@@@@@@@@@@@@@@@@@@
@@@@@@@@@@.....T...TT.........@@@@@@@@@@@@@@@@@@@@@@
@@@@@@@@@@@.....T.........T.T@@@@@@@@@@@@@@@@@@@@@@@
@@@@@@@@@@@@...........T....@@@@@@@@@@@@@@@@@@@@@@@@
@@@@@@@@@@@@@..T...........@@@@@@@@@@@@@@@@@@@@@@@@@
@@@@@@@@@@@@@@...........T@@@@@@@@@@@@@@@@@@@@@@@@@@
@@@@@@@@@@@@@@@...T......@@@@@@@@@@@@@@@@@@@@@@@@@@@
@@@@@@@@@@@@@@@@........@@@@@@@@@@@@@@@@@@@@@@@@@@@@
@@@@@@@@@@@@@@@@@......@@@@@@@@@@@@@@@@@@@@@@@@@@@@@
@@@@@@@@@@@@@@@@@@....@@@@@@@@@@@@@@@@@@@@@@@@@@@@@@
@@@@@@@@@@@@@@@@@@@..@@@@@@@@@@@@@@@@@@@@@@@@@@@@@@@
@@@@@@@@@@@@@@@@@@@@@@@@@@@@@@@@@@@@@@@@@@@@@@@@@@@@
@@@@@@@@@@@@@@@@@@@@@@@@@@@@@@@@@@@@@@@@@@@@@@@@@@@@
@@@@@@@@@@@@@@@@@@@@@@@@@@@@@@@@@@@@@@@@@@@@@@@@@@@@
@@@@@@@@@@@@@@@@@@@@@@@@@@@@@@@@@@@@@@@@@@@@@@@@@@@@
