type octile
height 64
width 60
map
@@@@@@@@@@@@@@@@@@@@@@@@@@@@@@@@@@@@@@@@@@@@@@@@@@@@@@@@@@@@
@@@@@@@@@@@@@@@@@@@@@@@@@@@@@@@@@@@@@@@@@@@@@@@@@@@@@@@@@@@@
@@@@@@@@@@@@@@@@@@@@@@@@@@@@@@@@@@@@@@@@@@@@@@@@@@@@@@@@@@@@
@@@@@@@@@@@@@@@@@@@@@@@@@@@@@@@@@@@@@@@@@@@@@@@@@@@@@@@@@@@@
@@@@@@@@@@@@@@@@@@@@@@@@@@@@@@@@@@@@@@@@@@@@@@@@@@@@@@@@@@@@
@@@@@@@@@@@@@@@@@@@@@@@@@@@@@@@@@@@@@@@@@@@@@@@@@@@@@@@@@@@@
@@@@@@@@@@@@@@@@@@@@@@@@@@@@@@@@@@@@@@@@@@@@@@@@@@@@@@@@@@@@
@@@@@@@@@@@@@@@@@@@@@@@@@@@@@@@@@@@@@@@@@@@@@@@@@@@@@@@@@@@@
@@@@@@@@@@@@@@@@@@@@@@@@@@@@@@@@@@@@@@@@@@@@@@@@@@@@@@@@@@@@
@@@@@@@@@@@@@@@@@@@@@@@@@@@@@@@@@@@@@@@@@@@@@@@@@@@@@@@@@@@@
@@@@@@@@@@@@@@@@@@@@@@@@@@@@@@@@@@@@@@@@@@@@@@@@@@@@@@@@@@@@
@@@@@@@@@@@@@@@@@@@@@@@@@@@@@@@@.@@@@@@@@@@@@@@@@@@@@@@@@@@@
@@@@@@@@@@@@@@@@@@@@@@@@@@@@@@@..@@@@@@@@@@@@@@@@@@@@@@@@@@@
@@@@@@@@@@@@@@@@@@@@@@@@@@@@@@@..@@@@...@@@@@@@@@@@@@@@@@@@@
@@@@@@@@@@@@@@@@@@@@@@@@@@@@@@@..@@@@@@..@@@@@@@@@@@@@@@@@@@
@@@@@@@@@@@@@@@@@@@@@@@@@@@@@@@..@.@@@@@..@@@@@@@@@@@@@@@@@@
@@@@@@@@@@@@@@@@@@@@@@@@@@@@@@@.....@@@@@..@@@@@@@@@@@@@@@@@
@@@@@@@@@@@@@@@@@@@@@@@@@@@@@@@......@@@@@..@@@@@@@@@@@@@@@@
@@@@@@@@@@@@@@@@@@@@@@@@@@@@@@@.....T@@@@@...@@@@@@@@@@@@@@@
@@@@@@@@@@@@@@@@@@@@@@@@@@@@@@@@@...T@@@@.......@@@@@@@@@@@@
@@@@@@@@@@@@@@@@@@@@@@@@@@@@@@@@@.............@..@@@@@@@@@@@
@@@@@@@@@@@@@@@@@@@@@@@@@@@@@@@..........T...@@@..@@@@@@@@@@
@@@@@@@@@@@@@@@@@@@@@@@@@@@@@@........T.....@@@..T.@@@@@@@@@
@@@@@@@@@@@@@@@@@@@@@@@@@@@@@.........TT...@@@@@.T..@@@@@@@@
@@@@@@@@@@@@@@@@@@@@@@@@@@..@@.TT........T.@@@@@@@@..@@@@@@@
@@@@@@@@@@@@@@@@@@@@@@@.@@.@@@.......T.T..@@@@@@@@@..T@@@@@@
@@@@@@@@@@@@@@@@@@@@@@@...................@@@.@@......T@@@@@
@@@@@@@@@@@@@@@@@@@@@@...T.........@@@.T........T.......@@@@
@@@@@@@@@@@@@@@@@@@@..T............@@@..................@@@@
@@@@@@@@@@@@@@@@@@@.....T..............T.T......T......@@@@@
@@@@@@@@@@@@@@@@@@.....@@..T.........T.T.............T@@@@@@
@@@@@@@@@@@@@@@@@.....@@@@..@@..........T..TTT..T....@@@@@@@
@@@@@@@@@@@@@@@@@....@@@@@@@@@....................T.@@@@@@@@
@@@@@@@.@@@@@@@@..T@@@@@@@@@...T.................T.@@@@@@@@@
@@@@@@...@@@@@@...@@@@@@@@@@@..@@....T............@@@@@@@@@@
@@@@@T...T@@@@.....@@@@@@@@@@@@@@.....T..........@@@@@@@@@@@
@@@@......@@@.T..T.@@@@@@@@@@@@.......T...T.....@@@@@@@@@@@@
@@@@.T.....@.T.T...T@T.@@@@@@@@@...............@@@@@@@@@@@@@
@@@@@.TT...@............@@@@@@@@@......T......@@@@@@@@@@@@@@
@@@@@......@@......T....@@@@@@@@@@...........@@@@@@@@@@@@@@@
@@@@@@......@T..........@@@@@@@@....T.......@@@@@@@@@@@@@@@@
@@@@@@......@@.........@@@@@@@@............@@@@@@@@@@@@@@@@@
@@@@@@.......@........@@@@@@@@........T...@@@@@@@@@@@@@@@@@@
@@@@@........@@T..T..@@@@@@@@@@T.........@@@@@@@@@@@@@@@@@@@
@@@@..........@.....@@@@@@@@@@..........@@@@@@@@@@@@@@@@@@@@
@@@@..........@T...@@@@@@@@T....TT.....@@@@@@@@@@@@@@@@@@@@@
@@@@@.............@@@@@@@@@@..TT.T...T@@@@@@@@@@@@@@@@@@@@@@
@@@@@@....T......@@@@@@@@.@..........@@@@@@@@@@@@@@@@@@@@@@@
@@@@@@@.T..T....@@@@@@@@..T.........@@@@@@@@@@@@@@@@@@@@@@@@
@@@@@@@@.....T.@@@@@@@@....T...T...@@@@@@@@@@@@@@@@@@@@@@@@@
@@@@@@@@@.....@@@@@@@@@...........@@@@@@@@@@@@@@@@@@@@@@@@@@
@@@@@@@@@@.....@@@@@@@...........@@@@@@@@@@@@@@@@@@@@@@@@@@@
@@@@@@@@@@@.....@@@@...T........@@@@@@@@@@@@@@@@@@@@@@@@@@@@
@@@@@@@@@@@@....T@@..........T.@@@@@@@@@@@@@@@@@@@@@@@@@@@@@
@@@@@@@@@@@@@.................@@@@@@@@@@@@@@@@@@@@@@@@@@@@@@
@@@@@@@@@@@@@@..............@@@@@@@@@@@@@@@@@@@@@@@@@@@@@@@@
@@@@@@@@@@@@@@@............@@@@@@@@@@@@@@@@@@@@@@@@@@@@@@@@@
@@@@@@@@@@@@@@@@.....T....@@@@@@@@@@@@@@@@@@@@@@@@@@@@@@@@@@
@@@@@@@@@@@@@@@@@........@@@@@@@@@@@@@@@@@@@@@@@@@@@@@@@@@@@
@@@@@@@@@@@@@@@@@@@.....@@@@@@@@@@@@@@@@@@@@@@@@@@@@@@@@@@@@
@@@@@@@@@@@@@@@@@@@@...@@@@@@@@@@@@@@@@@@@@@@@@@@@@@@@@@@@@@
@@@@@@@@@@@@@@@@@@@@@@@@@@@@@@@@@@@@@@@@@@@@@@@@@@@@@@@@@@@@
@@@@@@@@@@@@@@@@@@@@@@@@@@@@@@@@@@@@@@@@@@@@@@@@@@@@@@@@@@@@
@@@@@@@@@@@@@@@@@@@@@@@@@@@@@@@@@@@@@@@@@@@@@@@@@@@@@@@@@@@@
