type octile
height 86
width 88
map
@@@@@@@@@@@@@@@@@@@@@@@@@@@@@@@@@@@@@@@@@@@@@@@@@@@@@@@@@@@@@@@@@@@@@@@@@@@@@@@@@@@@@@@@
@@@@@@@@@@@@@@@@@@@@@@@@@@@@@@@@@@@@@@@@@@@@@@@@@@@@@@@@@@@@@@@@@@@@@@@@@@@@@@@@@@@@@@@@
@@@@@@@@@@@@@@@@@@@@@@@@@@@@@@@@@@@@@@@@@@@@@@@@@@@@@@@@@@@@@@@@@@@@@@@@@@@@@@@@@@@@@@@@
@@@@@@@@@@@@@@@@@@@@@@@@@@@@@@@@@@@@@@@@@@@@@@@@@@@@@@@@@@@@@@@@@@@@@@@@@@@@@@@@@@@@@@@@
@@@@@@@@@@@@@@@@@@@@@@@@@@@@@@@@@@@@@@@@@@@@@@@@@@@@@@@@@@@@@@@@@@@@@@@@@@@@@@@@@@@@@@@@
@@@@@@@@@@@@@@@@@@@@@@@@@@@@@@@@@@@@@@@@@@@@@@@@@@@@@@@@@@@@@@@@@@@@@@@@@@@@@@@@@@@@@@@@
@@@@@@@@@@@@@@@@@@@@@@@@@@@@@@@@@@@@@@@@@@@@@@@@@@@@@@@@@@@@@@@@@@@@@@@@@@@@@@@@@@@@@@@@
@@@@@@@@@@@@@@@@@@@@@@@@@@@@@@@@@@@@@@@@@@@@@@@@@@@@@@@@@@@@@@@@@@@@@@@@@@@@@@@@@@@@@@@@
@@@@@@@@@@@@@@@@@@@@@@@@@@@@@@@@@@@@@@@@@@@@@@@@@@@@@@@@@@@@@@@@@@@@@@@@@@@@@@@@@@@@@@@@
@@@@@@@@@@@@@@@@@@@@@@@@@@@@@@@@@@@@@@@@@@@@@@@@@@@@@@@@@@@@@@@@@@@@@@@@@@@@@@@@@@@@@@@@
@@@@@@@@@@@@@@@@@@@@@@@@@@@@@@@@@@@@@@@@@@@@@@@@@@@@@@@@@@@@@@@@@@@@@@@@@@@@@@@@@@@@@@@@
@@@@@@@@@@@@@@@@@@@@@@@@@@@@@@@@@@@@@@@@@@@@@@@@@@@@@@@@@@@@@@@@@@@@@@@@@@@@@@@@@@@@@@@@
@@@@@@@@@@@@@@@@@@@@@@@@@@@@@@@..@@@@@@@@@@@@@@@@@@@@@@@@@@@@@@@@@@@@@@@@@@@@@@@@@@@@@@@
@@@@@@@@@@@@@@@@@@@@@@@@@@@@@@@...@@@@@@@@@@@@@@@@@@@@@@@@@@@@@@@@@@@@@@@@@@@@@@@@@@@@@@
@@@@@@@@@@@@@@@@@@@@@@@@@@@@@@.....@@@@@@@@@@@@@@@@@@@@@@@@@@@@@@@@@@@@@@@@@@@@@@@@@@@@@
@@@@@@@@@@@@@@@@@@@@@@@@@@@@@....T..@@@@@@@@@@@@@@@@@@@@@@@@@@@@@@@@@@@@@@@@@@@@@@@@@@@@
@@@@@@@@@@@@@@@@@@@@@@@@@@@@.......T.@@@..@@@@@@@@@@@@@@@@@@@@@@@@@@@@@@@@@@@@@@@@@@@@@@
@@@@@@@@@@@@@@@@@@@@@@@@@@@.....@@.T.T....@@@@@@@@@@@@@@@@@@@@@@@@@@@@@@@@@@@@@@@@@@@@@@
@@@@@@@@@@@@@@@@@@@@@@@@@@T...T@@@T..T.....@@@@@@@@@@@@@@@@@@@@@@@@@@@@@@@@@@@@@@@@@@@@@
@@@@@@@@@@@@@@@@@@@@@@@@@.....@@@..T.TT......@@@@@@@@@@@@@@@@@@@@@@@@@@@@@@@@@@@@@@@@@@@
@@@@@@@@@@@@@@@@@@@@@@@@.....@@@...T........T.@@@@@@@@@@@@@@@@@@@@@@@@@@@@@@@@@@@@@@@@@@
@@@@@@@@@@@@@@@@@@@@@@@@@T.T@@@..T...@@...T...@@@@@@@@@@@@@@@@@@@@@@@@@@@@@@@@@@@@@@@@@@
@@@@@@@@@@@@@@@@@@@@@@.@@..@@@..T..TT@@@.......@@@@@@@@@@@@@@@@@@@@@@@@@@@@@@@@@@@@@@@@@
@@@@@@@@@@@@@@@@@@@@@...@@@@@.....T.@@@@@.....@@@@@@@@@@@@@@@@@@@@@@@@@@@@@@@@@@@@@@@@@@
@@@@@@@@@@@@@@@@@@@@....@@@@T......@@@@@@....@@@@@@@@@@@@@@@@@@@@@@@@@@@@@@@@@@@@@@@@@@@
@@@@@@@@@@@@@@@@@@@...T...........T@@@@@..T.@@@@@@@@@@@@@@@@@@@@@@@@@@@@@@@@@@@@@@@@@@@@
@@@@@@@@@@@@@@@@@@............T......@@@....@@@@@@@@@@@@@@@@@@@@@@@@@@@@@@@@@@@@@@@@@@@@
@@@@@@@@@@@@@@@@@............TT.......@@@..@@@@@@.@@.@@@@@@@@@@@@@@@@@@@@@@@@@@@@@@@@@@@
@@@@@@@@@@@@@@@@.......T...T...T..TT...@..@@@@@@@..@TT@@@@@@@@@@@@@@@@@@@@@@@@@@@@@@@@@@
@@@@@@@@@@@@@@@T.............T..TT........@@@@@@@@....@@@@@@@@@@@@@@@@@@@@@@@@@@@@@@@@@@
@@@@@@@@@@@@@@@.................T........@@@@@@@@T.T...@@@@@@@@@@@@@@@@@@@@@@@@@@@@@@@@@
@@@@@@@@@@@@@@@@.T..T.....TT.T..........@@@@@@@@...T..T..@@@@@@@@@@@@@@@@@@@@@@@@@@@@@@@
@@@@@@@@@@@@@@@@@@......T.T.........T.@@@@@@@@@..T.........@@@@@@@@@@@@@@@@@@@@@@@@@@@@@
@@@@@@@@@@@@@@@@@@@@@...T.T....TT.....@@@@@@@@@............@@@@@@@@@@@@@@@@@@@@@@@@@@@@@
@@@@@@@@@@.@@@@@@@@@@T......T.........@@@@@@@@@....T......@@@@@@@@@@@@@@@@@@@@@@@@@@@@@@
@@@@@@@@T...@@@@@@@@@.....T..........@@@@@@@@......T......@@@T@@@@@@@@@@@@@@@@@@@@@@@@@@
@@@@@@@......@@@@@@@@@@@......T.....@@@@@@....................T@@@@@@@@@@@@@@@@@@@@@@@@@
@@@@@@.....T..@@@@@@.@@@......T.....@@@.@@.........T.........T.@@@@@@@@@@@@@@@@@@@@@@@@@
@@@@@..T.......@@@@..@@............@@@.T.........@@@@......T....@@@@@@@@@@@@@@@@@@@@@@@@
@@@@...T......T..@..@@.............@@@.......T...@@@@@..T.........@@@@@@@@@@@@@@@@@@@@@@
@@@....T...TT.....T.@..T.......@...T.@.....T.....T..@@@....TT......@@@@@@@@@@@@@@@@@@@@@
@@@..........T....TT...T..T...@@TT.T.@......T..T....@@@............@@@@@@@@@@@@@@@@@@@@@
@@@...........T.T....T......T@@@@@.T..............T..@@@...........@@@@@@@@@@@@@@@@@@@@@
@@@@.......T.........T......@@@@@@@..T..T..T..T.......@........T..@@@@@@@@@@@@@@@@@@@@@@
@@@@@T.......T.............@@@@..@@T.......................T......@@@@@@@@@@@@@@@@@@@@@@
@@@@@@.................T..@@@@...............T..T.T..........T..@@@@@@@@@@@@@@@@@@@@@@@@
@@@@@@@....TT......T....T@@@@@..........T.....................T@@@@@..@@@@@@@@@@@@@@@@@@
@@@@@@@@....T......T....@@@@@@@.......................T.......@@@@@....@@@@@@@@@@@@@@@@@
@@@@@@@@@....T.T.......@@@@@@@@.T...T...TT@@@........T.T....T@@@@@@.....@@@@@@@@@@@@@@@@
@@@@@@@@@@.T...T......@@@@@@@@............@@@..........T....@@@@@@@.T.T..@@@@@@@@@@@@@@@
@@@@@@@@@@@..........@@@@@@@@@..........T.@@@..............@@@@@@.........@@@@@@@@@@@@@@
@@@@@@@@@@@@......@@@@@@@@@@...T...................T.....@@@@@@@@.@@@@...T..T.@@@@@@@@@@
@@@@@@@@@@@@@.....@@@@@@@@@@.....................T......T@@@@@@@@T@@@@@.......@@@@@@@@@@
@@@@@@@@@@@@@@...@@@@@@@@@@.....T.....T.T..T............@@@@@@@@..@@@@@@......@@@@@@@@@@
@@@@@@@@@@@@@@@@@@@@@@@@@......T.T....T...T.TT.......T@@@@@@@@@...@@@@@@@.....@@@@@@@@@@
@@@@@@@@@@@@@@@@@@@@...T..........TT..T.T...T.......T@@@@@@@@@....@@@@@@@..T....@@@@@@@@
@@@@@@@@@@@@@@@@@@@T...TT..T....T.T.TT..............T@@@@@@@@@....@@@@@@@.......@@@@@@@@
@@@@@@@@@@@@@@@@@@....T.........TTT...T............T..@@..........T@@@@@....T....@..@@@@
@@@@@@@@@@@@@@@@@@@.TT..........T..........................T.....T..........@@.......@@@
@@@@@@@@@@@@@@@@@@@@...............T.T...........@@.......T................@@@...T.@@@@@
@@@@@@@@@@@@@@@@@@@@@......T......T.T..........T@@@@....................T.@@@.....@@@@@@
@@@@@@@@@@@@@@@@@@@@@@.........................@@@@@...T...T.T...........@@@.....@@@@@@@
@@@@@@@@@@@@@@@@@@@@@@@.......................@@@@@@.TT.................@@@.....@@@@@@@@
@@@@@@@@@@@@@@@@@@@@@@@@.T..........T........@@@@@@@............T..TT..@@@.....@@@@@@@@@
@@@@@@@@@@@@@@@@@@@@@@@@@...............T.TT@@@@@@@....T.T............@@@......@@@@@@@@@
@@@@@@@@@@@@@@@@@@@@@@@@@@...........T.....@@@@@@@...T.....T.........@@@...T..@@@@@@@@@@
@@@@@@@@@@@@@@@@@@@@@@@@@@@.....T.......T@@@@@@@...............T....@@@..T...@@@@@@@@@@@
@@@@@@@@@@@@@@@@@@@@@@@@@@@@.......T...T.@@@@@@@.T.....T...T........@@@.T...@@@@@@@@@@@@
@@@@@@@@@@@@@@@@@@@@@@@@@@@@@..........T@@@@@@@...T.......TT..........@@...@@@@@@@@@@@@@
@@@@@@@@@@@@@@@@@@@@@@@@@@@@@@.........@@@@@@@T.T............T......T.@@@.@@@@@@@@@@@@@@
@@@@@@@@@@@@@@@@@@@@@@@@@@@@@@@...T..@@@@@@@....T..T..@................@@@@@@@@@@@@@@@@@
@@@@@@@@@@@@@@@@@@@@@@@@@@@@@@@@....T@@@@@@@.........@@........T.......@@@@@@@@@@@@@@@@@
@@@@@@@@@@@@@@@@@@@@@@@@@@@@@@@@@..T@@@@@@@...T.....T...@.............@@@@@@@@@@@@@@@@@@
@@@@@@@@@@@@@@@@@@@@@@@@@@@@@@@@@@.@@@@@........T....@@@@@@TT.......T@@@@@@@@@@@@@@@@@@@
@@@@@@@@@@@@@@@@@@@@@@@@@@@@@@@@@@@@@@@TT...........@@@@@@@@.....TT.@@@@@@@@@@@@@@@@@@@@
@@@@@@@@@@@@@@@@@@@@@@@@@@@@@@@@@@@@@@.......T.....@@@@@@@@@@..TT.T@@@@@@@@@@@@@@@@@@@@@
@@@@@@@@@@@@@@@@@@@@@@@@@@@@@@@@@@@@@..........TT..@@@@@@@@@@@....@@@@@@@@@@@@@@@@@@@@@@
@@@@@@@@@@@@@@@@@@@@@@@@@@@@@@@@@@@@@@T.....T........@@@@@@@@@@..@@@@@@@@@@@@@@@@@@@@@@@
@@@@@@@@@@@@@@@@@@@@@@@@@@@@@@@@@@@@@@@...T..T.T.....T....@@@@@@@@@@@@@@@@@@@@@@@@@@@@@@
@@@@@@@@@@@@@@@@@@@@@@@@@@@@@@@@@@@@@@@@T.....T...T........@@@@@@@@@@@@@@@@@@@@@@@@@@@@@
@@@@@@@@@@@@@@@@@@@@@@@@@@@@@@@@@@@@@@@@@.......T...........@@@@@@@@@@@@@@@@@@@@@@@@@@@@
@@@@@@@@@@@@@@@@@@@@@@@@@@@@@@@@@@@@@@@@@@T......T.T..T..T...@@@@@@@@@@@@@@@@@@@@@@@@@@@
@@@@@@@@@@@@@@@@@@@@@@@@@@@@@@@@@@@@@@@@@@@..T..T....T...T..@@@@@@@@@@@@@@@@@@@@@@@@@@@@
@@@@@@@@@@@@@@@@@@@@@@@@@@@@@@@@@@@@@@@@@@@@.T......T....T.@@@@@@@@@@@@@@@@@@@@@@@@@@@@@
@@@@@@@@@@@@@@@@@@@@@@@@@@@@@@@@@@@@@@@@@@@@@...T...T....T@@@@@@@@@@@@@@@@@@@@@@@@@@@@@@
@@@@@@@@@@@@@@@@@@@@@@@@@@@@@@@@@@@@@@@@@@@@@@@@@@@@@@@@@@@@@@@@@@@@@@@@@@@@@@@@@@@@@@@@
