type octile
height 80
width 80
map
@@@@@@@@@@@@@@@@@@@@@@@@@@@@@@@@@@@@@@@@@@@@@@@@@@@@@@@@@@@@@@@@@@@@@@@@@@@@@@@@
@@@@@@@@@@@@@@@@@@@@@@@@@@@@@@@@@@@@@@@@@@@@@@@@@@@@@@@@@@@@@@@@@@@@@@@@@@@@@@@@
@@@@@@@@@@@@@@@@@@@@@@@@@@@@@@@@@@@@@@@@@@@@@@@@@@@@@@...T...TT.....T.........@@
@@@@@@@@@@@@@@@@@@@@@@@@@@@@@@@@@@@@@@@@@@@@@@@@@@@@@@........T.T.......T.....@@
@@@@@@@@@@@@@@@@@@@@@@@@@@@@@@@@@@@@@@@@@@@@@@@@@@@@@..............T..........@@
@@@@@@@@@@@@@@@@@@@@@@@@@@@@@@@@@@@@@@@@@@@@@@@@@@@@..........................@@
@@@@@@@@@@@@@@@@@@@@@@@@@@@@@@@@@@@@@@@@@@@@@@@@@@@.........T...T.....T......T@@
@@@@@@@@@@@@@@@@@@@@@@@@@@@@@@@@@@@@@@@@@@@@@@@@@@@@....T.........T..T.T......@@
@@@@@@@@@@@@@@@@@@@@@@@@@@@@@@@@@@@@@@@@@@@@@@@@@@@@@.T..........T....T....T..@@
@@@@@@@@@@@@@@@@@@@@@@@@@@@@@@@@@@@@@@@@@@@@@@@@@@@@@.................T..T....@@
@@@@@@@@@@@@@@@@@@@@@@@@@@@@@@@@@@@@@@@@@@@@@@@@@@@@@................T..T.....@@
@@@@@@@@@@@@@@@@@@@@@@@@@@@@@@@@@@@@@@@@@@@@@@@@@@@@.......................T..@@
@@@@@@@@@@@@@@@@@@@@@@@@@@@@@@@@@@@@@@@@@@@@@@@@@@....TT.......T..T.....T.....@@
@@@@@@@@@@@@@@@@@@@@@@@@@@@@@@@@@@@@@@@@@@@@@@@@@@@........T..................@@
@@@@@@@@@@@@@@@@@@@@@@@@@@@@@@@@@@@@@..@@@@@@@@@@@@...............T.......T.T.@@
@@@@@@@@@@@@@@@@@@@@@@@@@@@@@@@@@@@@...@@@@@@@@@...................@@.T.......@@
@@@@@@@@@@@@@@@@@@@@@@@@@@@@@@@@@@@@.TTT@@@@@@@T.....T..T.T......@@@@........T@@
@@@@@@@@@@@@@@@@@@@@@@@@@@@@@@@@@@@T....@@....T..T.............@@@@@@@T.......@@
@@@@@@@@@@@@@@@@@@@@@@@@@@@@@@@@@@..T......T...T...T..T.T.T...@@@@@@@@....T...@@
@@@@@@@@@@@@@@@@@@@@@@@@@@@@@@@@@@.@@.T................T......@@@@@@@@@.......@@
@@@@@@@@@@@@@@@@@@@@@@@@@@@@@@@@@@@@@....T.T.............T.....@@@@@@@@.......@@
@@@@@@@@@@@@@@@@@@@@@@@@@@@@@@@@@@@@@@....T...............T....@@@@@@@@.......@@
@@@@@@@@@@@@@@@@@@@@@@@@@@@@@@@@@@@@......T.............T..T..T@@@@@@@........@@
@@@@@@@@@@@@@@@@@@@@@@@@@@@@@@@@@@@@.........T........TT..T.....@@@@@........T@@
@@@@@@@@@@@@@@@@@@@@@@@@@@@@@@@@@@@@...........T........T.......T@T..........T@@
@@@@@@@@@@@@@@@@@@@@@@@@@@@@@@@@@@..........................................T.@@
@@@@@@@@@@@@@@@@@@@@@@@@@@@@@@@@@@.................T................TT....T..@@@
@@@@@@@@@@@@@@@@@@@@@@@@@@@@@@@@@@............TT............T........T.T.T..@@@@
@@@@@@@@@@@@@@@@@@@@@@@@@@@@@@@@@@.T........................T..............@@@@@
@@@@@@@@@@@@@@@@@@@@@@.....@@@@@@...........T......T.............T..T....@@@@@@@
@@@@@@@@@@@@@@@@@@@@@......@@@@@@............T..T......T...........T...T@@@@@@@@
@@@@@@@@@@@@@@@@.@@@.............................T.........T...........@@@@@@@@@
@@@@@@@@@@@@@@@...............TT.................T....T....T...T.......@@@@@@@@@
@@@@@@@@@@@@@....................T.........T...T.T..T.....T..T...T.T..@@@@@@@@@@
@@@@@@@@@@@@..T...........T..TT...........T.........T................@@@@@@@@@@@
@@@@@@@@@@@....T........................T....T.T.......T............@@@@@@@@@@@@
@@@@@@@@@@...............T......T..................................@@@@@@@@@@@@@
@@@@@@@@@............T.....T........T................T...T........@@@@@@@@@@@@@@
@@@@@@@@.....TT.................T...........TTT...T...........T..@@@@@@@@@@@@@@@
@@@@@@............@@@@@@@..T.T.......T.........................T.@@@@@@@@@@@@@@@
@@@@@............@@@@@@@@......T.T........T.....................@@@@@@@@@@@@@@@@
@@@@.............@@@@@@@@......T.T..........T..........T.....T.@@@@@@@@@@@@@@@@@
@@@...T.....TT....@@@@@@@.T....................T.......T......@@@@@@@@@@@@@@@@@@
@@T........T...T..@@@@@.T....T........TT.............T...T.T.@@@@@@@@@@@@@@@@@@@
@@..................@@......T.........................T.....@@@@@@@@@@@@@@@@@@@@
@@............T...T........................................@@@@@@@@@@@@@@@@@@@@@
@@.....@.T.....T...........T..............T........T......@@@@@@@@@@@@@@@@@@@@@@
@@T...@@@@......T...T........T......T..................T@@@@@@@@@@@@@@@@@@@@@@@@
@@..@@@@@@@@................TT.............T..T.......T@@@@@@@@@@@@@@@@@@@@@@@@@
@@.@@@@@@@@@@.T.............T...T...................T.@@@@@@@@@@@@@@@@@@@@@@@@@@
@@@@@@@@@@@@@@........T............T..........T.....@@@@@@@@@@@@@@@@@@@@@@@@@@@@
@@@@@@@@@@@@@@@............T...........T...T.....T.@@@@@@@@@@@@@@@@@@@@@@@@@@@@@
@@@@@@@@@@@@@@@@...T...T..........................@@@@@@@@@@@@@@@@@@@@@@@@@@@@@@
@@@@@@@@@@@@@@@@@...................T......T.T...@@@@@@@@@@@@@@@@@@@@@@@@@@@@@@@
@@@@@@@@@@@@@@@@@@..........T...T..T.....T.....T@@@@@@@@@@@@@@@@@@@@@@@@@@@@@@@@
@@@@@@@@@@@@@@@@@@@............T...T....T......@@@@@@@@@@@@@@@@@@@@@@@@@@@@@@@@@
@@@@@@@@@@@@@@@@@@@@..........................@@@@@@@@@@@@@@@@@@@@@@@@@@@@@@@@@@
@@@@@@@@@@@@@@@@@@@@@...........T....T.......T@@@@@@@@@@@@@@@@@@@@@@@@@@@@@@@@@@
@@@@@@@@@@@@@@@@@@@@@@.......................@@@@@@@@@@@@@@@@@@@@@@@@@@@@@@@@@@@
@@@@@@@@@@@@@@@@@@@@@@@.....................@@@@@@@@@@@@@@@@@@@@@@@@@@@@@@@@@@@@
@@@@@@@@@@@@@@@@@@@@@@@@.........T.........@@@@@@@@@@@@@@@@@@@@@@@@@@@@@@@@@@@@@
@@@@@@@@@@@@@@@@@@@@@@@@@....T..T....T..T.@@@@@@@@@@@@@@@@@@@@@@@@@@@@@@@@@@@@@@
@@@@@@@@@@@@@@@@@@@@@@@@@.TTT......T.....@@@@@@@@@@@@@@@@@@@@@@@@@@@@@@@@@@@@@@@
@@@@@@@@@@@@@@@@@@@@@@@@@.......TT..T...@@@@@@@@@@@@@@@@@@@@@@@@@@@@@@@@@@@@@@@@
@@@@@@@@@@@@@@@@@@@@@@@@@...........T..@@@@@@@@@@@@@@@@@@@@@@@@@@@@@@@@@@@@@@@@@
@@@@@@@@@@@@@@@@@@@@@@@@@@T.......T...@@@@@@@@@@@@@@@@@@@@@@@@@@@@@@@@@@@@@@@@@@
@@@@@@@@@@@@@@@@@@@@@@@@@@@...........@@@@@@@@@@@@@@@@@@@@@@@@@@@@@@@@@@@@@@@@@@
@@@@@@@@@@@@@@@@@@@@@@@@@@@@.T........@@@@@@@@@@@@@@@@@@@@@@@@@@@@@@@@@@@@@@@@@@
@@@@@@@@@@@@@@@@@@@@@@@@@@@@@...T...T.@@@@@@@@@@@@@@@@@@@@@@@@@@@@@@@@@@@@@@@@@@
@@@@@@@@@@@@@@@@@@@@@@@@@@@@@@........T@@@@@@@@@@@@@@@@@@@@@@@@@@@@@@@@@@@@@@@@@
@@@@@@@@@@@@@@@@@@@@@@@@@@@@@@@@..T.T...@@@@@@@@@@@@@@@@@@@@@@@@@@@@@@@@@@@@@@@@
@@@@@@@@@@@@@@@@@@@@@@@@@@@@@@@@@........@@@@@@@@..@@@@@@@@@@@@@@@@@@@@@@@@@@@@@
@@@@@@@@@@@@@@@@@@@@@@@@@@@@@@@@@@....T...@@@@@@..TT@@@@@@@@@@@@@@@@@@@@@@@@@@@@
@@@@@@@@@@@@@@@@@@@@@@@@@@@@@@@@@@@.....T..@@@@......@@@@@@@@@@@@@@@@@@@@@@@@@@@
@@@@@@@@@@@@@@@@@@@@@@@@@@@@@@@@@@@@....T...@@.......@@@@@@@@@@@@@@@@@@@@@@@@@@@
@@@@@@@@@@@@@@@@@@@@@@@@@@@@@@@@@@@@@................@@@@@@@@@@@@@@@@@@@@@@@@@@@
@@@@@@@@@@@@@@@@@@@@@@@@@@@@@@@@@@@@@@..T....T.T......@@@@@@@@@@@@@@@@@@@@@@@@@@
@@@@@@@@@@@@@@@@@@@@@@@@@@@@@@@@@@@@@@@@....T..........@@@@@@@@@@@@@@@@@@@@@@@@@
@@@@@@@@@@@@@@@@@@@@@@@@@@@@@@@@@@@@@@@@@@@@@@@@@@@@@@@@@@@@@@@@@@@@@@@@@@@@@@@@
@@@@@@@@@@@@@@@@@@@@@@@@@@@@@@@@@@@@@@@@@@@@@@@@@@@@@@@@@@@@@@@@@@@@@@@@@@@@@@@@
