type octile
height 118
width 120
map
@@@@@@@@@@@@@@@@@@@@@@@@@@@@@@@@@@@@@@@@@@@@@@@@@@@@@@@@@@@@@@@@@@@@@@@@@@@@@@@@@@@@@@@@@@@@@@@@@@@@@@@@@@@@@@@@@@@@@@@@
@@@@@@@@@@@@@@@@@@@@@@@@@@@@@@@@@@@@@@@@@@@@@@@@@@@@@@@@@@@@@@@@@@@@@@@@@@@@@@@@@@@@@@@@@@@@@@@@@@@@@@@@@@@@@@@@@@@@@@@@
@@@@@@@@@@@@@@@@@@@@@@@@@@@@@@@@@@@@@@@@@@@@@@@@@@@@@@@@@@@@@@@@@@@@@@@@@@@@@@@@@@@@@@@@@@@@@@@@@@@@@@@@@@@@@@@@@@@@@@@@
@@@@@@@@@@@@@@@@@@@@@@@@@@@@@@@@@@@@@@@@@@@@@@@@@@@@@@@@@@@@@@@@@@@@@@@@@@@@@@@@@@@@@@@@@@@@@@@@@@@@@@@@@@@@@@@@@@@@@@@@
@@@@@@@@@@@@@@@@@@@@@@@@@@@@@@@@@@@@@@@@@@@@@@@@@@@@@@@@@@@@@@@@@@@@@@@@@@@@@@@@@@@@@@@@@@@@@@@@@@@@@@@@@@@@@@@@@@@@@@@@
@@@@@@@@@@@@@@@@@@@@@@@@@@@@@@@@@@@@@@@@@@@@@@@@@@@@@@@@@@@@@@@@@@@@@@@@@@@@@@@@@@@@@@@@@@@@@@@@@@@@@@@@@@@@@@@@@@@@@@@@
@@@@@@@@@@@@@@@@@@@@@@@@@@@@@@@@@@@@@@@@@@@@@@@@@@@@@@@@@@@@@@@@@@@@@@@@@@@@@@@@@@@@@@@@@@@@@@@@@@@@@@@@@@@@@@@@@@@@@@@@
@@@@@@@@@@@@@@@@@@@@@@@@@@@@@@@@@@@@@@@@@@@@@@@@@@@@@@@@@@@@@@@@@@@@@@@@@@@@@@@@@@@@@@@@@@@@@@@@@@@@@@@@@@@@@@@@@@@@@@@@
@@@@@@@@@@@@@@@@@@@@@@@@@@@@@@@@@@@@@@@@@@@@@@@@@@@@@@@@@@@@@@@@@@@@@@@@@@@@@@@@@@@@@@@@@@@@@@@@@@@@@@@@@@@@@@@@@@@@@@@@
@@@@@@@@@@@@@@@@@@@@@@@@@@@@@@@@@@@@@@@@@@@@@@@@@@@@@@@@@@@@@@@@@@@@@@@@@@@@@@@@@@@@@@@@@@@@@@@@@@@@@@@@@@@@@@@@@@@@@@@@
@@@@@@@@@@@@@@@@@@@@@@@@@@@@@@@@@@@@@@@@@@@@@@@@@@@@@@@@@@@@@@@@@@@@@@@@..@@@@@@@@@@@@@@@@@@@@@@@@@@@@@@@@@@@@@@@@@@@@@@
@@@@@@@@@@@@@@@@@@@@@@@@@@@@@@@@@@@@@@@@@@@@@@@@@@@@@@@@@@@@@@@@@@@@@@@.....@@@@@@@@@@@@@@@@@@@@@@@@@@@@@@@@@@@@@@@@@@@@
@@@@@@@@@@@@@@@@@@@@@@@@@@@@@@@@@@@@@@@@@@@@@@@@@@@@@@@@@@@@@@@@@@@@@@.......@@@@@@@@@@@@@@@@@@@@@@@@@@@@@@@@@@@@@@@@@@@
@@@@@@@@@@@@@@@@@@@@@@@@@@@@@@@@@@@@@@@@@@@@@@@@@@@@@@@@@@@@@@@@@@@@..........@@@@@@@@@@@@@@@@@@@@@@@@@@@@@@@@@@@@@@@@@@
@@@@@@@@@@@@@@@@@@@@@@@@@@@@@@@@@@@@@@@@@@@@@@@@@@@@@@@@@@@@@@@@@@@....@@@.....@@@@@@@@@@@@@@@@@@@@@@@@@@@@@@@@@@@@@@@@@
@@@@@@@@@@@@@@@@@@@@@@@@@@@@@@@@@@@@@@@@@@@@@@@@@@@@@@@@@@@@@@@@@@....@@@@@.....@@@@@@@@@@@@@@@@@@@@@@@@@@@@@@@@@@@@@@@@
@@@@@@@@@@@@@@@@@@@@@@@@@@@@@@@@@@@@@@@@@@@@@@@@@@@@@@@@@@@@@@@@@....@@@@@@@.....@@@@@@@@@@@@@@@@@@@@@@@@@@@@@@@@@@@@@@@
@@@@@@@@@@@@@@@@@@@@@@@@@@@@@@@@@@@@@@@@@@@@@@@@@@@@@@@@@@@@@@@@....@@@@@@@@@.T...@@@@@@@@@@@@@@@@@@@@@@@@@@@@@@@@@@@@@@
@@@@@@@@@@@@@@@@@@@@@@@@@@@@@@@@@@@@@@@@@@@@@@@@@@@@@@@@@@@@@@@@..T@@@@@@@@@@@..T..@@@@@@@@@@@@@@@@@@@@@@@@@@@@@@@@@@@@@
@@@@@@@@@@@@@@@@@@@@@@@@@@@@@@@@@@@@@@@@@@@@@@@@@@@@@@@@@@@@@@@@@.@@@@@@@@@@@@@.....@@@@@@@@@@@@@@@@@@@@@@@@@@@@@@@@@@@@
@@@@@@@@@@@@@@@@@@@@@@@@@@@@@@@@@@@@@@@@@@@@@@@@@@@@@@@@@@@@@@@@@@@@@@@@..@@@@@@...T.@@@@@@@@@@@@@@@@@@@@@@@@@@@@@@@@@@@
@@@@@@@@@@@@@@@@@@@@@@@@@@@@@@@@@@@@@@@@@@@@@@@@@@@@@@@@@@@@@@@@@@@@@@@@...@@@@@@.....@@@@@@@@@@@@@@@@@@@@@@@@@@@@@@@@@@
@@@@@@@@@@@@@@@@@@@@@@@@@@@@@@@@@@@@@@@@@@@@@@@@@@@@@@@@@@@@@@@@@@@@@@....T.@@@@@@.....@@@@@@@@@@@@@@@@@@@@@@@@@@@@@@@@@
@@@@@@@@@@@@@@@@@@@@@@@@@@@@@@@@@@@@@@@@@@@@@@@@@@@@@@@@@@@@@@@@@@..@@.......@@@@@@.....@@@@@@@@@@@@@@@@@@@@@@@@@@@@@@@@
@@@@@@@@@@@@@@@@@@@@@@@@@@@@@@@@@@@@@@@@@@@@@@@@@@@@@@@@@@@@@@@@@@...TT.......@@@@@@.T..T@@@@@@@@@@@@@@@@@@@@@@@@@@@@@@@
@@@@@@@@@@@@@@@@@@@@@@@@@@@@@@@@@@@@@@@@@@@@@@@@@@@@@@@@@@@@@@@@@@.....T.T.@...@@@@@@@....@@@@@@@@@@@@@@@@@@@@@@@@@@@@@@
@@@@@@@@@@@@@@@@@@@@@@@@@@@@@@@@@@@@@@@@@@@@@@@@@@@@@@@@...T..@@@@@T.TT..@@@....@@@@@@.T..@@@@@@@@@@@@@@@@@@@@@@@@@@@@@@
@@@@@@@@@@@@@@@@@@@@@@@@@@@@@@@@@@@@@@@@@@@@@@@@@@@@@@@.....T..@@@@..T.@@@@@@..@@@@@@....@@@@@@@@@@@@@@@@@@@@@@@@@@@@@@@
@@@@@@@@@@@@@@@@@@@@@@@@@@@@@@@@@@@@@@@@@@@@@@@@@@@@@@.....@@@..T@@...T@@@@@@@T@@@@@@...@@@@@@@@@@@@@@@@@@@@@@@@@@@@@@@@
@@@@@@@@@@@@@@@@@@@@@@@@@@@@@@@@@@@@@@@@@@@@@@@@@@@@@T.....@@@T@@@@@...@@@@@@T.@@@@@T..T@@@@@@@@@@@@@@@@@@@@@@@@@@@@@@@@
@@@@@@@@@@@@@@@@@@@@@@@@@@@@@@@@@@@@@@@@@@@.@@@@@@@@..@@@@....T@@@@@...@@@.@@T.@@@@@T.T@@@@@@@@@@@@@@@@@@@@@@@@@@@@@@@@@
@@@@@@@@@@@@@@@@@@@@@@@@@@@@@@@@@@@@@@@@@@...@@@@@@@..@@@@@...@@@@@@...T......T@@@@..T.@@@@@@@@@@@@@@@@@@@@@@@@@@@@@@@@@
@@@@@@@@@@@@@@@@@@@@@@@@@@@@@@@@@@@@@@@@@.....@@@@@@...@@.@...T@@@@@...........@@@@..T@@@@@@@@@@@@@@@@@@@@@@@@@@@@@@@@@@
@@@@@@@@@@@@@@@@@@@@@@@@@@@@@@@@@@@@@@@@......@@@@@@.......T@@.@@@@@......T...@@@@....@@@@@@@@@@@@@@@@@@@@@@@@@@@@@@@@@@
@@@@@@@@@@@@@@@@@@@@@@@@@@@@@@@@@@@@@@@......@@@@@@@....@@@.@@....@@.........@@@@@...@@@@@@@...@@@@@@@@@@@@@@@@@@@@@@@@@
@@@@@@@@@@@@@@@@@@@@@@@@@@@@@@@@@@@@@@.....T@@@@@@@@@T..@@@.......@@T........@@@@..TT@@@@@@@..@@@@@@@@@@@@@@@@@@@@@@@@@@
@@@@@@@@@@@@@@@@@@@@@@@@@@@@@@@@@@@@@T.....@@T@@@@@@@...@@@.T.....@T......T...@.@...@@@@@@@@T.@@@@@@@@@@@@@@@@@@@@@@@@@@
@@@@@@@@@@@@@@@@@@@@@@@@@@@@@@@@@@@@T..T..@@..@@@@@@@@...........................T..@@@@@@@...T.@@@@@@@@@@@@@@@@@@@@@@@@
@@@@@@@@@@@@@@@@@@@@@@@@@@@@@@@@@@@T...T..@...@@@@@@@@@........@.T.....T.........T.@@@@@@@.....@@@@@@@@@@@@@@@@@@@@@@@@@
@@@@@@@@@@@@@@@@@@@@@@@@@@@@@@@@@@.T.T....@...@.@@@@@@@@@@@@@@@@.........T..T......@@@@@@..TTT@@@@@@@@@@@@@@@@@@@@@@@@@@
@@@@@@@@@@@@@@@@@@@@@@@@@@@@@@@@@@........@@.....@@@@@@@@@@@@@@....T........@@@.T.@@@@@@.....@@@@@@@@@@@@@@@@@@@@@@@@@@@
@@@@@@@@@@@@@@@@@@@@@@@@@@@@@@@@@T..T@@....@......@@@@@@....TT.T..T........@@@@@.@@@@@@....@@@@@@..@@@@@@@@@@@@@@@@@@@@@
@@@@@@@@@@@@@@@@@@@@@@@@@@@@@@@.TT..@@@..T.@@.....T@.@@@@..T..T...........@@@@@@@@@@@@......@@@@.T.T@@@@@@@@@@@@@@@@@@@@
@@@@@@@@@@@@@@@@@@@@@@@@@@@@@@.....@@@@@....@.........@@@....T..T......T.@@@@@@@@@@.@T.......@@.T.T@@@@@@@@@@@@@@@@@@@@@
@@@@@@@@@@@@@@@@@@@@@@@@@@@@@.....@@@@@@...T@@...T.....@..T...T.......T@@@@@@@@@@@@.........TT@@T.@@@@@@@@@@@@@@@@@@@@@@
@@@@@@@@@@@@@@@@@@@@@@@@@@@@.....@@@@@@@.....@........T...T@@......T....@@@@@@@@@@@..........T...@@@@@@@@@@@@@@@@@@@@@@@
@@@@@@@@@@@@@@@@@@@@@@@@@@.T....@@@@@@@@@....@@........T.@@@@@........T..@@@@@@@@@.....T.....T.@@@@@@@.T@@@@@@.@@@@@@@@@
@@@@@@@@@@@@@@@@@@@@@@@@@......@@@@@@@@@@@....@T..........@@@@@T.........@@@@@@@...............@@@@@@....@@@@@..@@@@@@@@
@@@@@@@@@@@@@@@@@@@@@@@@......@@@@@@@@@@.@.T..@...........@@@@@@....T...@@@@@@@T.T.@.....T.....T..@@....@@@@@...@@@@@@@@
@@@@@@@@@@@@@@@@@@@@@@@......@@@@@@@@@@..@@.T.@...........@@@@@@@......@@@@@.@@...@@@@.T.T......T.TT...@@@@@@...@@@@@@@@
@@@@@@@@@@@@@@@@@@@@@@......@@@@@@@@@@.T..@.........T.T.@@@@@@@@@@....@@@@@..@@..@@@@@@..T......T.....@@@@@@...@@@@@@@@@
@@@@@@@@@@@@@@@@@@@@@.T.T..@@@@@@@@@@.....@@.....T...T.@@@@@@@@@@@@..@@@@@@..@@@@@@@@@@..............T@@@@@@...@@@@@@@@@
@@@@@@@@@@@@@@@@@@@@@.....@@@@@@@@@@...................@@@@@@@@@@@@@@@@@@@@...@@@@@@@.................@@@@@...@@@@@@@@@@
@@@@@@@@@@@@@@@@@@@@..T..@@@@@@@@@@.....................@@@@@@@@@@@@@@@@@@@@..@@@@@@....@@.....T......@@@@@...@@@@@@@@@@
@@@@@@@@@@@@@@@@@@....T.@@@@@@@@@@@....T..T................@@@@@@@@@@@@@@@@@...@@@@T...@@@@........T.@@@@@..T@@@@@@@@@@@
@@@@@@@@@@@@@@@@@......@@@@@@@@@@@@@.....T..T..............T@@@@@@@@@@@@@@@@.T.@@@@@..@@@@@...T.....@@@@@@T.@@@@@@@@@@@@
@@@@@@@@@@@@@@@@......@@@@@@@@@@..@@@.T.T.....TT..T...T.....T@@@@@@@@@@@@@@@@..@@@@@@@@@@@@@.......T@@.@....@@@@@@@@@@@@
@@@@@@@@@@@@@@@T.....@@@@@@@@@@....@@@....T.....T...T.........@@@@@@@@@@@@@@@...@@@@@@@@@@@@.@T.....@.......@@@@@@@@@@@@
@@@@@@@@@@@@@@......@@@@@@@@@@..T...@@@.T.....T.....T..T.....T..@@@@@@@@@@.@@..T.@@@@@@@@...@@@......T..T...@@@@@@@@@@@@
@@@@@@@@@@@@.T..T..@@@@@@@@@@........@@@...........@@...........@@@@@@@@@@..@@..T@@@@@@@...@@@@@............@@@@@@@@@@@@
@@@@@@@@@@@T..T.T..@@@@@@@@@..T...T...@@...........@@@............@@.@@@....@@....@@@@@T..@@@@@@....T.......T@@@@@@@@@@@
@@@@@@@@@@....T.T.@@@@@@@@@@..T................T...@@@@..............@@@....@@...T@@@@...@@@@@@...........TT@@@@@@@@@@@@
@@@@@@@@@.........@@@@@@@.@@@........T.....T......T.@@@@..............T...T..@@...@@@@@@@@@@@@.............@@@@@@@@@@@@@
@@@@@@@@.T.........@@@@@..T@@@.T.TT.....T......T.....@@@@..........................@@@@@@@@@@.T........TT.@@@@@@@@@@@@@@
@@@@@@@@......@@...@@@@.....@@@..T.................T..@@@..T.......T.T....T....@@...@@@@@@@@.......T.T...@@@@@@@@@@@@@@@
@@@@@@@..TT..@@@....@@.......@@@.....................T....T..........T........@@@@...@@@@@@.....T.......@@@@@@@@@@@@@@@@
@@@@@@......@@@@....@@..T.....@@@....T.@@@@@@.T......T..T........T.....T.....@@@@@@...@@@@@@...........@@@@@@@@@@@@@@@@@
@@@@@@.....@@@@@@....@.........@@.....@@@@@@@TT.......@@@..........T........@@@@@@@@...@@@@.T...T.....@@@@@@@@@@@@@@@@@@
@@@@@@@.T.@@@@@@@@..T@...T...........@@@@@@@@..T......@@@......T............@@@@@@@@@..@@@...........@@@@@@@@@@@@@@@@@@@
@@@@@@@@.@@@@@@@@@...@@T..TT....TT.T.@@@@@@@@...........T.TT..........T....@@@@@@@@@@........@@...T.@@@@@@@@@@@@@@@@@@@@
@@@@@@@@@@@@@@@@@@@...@...T..........@@@@@@@@T........T....T.@@.........T.T.@@@@@@@@@.......@@@@...@@@@@@@@@@@@@@@@@@@@@
@@@@@@@@@@@@@@@@T.@...@@...T...........@@.@@@.T.............@@@@@............@@@@@@@@@@@...T.@@@@.@@@@@@@@@@@@@@@@@@@@@@
@@@@@@@@@@@@@@@..T@@T.......T.T.T......T..@@@@......T....T@@@@@@@@T..T........@@@@@@.@@@T...T.@@@@@@@@@@@@@@@@@@@@@@@@@@
@@@@@@@@@@@@@@....@@@...T...T...T..T......@@@@..T.........@@@@@@.....T......T..@@@@............@@@@@@@@@@@@@@@@@@@@@@@@@
@@@@@@@@@@@@@...T.@@@...T.................@@@..T........T.T.T@@@..T...T.....T...@@@............@@@@@@@@@@@@@@@@@@@@@@@@@
@@@@@@@@@@@@...............T...@@@...................T.T.T...@@@..T..............@@...........@@@@@@@@@@@@@@@@@@@@@@@@@@
@@@@@@@@@@T.............T....T.@@@.....T..T.T....T...........@@@.........................T...@@@@@@@@@@@@@@@@@@@@@@@@@@@
@@@@@@@@@@.....T........T.....@@@T............T...T..T..@@...@@@..T........T........T.T...T.@@@@@@@@@@@@@@@@@@@@@@@@@@@@
@@@@@@@@@@@..................@@@@.........T............T@@@...T......T......T.......T......@@@@@@@@@@@@@@@@@@@@@@@@@@@@@
@@@@@@@@@@@@...............@@@@@@@@...TT..........T....@@@@@.....T..................T.....@@@@@@@@@@@@@@@@@@@@@@@@@@@@@@
@@@@@@@@@@@@@..............@@@@@@@@@...@@@@@....T......@@@@@@......@@@....T..............@@@@@@@@@@@@@@@@@@@@@@@@@@@@@@@
@@@@@@@@@@@@@@.............@@@@@@@@@T.@@@@@@@..........@@@@@@.T...@@@@@......T......T...@@@@@@@@@@@@@@@@@@@@@@@@@@@@@@@@
@@@@@@@@@@@@@@@....T........T........@@@@.@@@@.........@@@@@TT...@@@@@@@.....T...TT....@@@@@@@@@@@@@@@@@@@@@@@@@@@@@@@@@
@@@@@@@@@@@@@@@@....................@@@@T..@@@@@.T.T....@@@T....@@@@@@@@@.....T...T...@@@@@@@@@@@@@@@@@@@@@@@@@@@@@@@@@@
@@@@@@@@@@@@@@@@@...T......T......T@@@@.....@@@T........@@.....@@@@@@@@@@............@@@@@@@@@@@@@@@@@@@@@@@@@@@@@@@@@@@
@@@@@@@@@@@@@@@@@@.T.T...T.......T@@@@@@@@.T.@...............T@@@@@@@@@@............@@@@@@@@@@@@@@@@@@@@@@@@@@@@@@@@@@@@
@@@@@@@@@@@@@@@@@@@.T............@@@@@@@@@@@.....@..........T@@@@@@@@@....@........@@@@@@@@@@@@@@@@@@@@@@@@@@@@@@@@@@@@@
@@@@@@@@@@@@@@@@@@@@............@@@@@@@@@@@.....@@@@.T......@@@@@@@@@T...@@@......@@@@@@@@@@@@@@@@@@@@@@@@@@@@@@@@@@@@@@
@@@@@@@@@@@@@@@@@@@@@T.T.T.....@@@@@@@@@@@@.....@@@@@.T..T.@@@@@@@@@......@@@....@@@@@@@@@@@@@@@@@@@@@@@@@@@@@@@@@@@@@@@
@@@@@@@@@@@@@@@@@@@@@@.....T..@@@@.@@@@@@@@......@@@@@...T@@@@@@@@@........@@@..@@@@@@@@@@@@@@@@@@@@@@@@@@@@@@@@@@@@@@@@
@@@@@@@@@@@@@@@@@@@@@@@....T.@@@@..@@@@@@@@.......@@@@@TT@@@@@@@@@@.T.T...TT@@@@@@@@@@@@@@@@@@@@@@@@@@@@@@@@@@@@@@@@@@@@
@@@@@@@@@@@@@@@@@@@@@@@@....@@@@...@@@@@@....T.....@@@@@@@@@@@@@@@@.....T....@@@@@@@@@@@@@@@@@@@@@@@@@@@@@@@@@@@@@@@@@@@
@@@@@@@@@@@@@@@@@@@@@@@@@..@@@@...@@@@@@@...T......@@@@@@@@@@@@@@@...........@@@@@@@@@@@@@@@@@@@@@@@@@@@@@@@@@@@@@@@@@@@
@@@@@@@@@@@@@@@@@@@@@@@@@@@@@@.....@@@@@.T........@@@.@@@@@@@@@@............@@@@@@@@@@@@@@@@@@@@@@@@@@@@@@@@@@@@@@@@@@@@
@@@@@@@@@@@@@@@@@@@@@@@@@@@@@...........T.......T@@@...@@@@@@@@@...........@@@@@@@@@@@@@@@@@@@@@@@@@@@@@@@@@@@@@@@@@@@@@
@@@@@@@@@@@@@@@@@@@@@@@@@@@@.....T....T.........@@@.....@@@@@@@....T.....T@@@@@@@@@@@@@@@@@@@@@@@@@@@@@@@@@@@@@@@@@@@@@@
@@@@@@@@@@@@@@@@@@@@@@@@@@@@@.T......T.........@@@.......@@@@............@@@@@@@@@@@@@@@@@@@@@@@@@@@@@@@@@@@@@@@@@@@@@@@
@@@@@@@@@@@@@@@@@@@@@@@@@@@@@@...........TTT....@T........@@@@.........T@@@@@@@@@@@@@@@@@@@@@@@@@@@@@@@@@@@@@@@@@@@@@@@@
@@@@@@@@@@@@@@@@@@@@@@@@@@@@@@@@.T.........T@@....@@@@@@@..@@@@..T.T.T.@@@@@@@@@@@@@@@@@@@@@@@@@@@@@@@@@@@@@@@@@@@@@@@@@
@@@@@@@@@@@@@@@@@@@@@@@@@@@@@@@@@..........@@@..T.@@@@@@@...@@@@.T....@@@@@@@@@@@@@@@@@@@@@@@@@@@@@@@@@@@@@@@@@@@@@@@@@@
@@@@@@@@@@@@@@@@@@@@@@@@@@@@@@@@@@........@@@@..T.@@@@@@...T.@@@@....@@@@@@@@@@@@@@@@@@@@@@@@@@@@@@@@@@@@@@@@@@@@@@@@@@@
@@@@@@@@@@@@@@@@@@@@@@@@@@@@@@@@@@@..T...@@@@@.T.@@@@@@@...T.T@@@@..@@@@@@@@@@@@@@@@@@@@@@@@@@@@@@@@@@@@@@@@@@@@@@@@@@@@
@@@@@@@@@@@@@@@@@@@@@@@@@@@@@@@@@@@@....@@@@@@...@@@@@@@......T@@@@@@@@@@@@@@@@@@@@@@@@@@@@@@@@@@@@@@@@@@@@@@@@@@@@@@@@@
@@@@@@@@@@@@@@@@@@@@@@@@@@@@@@@@@@@@@..@@@@@@@...@@@@@@@@.......@@@@@@@@@@@@@@@@@@@@@@@@@@@@@@@@@@@@@@@@@@@@@@@@@@@@@@@@
@@@@@@@@@@@@@@@@@@@@@@@@@@@@@@@@@@@@@@@@@@@@@.....@@..@@.........@@@@@@@@@@@@@@@@@@@@@@@@@@@@@@@@@@@@@@@@@@@@@@@@@@@@@@@
@@@@@@@@@@@@@@@@@@@@@@@@@@@@@@@@@@@@@@@@@.......T...............@@@@@@@@@@@@@@@@@@@@@@@@@@@@@@@@@@@@@@@@@@@@@@@@@@@@@@@@
@@@@@@@@@@@@@@@@@@@@@@@@@@@@@@@@@@@@@@@@......T.......T...T....@@@@@@@@@@@@@@@@@@@@@@@@@@@@@@@@@@@@@@@@@@@@@@@@@@@@@@@@@
@@@@@@@@@@@@@@@@@@@@@@@@@@@@@@@@@@@@@@@@@...T.....T...........@@@@@@@@@@@@@@@@@@@@@@@@@@@@@@@@@@@@@@@@@@@@@@@@@@@@@@@@@@
@@@@@@@@@@@@@@@@@@@@@@@@@@@@@@@@@@@@@@@@@@...........T....T.T@@@@@@@@@@@@@@@@@@@@@@@@@@@@@@@@@@@@@@@@@@@@@@@@@@@@@@@@@@@
@@@@@@@@@@@@@@@@@@@@@@@@@@@@@@@@@@@@@@@@@@@.................@@@@@@@@@@@@@@@@@@@@@@@@@@@@@@@@@@@@@@@@@@@@@@@@@@@@@@@@@@@@
@@@@@@@@@@@@@@@@@@@@@@@@@@@@@@@@@@@@@@@@@@@@...............@@@@@@@@@@@@@@@@@@@@@@@@@@@@@@@@@@@@@@@@@@@@@@@@@@@@@@@@@@@@@
@@@@@@@@@@@@@@@@@@@@@@@@@@@@@@@@@@@@@@@@@@@@@.........T.T.@@@@@@@@@@@@@@@@@@@@@@@@@@@@@@@@@@@@@@@@@@@@@@@@@@@@@@@@@@@@@@
@@@@@@@@@@@@@@@@@@@@@@@@@@@@@@@@@@@@@@@@@@@@@@T...TT.....@@@@@@@@@@@@@@@@@@@@@@@@@@@@@@@@@@@@@@@@@@@@@@@@@@@@@@@@@@@@@@@
@@@@@@@@@@@@@@@@@@@@@@@@@@@@@@@@@@@@@@@@@@@@@@@...T.T.T.@@@@@@@@@@@@@@@@@@@@@@@@@@@@@@@@@@@@@@@@@@@@@@@@@@@@@@@@@@@@@@@@
@@@@@@@@@@@@@@@@@@@@@@@@@@@@@@@@@@@@@@@@@@@@@@@@T......@@@@@@@@@@@@@@@@@@@@@@@@@@@@@@@@@@@@@@@@@@@@@@@@@@@@@@@@@@@@@@@@@
@@@@@@@@@@@@@@@@@@@@@@@@@@@@@@@@@@@@@@@@@@@@@@@@@@...@@@@@@@@@@@@@@@@@@@@@@@@@@@@@@@@@@@@@@@@@@@@@@@@@@@@@@@@@@@@@@@@@@@
@@@@@@@@@@@@@@@@@@@@@@@@@@@@@@@@@@@@@@@@@@@@@@@@@@@@@@@@@@@@@@@@@@@@@@@@@@@@@@@@@@@@@@@@@@@@@@@@@@@@@@@@@@@@@@@@@@@@@@@@
@@@@@@@@@@@@@@@@@@@@@@@@@@@@@@@@@@@@@@@@@@@@@@@@@@@@@@@@@@@@@@@@@@@@@@@@@@@@@@@@@@@@@@@@@@@@@@@@@@@@@@@@@@@@@@@@@@@@@@@@
