type octile
height 112
width 108
map
@@@@@@@@@@@@@@@@@@@@@@@@@@@@@@@@@@@@@@@@@@@@@@@@@@@@@@@@@@@@@@@@@@@@@@@@@@@@@@@@@@@@@@@@@@@@@@@@@@@@@@@@@@@@
@@@@@@@@@@@@@@@@@@@@@@@@@@@@@@@@@@@@@@@@@@@@@@@@@@@@@@@@@@@@@@@@@@@@@@@@@@@@@@@@@@@@@@@@@@@@@@@@@@@@@@@@@@@@
@@@@@@@@@@@@@@@@@@@@@@@@@@@@@@@@@@@@@@@@@@@@@@@@@@@@@@@@@@@@@@@@@@@@@@@@@@@@@@@@@@@@@@@@@@@@@@@@@@@@@@@@@@@@
@@@@@@@@@@@@@@@@@@@@@@@@@@@@@@@@@@@@@@@@@@@@@@@@@@@@@@@@@@@@@@@@@@@@@@@@@@@@@@@@@@@@@@@@@@@@@@@@@@@@@@@@@@@@
@@@@@@@@@@@@@@@@@@@@@@@@@@@@@@@@@@@@@@@@@@@@@@@@@@@@@@@@@@@@@@@@@@@@@@@@@@@@@@@@@@@@@@@@@@@@@@@@@@@@@@@@@@@@
@@@@@@@@@@@@@@@@@@@@@@@@@@@@@@@@@@@@@@@@@@@@@@@@@@@@@@@@@@@@@@@@@@@@@@@@@@@@@@@@@@@@@@@@@@@@@@@@@@@@@@@@@@@@
@@@@@@@@@@@@@@@@@@@@@@@@@@@@@@@@@@@@@@@@@@@@@@@@@@@@@@@@@@@@@@@@@@@@@@@@@@@@@@@@@@@@@@@@@@@@@@@@@@@@@@@@@@@@
@@@@@@@@@@@@@@@@@@@@@@@@@@@@@@@@@@@@@@@@@@@@@@@@@@@@@@@@@@@@@@@@@@@@@@@@@@@@@@@@@@@@@@@@@@@@@@@@@@@@@@@@@@@@
@@@@@@@@@@@@@@@@@@@@@@@@@@@@@@@@@@@@@@@@@@@@@@@@@@@@@@@@@@@@@@@@@..@@@@@@@@@@@@@@@@@@@@@@@@@@@@@@@@@@@@@@@@@
@@@@@@@@@@@@@@@@@@@@@@@@@@@@@@@@@@@@@@@@@@@@@@@@@@@@@@@@@@@@@@@@@...@@@@@@@@@@@@@@@@@@@@@@@@@@@@@@@@@@@@@@@@
@@@@@@@@@@@@@@@@@@@@@@@@@@@@@@@@@@@@@@@@@@@@@@@@@@@@@@@@@@@@@@@@@..T.@@@@@@@@@@@@@@@@@@@@@@@@@@@@@@@@@@@@@@@
@@@@@@@@@@@@@@@@@@@@@@@@@@@@@@@@@@@@@@@@@@@@@@@@@@@@@@@@@@@@@@@@@.T..T@@@@@@@@@@@@@@@@@@@@@@@@@@@@@@@@@@@@@@
@@@@@@@@@@@@@@@@@@@@@@@@@@@@@@@@@@@@@@@@@@@@@@@@@@@@@@@@@@@@@@@@@......@@@@@@@@@@@@@@@@@@@@@@@@@@@@@@@@@@@@@
@@@@@@@@@@@@@@@@@@@@@@@@@@@@@@@@@@@@@@@@@@@@@@@@@@@@@@@@@@@@@@@@........@@@@@@@@@@@@@@@@@@@@@@@@@@@@@@@@@@@@
@@@@@@@@@@@@@@@@@@@@@@@@@@@@@@@@@@@@@@@@@@@@@@@@@@@@@@@@@@@@@@......@@...@@@@@@@@@@@@@@@@@@@@@@@@@@@@@@@@@@@
@@@@@@@@@@@@@@@@@@@@@@@@@@@@@@@@@@@@@@@@@@@@@@@@@.@@@@@@@@@@@.T.....@@.T.@@@@@@@@@@@@@@@@@@@@@@@@@@@@@@@@@@@
@@@@@@@@@@@@@@@@@@@@@@@@@@@@@@@@@@@@@@@@@@@@@@@@T..@@@@@@.@@...@@@.T@@....@@@@@@@@@@@@@@@@@@@@@@@@@@@@@@@@@@
@@@@@@@@@@@@@@@@@@@@@@@@@@@@@@@@@@@@@@@@@@@@@@@....@@@@@T.....@@@@.@@@....@@@@@@@@@@@@@@@@@@@@@@@@@@@@@@@@@@
@@@@@@@@@@@@@@@@@@@@@@@@@@@@@@@@@@@@@@@@@@@@@@@.....@@......T.@@...@@@..T...@@@@@@@@@@@@@@@@@@@@@@@@@@@@@@@@
@@@@@@@@@@@@@@@@@@@@@@@@@@@@@@@@@@@@@@@@@@@@@@@@@.......T..@T....@@@@@@.....@@@@@@@@@@@@@@@@@@@@@@@@@@@@@@@@
@@@@@@@@@@@@@@@@@@@@@@@@@@@@@@@@@@@@@@@@@@@@@@@@@@.........@@@..@@@@@@@.....@@..@@@@@@@@@@@@@@@@@@@@@@@@@@@@
@@@@@@@@@@@@@@@@@@@@@@@@@@@@@@@@@@@@@@@@@@@@@@@@@@@.......T@@@.@@@@..............@@@@@@@@@@@@@@@@@@@@@@@@@@@
@@@@@@@@@@@@@@@@@@@@@@@@@@@@@@@@@@@@@@@@@@@@@@@@@@@@..T....@@@.@@@@............T..@@@@@@@@@@@@@@@@@@@@@@@@@@
@@@@@@@@@@@@@@@@@@@@@@@@@@@@@@@@@@@@@@@@@@@@@@@@@@@@@..T....T.T.T...T.......T.....T@@@@@@@@@@@@@@@@@@@@@@@@@
@@@@@@@@@@@@@@@@@@@@@@@@@@@@@@@@@@@@@@@@@@@@@@@@@@@@@@.....T................T.....T.@@@@@@@@@@@@@@@@@@@@@@@@
@@@@@@@@@@@@@@@@@@@@@@@@@@@@@@@@@@@@@@@@@@@@@@@@@@@@@@@@...........................@@@@@@@@@@@@@@@@@@@@@@@@@
@@@@@@@@@@@@@@@@@@@@@@@@@@@@@@@@@@@@@@@@@@@@@@@@@@@@@@@@....T.................T...@@@@@@@@@@@@@@@@@@@@@@@@@@
@@@@@@@@@@@@@@@@@@@@@@@@@@@@@@@@@@@@@@@@@@@@@@@@@@@@@@@@@.....T......T....T......@@@@@@@@@@@@@@@@@@@@@@@@@@@
@@@@@@@@@@@@@@@@@@@@@@@@@@@@@@@@@@@@@@@@@@@@@@@@@@@@@@@@@@T..........T...T......@@@@@@@@@@@@@@@@@@@@@@@@@@@@
@@@@@@@@@@@@@@@@@@@@@@@@@@@@@@@@@@@@@@@@@@@@@@@@.@@@@@@@@@@..........T.........@@@@@@@T@@@@@@@@@@@@@@@@@@@@@
@@@@@@@@@@@@@@@@@@@@@@@@@@@@@@@@@@@@@@@@@@@@@@@@.@@@@@@@@@@@@..T.........T.....@@@@@@.....@@@@@@@@@@@@@@@@@@
@@@@@@@@@@@@@@@@@@@@@@@@@@@@@@@@@@@@@@@@@@@@@@@@..@T@@@@@@@.@@..................@@@@.......@@@@@@@@@@@@@@@@@
@@@@@@@@@@@@@@@@@@@@@@@@@@@@@@@@@@@@@@@@@@@@@.......@@..@@...@@..................@.T....T..@@@@@@@@@@@@@@@@@
@@@@@@@@@@@@@@@@@@@@@@@@@@@@@@@@@@@@@@@@@@@@@..........@@.....@@.T.T....T..................@@@@@@@@@@@@@@@@@
@@@@@@@@@@@@@@@@@@@@@@@@@@@@@@@@@@@@@@@@@@@@.T......T.@@.T....@@@........T.....T...........@@@@@@@@@@@@@@@@@
@@@@@@@@@@@@@@@@@@@@@@@@@@@@@@@@@@@@@@@@@@.T........T@@......@@@@..................T.......T.@@@@@@@@@@@@@@@
@@@@@@@@@@@@@@@@@@@@@@@@@@@@@@@@@@@@@@@@@...........@@......@@@@@....................T......@@@@.@@@@@@@@@@@
@@@@@@@@@@@@@@@@@@@@@@@@@@@@@@@@@@@@@@@@T.........T@@......@@@@@@...T..T.T...........T....TT..@@..@@@@@@@@@@
@@@@@@@@@@@@@@@@@@@@@@@@@@@@@@@@@@@@@@@....T...T...@..T...@@@@@@@...............T.....@@@...T......@@@@@@@@@
@@@@@@@@@@@@@@@@@@@@@@@@@@@@@@@@@@@@@@......T......@.T.T.@@@@@@@@..............T......@@@...........@@@@@@@@
@@@@@@@@@@@@@@@@@@@@@@@@@@@@@@@@@@@@@@@............@....@@@@@@@@@..T........T....T....@@@.@....T..@..@@@@@@@
@@@@@@@@@@@@@@@@@@@@@@@@@@@@@@@@@@@@@@@@T.........T....@@@@@@@@@T..T.T.@@.............@@..@@T...@@@@..@@@@@@
@@@@@@@@@@@@@@@@@@@@@@@@@@@@@@@@@@@@@@@@.T.......T....@@@@@@@........T@@@@...........@@@.@@...@@@@@@@@@@@@@@
@@@@@@@@@@@@@@@@@@@@@@@@@@@@@@@@@@@@@@@@.....T..T.....@@@@@@.TT......@@.@@@....TT....@@@.@@T..@@@@@@@@@@@@@@
@@@@@@@@@@@@@@@@@@@@@@@@@@@@@@@@@@@@@@@@T.......@@....@@@@@.........@@T..@@@TT.......@@@.@@...@@@@@@@@@@@@@@
@@@@@@@@@@@@@@@@@@@@@@@@@@@@@@@@@@@@@@.........@@@@..T@@@@@...T...T@@.....@@......T...@@........@@....@...@@
@@@@@@@@@@@@@@@@@@@@@@@@@@@@@@@@@@@@..........T@@@@@T.@@@@........@@.....@@@@...T.....@@@....T...........T@@
@@@@@@@@@@@@@@@@@@@@@@@@@@@@@@@@@@@............T@@@@..@@.......TT@@..T..@@@@@@....T...@@@................@@@
@@@@@@@@@@@@@@@@@@@@@@@@@@@@@@@@@@@TT............@@@...@T.......@@.....@@@@@@@@T..........T.....T......T@@@@
@@@@@@@@@@@@@@@@@@@@@@@@@@..@@@@@@@@.........T....@@@.....T....@@.T...@@@@@@@@@@..T.................T..@@@@@
@@@@@@@@@@@@@@@@@@@@.........@@@@@@@@.............T@@..........@.....@@@@@@@@@@@....T............T....@@@@@@
@@@@@@@@@@@@@@@@@@@...........@@@@@@@@..T......................@....@@@@@@@@@@@@..........T..........@@@@@@@
@@@@@@@@@@@@@@@@@@T....@@@T...T@@@@@@@@......TT....T..T..T......T..@@@@@@@@@@@@@.........T...T.T....@@@@@@@@
@@@@@@@@@@@@@@@@@.....@@@@@.....@@@@@@@@....T......T..T.....T.....@@@@@@@@@@@@@@...................@@@@@@@@@
@@@@@@@@@@@@@@@@@....@@@@@@@.....@@@@@@@@T.....TT.................@@@@@@.T@@@@..............T...T.@@@@@@@@@@
@@@@@@@@@@@@@@@@@@...@@@@@@@@.....@@@@@@@@............T.....@@....@@@@@@..T@@...........T.T......@@@@@@@@@@@
@@@@@@@@@@@@@@@@@@@...@@@@@@@@.....@@@@@@@@.....T........TT.@@@...@@@@@........@@@..........T...@@@@@@@@@@@@
@@@@@@@@@@@@@@@@@@....@@@@@@@@@.....@@@@@@@..T.....TT.TT....@@@@..@@@@@T......@@@@@.......T....@@@@@@@@@@@@@
@@@@@@@@@@@@@@@@@@...T.@@@@@@@@......@@@@@@......T...........@@@..@@@@T.......@@@@@@.........T@@@@@@@@@@@@@@
@@@@@@@@@@@@@@@@@@@.....@@@@@@@.......@@@@@@..................@@@.T@T.........@@@@@@.........@@@@@@@@@@@@@@@
@@@@@@@@@@@@@@@@@@@@.....@@@@@@T.T.....@@@@@...........TT...T..@@..@.TT....TT.@@@@@@....T.TT@@@@@@@@@@@@@@@@
@@@@@@@@@@@@@@@@@@@@@....@@@T...........@@@.T.T..T.....T..T....@@.............@@@@@........@@@@@@@@@@@@@@@@@
@@@@@@@@@@@@@@@@@@@@@@...T.T.......T....@@....T..............T..@............T.T.T..T.....@@@@@@@@@@@@@@@@@@
@@@@@@@@@.@@@@.@@@@@@@@.................@.T...T......T...T....T..........................@@@@@@@@@@@@@@@@@@@
@@@@@@@@T..@@...@@@@@@@@........@@@@.........T...........................T..T...........@@@@@@@@@@@@@@@@@@@@
@@@@@@@....@@..T@@@@@@@@@......@@@@@@.....T.......@@.....................T.............@@@@@@@@@@@@@@@@@@@@@
@@@@@@T..........@@@@@@@@@....@@@@@@@.....T..T..TT@@@@.....T.T..........T..@@.........@@@@@@@@@@@@@@@@@@@@@@
@@@@@@@@....T.....@@@@@@@@@..@@@@@@@....T.........@@@@@..................T@@@@T......@@@@@@@@@@@@@@@@@@@@@@@
@@@@@@@@@........T..T@@@@@@@@@@@@@@.T....T.....TT@@@@@@@.........T.......@@@@@@.T.T.@@@@@@@@@@@@@@@@@@@@@@@@
@@.@@@@@@....T.T.T....@@@@@@@@@@@@..T............@@@@@@@@.....T......T..@@@@@@....T@@@@@@@@@@@@@@@@@@@@@@@@@
@@.T@@@@...............@@@@@@@@@@.....T..........@@@@@@@@@........T....@@@@@@.....@@@@@@@@@@@@@@@@@@@@@@@@@@
@@....T....T..T........T@@@@@@@@T...........T.TT.@@@@@@@@@@..T........@@@@@@.T...@@@@@@@@@@@@@@@@@@@@@@@@@@@
@@......T..........T..T..@@@@@@@.TTT...........T....@@@@@@@@.......T.@@@@@@.T...@@@@@@@@@@@@@@@@@@@@@@@@@@@@
@@T................T.T...@@@@@.@........@@@@@..T....T@@@@@@@@.......@@@@@@..T..@@@@@@@@@@@@@@@@@@@@@@@@@@@@@
@@..........T............@@@@......T...@@@@@@@........@@@@@@@@....TT@@@@@....@@@@@@@@@@@@@@@@@@@@@@@@@@@@@@@
@@@...............T.....T@@@..........@@@@@@@@.....T.@@@@@@@@@@...T.@@@@..T.@@@@@@@@@@@@@@@@@@@@@@@@@@@@@@@@
@@@@..T..............T...@@T...T.....@@@@@@@@..........@@@@@@@@@.....@@.T.T@@@@@@@@@@@@@@@@@@@@@@@@@@@@@@@@@
@@@@@.......T.....@@@....@.T........@@@@@@@@..T..T.....T@@@@@@@@@..T....T.@@@@@@@@@@@@@@@@@@@@@@@@@@@@@@@@@@
@@@@@@.....T.....@@@@@.......T.....@@@@@@@@..............@@@@@@@@@.......@@@@@@@@@@@@@@@@@@@@@@@@@@@@@@@@@@@
@@@@@@@...T.T...@@@@@@....T....T..@@@@@@@@........@..T...@@@@@@@@@@.....@@@@@@@@@@@@@@@@@@@@@@@@@@@@@@@@@@@@
@@@@@@@@T......@@@@@@@.....T......@@@@@@@.T......@@@@@......@@@@@@@@...@@@@@@@@@@@@@@@@@@@@@@@@@@@@@@@@@@@@@
@@@@@@@@@...T.@@@@@@@@.........T..@@@@@@@@.T.T...@@@@@@@.....@@@@@@@@.@@@@@@@@@@@@@@@@@@@@@@@@@@@@@@@@@@@@@@
@@@@@@@@@@T..@@@@@@@@T............@@@@@@@@@T....T.@@@@@@......@@@@@@@@@@@@@@@@@@@@@@@@@@@@@@@@@@@@@@@@@@@@@@
@@@@@@@@@@@.@@@@@@@@..............@@@@@@@@@@.....@@@@@@@.T.....@@@@@@@@@@@@@@@@@@@@@@@@@@@@@@@@@@@@@@@@@@@@@
@@@@@@@@@@@@@@@@@@@...............@@@@@@@@@@@.T..@@@@.........TT@@@@@@@@@@@@@@@@@@@@@@@@@@@@@@@@@@@@@@@@@@@@
@@@@@@@@@@@@@@@@@@...T......T.....@@@@@@@@@@@@....@T.T.........T.@@@@@@@@@@@@@@@@@@@@@@@@@@@@@@@@@@@@@@@@@@@
@@@@@@@@@@@@@@@@@..............T.......@@@@@@@@..T.....T........@@@@@@@@@@@@@@@@@@@@@@@@@@@@@@@@@@@@@@@@@@@@
@@@@@@@@@@@@@@@@..........@@@.....T...@@@@@@@@@@T..T...........@@@@@@@@@@@@@@@@@@@@@@@@@@@@@@@@@@@@@@@@@@@@@
@@@@@@@@@@@@@@@@..T...T.T@@@@@.......T@@@@@@@@@@@...T........T@@@@@@@@@@@@@@@@@@@@@@@@@@@@@@@@@@@@@@@@@@@@@@
@@@@@@@@@@@@@@@@@...T...@@@@@@@T.....T.T...@@@@@@@.........T.@@@@@@@@@@@@@@@@@@@@@@@@@@@@@@@@@@@@@@@@@@@@@@@
@@@@@@@@@@@@@@@@@@.....@@@@@@@....T.......@@@@@@@@@....T....@@@@@@@@@@@@@@@@@@@@@@@@@@@@@@@@@@@@@@@@@@@@@@@@
@@@@@@@@@@@@@@@@@@@T..@@@@@@@...T....T..T@@@@@@@@@@@.......@@@@@@@@@@@@@@@@@@@@@@@@@@@@@@@@@@@@@@@@@@@@@@@@@
@@@@@@@@@@@@@@@@@@@@.@@@@@@@....T......@@@@@@@@@@@@@@.....@@@@@@@@@@@@@@@@@@@@@@@@@@@@@@@@@@@@@@@@@@@@@@@@@@
@@@@@@@@@@@@@@@@@@@@@@@@@@@T.T........T.@@@@@@@@@@@@@@...@@@@@@@@@@@@@@@@@@@@@@@@@@@@@@@@@@@@@@@@@@@@@@@@@@@
@@@@@@@@@@@@@@@@@@@@@@@@@@...............@@@..@@@@@@@@@.@@@@@@@@@@@@@@@@@@@@@@@@@@@@@@@@@@@@@@@@@@@@@@@@@@@@
@@@@@@@@@@@@@@@@@@@@@@@@@.................@.....@@@@@@@@@@@@@@@@@@@@@@@@@@@@@@@@@@@@@@@@@@@@@@@@@@@@@@@@@@@@
@@@@@@@@@@@@@@@@@@@@@@@@.....................T..T@@@@@@@@@@@@@@@@@@@@@@@@@@@@@@@@@@@@@@@@@@@@@@@@@@@@@@@@@@@
@@@@@@@@@@@@@@@@@@@@@@@@@.........................@@@@@@@@@@@@@@@@@@@@@@@@@@@@@@@@@@@@@@@@@@@@@@@@@@@@@@@@@@
@@@@@@@@@@@@@@@@@@@@@@@@@@.....T.........T.T......T@@@@@@@@@@@@@@@@@@@@@@@@@@@@@@@@@@@@@@@@@@@@@@@@@@@@@@@@@
@@@@@@@@@@@@@@@@@@@@@@@@@@@........................@@@@@@@@@@@@@@@@@@@@@@@@@@@@@@@@@@@@@@@@@@@@@@@@@@@@@@@@@
@@@@@@@@@@@@@@@@@@@@@@@@@@@@.......T.T............@@@@@@@@@@@@@@@@@@@@@@@@@@@@@@@@@@@@@@@@@@@@@@@@@@@@@@@@@@
@@@@@@@@@@@@@@@@@@@@@@@@@@@@@....................@@@@@@@@@@@@@@@@@@@@@@@@@@@@@@@@@@@@@@@@@@@@@@@@@@@@@@@@@@@
@@@@@@@@@@@@@@@@@@@@@@@@@@@@@@.T..........T.....@@@@@@@@@@@@@@@@@@@@@@@@@@@@@@@@@@@@@@@@@@@@@@@@@@@@@@@@@@@@
@@@@@@@@@@@@@@@@@@@@@@@@@@@@@@@................@@@@@@@@@@@@@@@@@@@@@@@@@@@@@@@@@@@@@@@@@@@@@@@@@@@@@@@@@@@@@
@@@@@@@@@@@@@@@@@@@@@@@@@@@@@@@@..T...........@@@@@@@@@@@@@@@@@@@@@@@@@@@@@@@@@@@@@@@@@@@@@@@@@@@@@@@@@@@@@@
@@@@@@@@@@@@@@@@@@@@@@@@@@@@@@@@@..........T.@@@@@@@@@@@@@@@@@@@@@@@@@@@@@@@@@@@@@@@@@@@@@@@@@@@@@@@@@@@@@@@
@@@@@@@@@@@@@@@@@@@@@@@@@@@@@@@@@@...TT.....@@@@@@@@@@@@@@@@@@@@@@@@@@@@@@@@@@@@@@@@@@@@@@@@@@@@@@@@@@@@@@@@
@@@@@@@@@@@@@@@@@@@@@@@@@@@@@@@@@@@........@@@@@@@@@@@@@@@@@@@@@@@@@@@@@@@@@@@@@@@@@@@@@@@@@@@@@@@@@@@@@@@@@
@@@@@@@@@@@@@@@@@@@@@@@@@@@@@@@@@@@@T.....@@@@@@@@@@@@@@@@@@@@@@@@@@@@@@@@@@@@@@@@@@@@@@@@@@@@@@@@@@@@@@@@@@
@@@@@@@@@@@@@@@@@@@@@@@@@@@@@@@@@@@@@....@@@@@@@@@@@@@@@@@@@@@@@@@@@@@@@@@@@@@@@@@@@@@@@@@@@@@@@@@@@@@@@@@@@
@@@@@@@@@@@@@@@@@@@@@@@@@@@@@@@@@@@@@@..@@@@@@@@@@@@@@@@@@@@@@@@@@@@@@@@@@@@@@@@@@@@@@@@@@@@@@@@@@@@@@@@@@@@
@@@@@@@@@@@@@@@@@@@@@@@@@@@@@@@@@@@@@@@@@@@@@@@@@@@@@@@@@@@@@@@@@@@@@@@@@@@@@@@@@@@@@@@@@@@@@@@@@@@@@@@@@@@@
