type octile
height 86
width 80
map
@@@@@@@@@@@@@@@@@@@@@@@@@@@@@@@@@@@@@@@@@@@@@@@@@@@@@@@@@@@@@@@@@@@@@@@@@@@@@@@@
@@@@@@@@@@@@@@@@@@@@@@@@@@@@@@@@@@@@@@@@@@@@@@@@@@@@@@@@@@@@@@@@@@@@@@@@@@@@@@@@
@@@@@@@@@@@@@@@@@@@@@@@@@@@@@@@@@@@@@@@@@@@@@@@@@@@@@@@@@@@@@@@@@@@@@@@@@@@@@@@@
@@@@@@@@@@@@@@@@@@@@@@@@@@@@@@@@@@@@@@@@@@@@@@@@@@@@@@@@@@@@@@@@@@@@@@@@@@@@@@@@
@@@@@@@@@@@@@@@@@@@@@@@@@@@@@@@@@@@@@@@@@@@@@@@@@@@@@@@@@@@@@@@@@@@@@@@@@@@@@@@@
@@@@@@@@@@@@@@@@@@@@@@@@@@@@@@@@@@@@@@@@@@@@@@@@@@@@@@@@@@@@@@@@@@@@@@@@@@@@@@@@
@@@@@@@@@@@@@@@@@@@@@@@@@@@@@@@@@@@@@@@@@@@@@@@@@@@@@@@@@@@@@@@@@@@@@@@@@@@@@@@@
@@@@@@@@@@@@@@@@@@@@@@@@@@@@@@@@@@@@@@@@@@@@@@@@@@@@@@@@@@@@@@@@@@@@@@@@@@@@@@@@
@@@@@@@@@@@@@@@@@@@@@@@@@@@@@@@@@@@@@@@@@@@@@@@@@@@@@@@@@@@@@@@@@@@@@@@@@@@@@@@@
@@@@@@@@@@@@@@@@@@@@@@@@@@@@@@@@@@@@@@@@@@@@@@@@@@@@@@@@@@@@@@@@@@@@@@@@@@@@@@@@
@@@@@@@@@@@@@@@@@@@@@@@@@@@@@@@@@@@@@@@@@@@@@@@@@@@@@@@@@@@@@@@@@@@@@@@@@@@@@@@@
@@@@@@@@@@@@@@@@@@@@@@@@@@@@@@@@@@@@@@@@@@@@@@@@@@@@@@@@@@@@@@@@@@@@@@@@@@@@@@@@
@@@@@@@@@@@@@@@@@@@@@@@@@@@@@@@@@@@@@@@@@@@@@@@@@@@@@@@@@@@@@@@@@@@@@@@@@@@@@@@@
@@@@@@@@@@@@@@@@@@@@@@@@@@@@@@@@@@@@@@@@@@@@@@@@@@@@@@@@@@@@@@@@@@@@@@@@@@@@@@@@
@@@@@@@@@@@@@@@@@@@@@@@@@@@@@@@@@@@@@@@@@.@@@@@@@@@...@@@@@@@@@@@@@@@@@@@@@@@@@@
@@@@@@@@@@@@@@@@@@@@@@@@@@@@@@@@@@@@@@@@....@@@@@@.....@@@@@@@@@@@@@@@@@@@@@@@@@
@@@@@@@@@@@@@@@@@@@@@@@@@@@@@@@@@@@@@@@......@@@@......@@@@@@@@@@@@@@@@@@@@@@@@@
@@@@@@@@@@@@@@@@@@@@@@@@@@@@@@@@@@@@@@@.......@@@..TT.@@@@@@@@@@@@@@@@@@@@@@@@@@
@@@@@@@@@@@@@@@@@@@@@@@@@@@@@@@@@@@@@@@@....T@@@@T...@@@@@@@@@@@@@@@@@@@@@@@@@@@
@@@@@@@@@@@@@@@@@@@@@@@@@@@@@@@@@@@@@@@......@@@@...@@@@@@@@@@@@@@@@@@@@@@@@@@@@
@@@@@@@@@@@@@@@@@@@@@@@@@@@@@@@@@@@@@@..............@@@@@@@T@@@@@@@@@@@@@@@@@@@@
@@@@@@@@@@@@@@@@@@@@@@@@@@@@@@@@@@@@@.....T....T...@@@@@@@...@@@@@@@@@@@@@@@@@@@
@@@@@@@@@@@@@@@@@@@@@@@@@@@@@@@@@@@@.............@@@@@@@@.T...@@@@@@@@@@@@@@@@@@
@@@@@@@@@@@@@@@@@@@@@@@@@@@@@@@@@@@@@........TTT..@@@@@..T...@@@@@@@@@@@@@@@@@@@
@@@@@@@@@@@@@@@@@@@@@@@@@@@@@@@@@@@@@@TT.T.........@@..T....@@@@@@@@@@@@@@@@@@@@
@@@@@@@@@@@@@@@@@@@@@@@@@@@@@@@@@@@@@@@........T...........@@@@@@@@@@@@@@@@@@@@@
@@@@@@@@@@@@@@@@@@@@@@@@@@@@@.T.@@@@@@@@..................@@@@@@@@@@@@@@@@@@@@@@
@@@@@@@@@@@@@@@@@@@@@@@@@@@@@....@@@@@@@@...T.........T..@@@@@@@@@@@@@@@@@@@@@@@
@@@@@@@@@@@@@@@@@@@@@@@@@@@@@....@@@@@@@@@...............@@@@@@....T.@@@@@@@@@@@
@@@@@@@@@@@@@@@@@@@@@@@@@@@@@@@...@@@@@@@@@...............@@@@@......T@@@@@@@@@@
@@@@@@@@@@@@@@@@@@@@@@@@@@@@@@@@..T@@..@@@@@TT.........T..T@@.........@@@@@@@@@@
@@@@@@@@@@@@@@@@@@@@@@@@.@@@@@@@@.......@@@@@.T............@@........@@@@@@@@@@@
@@@@@@@@@@@@@@@@@@@@@@@T..@@@@@@@.T.......@@@@......T...........T...@@@@@@@@@@@@
@@@@@@@@@@@@@@@@@@@@@@.....@@@@@.........@@@@@.....................@@@@@@@@@@@@@
@@@@@@@@@@@@@@@@@@@@@....T..@@@T........@@@@@....T................@@@@@@...@@@@@
@@@@@@@@@@@@@@@@@@@@...T........T......@@@@@.............TT......@@@@@@......@@@
@@@@@@@@@@@@@@@@@@@..............TT...@@@@@.............T..T..T..@@@@@.....T.@@@
@@@@@@@@@@@@@@@@@@@@.................@@@@@......T..@......T.......@@@........@@@
@@@@@@@@@@@@@@@@@@@@@.T.......T......@@@@......T..@@@.........T..............@@@
@@@@@@@@@@@@@@@@@@@@@@.T........T..TT@@@......T..@@@@@....T.....T.T.........@@@@
@@@@@@@@@@@@@@@@@@@@@@@..T.......@T...@...T.....@@@@@@@..T...T..@@....T....@@@@@
@@@@@@@@@@@@@@@@@@@@@@@@....TT..@@@............@@@@@@@@@.T....T@@.........@@@@@@
@@@@@@@@@@@@@@@@@@@@@@@@@.....T@@@@@..........@@@@@@@@@@@.....@@.........@@@@@@@
@@@@@@@@@@@@@@@@@@.@@@@@@@....@@@@@@...T..T..@@@@@@.@@@@@@..T@@..T......@@@@@@@@
@@@@@@@@@@T@@@@@@@..@@@@@@@..@@@@@@.......T.@@@@@@@..@@@@@@.@@.......T.@@@@@@@@@
@@@@@@@@@...@@@@....T@@@@@@@@@@@@@..........@@@....T..@@@@@@@..T.T....@@@@@@@@@@
@@@@@@@@.T..T.@...T.T.@@@@@@@@@@@..........T.@TT.T..@..@@@@@@........@@@@@@@@@@@
@@@@@@@....TT........T.@@@@@@@@@..T.....@@......@@@@@...@@@@@@......@@@@@@@@@@@@
@@@@@@.................T@@@@@@@........@@@@....@@@@@@....@@@@@@...T@@@@@@@@@@@@@
@@@@@..TT..@.............@@@@@.T......@@@@@T...@@@@@@.....@@@@@@.T@@@@@@@@@@@@@@
@@@@......@@@...T.T.....@@@@@..T.....@@@@@@....@@@@@@...T..@@@@@@@@@@@@@@@@@@@@@
@@@....T.@@@@@...T.....@@@@@........@@@@@@@@...@@@@@@.......@@@@@@@@@@@@@@@@@@@@
@@T...@@@@@@@@........@@@@@T.......@@@@@@@@...@@@@@@@..TT....@@@@@@@@@@@@@@@@@@@
@@...@@@.@@@@@........@@@@@.......@@@@@@@@...T@@@@@@..........@@@@@@@@@@@@@@@@@@
@@@.@@@...@@@........T.@.T.......@@@@@@@@.....@@@@@..........@@@@@@@@@@@@@@@@@@@
@@@@@@...T....T...@@.......T....@@@@@@@@.......@........T...@@@@@@@@@@@@@@@@@@@@
@@@@@............@@@@..........@@@@@@@@@@T.................@@@@@@@@@@@@@@@@@@@@@
@@@@@@.....T....@@@@@.........@@@@@@@@@@@@...T...T........@@@@@@@@@@@@@@@@@@@@@@
@@@@@@@........@@@@@..T......@@@@@@@@@@@@@@.......T......@@@@@@@@@@@@@@@@@@@@@@@
@@@@@@@@.T....@@@@@..........@@@..@@...@@@@@..T.........@@@@@@@@@@@@@@@@@@@@@@@@
@@@@@@@@@....@@@@@...........@@.T.T.....@@@@@..........@@@@@@@@@@@@@@@@@@@@@@@@@
@@@@@@@@@@..@@@@@.........T.........T...@@@@@@......T.@@@@@@@@@@@@@@@@@@@@@@@@@@
@@@@@@@@@@@@@@@@......T.@@.......@.T....@@@@@@@......@@@@@@@@@@@@@@@@@@@@@@@@@@@
@@@@@@@@@@@@@@@.....T..@@@@..T.@@@@.....T@@@@@@@....@@@@@@@@@@@@@@@@@@@@@@@@@@@@
@@@@@@@@@@@@@@........@@@@@...@@@@@@....T.@.@@@@@..@@@@@@@@@@@@@@@@@@@@@@@@@@@@@
@@@@@@@@@@@@@@@......@@@@@..T@@@@@@@@...T.T..@@@@@@@@@@@@@@@@@@@@@@@@@@@@@@@@@@@
@@@@@@@@@@@@@@@@....@@@@@....@@@@@@@@.......T.@@@@@@@@@@@@@@@@@@@@@@@@@@@@@@@@@@
@@@@@@@@@@@@@@@@@..@@@@@...T.@@@@@@@.......T.T.@@@@@@@@@@@@@@@@@@@@@@@@@@@@@@@@@
@@@@@@@@@@@@@@@@@@@@@@@.....@@@@@@@@...........@@@@@@@@@@@@@@@@@@@@@@@@@@@@@@@@@
@@@@@@@@@@@@@@@@@@@@@@......@@@@@@@....T......@@@@@@@@@@@@@@@@@@@@@@@@@@@@@@@@@@
@@@@@@@@@@@@@@@@@@@@@.....T.@@@@@@....TT.....@@@@@@@@@@@@@@@@@@@@@@@@@@@@@@@@@@@
@@@@@@@@@@@@@@@@@@@@@.......@@@@............@@@@@@@@@@@@@@@@@@@@@@@@@@@@@@@@@@@@
@@@@@@@@@@@@@@@@@@@@@@...T...........T.....@@@@@@@@@@@@@@@@@@@@@@@@@@@@@@@@@@@@@
@@@@@@@@@@@@@@@@@@@@@@@...............T...@@@@@@@@@@@@@@@@@@@@@@@@@@@@@@@@@@@@@@
@@@@@@@@@@@@@@@@@@@@@@@@..............T..@@@@@@@@@@@@@@@@@@@@@@@@@@@@@@@@@@@@@@@
@@@@@@@@@@@@@@@@@@@@@@@@@...............@@@@@@@@@@@@@@@@@@@@@@@@@@@@@@@@@@@@@@@@
@@@@@@@@@@@@@@@@@@@@@@@@@@T....T.......@@@@@@@@@@@@@@@@@@@@@@@@@@@@@@@@@@@@@@@@@
@@@@@@@@@@@@@@@@@@@@@@@@@@@..........T@@@@@@@@@@@@@@@@@@@@@@@@@@@@@@@@@@@@@@@@@@
@@@@@@@@@@@@@@@@@@@@@@@@@@@@T.T.T....@@@@@@@@@@@@@@@@@@@@@@@@@@@@@@@@@@@@@@@@@@@
@@@@@@@@@@@@@@@@@@@@@@@@@@@@@......@@@@@@@@@@@@@@@@@@@@@@@@@@@@@@@@@@@@@@@@@@@@@
@@@@@@@@@@@@@@@@@@@@@@@@@@@@@@...@@@@@@@@@@@@@@@@@@@@@@@@@@@@@@@@@@@@@@@@@@@@@@@
@@@@@@@@@@@@@@@@@@@@@@@@@@@@@@@@@@@@@@@@@@@@@@@@@@@@@@@@@@@@@@@@@@@@@@@@@@@@@@@@
@@@@@@@@@@@@@@@@@@@@@@@@@@@@@@@@@@@@@@@@@@@@@@@@@@@@@@@@@@@@@@@@@@@@@@@@@@@@@@@@
@@@@@@@@@@@@@@@@@@@@@@@@@@@@@@@@@@@@@@@@@@@@@@@@@@@@@@@@@@@@@@@@@@@@@@@@@@@@@@@@
@@@@@@@@@@@@@@@@@@@@@@@@@@@@@@@@@@@@@@@@@@@@@@@@@@@@@@@@@@@@@@@@@@@@@@@@@@@@@@@@
@@@@@@@@@@@@@@@@@@@@@@@@@@@@@@@@@@@@@@@@@@@@@@@@@@@@@@@@@@@@@@@@@@@@@@@@@@@@@@@@
