type octile
height 64
width 60
map
@@@@@@@@@@@@@@@@@@@@@@@@@@@@@@@@@@@@@@@@@@@@@@@@@@@@@@@@@@@@
@@@@@@@@@@@@@@@@@@@@@@@@@@@@@@@@@@@@@@@@@@@@@@@@@@@@@@@@@@@@
@@@@@@@@@@@@@@@@@@@@@@@@@@@@@@@@@@@@@@@@@@@@@@@@@@@@@@@@@@@@
@@@@@@@@@@@@@@@@@@@@@@@@@@@@@@@@@@@@@@@@@@@@@@@@@@@@@@@@@@@@
@@@@@@@@@@@@@@@@@@@@@@@@@@@@@@@@@@@@@@@@@@@@@@@@@@@@@@@@@@@@
@@@@@@@@@@@@@@@@@@@@@@@@@@@@@@@@@@@@@@@@@@@@@@@@@@@@@@@@@@@@
@@@@@@@@@@@@@@@@@@@@@@@@@@@@@@@@@@@@@@@@@@@@@@@@@@@@@@@@@@@@
@@@@@@@@@@@@@@@@@@@@@@@@@@@@@@@@@@@@@@@@@@@@@@@@@@@@@@@@@@@@
@@@@@@@@@@@@@@@@@@@@@@@@@@@@@@@@@@@@@@@@@@@@@@@@@@@@@@@@@@@@
@@@@@@@@@@@@@@@@@@@@@@@@@@@@@@@@@@@@@@@@@@@@@@@@@@@@@@@@@@@@
@@@@@@@@@@@@@@@@@@@@@@@@@@@@@@@@@@@@@@@@@@@@@@@@@@@@@@@@@@@@
@@@@@@@@@@@@@@@@@@@@@@@@@@@@@@@@@@@@@@@@@@@@@@@@@@@@@@@@@@@@
@@@@@@@@@@@@@@@@@@@@@@@@@@@@@@@@@@@@@@@@@@@@@@@@@@@@@@@@@@@@
@@@@@@@@@@@@@@@@@@@@@@@@@@@@@@@@@@@@@...@@@@@@@@@@@@@@@@@@@@
@@@@@@@@@@@@@@@@@@@@@@@@@@@@@@@@@@@@@@@T.@@@@@@@@@@@@@@@@@@@
@@@@@@@@@@@@@@@@@@@@@@@@@@@@@@@@@@.@@@@@..@@@@@@@@@@@@@@@@@@
@@@@@@@@@@@@@@@@@@@@@@@@@@@@@@@@@.T.@@@@@..@@@@@@@@@@@@@@@@@
@@@@@@@@@@@@@@@@@@@@@@@@@@@@@@@@..T..@@@@@..@@@@@@@@@@@@@@@@
@@@@@@@@@@@@@@@@@@@@@@@@@@@@@@@....T.@@@@@...@@@@@@@@@@@@@@@
@@@@@@@@@@@@@@@@@@@@@@@@@@@@@@@@@T..T@@@@T.....T@@@@@@@@@@@@
@@@@@@@@@@@@@@@@@@@@@@@@@@@@@@@@@.T..T........@T.@@@@@@@@@@@
@@@@@@@@@@@@@@@@@@@@@@@@@@@@@@@....T.........@@@..@@@@@@@@@@
@@@@@@@@@@@@@@@@@@@@@@@@@@@@@@TTT.T.....T...@@@..TT@@@@@@@@@
@@@@@@@@@@@@@@@@@@@@@@@@@@@@@TT.T...T...T..@@@@@..T.@@@@@@@@
@@@@@@@@@@@@@@@@@@@@@@@@@@..@@..........T..@@@@@@@@.T@@@@@@@
@@@@@@@@@@@@@@@@@@@@@@@.@@T@@@....T.......@@@@@@@@@...@@@@@@
@@@@@@@@@@@@@@@@@@@@@@@..T...TT....T....T.@@@T@@.......@@@@@
@@@@@@@@@@@@@@@@@@@@@@...T....TT.T.@@@.........T.T..T..T@@@@
@@@@@@@@@@@@@@@@@@@@....T..T..TTTT.@@@..TT..............@@@@
@@@@@@@@@@@@@@@@@@@...T.T.T....T.T......T....TTTTT.T...@@@@@
@@@@@@@@@@@@@@@@@@.T..T@@......T..T........T...T.T....@@@@@@
@@@@@@@@@@@@@@@@@...T.@@@@..@@.....T..T.TTT.T...T.T..@@@@@@@
@@@@@@@@@@@@@@@@@..T.@@@@@@@@@....T.....T...T....T..@@@@@@@@
@@@@@@@@@@@@@@@@T..@@@@@@@@@..T....T..T...TT..T....@@@@@@@@@
@@@@@@@@@@@@@@@...@@@@@@@@@@@..@@...T.T.T.TTTT....@@@@@@@@@@
@@@@@@@@@@@@@@..T..@@@@@@@@@@@@@@...TT.....TTT.T.@@@@@@@@@@@
@@@@@@@@@@@@@..TTT.@@@@@@@@@@@@...T..TT..T.T....@@@@@@@@@@@@
@@@@@@@@@@@....T.T..@..@@@@@@@@@.T..T..T.T.T.T.@@@@@@@@@@@@@
@@@@@@@@@@@...TTT......T@@@@@@@@@.....TTTT..T.@@@@@@@@@@@@@@
@@@@@@@@@@@@...T........@@@@@@@@@@T...TT.....@@@@@@@@@@@@@@@
@@@@@@@@@@@.T.T.T.TT.T..@@@@@@@@........TT..@@@@@@@@@@@@@@@@
@@@@@@@.@@.............@@@@@@@@T.T.....T..T@@@@@@@@@@@@@@@@@
@@@@@@.T.T.....T.....T@@@@@@@@....T.......@@@@@@@@@@@@@@@@@@
@@@@@..T...T.TT......@@@@@@@@@@.TT.......@@@@@@@@@@@@@@@@@@@
@@@@.....TT...T.TT..@@@@@@@@@@.T.T.T....@@@@@@@@@@@@@@@@@@@@
@@@@.....T...T.TT..@@@@@@@@T..T.....TT.@@@@@@@@@@@@@@@@@@@@@
@@@@@..T.T.T...T..@@@@@@@@@@T...TT..T.@@@@@@@@@@@@@@@@@@@@@@
@@@@@@...........@@@@@@@@.@T..T.T....@@@@@@@@@@@@@@@@@@@@@@@
@@@@@@@...T.....@@@@@@@@T.T.TT...T.T@@@@@@@@@@@@@@@@@@@@@@@@
@@@@@@@@.T.....@@@@@@@@.TTTT..T..T.@@@@@@@@@@@@@@@@@@@@@@@@@
@@@@@@@@@.TT.T@@@@@@@@@..TT...TT..@@@@@@@@@@@@@@@@@@@@@@@@@@
@@@@@@@@@@.....@@@@@@@.T.........@@@@@@@@@@@@@@@@@@@@@@@@@@@
@@@@@@@@@@@....T@@@@.T....T.....@@@@@@@@@@@@@@@@@@@@@@@@@@@@
@@@@@@@@@@@@T....@@.....T....TT@@@@@@@@@@@@@@@@@@@@@@@@@@@@@
@@@@@@@@@@@@@...TTT.....T.....@@@@@@@@@@@@@@@@@@@@@@@@@@@@@@
@@@@@@@@@@@@@@.T..TT...T....@@@@@@@@@@@@@@@@@@@@@@@@@@@@@@@@
@@@@@@@@@@@@@@@.T..TTT.....@@@@@@@@@@@@@@@@@@@@@@@@@@@@@@@@@
@@@@@@@@@@@@@@@@TT....T...@@@@@@@@@@@@@@@@@@@@@@@@@@@@@@@@@@
@@@@@@@@@@@@@@@@@.....T..@@@@@@@@@@@@@@@@@@@@@@@@@@@@@@@@@@@
@@@@@@@@@@@@@@@@@@@.....@@@@@@@@@@@@@@@@@@@@@@@@@@@@@@@@@@@@
@@@@@@@@@@@@@@@@@@@@.T.@@@@@@@@@@@@@@@@@@@@@@@@@@@@@@@@@@@@@
@@@@@@@@@@@@@@@@@@@@@@@@@@@@@@@@@@@@@@@@@@@@@@@@@@@@@@@@@@@@
@@@@@@@@@@@@@@@@@@@@@@@@@@@@@@@@@@@@@@@@@@@@@@@@@@@@@@@@@@@@
@@@@@@@@@@@@@@@@@@@@@@@@@@@@@@@@@@@@@@@@@@@@@@@@@@@@@@@@@@@@
