type octile
height 59
width 56
map
@@@@@@@@@@@@@@@@@@@@@@@@@@@@@@@@@@@@@@@@@@@@@@@@@@@@@@@@
@@@@@@@@@@@@@@@@@@@@@@@@@@@@@@@@@@@@@@@@@@@@@@@@@@@@@@@@
@@@@@@@@@@@@@@@@@@@@@@@@@@@@@@@@@@@@@@@@@@@@@@@@@@@@@@@@
@@@@@@@@@@@@@@@@@@@@@@@@@@@@@@@@@@@@@@@@@@@@@@@@@@@@@@@@
@@@@@@@@@@@@@@@@@@@@@@@@@@@@@@@@@@@@@@@@@@@@@@@@@@@@@@@@
@@@@@@@@@@@@@@@@@@@@@@@@@@@@@@@@@@@@@@@@@@@@@@@@@@@@@@@@
@@@@@@@@@@@@@@@@@@@@@@@@@@@@@@@@@@@@@@@@@@@@@@@@@@@@@@@@
@@@@@@@@@@@@@@@@@@@@@@@@@@@@@@@@@@@@@@@@@@@@@@@@@@@@@@@@
@@@@@@@@@@@@@@@@@@@@@@@@@@@@@@@@@@@@@@@@@@@@@@@@@@@@@@@@
@@@@@@@@@@@@@@@@@@@@@@@@@@@@@@@@@@@@@@@@@@@@@@@@@@@@@@@@
@@@@@@@@@@@@@@@@@@@@@@@@@@@@@@@@@@@@@@@@@@@@@@@@@@@@@@@@
@@@@@@@@@@@@@@@@@@@@@@@@@@@@@@@@@@@@@@@@@@@@@@@@@@@@@@@@
@@@@@@@@@@@@@@@@@@@@@@@@@@@@@@@@@@@@@@@@@@@@@@@@@@@@@@@@
@@@@@@@@@@@@@@@@@@@@@@@@@@@@@@@@.@@@@@@@@@@@@@@@@@@@@@@@
@@@@@@@@@@@@@@@@@@@@@@@@@@@@@@@......@@@@@@@@@@@@@@@@@@@
@@@@@@@@@@@@@@@@@@@@@@@@@@@@@@.......@@@@@@@@@@@@@@@@@@@
@@@@@@@@@@@@@@@@@@@@@@@@@@@@T..TT.@@@@@@@@@@@@@@@@@@@@@@
@@@@@@@@@@@@@@@@@@@@@@@@@@@.....T@@@@@.@@@@@@@@@@@@@@@@@
@@@@@@@@@@@@@@@@@@@@@@@@@@T..@@.T@@@@@.T..@@@@@@@@@@@@@@
@@@@@@@@@@@@@@@@@@@@@@@@@@..@@@T.@@@@@..T..T@@@@@@@@@@@@
@@@@@@@@@@@@@@@@@@@@@@@@@T.@@@@..@@@@@..@@TT@@@@@@@@@@@@
@@@@@@@@@@@@@@@@@@@@@@@@.T@@@T.....@@@..@@@@@@@@@@@@@@@@
@@@@@@@@@@@@@@@@@@@@@@@@T.@@@..T...T..T.@@@@@@@@@@@@@@@@
@@@@@@@@@@@@@@@@@@@@@..T...T..T...TT.TT...@@@@@@@@@@@@@@
@@@@@@@@@@@@@@@@@@@@T.T@......TT.T...T..T..@@@@@@@@@@@@@
@@@@@@@@@@@@@@@@@@@T.T@@@...TTT....T.T......@@.@@@@@@@@@
@@@@@@@@@@@@@@@@@@@@.@@@@@.TT.T.TTT.............T@@@@@@@
@@@@@@@@@@@@@@@@@@@@T@@@@@@.T.....T...TTT..T.....T.@@@@@
@@@@@@@@@@@@@@@@@@@T.@@@@@@@T....T.TTT.T.TT.T.T...T.@@@@
@@@@@@@@@@@@@@@@@....@@@@@........T.T.T.T.TT.TTT.T.T@@@@
@@@@@@@@@@@@@@@@@@@T.T.@@T.T....T........T.TT.....T@@@@@
@@@@@@@@@@@@@@@@@@@@T.T.T..T.......T...TT...T.TT..@@@@@@
@@@@@@@@@@@@@@@@@@@@......@T...T.........T....T.T@@@@@@@
@@@@@@@@@@@@@@@@@@@T.T...@@@T............TT...TT@@@@@@@@
@@@@@@@@@.@@@.T@@@.....@@@@@.......T......T....@@@@@@@@@
@@@@@@@@..@@@T..@.....T@@@@@@...T.TT.....T....@@@@@@@@@@
@@@@@@@T...@@T....T....@@@@@TT..............T@@@@@@@@@@@
@@@@@.T.T..T@..@@.T......@TT....TT.......T..@@@@@@@@@@@@
@@@@.....TT..T@@@@.TT.......TTT.T......T...@@@@@@@@@@@@@
@@@T.T........@@@@@........T.TT...........@@@@@@@@@@@@@@
@@.T.......T.TT@@@@T.......T...T.........@@@@@@@@@@@@@@@
@...T...........@@@.......T.T.TT.......T@@@@@@@@@@@@@@@@
@@T...TTTT..TT..T@.T..T.......T.......T@@@@@@@@@@@@@@@@@
@@@......TT........T....T.......T.....@@@@@@@@@@@@@@@@@@
@@@@...TT.......T.T..T..T....TTT...T.@@@@@@@@@@@@@@@@@@@
@@@@@....T.T.T..TTT......T...T..T..T@@@@@@@@@@@@@@@@@@@@
@@@@@@T..TTTTT...T...T.............@@@@@@@@@@@@@@@@@@@@@
@@@@@@@.TT.........T...T..T.......@@@@@@@@@@@@@@@@@@@@@@
@@@@@@@@....T..T..T.TT....T.....T@@@@@@@@@@@@@@@@@@@@@@@
@@@@@@@@@.........T.TT.T...T....@@@@@@@@@@@@@@@@@@@@@@@@
@@@@@@@@@@T..T...T.............@@@@@@@@@@@@@@@@@@@@@@@@@
@@@@@@@@@@@T.....T.T.T......T.@@@@@@@@@@@@@@@@@@@@@@@@@@
@@@@@@@@@@@@.TTT.....TTT..TT.@@@@@@@@@@@@@@@@@@@@@@@@@@@
@@@@@@@@@@@@@...........T.T.@@@@@@@@@@@@@@@@@@@@@@@@@@@@
@@@@@@@@@@@@@@.T...T.......@@@@@@@@@@@@@@@@@@@@@@@@@@@@@
@@@@@@@@@@@@@@@......T..T.@@@@@@@@@@@@@@@@@@@@@@@@@@@@@@
@@@@@@@@@@@@@@@@TT.TT...T@@@@@@@@@@@@@@@@@@@@@@@@@@@@@@@
@@@@@@@@@@@@@@@@@.......@@@@@@@@@@@@@@@@@@@@@@@@@@@@@@@@
@@@@@@@@@@@@@@@@@@@@@@@@@@@@@@@@@@@@@@@@@@@@@@@@@@@@@@@@
