type octile
height 118
width 120
map
@@@@@@@@@@@@@@@@@@@@@@@@@@@@@@@@@@@@@@@@@@@@@@@@@@@@@@@@@@@@@@@@@@@@@@@@@@@@@@@@@@@@@@@@@@@@@@@@@@@@@@@@@@@@@@@@@@@@@@@@
@@@@@@@@@@@@@@@@@@@@@@@@@@@@@@@@@@@@@@@@@@@@@@@@@@@@@@@@@@@@@@@@@@@@@@@@@@@@@@@@@@@@@@@@@@@@@@@@@@@@@@@@@@@@@@@@@@@@@@@@
@@@@@@@@@@@@@@@@@@@@@@@@@@@@@@@@@@@@@@@@@@@@@@@@@@@@@@@@@@@@@@@@@@@@@@@@@@@@@@@@@@@@@@@@@@@@@@@@@@@@@@@@@@@@@@@@@@@@@@@@
@@@@@@@@@@@@@@@@@@@@@@@@@@@@@@@@@@@@@@@@@@@@@@@@@@@@@@@@@@@@@@@@@@@@@@@@@@@@@@@@@@@@@@@@@@@@@@@@@@@@@@@@@@@@@@@@@@@@@@@@
@@@@@@@@@@@@@@@@@@@@@@@@@@@@@@@@@@@@@@@@@@@@@@@@@@@@@@@@@@@@@@@@@@@@@@@@@@@@@@@@@@@@@@@@@@@@@@@@@@@@@@@@@@@@@@@@@@@@@@@@
@@@@@@@@@@@@@@@@@@@@@@@@@@@@@@@@@@@@@@@@@@@@@@@@@@@@@@@@@@@@@@@@@@@@@@@@@@@@@@@@@@@@@@@@@@@@@@@@@@@@@@@@@@@@@@@@@@@@@@@@
@@@@@@@@@@@@@@@@@@@@@@@@@@@@@@@@@@@@@@@@@@@@@@@@@@@@@@@@@@@@@@@@@@@@@@@@@@@@@@@@@@@@@@@@@@@@@@@@@@@@@@@@@@@@@@@@@@@@@@@@
@@@@@@@@@@@@@@@@@@@@@@@@@@@@@@@@@@@@@@@@@@@@@@@@@@@@@@@@@@@@@@@@@@@@@@@@@@@@@@@@@@@@@@@@@@@@@@@@@@@@@@@@@@@@@@@@@@@@@@@@
@@@@@@@@@@@@@@@@@@@@@@@@@@@@@@@@@@@@@@@@@@@@@@@@@@@@@@@@@@@@@@@@@@@@@@@@@@@@@@@@@@@@@@@@@@@@@@@@@@@@@@@@@@@@@@@@@@@@@@@@
@@@@@@@@@@@@@@@@@@@@@@@@@@@@@@@@@@@@@@@@@@@@@@@@@@@@@@@@@@@@@@@@@@@@@@@@@@@@@@@@@@@@@@@@@@@@@@@@@@@@@@@@@@@@@@@@@@@@@@@@
@@@@@@@@@@@@@@@@@@@@@@@@@@@@@@@@@@@@@@@@@@@@@@@@@@@@@@@@@@@@@@@@@@@@@@@@..@@@@@@@@@@@@@@@@@@@@@@@@@@@@@@@@@@@@@@@@@@@@@@
@@@@@@@@@@@@@@@@@@@@@@@@@@@@@@@@@@@@@@@@@@@@@@@@@@@@@@@@@@@@@@@@@@@@@@@.....@@@@@@@@@@@@@@@@@@@@@@@@@@@@@@@@@@@@@@@@@@@@
@@@@@@@@@@@@@@@@@@@@@@@@@@@@@@@@@@@@@@@@@@@@@@@@@@@@@@@@@@@@@@@@@@@@@@.......@@@@@@@@@@@@@@@@@@@@@@@@@@@@@@@@@@@@@@@@@@@
@@@@@@@@@@@@@@@@@@@@@@@@@@@@@@@@@@@@@@@@@@@@@@@@@@@@@@@@@@@@@@@@@@@@...T.....T@@@@@@@@@@@@@@@@@@@@@@@@@@@@@@@@@@@@@@@@@@
@@@@@@@@@@@@@@@@@@@@@@@@@@@@@@@@@@@@@@@@@@@@@@@@@@@@@@@@@@@@@@@@@@@...T@@@.....@@@@@@@@@@@@@@@@@@@@@@@@@@@@@@@@@@@@@@@@@
@@@@@@@@@@@@@@@@@@@@@@@@@@@@@@@@@@@@@@@@@@@@@@@@@@@@@@@@@@@@@@@@@@....@@@@@...TT@@@@@@@@@@@@@@@@@@@@@@@@@@@@@@@@@@@@@@@@
@@@@@@@@@@@@@@@@@@@@@@@@@@@@@@@@@@@@@@@@@@@@@@@@@@@@@@@@@@@@@@@@@....@@@@@@@T.T..@@@@@@@@@@@@@@@@@@@@@@@@@@@@@@@@@@@@@@@
@@@@@@@@@@@@@@@@@@@@@@@@@@@@@@@@@@@@@@@@@@@@@@@@@@@@@@@@@@@@@@@@..TT@@@@@@@@@T..T.@@@@@@@@@@@@@@@@@@@@@@@@@@@@@@@@@@@@@@
@@@@@@@@@@@@@@@@@@@@@@@@@@@@@@@@@@@@@@@@@@@@@@@@@@@@@@@@@@@@@@@@.TT@@@@@@@@@@@.T...@@@@@@@@@@@@@@@@@@@@@@@@@@@@@@@@@@@@@
@@@@@@@@@@@@@@@@@@@@@@@@@@@@@@@@@@@@@@@@@@@@@@@@@@@@@@@@@@@@@@@@@.@@@@@@@@@@@@@.....@@@@@@@@@@@@@@@@@@@@@@@@@@@@@@@@@@@@
@@@@@@@@@@@@@@@@@@@@@@@@@@@@@@@@@@@@@@@@@@@@@@@@@@@@@@@@@@@@@@@@@@@@@@@@..@@@@@@T...T@@@@@@@@@@@@@@@@@@@@@@@@@@@@@@@@@@@
@@@@@@@@@@@@@@@@@@@@@@@@@@@@@@@@@@@@@@@@@@@@@@@@@@@@@@@@@@@@@@@@@@@@@@@@T..@@@@@@...TT@@@@@@@@@@@@@@@@@@@@@@@@@@@@@@@@@@
@@@@@@@@@@@@@@@@@@@@@@@@@@@@@@@@@@@@@@@@@@@@@@@@@@@@@@@@@@@@@@@@@@@@@@...T..@@@@@@..T..@@@@@@@@@@@@@@@@@@@@@@@@@@@@@@@@@
@@@@@@@@@@@@@@@@@@@@@@@@@@@@@@@@@@@@@@@@@@@@@@@@@@@@@@@@@@@@@@@@@@..@@.......@@@@@@..T..@@@@@@@@@@@@@@@@@@@@@@@@@@@@@@@@
@@@@@@@@@@@@@@@@@@@@@@@@@@@@@@@@@@@@@@@@@@@@@@@@@@@@@@@@@@@@@@@@@@.T........T.@@@@@@.....@@@@@@@@@@@@@@@@@@@@@@@@@@@@@@@
@@@@@@@@@@@@@@@@@@@@@@@@@@@@@@@@@@@@@@@@@@@@@@@@@@@@@@@@@@@@@@@@@@..T....TT@TT.@@@@@@@T...@@@@@@@@@@@@@@@@@@@@@@@@@@@@@@
@@@@@@@@@@@@@@@@@@@@@@@@@@@@@@@@@@@@@@@@@@@@@@@@@@@@@@@@......@@@@@......@@@.T..@@@@@@..T.@@@@@@@@@@@@@@@@@@@@@@@@@@@@@@
@@@@@@@@@@@@@@@@@@@@@@@@@@@@@@@@@@@@@@@@@@@@@@@@@@@@@@@TT......@@@@.T..@@@@@@..@@@@@@T..T@@@@@@@@@@@@@@@@@@@@@@@@@@@@@@@
@@@@@@@@@@@@@@@@@@@@@@@@@@@@@@@@@@@@@@@@@@@@@@@@@@@@@@....T@@@...@@.T..@@@@@@@.@@@@@@T..@@@@@@@@@@@@@@@@@@@@@@@@@@@@@@@@
@@@@@@@@@@@@@@@@@@@@@@@@@@@@@@@@@@@@@@@@@@@@@@@@@@@@@....T.@@@.@@@@@...@@@@@@TT@@@@@....@@@@@@@@@@@@@@@@@@@@@@@@@@@@@@@@
@@@@@@@@@@@@@@@@@@@@@@@@@@@@@@@@@@@@@@@@@@@.@@@@@@@@..@@@@...T.@@@@@..T@@@T@@..@@@@@...@@@@@@@@@@@@@@@@@@@@@@@@@@@@@@@@@
@@@@@@@@@@@@@@@@@@@@@@@@@@@@@@@@@@@@@@@@@@T..@@@@@@@..@@@@@...@@@@@@..TT....T..@@@@....@@@@@@@@@@@@@@@@@@@@@@@@@@@@@@@@@
@@@@@@@@@@@@@@@@@@@@@@@@@@@@@@@@@@@@@@@@@T....@@@@@@...@@.@....@@@@@......T...T@@@@...@@@@@@@@@@@@@@@@@@@@@@@@@@@@@@@@@@
@@@@@@@@@@@@@@@@@@@@@@@@@@@@@@@@@@@@@@@@....T.@@@@@@........@@.@@@@@..TT....T.@@@@...T@@@@@@@@@@@@@@@@@@@@@@@@@@@@@@@@@@
@@@@@@@@@@@@@@@@@@@@@@@@@@@@@@@@@@@@@@@...T..@@@@@@@...T@@@.@@....@@....TT...@@@@@..T@@@@@@@.T.@@@@@@@@@@@@@@@@@@@@@@@@@
@@@@@@@@@@@@@@@@@@@@@@@@@@@@@@@@@@@@@@.TT..T@@@@@@@@@...@@@....T.T@@.....TT..@@@@T.T.@@@@@@@..@@@@@@@@@@@@@@@@@@@@@@@@@@
@@@@@@@@@@@@@@@@@@@@@@@@@@@@@@@@@@@@@..TT..@@.@@@@@@@.T.@@@..T....@TT.T.TT.TT.@.@.T.@@@@@@@@T.@@@@@@@@@@@@@@@@@@@@@@@@@@
@@@@@@@@@@@@@@@@@@@@@@@@@@@@@@@@@@@@....TT@@..@@@@@@@@.....................T....T...@@@@@@@...T.@@@@@@@@@@@@@@@@@@@@@@@@
@@@@@@@@@@@@@@@@@@@@@@@@@@@@@@@@@@@.T.....@...@@@@@@@@@TT......@.........T.T.......@@@@@@@T....@@@@@@@@@@@@@@@@@@@@@@@@@
@@@@@@@@@@@@@@@@@@@@@@@@@@@@@@@@@@........@.T.@.@@@@@@@@@@@@@@@@.TT....T.....T..TT.@@@@@@...TT@@@@@@@@@@@@@@@@@@@@@@@@@@
@@@@@@@@@@@@@@@@@@@@@@@@@@@@@@@@@@...T.T.T@@T....@@@@@@@@@@@@@@TT....TT.....@@@.T.@@@@@@T.T..@@@@@@@@@@@@@@@@@@@@@@@@@@@
@@@@@@@@@@@@@@@@@@@@@@@@@@@@@@@@@.T..@@....@.T.T..@@@@@@.TT.T.T...T....T.T.@@@@@T@@@@@@.T..@@@@@@T.@@@@@@@@@@@@@@@@@@@@@
@@@@@@@@@@@@@@@@@@@@@@@@@@@@@@@.T...@@@....@@......@T@@@@....TTT..........@@@@@@@@@@@@......@@@@....@@@@@@@@@@@@@@@@@@@@
@@@@@@@@@@@@@@@@@@@@@@@@@@@@@@..T.T@@@@@TT..@.....T...@@@....T......TT.T.@@@@@@@@@@.@.TT.T...@@....@@@@@@@@@@@@@@@@@@@@@
@@@@@@@@@@@@@@@@@@@@@@@@@@@@@...TT@@@@@@....@@.T.T...T.@....T...TT.TT.T@@@@@@@@@@@@.T...TT...T@@..@@@@@@@@@@@@@@@@@@@@@@
@@@@@@@@@@@@@@@@@@@@@@@@@@@@.T.T.@@@@@@@T..T.@.T......T....@@.........TT@@@@@@@@@@@...T.......T..@@@@@@@@@@@@@@@@@@@@@@@
@@@@@@@@@@@@@@@@@@@@@@@@@@T.....@@@@@@@@@T...@@..T.......@@@@@T..T.T.....@@@@@@@@@.T.T..T.....T@@@@@@@..@@@@@@.@@@@@@@@@
@@@@@@@@@@@@@@@@@@@@@@@@@.T....@@@@@@@@@@@....@..T......T.@@@@@..T...T.T.@@@@@@@..T........T..T@@@@@@..T.@@@@@.T@@@@@@@@
@@@@@@@@@@@@@@@@@@@@@@@@.T..T.@@@@@@@@@@.@....@...........@@@@@@TT..T.T.@@@@@@@...T@.........TT...@@..T.@@@@@...@@@@@@@@
@@@@@@@@@@@@@@@@@@@@@@@...TTT@@@@@@@@@@.T@@...@T.TT.T.T.TT@@@@@@@..TT..@@@@@.@@...@@@@.....T..........T@@@@@@T..@@@@@@@@
@@@@@@@@@@@@@@@@@@@@@@TT..T.@@@@@@@@@@....@TT...T.T.....@@@@@@@@@@.T..@@@@@..@@..@@@@@@........TT.TT.T@@@@@@...@@@@@@@@@
@@@@@@@@@@@@@@@@@@@@@..TT..@@@@@@@@@@T....@@.TTT.TT....@@@@@@@@@@@@TT@@@@@@.T@@@@@@@@@@...TTTT........@@@@@@...@@@@@@@@@
@@@@@@@@@@@@@@@@@@@@@.....@@@@@@@@@@T..T.T.....T...TT.T@@@@@@@@@@@@@@@@@@@@...@@@@@@@......T.....T....@@@@@TT.@@@@@@@@@@
@@@@@@@@@@@@@@@@@@@@....T@@@@@@@@@@......T.TT..T.T......@@@@@@@@@@@@@@@@@@@@..@@@@@@T.TT@@..........T.@@@@@.T.@@@@@@@@@@
@@@@@@@@@@@@@@@@@@...T.T@@@@@@@@@@@........T....T.T.TT....T@@@@@@@@@@@@@@@@@...@@@@....@@@@..T..T..T.@@@@@.T.@@@@@@@@@@@
@@@@@@@@@@@@@@@@@TT...T@@@@@@@@@@@@@..TT..................T.@@@@@@@@@@@@@@@@...@@@@@..@@@@@TT...T.T.@@@@@@..@@@@@@@@@@@@
@@@@@@@@@@@@@@@@..T...@@@@@@@@@@.T@@@..T...T...T...........T.@@@@@@@@@@@@@@@@..@@@@@@@@@@@@@T...T.T.@@T@T.T.@@@@@@@@@@@@
@@@@@@@@@@@@@@@.....T@@@@@@@@@@....@@@...T.......T..T....T....@@@@@@@@@@@@@@@...@@@@@@@@@@@@.@..TTT.@...T...@@@@@@@@@@@@
@@@@@@@@@@@@@@T.T...@@@@@@@@@@T.T...@@@...T..T...TT.............@@@@@@@@@@T@@..TT@@@@@@@@...@@@T.TT.T.....T.@@@@@@@@@@@@
@@@@@@@@@@@@.......@@@@@@@@@@...TT...@@@.T...T.....@@....TT.T...@@@@@@@@@@TT@@...@@@@@@@T.T@@@@@...T...T.TTT@@@@@@@@@@@@
@@@@@@@@@@@TT.....T@@@@@@@@@.T....T...@@..........T@@@.TT.....T...@@T@@@T.T.@@....@@@@@TT.@@@@@@T...T......T.@@@@@@@@@@@
@@@@@@@@@@......T.@@@@@@@@@@T....TT.T....T....T.TT.@@@@...T.T.....T.T@@@T.T.@@...T@@@@...@@@@@@...T.......T.@@@@@@@@@@@@
@@@@@@@@@.......T.@@@@@@@.@@@...T.T....TT..........T@@@@T..T...T.......TT....@@TTT@@@@@@@@@@@@T....T....T..@@@@@@@@@@@@@
@@@@@@@@T.TT......T@@@@@...@@@...TTT....T.T....T..TT.@@@@TTT...T.....T..T...TT..T.T@@@@@@@@@@.T.T.T...T.T.@@@@@@@@@@@@@@
@@@@@@@@.T....@@.T.@@@@..TT.@@@..T.T.T.........T..T...@@@.T..T.T...T.T.....T...@@T..@@@@@@@@.T...T..TTT.T@@@@@@@@@@@@@@@
@@@@@@@TT.TTT@@@T..T@@..T.T..@@@TT.....TT...T.T........T..T.....T...T.....T...@@@@...@@@@@@..........T..@@@@@@@@@@@@@@@@
@@@@@@....T.@@@@...T@@T.TTT...@@@....T.@@@@@@........TTT..TT....T..T....T.T..@@@@@@...@@@@@@......TTT..@@@@@@@@@@@@@@@@@
@@@@@@.....@@@@@@.T..@.....T...@@.....@@@@@@@..T...T..@@@T..............T.T.@@@@@@@@T..@@@@.T.......T.@@@@@@@@@@@@@@@@@@
@@@@@@@...@@@@@@@@.T.@........T..T...@@@@@@@@..T..T...@@@..T....T....TT.....@@@@@@@@@T.@@@..T..T.....@@@@@@@@@@@@@@@@@@@
@@@@@@@@T@@@@@@@@@.T.@@..T..T..T.....@@@@@@@@....TT...T..........T...T.....@@@@@@@@@@.....T..@@...T.@@@@@@@@@@@@@@@@@@@@
@@@@@@@@@@@@@@@@@@@..T@.....T..TT.T.T@@@@@@@@T.T...TT........@@.TT.......T..@@@@@@@@@......T@@@@...@@@@@@@@@@@@@@@@@@@@@
@@@@@@@@@@@@@@@@T.@TT.@@.......T.T.....@@.@@@.T.....TT.T..TT@@@@@............@@@@@@@@@@@.....@@@@.@@@@@@@@@@@@@@@@@@@@@@
@@@@@@@@@@@@@@@T..@@..T...T...T...T.....T.@@@@..T.....T..T@@@@@@@@....T......T@@@@@@.@@@..T...@@@@@@@@@@@@@@@@@@@@@@@@@@
@@@@@@@@@@@@@@....@@@....TTTT..TTT...T....@@@@T..........T@@@@@@T..T...T...T...@@@@.TTTTTT.T...@@@@@@@@@@@@@@@@@@@@@@@@@
@@@@@@@@@@@@@.....@@@TT.T.T.......TT....TT@@@....T.....T.TTT.@@@....T..T.T...T.T@@@T....TTT...T@@@@@@@@@@@@@@@@@@@@@@@@@
@@@@@@@@@@@@.T.............T..T@@@T.T.......T.......T..T.T.TT@@@...T.....T...T...@@.T.........@@@@@@@@@@@@@@@@@@@@@@@@@@
@@@@@@@@@@.T..TT..TT...........@@@.T...T.T..T.T..T........T..@@@..........T.........T.T...T..@@@@@@@@@@@@@@@@@@@@@@@@@@@
@@@@@@@@@@.T...T...T.T........@@@T..T....TT.T..T........@@T.T@@@T...T......T.........T...T.T@@@@@@@@@@@@@@@@@@@@@@@@@@@@
@@@@@@@@@@@..T.T.......TTTT.T@@@@....TTTTT...T.TT.T.TT..@@@.T.T.........T..TTT.T..TT..TT..T@@@@@@@@@@@@@@@@@@@@@@@@@@@@@
@@@@@@@@@@@@.T...TT.TT....T@@@@@@@@..............T.TT..@@@@@..........T.T.TT.....T...T..T.@@@@@@@@@@@@@@@@@@@@@@@@@@@@@@
@@@@@@@@@@@@@..T........TTT@@@@@@@@@.T.@@@@@.......T...@@@@@@TT....@@@.T.T.TT...T........@@@@@@@@@@@@@@@@@@@@@@@@@@@@@@@
@@@@@@@@@@@@@@......TTTT..T@@@@@@@@@..@@@@@@@....T.T.TT@@@@@@T....@@@@@...TT............@@@@@@@@@@@@@@@@@@@@@@@@@@@@@@@@
@@@@@@@@@@@@@@@...TT...TT..T.T.......@@@@.@@@@.....TTT.@@@@@....T@@@@@@@...T...T......T@@@@@@@@@@@@@@@@@@@@@@@@@@@@@@@@@
@@@@@@@@@@@@@@@@....T..T..TTT.T....T@@@@T.T@@@@@..T...T.@@@..T.T@@@@@@@@@...T.T.......@@@@@@@@@@@@@@@@@@@@@@@@@@@@@@@@@@
@@@@@@@@@@@@@@@@@.T........T.T.T...@@@@..T..@@@..T...T..@@..T..@@@@@@@@@@.T.TT.......@@@@@@@@@@@@@@@@@@@@@@@@@@@@@@@@@@@
@@@@@@@@@@@@@@@@@@.........T......@@@@@@@@TTT@.....T.....T..T.@@@@@@@@@@...TTTT...TT@@@@@@@@@@@@@@@@@@@@@@@@@@@@@@@@@@@@
@@@@@@@@@@@@@@@@@@@..TT..T...TTT.@@@@@@@@@@@.....@..T.T...TT.@@@@@@@@@..TT@..T...TT@@@@@@@@@@@@@@@@@@@@@@@@@@@@@@@@@@@@@
@@@@@@@@@@@@@@@@@@@@..TT...T....@@@@@@@@@@@.....@@@@T...T..T@@@@@@@@@.T.T@@@......@@@@@@@@@@@@@@@@@@@@@@@@@@@@@@@@@@@@@@
@@@@@@@@@@@@@@@@@@@@@..T..T.TT.@@@@@@@@@@@@T....@@@@@TT.T..@@@@@@@@@....T.@@@.T..@@@@@@@@@@@@@@@@@@@@@@@@@@@@@@@@@@@@@@@
@@@@@@@@@@@@@@@@@@@@@@..T.....@@@@.@@@@@@@@T.....@@@@@.TTT@@@@@@@@@T...T..T@@@..@@@@@@@@@@@@@@@@@@@@@@@@@@@@@@@@@@@@@@@@
@@@@@@@@@@@@@@@@@@@@@@@...T..@@@@..@@@@@@@@.T.TT.T@@@@@T.@@@@@@@@@@.T..T....@@@@@@@@@@@@@@@@@@@@@@@@@@@@@@@@@@@@@@@@@@@@
@@@@@@@@@@@@@@@@@@@@@@@@....@@@@..T@@@@@@....T..T..@@@@@@@@@@@@@@@@..........@@@@@@@@@@@@@@@@@@@@@@@@@@@@@@@@@@@@@@@@@@@
@@@@@@@@@@@@@@@@@@@@@@@@@TT@@@@..T@@@@@@@.......T..@@@@@@@@@@@@@@@.T.T..TT...@@@@@@@@@@@@@@@@@@@@@@@@@@@@@@@@@@@@@@@@@@@
@@@@@@@@@@@@@@@@@@@@@@@@@@@@@@....T@@@@@..T...T...@@@.@@@@@@@@@@T..TT...T...@@@@@@@@@@@@@@@@@@@@@@@@@@@@@@@@@@@@@@@@@@@@
@@@@@@@@@@@@@@@@@@@@@@@@@@@@@.T....TT......TTT.TT@@@T..@@@@@@@@@.......TTT.@@@@@@@@@@@@@@@@@@@@@@@@@@@@@@@@@@@@@@@@@@@@@
@@@@@@@@@@@@@@@@@@@@@@@@@@@@........T.........TT@@@.T...@@@@@@@...TT..T...@@@@@@@@@@@@@@@@@@@@@@@@@@@@@@@@@@@@@@@@@@@@@@
@@@@@@@@@@@@@@@@@@@@@@@@@@@@@....T...T.TT..TTT.@@@....TT.@@@@.........T..@@@@@@@@@@@@@@@@@@@@@@@@@@@@@@@@@@@@@@@@@@@@@@@
@@@@@@@@@@@@@@@@@@@@@@@@@@@@@@.......T..T.....T.@TT.......@@@@T..T......@@@@@@@@@@@@@@@@@@@@@@@@@@@@@@@@@@@@@@@@@@@@@@@@
@@@@@@@@@@@@@@@@@@@@@@@@@@@@@@@@T.......TT..@@T...@@@@@@@T.@@@@T.......@@@@@@@@@@@@@@@@@@@@@@@@@@@@@@@@@@@@@@@@@@@@@@@@@
@@@@@@@@@@@@@@@@@@@@@@@@@@@@@@@@@T.......T.@@@..T.@@@@@@@.T.@@@@T.T..T@@@@@@@@@@@@@@@@@@@@@@@@@@@@@@@@@@@@@@@@@@@@@@@@@@
@@@@@@@@@@@@@@@@@@@@@@@@@@@@@@@@@@....T...@@@@....@@@@@@....T@@@@....@@@@@@@@@@@@@@@@@@@@@@@@@@@@@@@@@@@@@@@@@@@@@@@@@@@
@@@@@@@@@@@@@@@@@@@@@@@@@@@@@@@@@@@T.....@@@@@T..@@@@@@@....TT@@@@.T@@@@@@@@@@@@@@@@@@@@@@@@@@@@@@@@@@@@@@@@@@@@@@@@@@@@
@@@@@@@@@@@@@@@@@@@@@@@@@@@@@@@@@@@@....@@@@@@T..@@@@@@@..T....@@@@@@@@@@@@@@@@@@@@@@@@@@@@@@@@@@@@@@@@@@@@@@@@@@@@@@@@@
@@@@@@@@@@@@@@@@@@@@@@@@@@@@@@@@@@@@@T.@@@@@@@T..@@@@@@@@..T....@@@@@@@@@@@@@@@@@@@@@@@@@@@@@@@@@@@@@@@@@@@@@@@@@@@@@@@@
@@@@@@@@@@@@@@@@@@@@@@@@@@@@@@@@@@@@@@@@@@@@@...TT@@T.@@.....T...@@@@@@@@@@@@@@@@@@@@@@@@@@@@@@@@@@@@@@@@@@@@@@@@@@@@@@@
@@@@@@@@@@@@@@@@@@@@@@@@@@@@@@@@@@@@@@@@@...TT..T..........TT...@@@@@@@@@@@@@@@@@@@@@@@@@@@@@@@@@@@@@@@@@@@@@@@@@@@@@@@@
@@@@@@@@@@@@@@@@@@@@@@@@@@@@@@@@@@@@@@@@.......TT..TT...T....T.@@@@@@@@@@@@@@@@@@@@@@@@@@@@@@@@@@@@@@@@@@@@@@@@@@@@@@@@@
@@@@@@@@@@@@@@@@@@@@@@@@@@@@@@@@@@@@@@@@@T..............T....T@@@@@@@@@@@@@@@@@@@@@@@@@@@@@@@@@@@@@@@@@@@@@@@@@@@@@@@@@@
@@@@@@@@@@@@@@@@@@@@@@@@@@@@@@@@@@@@@@@@@@T...T...T...T...TT.@@@@@@@@@@@@@@@@@@@@@@@@@@@@@@@@@@@@@@@@@@@@@@@@@@@@@@@@@@@
@@@@@@@@@@@@@@@@@@@@@@@@@@@@@@@@@@@@@@@@@@@...T.T...T.T...T.@@@@@@@@@@@@@@@@@@@@@@@@@@@@@@@@@@@@@@@@@@@@@@@@@@@@@@@@@@@@
@@@@@@@@@@@@@@@@@@@@@@@@@@@@@@@@@@@@@@@@@@@@....TTT...T....@@@@@@@@@@@@@@@@@@@@@@@@@@@@@@@@@@@@@@@@@@@@@@@@@@@@@@@@@@@@@
@@@@@@@@@@@@@@@@@@@@@@@@@@@@@@@@@@@@@@@@@@@@@....T......TT@@@@@@@@@@@@@@@@@@@@@@@@@@@@@@@@@@@@@@@@@@@@@@@@@@@@@@@@@@@@@@
@@@@@@@@@@@@@@@@@@@@@@@@@@@@@@@@@@@@@@@@@@@@@@.....T...T.@@@@@@@@@@@@@@@@@@@@@@@@@@@@@@@@@@@@@@@@@@@@@@@@@@@@@@@@@@@@@@@
@@@@@@@@@@@@@@@@@@@@@@@@@@@@@@@@@@@@@@@@@@@@@@@.T....T.T@@@@@@@@@@@@@@@@@@@@@@@@@@@@@@@@@@@@@@@@@@@@@@@@@@@@@@@@@@@@@@@@
@@@@@@@@@@@@@@@@@@@@@@@@@@@@@@@@@@@@@@@@@@@@@@@@TT..TTT@@@@@@@@@@@@@@@@@@@@@@@@@@@@@@@@@@@@@@@@@@@@@@@@@@@@@@@@@@@@@@@@@
@@@@@@@@@@@@@@@@@@@@@@@@@@@@@@@@@@@@@@@@@@@@@@@@@@T..@@@@@@@@@@@@@@@@@@@@@@@@@@@@@@@@@@@@@@@@@@@@@@@@@@@@@@@@@@@@@@@@@@@
@@@@@@@@@@@@@@@@@@@@@@@@@@@@@@@@@@@@@@@@@@@@@@@@@@@@@@@@@@@@@@@@@@@@@@@@@@@@@@@@@@@@@@@@@@@@@@@@@@@@@@@@@@@@@@@@@@@@@@@@
@@@@@@@@@@@@@@@@@@@@@@@@@@@@@@@@@@@@@@@@@@@@@@@@@@@@@@@@@@@@@@@@@@@@@@@@@@@@@@@@@@@@@@@@@@@@@@@@@@@@@@@@@@@@@@@@@@@@@@@@
