type octile
height 70
width 56
map
@@@@@@@@@@@@@@@@@@@@@@@@@@@@@@@@@@@@@@@@@@@@@@@@@@@@@@@@
@@@@@@@@@@@@@@@@@@@@@@@@@@@@@@@@@@@@@@@@@@@@@@@@@@@@@@@@
@@@@@@@@@@@@@@@@@@@@@@@@@@@@@@@@@@@@@@@@@@@@@@@@@@@@@@@@
@@@@@@@@@@@@@@@@@@@@@@@@@@@@@@@@@@@@@@@@@@@@@@@@@@@@@@@@
@@@@@@@@@@@@@@@@@@@@@@@@@@@@@@@@@@@@@@@@@@@@@@@@@@@@@@@@
@@@@@@@@@@@@@@@@@@@@@@@@@@@@@@@@@@@@@@@@@@@@@@@@@@@@@@@@
@@@@@@@@@@@@@@@@@@@@@@@@@@@@@@@@@@@@@@@@@@@@@@@@@@@@@@@@
@@@@@@@@@@@@@@@@@@@@@@@@@@@@@@@@@@@@@@@@@@@@@@@@@@@@@@@@
@@@@@@@@@@@@@@@@@@@@@@@@@@@@@@@@@@@@@@@@@@@@@@@@@@@@@@@@
@@@@@@@@@@@@@@@@@@@@@@@@@@@@@@@@@@@@@@@@@@@@@@@@@@@@@@@@
@@@@@@@@@@@@@@@@@@@@@@@@@@@@@@@@@@@@@.@@@@@@@@@@@@@@@@@@
@@@@@@@@@@@@@@@@@@@@@@@@@@@@@@@@@@@@@.T@@@@@@@@@@@@@@@@@
@@@@@@@@@@@@@@@@@@@@@@@@@@@@@@@@@@@@@T..@@@@@@@@@@@@@@@@
@@@@@@@@@@@@@@@@@@@@@@@@@@@@@@@@@@@.TT...@@@@@@@@@@@@@@@
@@@@@@@@@@@@@@@@@@@@@@@@@@@@@@@@@@@.......@@@@@@@@@@@@@@
@@@@@@@@@@@@@@@@@@@@@@@@@@@@@@@@@....T....@@@@@@@@@@@@@@
@@@@@@@@@@@@@@@@@@@@@@@@@@@@@@@@@.....T..@@@@@@@@@@@@@@@
@@@@@@@@@@@@@@@@@@@@@@@@@@@@@@@@@..T...@@@@@@@@@@@@@@@@@
@@@@@@@@@@@@@@@@@@@@@@@@@@@@@@........@@@@@@@@@@@@@@@@@@
@@@@@@@@@@@@@@@@@@@@@@@@@@T@@@TT..T.@@@@@@@@@@@@@@@@@@@@
@@@@@@@@@@@@@@@@@@@@@@@T....@@@T...@@@@@@@@@@@@@@@@@@@@@
@@@@@@@@@@@@@@@@@@@@@@.T..T....T.@@@@@@@@@@@@@@@@@@@@@@@
@@@@@@@@@@@@@@@@@@@@@@@..........@@@@@@@@@@@@@@@@@@@@@@@
@@@@@@@@@@@@@@@@@@@@@@@@...T.....@@@@@@@@@@@@@@@@@@@@@@@
@@@@@@@@@@@@@@@@@@@@@@@@@T....T.T@@@@@@@@@@@@@@@@@@@@@@@
@@@@@@@@@@@@@@@@@@.@@@@@@@....T@@@@@@@@@@@@@@@@@@@@@@@@@
@@@@@@@@@@@@@@@@....@@@@@@@..T@@@@@@@@@@@@@@@@@@@@@@@@@@
@@@@@@@@@@@@@@@@...T.@@@@@....@@@@@@@@@@@@@@@@@@@@@@@@@@
@@@@@@@@@@@@@@@@..TT..@@@...T.@@@@@@.@@@@@@@@@@@@@@@@@@@
@@@@@@@@@@@@@@@........T......T@@@@...@@@@@@@@@@@@@@@@@@
@@@@@@@@@@@@@@@@...TT.........@@@@.T.TT@@@@@@@@@@@@@@@@@
@@@@@@@@@@@@@@@@@.T.TT.T..T..@@@@.T....T@@@@@@@@@@@@@@@@
@@@@@@@@@@@@@@@@@@T...T......T.@@.T.TT..@@@@@@@@@@@@@@@@
@@@@@@@@@@@@@@@@@T..........T..@@.......@@@@@@@@@@@@@@@@
@@@@@@@@@@@@@@@@.....T..@.....TT@@T.@....@@@@@@@@@@@@@@@
@@@@@@@@@@@@.@@T.......@@@..T....@@@@.T..@@@@@@@@@@@@@@@
@@@@.@@@@@@...T.....T.@@@@@......T..T..T..@@@@@@@@@@@@@@
@@@..T.TT.T.......T..@@@@@@@..............@@@@@@@@@@@@@@
@@T.T.T.T.T.........T@@@@@@@.T...TTT.T....@@@@@@@@@@@@@@
@@@T....T...T.T..TT...@@@@@@@T...T.....T...@@@@@@@@@@@@@
@@@........T.....T.T...@@@@@@@.@@...........@@@@@@@@@@@@
@@@@....T.....@@T.T....@@@@@@@@@@.....T....T...@@@@@@@@@
@@@@@....TTTT@@@@.......@@@@@@@@@....T..TT..TT..@@@@@@@@
@@@@@@.T....@@@@@....T...@@@@@@@@.T..T...TTT.TT.T@@@@@@@
@@@@@@@...T@@@@.@@...T....@@@@@@@....@@@@.T.......@@@@@@
@@@@@@@@..@@@@.T.@.T.......@@@@@.....@@@@@@...T..T..@@@@
@@@@@@@@@@@@@@.TT@@.TT.T..T.@@@@.TTT@@@@@@@..T.........@
@@@@@@@@@@@@@@T...@T...T.T...T.....@@@@@@@.T.....T....@@
@@@@@@@@@@@@@@@T..@@....T..T......T@@@@@@@.T...TT....@@@
@@@@@@@@@@@@@@@T...@@...........T.....T@@@T....T....@@@@
@@@@@@@@@@@@@@@@..T@@@.T.TT.TTT.T....T...T.T.......@@@@@
@@@@@@@@@@@@@@@@.T..@....T...T.T.....T....TT......@@@@@@
@@@@@@@@@@@@@@@@@T..@.T...T...T..TT..T.......TTT.@@@@@@@
@@@@@@@@@@@@@@@@@...@@.T.......T.........T...TT.@@@@@@@@
@@@@@@@@@@@@@@@@@@.TT........T..T....TT.T.TTTT.@@@@@@@@@
@@@@@@@@@@@@@@@@@@@T....T.T...T.T.T......T..T.@@@@@@@@@@
@@@@@@@@@@@@@@@@@@.....T.TT....T........T....@@@@@@@@@@@
@@@@@@@@@@@@@@@@@.........TT.T...T........T@@@@@@@@@@@@@
@@@@@@@@@@@@@@@@@.TT...T...T......T....T..@@@@@@@@@@@@@@
@@@@@@@@@@@@@@@@@@..T...............T....@@@@@@@@@@@@@@@
@@@@@@@@@@@@@@@@@@@..T.TT..T.T.T....TT..@@@@@@@@@@@@@@@@
@@@@@@@@@@@@@@@@@@@@..T.......T.T.T.T..@@@@@@@@@@@@@@@@@
@@@@@@@@@@@@@@@@@@@@@.T...T..T.TTT.T..@@@@@@@@@@@@@@@@@@
@@@@@@@@@@@@@@@@@@@@@@.T.T......TTT..@@@@@@@@@@@@@@@@@@@
@@@@@@@@@@@@@@@@@@@@@@@T............@@@@@@@@@@@@@@@@@@@@
@@@@@@@@@@@@@@@@@@@@@@@@T...T...T.@@@@@@@@@@@@@@@@@@@@@@
@@@@@@@@@@@@@@@@@@@@@@@@@......T.@@@@@@@@@@@@@@@@@@@@@@@
@@@@@@@@@@@@@@@@@@@@@@@@@@@T....@@@@@@@@@@@@@@@@@@@@@@@@
@@@@@@@@@@@@@@@@@@@@@@@@@@@@@@@@@@@@@@@@@@@@@@@@@@@@@@@@
@@@@@@@@@@@@@@@@@@@@@@@@@@@@@@@@@@@@@@@@@@@@@@@@@@@@@@@@
