type octile
height 70
width 64
map
@@@@@@@@@@@@@@@@@@@@@@@@@@@@@@@@@@@@@@@@@@@@@@@@@@@@@@@@@@@@@@@@
@@@@@@@@@@@@@@@@@@@@@@@@@@@@@@@@@@@@@@@@@@@@@@@@@@@@@@@@@@@@@@@@
@@@@@@@@@@@@@@@@@@@@@@@@@@@@@@@@@@@@@@@@@@@@@@@@@@@@@@@@@@@@@@@@
@@@@@@@@@@@@@@@@@@@@@@@@@@@@@@@@@@@@@@@@@@@@@@@@@@@@@@@@@@@@@@@@
@@@@@@@@@@@@@@@@@@@@@@@@@@@@@@@@@@@@@@@@@@@@@@@@@@@@@@@@@@@@@@@@
@@@@@@@@@@@@@@@@@@@@@@@@@@@@@@@@@@@@@@@@@@@@@@@@@@@@@@@@@@@@@@@@
@@@@@@@@@@@@@@@@@@@@@@@@@@@@@@@@@@@@@@@@@@@@@@@@@@@@@@@@@@@@@@@@
@@@@@@@@@@@@@@@@@@@@@@@@@@@@@@@@@@@@@@@@@@@@@@@@@@@@@@@@@@@@@@@@
@@@@@@@@@@@@@@@@@@@@@@@@@@@@@@@@@@@@@@@@@@@@@@@@@@@@@@@@@@@@@@@@
@@@@@@@@@@@@@@@@@@@@@@@@@@@@@@@@@@@@@@@@@@@@@@@@@@@@@@@@@@@@@@@@
@@@@@@@@@@@@@@@@@@@@@@@@@@@@@@@@@@@@@@@@@@@@@@@@@@@@@@@@@@@@@@@@
@@@@@@@@@@@@@@@@@@@@@@@@@@@@@@@@@@@@@@@@@@@@@@@@@@@@@@@@@@@@@@@@
@@@@@@@@@@@@@@@@@@@@@@@@@@@@@@@@@@@T..@@@@@@@@@@@@@@@@@@@@@@@@@@
@@@@@@@@@@@@@@@@@@@@@@@@@@@@@@@@@@.....@@@@@@@@@@@@@@@@@@@@@@@@@
@@@@@@@@@@@@@@@@@@@@@@@@@@@@@@@@@T.T@@..@@@@@@@@@@@@@@@@@@@@@@@@
@@@@@@@@@@@@@@@@@@@@@@@@@@@@@@@@@...@@...@@@@@@@@@@@@@@@@@@@@@@@
@@@@@@@@@@@@@@@@@@@@@@@@@@@@@@@@@@.T@.....@@@@@@@@@@@@@@@@@@@@@@
@@@@@@@@@@@@@@@@@@@@@@@@@@@@@@@@@@@T...T...@@@@@@@@@@@@@@@@@@@@@
@@@@@@@@@@@@@@@@@@@@@@@@@@@@@@@@@@@@........@@@@@@@@@@@@@@@@@@@@
@@@@@@@@@@@@@@@@@@@@@@@@@@@@@@@@@@@@@.......T@@@@@@@@@@@@@@@@@@@
@@@@@@@@@@@@@@@@@@@@@@@@@@@@@@@@@@@@@.T.......@@@@@@@@@@@@@@@@@@
@@@@@@@@@@@@@@@@@@@@@@@@@@@.T@@@@@@.T...TT.T...@@@@@@@@@@@@@@@@@
@@@@@@@@@@@@@@@@@@@@@@@@@@@..@@@@@T..T..T.T.....@@@@@@@@@@@@@@@@
@@@@@@@@@@@@@@@@@@@@@@@@@@@@.T..........T.TTT....@@@@@@@@@@@@@@@
@@@@@@@@@@@@@@@@@@@@@@@@@@@@@T..TT.........@@.T..T@@@@@@@@@@@@@@
@@@@@@@@@@@@@@@@@@@@@@@@@@@@@@...T.T...T..@@@@.T...@@@@@@@@@@@@@
@@@@@@@@@@@@@@@@@@@@@@@@@@@@@@.T.TTT..TT...@@@.TT..T@@@@@@@@@@@@
@@@@@@@@@@@@@@@@@@@@@@@@@@@@@...T.T........@T.T..T....@@@@@@@@@@
@@@@@@@@@@@@@@@@@@@@@@@@@@@@T.T.TT..T....T..T.T.TT.....@@@@@@@@@
@@@@@@@@@@@@@@@@@@@@@@@@@@@TT....T....T...T.....T.T..T.@@@@@@@@@
@@@@@@@@@@@@@@@@@@@@@@@T.T.T.T.........T.T..T...TT....T@@@@@@@@@
@@@@@@@@@@@@@@@@@@@@@@@@T..TTT.TT.........TTT..........T..@@@@@@
@@@@@@@@@@@@@@@@@@@@@@@@...................T...T..@..T.T...@@@@@
@@@@@@@@@@@@@@..@@@@@@@.TT..T..........T.....T...@@@.TTTT.T.@@@@
@@@@@@@@@@@@TT..@@@@@@.....T..T.T@@....TT.T.....@@@@@..TT...T@@@
@@@@@@@@@@@..T.T@@@@..T..T....T..@@.....TT.TTT.@@@@@@@.T.TTT@@@@
@@@@@@@@@@T...T.T.....T.......T...T..........T@@@@@@@@@....@@@@@
@@@@@@@@@T........T.T.......TT.T...T...........@@@@@@@@@.T@@@@@@
@@@@@@@@T........T.TTT.T..TT..T...T..T..T..TT....@@@@@@@@@@@@@@@
@@@@@@@T....T.@.T...T..T.........T.T...T.....T...@@@@@@@@@@@@@@@
@@@@@@@@TT.T@@@@.T.......T..T.T.....TTT..T.@@..TT.@@@@@@@@@@@@@@
@@@@@@@@...T@@@@.TT..TT.....T.....T....T..@@@@.T.T.@@@@@@@@@@@@@
@@@@..@@..T@@@@@@..T.TT....T...T.........@@@@@@.....@@@@@@@@@@@@
@@@........@@@@@@.T......T.T..T......T..@@@@@@@@....@@@@@@@@@@@@
@@.......TT..@@@@.T..T..........T......@@@@@@@@@@..@@@@@@@@@@@@@
@@...........T.@@.T..T..T...T..T........@@@@@@@@@@@@@@@@@@@@@@@@
@@@TT....TT........T.T...TTT.TT...T.....T.@@@@@@@@@@@@@@@@@@@@@@
@@@@.T.T.T.....T..TT.@@..T........@@....T.@@@@@@@@@@@@@@@@@@@@@@
@@@@@.......T.......@@@..TT......@@@@...TT.@@@@@@@@@@@@@@@@@@@@@
@@@@@@......T...T...T@@.T...T...@@@@@@...T..@@@@@@@@@@@@@@@@@@@@
@@@@@@@.........T........T.....@@@@@@@@......@@@@@@@@@@@@@@@@@@@
@@@@@@@@T..T..T.TT...........T.@@@@@@@@@.T.T@@@@@@@@@@@@@@@@@@@@
@@@@@@@@@T...T.T........@...T..@@@@@@@@@@..@@@@@@@@@@@@@@@@@@@@@
@@@@@@@@@@.....TTT....T@@@T.....T@@@@@@@@T@@@@@@@@@@@@@@@@@@@@@@
@@@@@@@@@@@.T...T.....@@@@@TT....@@@@@@@@@@@@@@@@@@@@@@@@@@@@@@@
@@@@@@@@@@@@........T@@@@@@@.TT..@@@@@@@@@@@@@@@@@@@@@@@@@@@@@@@
@@@@@@@@@@@@@.T..TTT@@@@@@@@@......@@@@@@@@@@@@@@@@@@@@@@@@@@@@@
@@@@@@@@@@@@@@...T.@@@@@@@..T......T@@@@@@@@@@@@@@@@@@@@@@@@@@@@
@@@@@@@@@@@@@@@.T.@@@@@@.T.T.T.......@@@@@@@@@@@@@@@@@@@@@@@@@@@
@@@@@@@@@@@@@@@@T.@@@@@.....T.TT..T.@@@@@@@@@@@@@@@@@@@@@@@@@@@@
@@@@@@@@@@@@@@@@@.T@@@@.T.....T....@@@@@@@@@@@@@@@@@@@@@@@@@@@@@
@@@@@@@@@@@@@@@@@@..@@@.T...T.....@@@@@@@@@@@@@@@@@@@@@@@@@@@@@@
@@@@@@@@@@@@@@@@@@@T.@@......T...@@@@@@@@@@@@@@@@@@@@@@@@@@@@@@@
@@@@@@@@@@@@@@@@@@@@..@TT..T...T@@@@@@@@@@@@@@@@@@@@@@@@@@@@@@@@
@@@@@@@@@@@@@@@@@@@@@T...T.T...@@@@@@@@@@@@@@@@@@@@@@@@@@@@@@@@@
@@@@@@@@@@@@@@@@@@@@@@T...TT..@@@@@@@@@@@@@@@@@@@@@@@@@@@@@@@@@@
@@@@@@@@@@@@@@@@@@@@@@@T.T..T@@@@@@@@@@@@@@@@@@@@@@@@@@@@@@@@@@@
@@@@@@@@@@@@@@@@@@@@@@@@..T.@@@@@@@@@@@@@@@@@@@@@@@@@@@@@@@@@@@@
@@@@@@@@@@@@@@@@@@@@@@@@@@@@@@@@@@@@@@@@@@@@@@@@@@@@@@@@@@@@@@@@
@@@@@@@@@@@@@@@@@@@@@@@@@@@@@@@@@@@@@@@@@@@@@@@@@@@@@@@@@@@@@@@@
