type octile
height 54
width 52
map
@@@@@@@@@@@@@@@@@@@@@@@@@@@@@@@@@@@@@@@@@@@@@@@@@@@@
@@@@@@@@@@@@@@@@@@@@@@@@@@@@@@@@@@@@@@@@@@@@@@@@@@@@
@@@@@@@@@@@@@@@@@@@@@@@@@@@@@@@@@@@@@@@@@@@@@@@@@@@@
@@@@@@@@@@@@@@@@@@@@@@@@@@@@@@@@@@@@@@@@@@@@@@@@@@@@
@@@@@@@@@@@@@@@@@@@@@@@@@@@@@@@@@@@@@@@@@@@@@@@@@@@@
@@@@@@@@@@@@@@@@@@@@@@@@@@@@@@@@@@@@@@@@@@@@@@@@@@@@
@@@@@@@@@@@@@@@@@@@@@@@@@@@@@@@@@@@@@@@@@@@@@@@@@@@@
@@@@@@@@@@@@@@@@@@@@@@@@@@@@@@@@@@@@@@@@@@@@@@@@@@@@
@@@@@@@@@@@@@@@@@@@@@@@@@@@@@@@@@@@@@@@@@@@@@@@@@@@@
@@@@@@@@@@@@@@@@@@@@@@@@@@@@@@@@@@@@@@@@@@@@@@@@@@@@
@@@@@@@@@@@@@@@@@@@@@@@@@@@@@@@@@@@@@@@@@@@@@@@@@@@@
@@@@@@@@@@@@@@@@@@@@@@@@@@@@@.@@@@@@@@@@@@@@@@@@@@@@
@@@@@@@@@@@@@@@@@@@@@@@@@@@@@..@@@@@@@@@@@@@@@@@@@@@
@@@@@@@@@@@@@@@@@@@@@@@@@@@@@..T@@@@@@@@@@@@@@@@@@@@
@@@@@@@@@@@@@@@@@@@@@@@@@@@@@@T..@@@@@@@@@@@@@@@@@@@
@@@@@@@@@@@@@@@@@@@@@@@@@@@@@@TT..@@@@@@@@@@@@@@@@@@
@@@@@@@@@@@@@@@@@@@@@@@@@@@@@......@@T@@@@@@@@@@@@@@
@@@@@@@@@@@@@@@@@@@@@@@@@@@@.......T..@@@@@@@@@@@@@@
@@@@@@@@@@@@@@@@@@@@@@@@@@@....TTTTT.T@@@@@@@@@@@@@@
@@@@@@@@@@@@@@@@@@@@@@@@@@.......T...@@@@@@@@@@@@@@@
@@@@@@@@@@@@@@@@@@@@@@@@@TTTT.T@.......@@@@@@@@@@@@@
@@@@@@@@@@@@@@@@@@@.@@@@T..TT.@@@@....T...@@@@@@@@@@
@@@@@@@@@@@@@@@@@@@T..TTT.@@.@@@@@@T..TT.@@@@@@@@@@@
@@@@@@@@@@@@@@@@@@@.TT...@@@.T@@@@@.TTT..@@@@@@@@@@@
@@@@@@@@@@@@@@@@@@@@..T..@@@.T..@@@@...TT@@@@@@@@@@@
@@@@@@@@@@@@@@@@@@@..TT.....T@@..@@@.T....@@@@@@@@@@
@@@@@@@@@@@@@@@@@...........@@@.TT@..T.T.TT@@@@@@@@@
@@@@@@@@@@@@@@@@@.T....@@@..@@@......T....T.@@@@@@@@
@@@@@@@@@@@@@@@@.......@@@@.....@@.TT........@@@@@@@
@@@@@@@@@@@@@@@.....TT.T@@@@.TT@@@..TTTTT...T.@@@@@@
@@@@@@@@@@@@@..TTT..T....@@@@..@@@..T..TT..TT..@@@@@
@@@@@@@@@@@.....T.TT......@@@@..@..TT.......T.T@@@@@
@@@@@@@@@@@T....T....T.....@@....T....TT.....T@@@@@@
@@@@@@@@@@@..T..T........T........T...TTT.T..@@@@@@@
@@@@@@@@@@..T...@@T..T.T.T...T.............T@@@@@@@@
@@@@@@@@@....T.T@@@T.T...TT..TTTTTTTT...T..@@@@@@@@@
@@@@@....T..T...@@@TT....T....TTT.........@@@@@@@@@@
@@@@.T.T..T..T@.T@@...T.....T..TT.T......@@@@@@@@@@@
@@@TT..T..T..@@T.T@...........TT...T....@@@@@@@@@@@@
@@T...TT.T..T@@@.T.T....TT.TT..........@@@@@@@@@@@@@
@@.T...T.T.T..@@T.TT.T..T.......T.....@@@@@@@@@@@@@@
@@@.T.T.T....T@@....T.T......T.T.....@@@@@@@@@@@@@@@
@@@@.T.TT..TTT...TT.T.........T...T.@@@@@@@@@@@@@@@@
@@@@@.....T.TT...T.T..TT.T......T.T@@@@@@@@@@@@@@@@@
@@@@@@..T.T..TT...T.T..T..........@@@@@@@@@@@@@@@@@@
@@@@@@@T......TT..T....T...T.TT.T@@@@@@@@@@@@@@@@@@@
@@@@@@@@.......T..........TT.T..@@@@@@@@@@@@@@@@@@@@
@@@@@@@@@TT.T.TT.....T...TTT...@@@@@@@@@@@@@@@@@@@@@
@@@@@@@@@@..T.....T......TT.TT@@@@@@@@@@@@@@@@@@@@@@
@@@@@@@@@@@...T....TT........@@@@@@@@@@@@@@@@@@@@@@@
@@@@@@@@@@@@....T........T..@@@@@@@@@@@@@@@@@@@@@@@@
@@@@@@@@@@@@@.....T.......T@@@@@@@@@@@@@@@@@@@@@@@@@
@@@@@@@@@@@@@@.......TT...@@@@@@@@@@@@@@@@@@@@@@@@@@
@@@@@@@@@@@@@@@@@@@@@@@@@@@@@@@@@@@@@@@@@@@@@@@@@@@@
