type octile
height 54
width 52
map
@@@@@@@@@@@@@@@@@@@@@@@@@@@@@@@@@@@@@@@@@@@@@@@@@@@@
@@@@@@@@@@@@@@@@@@@@@@@@@@@@@@@@@@@@@@@@@@@@@@@@@@@@
@@@@@@@@@@@@@@@@@@@@@@@@@@@@@@@@@@@@@@@@@@@@@@@@@@@@
@@@@@@@@@@@@@@@@@@@@@@@@@@@@@@@@@@@@@@@@@@@@@@@@@@@@
@@@@@@@@@@@@@@@@@@@@@@@@@@@@@@@@@@@@@@@@@@@@@@@@@@@@
@@@@@@@@@@@@@@@@@@@@@@@@@@@@@@@@@@@@@@@@@@@@@@@@@@@@
@@@@@@@@@@@@@@@@@@@@@@@@@@@@@@@@@@@@@@@@@@@@@@@@@@@@
@@@@@@@@@@@@@@@@@@@@@@@@@@@@@@@@@@@@@@@@@@@@@@@@@@@@
@@@@@@@@@@@@@@@@@@@@@@@@@@@@@@@@@@@@@@@@@@@@@@@@@@@@
@@@@@@@@@@@@@@@@@@@@@@@@@@@@@@@@@@@@@@@@@@@@@@@@@@@@
@@@@@@@@@@@@@@@@@@@@@@@@@@@@@@@@@@@@@@@@@@@@@@@@@@@@
@@@@@@@@@@@@@@@@@@@@@@@@@@@@@@@@@@@@@@@@@@@@@@@@@@@@
@@@@@@@@@@@@@@@@@@@@@@@@@@@@@@@@@@@@@@@@@@@@@@@@@@@@
@@@@@@@@@@@@@@@@@@@@@@@@@@@@@.@@@@@@@@@@@@@@@@@@@@@@
@@@@@@@@@@@@@@@@@@@@@@@@@@@@T...@@@@@@@@@@@@@@@@@@@@
@@@@@@@@@@@@@@@@@@@@@@@@@@@@@.T...@@@@@@@@@@@@@@@@@@
@@@@@@@@@@@@@@@@@@@@@@@@@@@@@@....@@@@@@@@@@@@@@@@@@
@@@@@@@@@@@@@@@@@@@@@@@@@@@@@TT....T.@@@@@@@@@@@@@@@
@@@@@@@@@@@@@@@@@@@@@@@@@@TT....TT..T@@@@@@@@@@@@@@@
@@@@@@@@@@@@@@@@@@@@@@@@@@...T..TT.....@@@@@@@@@@@@@
@@@@@@@@@@@@@@@@@@@@@@@@@@.T............@@@@@@@@@@@@
@@@@@@@@@@@@@@@@@@@@@@@@.....T.T..TT......@@@@@@@@@@
@@@@@@@@@@@@@@@@@@@@@@@.T...........TT.....@@@@@@@@@
@@@@@@@@@@@@@@@@@@@@@@.T.......T....T....T..@@@@@@@@
@@@@@@@@@@@@@@@@@.@@@@...T...T.T..T.T..T.....@@@@@@@
@@@@@@@@@@@@@@@@TTT@@@.T@@@@TT...T.....T..T...@@@@@@
@@@@@@@@@@@@@@@T........@@@@@.....TTT.......T.@@@@@@
@@@@@@@@@@@@@@.....TTT.@@@@@@@..T.TT...T.T..T.@@@@@@
@@@@@@@@@@@@@TTT..TT..@@@@@@@@@..T....T...TT.@@@@@@@
@@@@@@@@@@@@@T.....T.@@@@@@@@@@T.T..........@@@@@@@@
@@@@@@@@@@@@@@......T@@@@@@@@@...........TT@@@@@@@@@
@@@@@@@@@@@@@@@T.T...@@@@@@@@......T...T.T@@@@@@@@@@
@@@@@@@@@@@@@@.......@@@@@@@@...T.T..T..T@@@@@@@@@@@
@@@@@@@@@@@@@..T.TT..@@@@@@TT....T......@@@@@@@@@@@@
@@@@@@@@@@@@....T.....T..TTT...........@@@@@@@@@@@@@
@@@@@@@@@@@T.....T..TTTTT.TT........T.@@@@@@@@@@@@@@
@@@@@@.@@@.T......TTT...TTT........T.@@@@@@@@@@@@@@@
@@@@@@.T@....T.T.......TT..T........@@@@@@@@@@@@@@@@
@@@@@@...TT.T.T.T.T.TT..........TT.@@@@@@@@@@@@@@@@@
@@@@@@...T.T.T........T...T.T.....@@@@@@@@@@@@@@@@@@
@@@@@@T...T........T.T.TT..T.TT..@@@@@@@@@@@@@@@@@@@
@@@@@@.T....T..TTT.......T......@@@@@@@@@@@@@@@@@@@@
@@@@@@@....T....T.T...........T@@@@@@@@@@@@@@@@@@@@@
@@@@@@@@.T....T...T..T........@@@@@@@@@@@@@@@@@@@@@@
@@@@@@@@@.T......T...T.T.....@@@@@@@@@@@@@@@@@@@@@@@
@@@@@@@@@@T..TT..T.T.T.T...T@@@@@@@@@@@@@@@@@@@@@@@@
@@@@@@@@@@@....T...........@@@@@@@@@@@@@@@@@@@@@@@@@
@@@@@@@@@@@@..T...TT....T.@@@@@@@@@@@@@@@@@@@@@@@@@@
@@@@@@@@@@@@@..T.TT..TT.T@@@@@@@@@@@@@@@@@@@@@@@@@@@
@@@@@@@@@@@@@@T.........@@@@@@@@@@@@@@@@@@@@@@@@@@@@
@@@@@@@@@@@@@@@..TT.T..@@@@@@@@@@@@@@@@@@@@@@@@@@@@@
@@@@@@@@@@@@@@@@...TT.@@@@@@@@@@@@@@@@@@@@@@@@@@@@@@
@@@@@@@@@@@@@@@@@....@@@@@@@@@@@@@@@@@@@@@@@@@@@@@@@
@@@@@@@@@@@@@@@@@@@@@@@@@@@@@@@@@@@@@@@@@@@@@@@@@@@@
