type octile
height 64
width 60
map
@@@@@@@@@@@@@@@@@@@@@@@@@@@@@@@@@@@@@@@@@@@@@@@@@@@@@@@@@@@@
@@@@@@@@@@@@@@@@@@@@@@@@@@@@@@@@@@@@@@@@@@@@@@@@@@@@@@@@@@@@
@@@@@@@@@@@@@@@@@@@@@@@@@@@@@@@@@@@@@@@@@@@@@@@@@@@@@@@@@@@@
@@@@@@@@@@@@@@@@@@@@@@@@@@@@@@@@@@@@@@@@@@@@@@@@@@@@@@@@@@@@
@@@@@@@@@@@@@@@@@@@@@@@@@@@@@@@@@@@@@@@@@@@@@@@@@@@@@@@@@@@@
@@@@@@@@@@@@@@@@@@@@@@@@@@@@@@@@@@@@@@@@@@@@@@@@@@@@@@@@@@@@
@@@@@@@@@@@@@@@@@@@@@@@@@@@@@@@@@@@@@@@@@@@@@@@@@@@@@@@@@@@@
@@@@@@@@@@@@@@@@@@@@@@@@@@@@@@@@@@@@@@@@@@@@@@@@@@@@@@@@@@@@
@@@@@@@@@@@@@@@@@@@@@@@@@@@@@@@@@@@@@@@@@@@@@@@@@@@@@@@@@@@@
@@@@@@@@@@@@@@@@@@@@@@@@@@@@@@@@@@@@@@@@@@@@@@@@@@@@@@@@@@@@
@@@@@@@@@@@@@@@@@@@@@@@@@@@@@@@@@@@@@@@@@@@@@@@@@@@@@@@@@@@@
@@@@@@@@@@@@@@@@@@@@@@@@@@@@@@@@@@@@@@@@@@@@@@@@@@@@@@@@@@@@
@@@@@@@@@@@@@@@@@@@@@@@@@@@@@@@@@@@@@@@@@@@@@@@@@@@@@@@@@@@@
@@@@@@@@@@@@@@@@@@@@@@@@@@@@@@@@@@@@@@@@@@@@@@@@@@@@@@@@@@@@
@@@@@@@@@@@@@@@@@@@@@@@@@@@@@@@@@@@@@@@@@@@@@@@@@@@@@@@@@@@@
@@@@@@@@@@@@@@@@@@@@@@@@@@@@@@@@@@@@@@@@@@@@@@@@@@@@@@@@@@@@
@@@@@@@@@@@@@@@@@@@@@@@@@@@@@@@@@@@@TT@@@@@@@@@@@@@@@@@@@@@@
@@@@@@@@@@@@@@@@@@@@@@@@@@@@@@@@@@@@.TT...@@@@@@@@@@@@@@@@@@
@@@@@@@@@@@@@@@@@@@@@@@@@@@@@@@@@@@...T...@@@@@@@@@@@@@@@@@@
@@@@@@@@@@@@@@@@@@@@@@@@@@@@@@@@@@..T.....T@@@@@@@@@@@@@@@@@
@@@@@@@@@@@@@@@@@@@@@@@@@@@@@@@@@........T.T.@@@@@@@@@@@@@@@
@@@@@@@@@@@@@@@@@@@@@@@@@@@@@@@@..............@@@@@@@@@@@@@@
@@@@@@@@@@@@@@@@@@@@@@@@@@@@@@@@@.@@......T.T..@@@@@@@@@@@@@
@@@@@@@@@@@@@@@@@@@@@@@@@@@@@@@@@.@@T......T....@@@@@@@@@@@@
@@@@@@@@@@@@@@@@@@@@@@@@@@@@@@@@T..T.....@@.T...@@@@@@@@@@@@
@@@@@@@@@@@@@@@@@@@@@@@@@@@.@@.T..TT.....@@......@@@..@@@@@@
@@@@@@@@@@@@@@@@@@@@@@@@@@............T..@T...T..T@@...@@@@@
@@@@@@@@@@@@@@@@@@@@@@@@@@..T...TT.....T...TT..T..T.T.T@@@@@
@@@@@@@@@@@@@@@@@@@@@@@@@......T......T..T...T.......T..@@@@
@@@@@@@@@@@@@@@@@@@@@@@@T...TT.........T..T...T.....T...@@@@
@@@@@@@@@@@@@@@@@@@@@........@..................T......@@@@@
@@@@@@@@@@@@@@@@@@@@@@@...T.@@@.TTT...T.T.T...T...T...@@@@@@
@@@@@@@@@@@@@@@@@@@@@@@@...@@@@@.T.T...T.T.T.........@@@@@@@
@@@@@@@@@@@@@@@@@@@@@@@@..@@@@@@@......T.T.....T....@@@@@@@@
@@@@@@@@@@@@@@@@@@@@@@@T..@@@@@@@@...TT...T.T..TT..@@@@@@@@@
@@@@@@@@@@@@@@@@@@@@@....TT@@@@@@@@..T.T...T......@@@@@@@@@@
@@@@@@@@@@@@@@@@@@@@T.TTTT.T@@@@@@@....TT.T......@@@@@@@@@@@
@@@@@@@@@@@@@@@@@@@...T.T.T..@@@@@TT...T..T..T.T@@@@@@@@@@@@
@@@@@@@@@@@@@@@@@@..........T.@@@T...T....TTT..@@@@@@@@@@@@@
@@@@@@@@@@@@@@@@@..T..T.....T.......T..T......@@@@@@@@@@@@@@
@@@@@@@@@@@@@@@@.T........T..T....T...T.TT.T.@@@@@@@@@@@@@@@
@@@@@@@@@@@@@@@..@@@.T.T.T.T.....T...T..T..T@@@@@@@@@@@@@@@@
@@@@@@T@@@@@@@@.@@@@@.T..T.T..TT.T.........@@@@@@@@@@@@@@@@@
@@@@@.T.@@@@@@T.@@@@@@.TTTT...T....T...T..@@@@@@@@@@@@@@@@@@
@@@@.....T@@@....@@@@@@........T.........@@@@@@@@@@@@@@@@@@@
@@@.T...TT.@T..T..@@@@@..T..T..T.....TT.@@@@@@@@@@@@@@@@@@@@
@@.T.....T....T...T@@@.....TT........T.@@@@@@@@@@@@@@@@@@@@@
@@.T.......TT.....T..T...T............@@@@@@@@@@@@@@@@@@@@@@
@@@T....TT.T...TT....T.T.............@@@@@@@@@@@@@@@@@@@@@@@
@@@@T.......T..TT..........TT..T....@@@@@@@@@@@@@@@@@@@@@@@@
@@@@@.T.T......T.TT..T........T....@@@@@@@@@@@@@@@@@@@@@@@@@
@@@@@@.....TT...T......T.....T..T.@@@@@@@@@@@@@@@@@@@@@@@@@@
@@@@@@@.T....TT.T...T..T........T@@@@@@@@@@@@@@@@@@@@@@@@@@@
@@@@@@@@...........TT.......T..T@@@@@@@@@@@@@@@@@@@@@@@@@@@@
@@@@@@@@@..T.......T...T......T@@@@@@@@@@@@@@@@@@@@@@@@@@@@@
@@@@@@@@@@.....T...T..T.......@@@@@@@@@@@@@@@@@@@@@@@@@@@@@@
@@@@@@@@@@@.T..........T....@@@@@@@@@@@@@@@@@@@@@@@@@@@@@@@@
@@@@@@@@@@@@...T....T.TT...@@@@@@@@@@@@@@@@@@@@@@@@@@@@@@@@@
@@@@@@@@@@@@@.T..T..T.....@@@@@@@@@@@@@@@@@@@@@@@@@@@@@@@@@@
@@@@@@@@@@@@@@T.T.....T..@@@@@@@@@@@@@@@@@@@@@@@@@@@@@@@@@@@
@@@@@@@@@@@@@@@.....T.T.@@@@@@@@@@@@@@@@@@@@@@@@@@@@@@@@@@@@
@@@@@@@@@@@@@@@@..TT..T@@@@@@@@@@@@@@@@@@@@@@@@@@@@@@@@@@@@@
@@@@@@@@@@@@@@@@@@@@@@@@@@@@@@@@@@@@@@@@@@@@@@@@@@@@@@@@@@@@
@@@@@@@@@@@@@@@@@@@@@@@@@@@@@@@@@@@@@@@@@@@@@@@@@@@@@@@@@@@@
