type octile
height 70
width 68
map
@@@@@@@@@@@@@@@@@@@@@@@@@@@@@@@@@@@@@@@@@@@@@@@@@@@@@@@@@@@@@@@@@@@@
@@@@@@@@@@@@@@@@@@@@@@@@@@@@@@@@@@@@@@@@@@@@@@@@@@@@@@@@@@@@@@@@@@@@
@@@@@@@@@@@@@@@@@@@@@@@@@@@@@@@@@@@@@@@@@@@@@@@@@@@@@@@@@@@@@@@@@@@@
@@@@@@@@@@@@@@@@@@@@@@@@@@@@@@@@@@@@@@@@@@@@@@@@@@@@@@@@@@@@@@@@@@@@
@@@@@@@@@@@@@@@@@@@@@@@@@@@@@@@@@@@@@@@@@@@@@@@@@@@@@@@@@@@@@@@@@@@@
@@@@@@@@@@@@@@@@@@@@@@@@@@@@@@@@@@@@@@@@@@@@@@@@@@@@@@@@@@@@@@@@@@@@
@@@@@@@@@@@@@@@@@@@@@@@@@@@@@@@@@@@@@@@@@@@@@@@@@@@@@@@@@@@@@@@@@@@@
@@@@@@@@@@@@@@@@@@@@@@@@@@@@@@@@@@@@@@@@@@@@@@@@@@@@@@@@@@@@@@@@@@@@
@@@@@@@@@@@@@@@@@@@@@@@@@@@@@@@@@@@@@@@@@@@@@@@@@@@@@@@@@@@@@@@@@@@@
@@@@@@@@@@@@@@@@@@@@@@@@@@@@@@@@@@@@@@@@@@@@@@@@@@@@@@@@@@@@@@@@@@@@
@@@@@@@@@@@@@@@@@@@@@@@@@@@@@@@@.@@@@@@@@@@@@@@@@@@@@@@@@@@@@@@@@@@@
@@@@@@@@@@@@@@@@@@@@@@@@@@@@@@@T..@@@@@@@@@@@@@@@@@@@@@@@@@@@@@@@@@@
@@@@@@@@@@@@@@@@@@@@@@@@@@@@@@T..T.@@@@@@@@@@@@@@@@@@@@@@@@@@@@@@@@@
@@@@@@@@@@@@@@@@@@@@@@@@@@@@@.T.....@@@@@@@@@@@@@@@@@@@@@@@@@@@@@@@@
@@@@@@@@@@@@@@@@@@@@@@@@@@@@@T..T..T.@@@@@@@@@@@@@@@@@@@@@@@@@@@@@@@
@@@@@@@@@@@@@@@@@@@@@@@@@@@@@....TTT....@@@@@@@@@@@@@@@@@@@@@@@@@@@@
@@@@@@@@@@@@@@@@@@@@@@@@@@@@.....TT....T.@@@@@@@@@@@@@@@@@@@@@@@@@@@
@@@@@@@@@@@@@@@@@@@@@@@@@.@.....TTT.......@@@@@@@@@@@@@@@@@@@@@@@@@@
@@@@@@@@@@@@@@@@@@@@@@@@T..T...@@@TT...T.TT@@@@@@@@@@@@@@@@@@@@@@@@@
@@@@@@@@@@@@@@@@@@@@@@@.T.....@@@@..T@@TT.T.@@@@@@@@@@@@@@@@@@@@@@@@
@@@@@@@@@@@@@@@@@@@@@@.......@@@@@@@..@@T..T.@@@@@@@@@@@@@@@@@@@@@@@
@@@@@@@@@@@@@@@@@@@@@.T.T..TT@@@@@@@@T.@@..TT.@@@@@@@@@@@@@@@@@@@@@@
@@@@@@@@@@@@@@@@@@@@.....TT....@@@@@@@T.@.T....@@@@@@@@@@@@@@@@@@@@@
@@@@@@@@@@@@@@@@@@@@@..........@@@@@@@@..T.T....@@@@@@@@@@@@@@@@@@@@
@@@@@@@@@@@@@@@@@.@@@@T.........@@@@@@@......TTT.@@@@@@@@@@@@@@@@@@@
@@@@@@@@@@@@@@@@...@@@@......@@..@@@@@...TT...T..T@@@@@@@@@@@@@@@@@@
@@@@@@@@@@@@@@@@@.TT@@@@T....T@@T.@@@..T..TT.T..TT@@@@@@@@@@@@@@@@@@
@@@@@@@@@@@@@@@@@@T.T@@@@......@@T.@...T..T.....T@@@@@@@@@@@@@@@@@@@
@@@@@@@@@@@@@@@@@@@..@@@@@......@@....T.......TT@@@@@@@@@@@@@@@@@@@@
@@@@@@@@@@@@@@@@@@@@.@@@@@@T.T.....TT.T....TT..@@@@@@@@@@@@@@@@@@@@@
@@@@@@@@@@@@@T@@@@@..T@@@@@@T..T....T.........@@@@@@@@@@@@@@@@@@@@@@
@@@@@@@@@@@@.T.@@@T....@@@@@@...........T....@@@@@@@@@@.@@@@@@@@@@@@
@@@@@@@@@@@T.T.T@.....T.T.@@@@......T.T.....@@@@@@@@@@...@@@@@@@@@@@
@@@@@@@@@@@@..TT......T.....@@@@...T...TT..@@@@@@@@....T.@@@@@@@@@@@
@@@@@@@@@@@@@.......TT.......@@@@........T@@@@@@@@@.TTT.T.@@@@@@@@@@
@@@@@@@@@@@@@@......TT....T..@@@@..T.T.T.@@@@@@@@....T@@..@@@@@@@@@@
@@@@@..T@@@@@TT.....T.T.T....@@@@.T.TT..@@@@@@......T@@@@.T@@@@@@@@@
@@@@@@...@@@........T........T...TT.T.T..@@@@TTT....@@@@@....@@@@@@@
@@@@@@@..T@.T.T..T.....T..@..TT.T..T...T....T....T.@@@@@@.....@@@@@@
@@@@@@@@..T.T....TTT.....@@@.TT..................T.@@@@@.T..T@@@@@@@
@@@@@@@@@T..TTT.........@@@........T..T.......T....@@@@.TTT.@@@@@@@@
@@@@@@@@@@.T..T.....T..@@@..T....T.T.T.......T.@T..@@@@.T.@@@@@@@@@@
@@@@@@@@@@@......T....@@@..........T.T........@@@....@@..@@@@@@@@@@@
@@@@@@@@@@@@..T....T.@@@T...T......T..TT......@@@@....T.@@@@@@@@@@@@
@@@@@@@@@@@@@.....TT@@@@T......T.T.T..T........@@@@..T.@@@@@@@@@@@@@
@@@@@@@@@@@@@.TT.T.@@@@@.TT...T........T....T..T.@@@..@@@@@@@@@@@@@@
@@@@@@@@@@@@@@.T..@@@@@T.......T@@T.......T...TT.T@@@@@@@@@@@@@@@@@@
@@@@@@@@@@@@@@@T.@@@......T....@@@@@......TTTT.T..T@@@@@@@@@@@@@@@@@
@@@@@@@@@@@@@@@@@@@........T.@@@@@@@...T.....T..T..@@@@@@@@@@@@@@@@@
@@@@@@@@@@@@@@@@@@TT.T.T.....@@@@@@@.......T.T.T..@@@@@@@@@@@@@@@@@@
@@@@@@@@@@@@@@@@@@......T.....@@@@@@.@@@....T....@@@@@@@@@@@@@@@@@@@
@@@@@@@@@@@@@@@@@@@T.T...TTT.@@@@@@@@@@@.T.....T@@@@@@@@@@@@@@@@@@@@
@@@@@@@@@@@@@@@@@@@@........@@@@@@@@@@@@T.TT...@@@@@@@@@@@@@@@@@@@@@
@@@@@@@@@@@@@@@@@@@@@.T....T@@@@@@@@@@@T.T...T@@@@@@@@@@@@@@@@@@@@@@
@@@@@@@@@@@@@@@@@@@@@@...T...@@@@@@@@@T.T..T.@@@@@@@@@@@@@@@@@@@@@@@
@@@@@@@@@@@@@@@@@@@@@@@TT...T.@@@@@@@.T.....@@@@@@@@@@@@@@@@@@@@@@@@
@@@@@@@@@@@@@@@@@@@@@@@@..T....@@@@@.......@@@@@@@@@@@@@@@@@@@@@@@@@
@@@@@@@@@@@@@@@@@@@@@@@@@..TT........T..T.@@@@@@@@@@@@@@@@@@@@@@@@@@
@@@@@@@@@@@@@@@@@@@@@@@@@@......T..T....T@@@@@@@@@@@@@@@@@@@@@@@@@@@
@@@@@@@@@@@@@@@@@@@@@@@@@@@.....T..TT...@@@@@@@@@@@@@@@@@@@@@@@@@@@@
@@@@@@@@@@@@@@@@@@@@@@@@@@@@..T.T..T..T@@@@@@@@@@@@@@@@@@@@@@@@@@@@@
@@@@@@@@@@@@@@@@@@@@@@@@@@@@@.T.T..TT.@@@@@@@@@@@@@@@@@@@@@@@@@@@@@@
@@@@@@@@@@@@@@@@@@@@@@@@@@@@@@..T....@@@@@@@@@@@@@@@@@@@@@@@@@@@@@@@
@@@@@@@@@@@@@@@@@@@@@@@@@@@@@@@@.T..@@@@@@@@@@@@@@@@@@@@@@@@@@@@@@@@
@@@@@@@@@@@@@@@@@@@@@@@@@@@@@@@@@@@@@@@@@@@@@@@@@@@@@@@@@@@@@@@@@@@@
@@@@@@@@@@@@@@@@@@@@@@@@@@@@@@@@@@@@@@@@@@@@@@@@@@@@@@@@@@@@@@@@@@@@
@@@@@@@@@@@@@@@@@@@@@@@@@@@@@@@@@@@@@@@@@@@@@@@@@@@@@@@@@@@@@@@@@@@@
@@@@@@@@@@@@@@@@@@@@@@@@@@@@@@@@@@@@@@@@@@@@@@@@@@@@@@@@@@@@@@@@@@@@
@@@@@@@@@@@@@@@@@@@@@@@@@@@@@@@@@@@@@@@@@@@@@@@@@@@@@@@@@@@@@@@@@@@@
@@@@@@@@@@@@@@@@@@@@@@@@@@@@@@@@@@@@@@@@@@@@@@@@@@@@@@@@@@@@@@@@@@@@
