type octile
height 64
width 64
map
@@@@@@@@@@@@@@@@@@@@@@@@@@@@@@@@@@@@@@@@@@@@@@@@@@@@@@@@@@@@@@@@
@@@@@@@@@@@@@@@@@@@@@@@@@@@@@@@@@@@@@@@@@@@@@@@@@@@@@@@@@@@@@@@@
@@@@@@@@@@@@@@@@@@@@@@@@@@@@@@@@@@@@@@@@@@@@@@@@@@@@@@@@@@@@@@@@
@@@@@@@@@@@@@@@@@@@@@@@@@@@@@@@@@@@@@@@@@@@@@@@@@@@@@@@@@@@@@@@@
@@@@@@@@@@@@@@@@@@@@@@@@@@@@@@@@@@@@@@@@@@@@@@@@@@@@@@@@@@@@@@@@
@@@@@@@@@@@@@@@@@@@@@@@@@@@@@@@@@@@@@@@@@@@@@@@@@@@@@@@@@@@@@@@@
@@@@@@@@@@@@@@@@@@@@@@@@@@@@@@@@@@@@@@@@@@@@@@@@@@@@@@@@@@@@@@@@
@@@@@@@@@@@@@@@@@@@@@@@@@@@@@@@@@@@@@@@@@@@@@@@@@@@@@@@@@@@@@@@@
@@@@@@@@@@@@@@@@@@@@@@@@@@@@@@@@@@@@@@@@@@@@@@@@@@@@@@@@@@@@@@@@
@@@@@@@@@@@@@@@@@@@@@@@@@@@@@@@@@@@@.@@@@@@@@@@@@@@@@@@@@@@@@@@@
@@@@@@@@@@@@@@@@@@@@@@@@@@@@@@@@@@@T..@@@@@@@@@@@@@@@@@@@@@@@@@@
@@@@@@@@@@@@@@@@@@@@@@@@@@@@@@@@@@.....@@@@@@@@@@@@@@@@@@@@@@@@@
@@@@@@@@@@@@@@@@@@@@@@@@@@@@@@@@@T..TT..@@@@@@@@@@@@@@@@@@@@@@@@
@@@@@@@@@@@@@@@@@@@@@@@@@@@@@@@@..T....TT@@@@@@@@@@@@@@@@@@@@@@@
@@@@@@@@@@@@@@@@@@@@@@@@@@@@@@@..TT.......@@@@@@@@@@@@@@@@@@@@@@
@@@@@@@@@@@@@@@@@@@@@@@@@@@@@@..T....T...T.@@@@@@@@@@@@@@@@@@@@@
@@@@@@@@@@@@@@@@@@@@@@@@@@@@@..........T...@@@@@@@@@@@@@@@@@@@@@
@@@@@@@@@@@@@@@@@@@@@@@@@@@@..T.@@....T...@@.@@@@@@@@@@@@@@@@@@@
@@@@@@@@@@@@@@@@@@@@@@@@@@@..TTT.@@T.T...@@T.T@@@@@@@@@@@@@@@@@@
@@@@@@@@@@@@@@@@@@@@@@@@@T.TT..TT.@@..T.@@..T..@@@@@@@@@@@@@@@@@
@@@@@@@@@@@@@@@@@@@@@@@@@.....T.TTT@@..@@..T...T@@@@@@@@@@@@@@@@
@@@@@@@@@@@@@@@@@@@@@@@@@.T.........@@@@.....T.T.@@@@@@@@@@@@@@@
@@@@@@@@@@@@@@@@@@@@@@@@@@.........TT@@....T...T...@@@@@@@@@@@@@
@@@@@@@@@@@@@@@@@@@@@@@@@@@..T.T..T....T.T..T.......@@@@@.@@@@@@
@@@@@@@@@@@@@@@@@@@@@@@@@@@@.....T...T........T.........T..@@@@@
@@@@@@@@@@@@@@@@@@@@@@@@@@@@@TT....TTTT..T.....TT.........TT@@@@
@@@@@@@@@@@@@@@@@@@@@@@@@@@@@@.....T.T..T...T..T........T....@@@
@@@@@@@@@@@@@@@@@@@@@@@@@@.@@@@.........T..T.T..T...T.T....TT.@@
@@@@@@@@@@@@@@@@@@@.@@@@@T..@@@@............T.TTT.@@.T.......T.@
@@@@@@@@@@@@@@@@@@T..@@@..T..@@@@.....TT.......T@@@@@TT.T......@
@@@@@@@@@@@@@@@@@@....T....TT.@@@@T.....T....T@@@@@@@@....TT...@
@@@@@@@@@@@@@@@@@@@T....T.T.T..@@...T.T.T.....@@@@@@@@@.....TT@@
@@@@@@@@@@@@@@@@@@@@TT.TT...T...T.......T..T..T@@@@@@@@@....T@@@
@@@@@@@@@@@@@@@@@@@@....T.....T..T..@..T........@@@@@@@@@T..@@@@
@@@@@@@@@@@@.T@@@@......TT....TT...@@@.....T.....@@@@@@@@@T@@@@@
@@@@@@@@@@@..TT@@......T.....@.....@@@@......TT..T@@@@@@@@@@@@@@
@@@@@@@@@@@.....T.T.........@@......@@@@T..TT...T..@@@@@@@@@@@@@
@@@@@@@@@@@@......T.T.T....@@@@......@@@@T.T........@@@@@@@@@@@@
@@@@@T@@@@@@@TT......TTT..@@@@@@..TT..@@@@T..TT..T.T.@@@@@@@@@@@
@@@@...@@@@@@..TT..T....T@@@@@@@....T..@@@@T..........@@@@@@@@@@
@@@.....@@@@...T........@@@@@@@@.T.T.....@@@.....T..T@@@@@@@@@@@
@@@.TT..T@@.T.T...T.T...@@@@@@@.TTTT.T..@@@@@@T...T.@@@@@@@@@@@@
@@@@TTT.............TT.@@@@@@@T...TT..T@@@@@@@@TT.T@@@@@@@@@@@@@
@@@@@T....TT........@..@@@@@@T..T.....@@@@@@@@@@..@@@@@@@@@@@@@@
@@@@@@.T..T..T.....@@@..@@.....T....TT@@@@@@@@@@@@@@@@@@@@@@@@@@
@@@@@@@....T..T.T.@@@@@.TT.TT....T.T..@@@@@@@@@@@@@@@@@@@@@@@@@@
@@@@@@@@.TT..T...@@@@@@@T...T......TTT.@@@@@@@@@@@@@@@@@@@@@@@@@
@@@@@@@@@T......@@@@@@@@.T.T......@@..T.@@@@@@@@@@@@@@@@@@@@@@@@
@@@@@@@@@@....T..@@@@@@.....TT..T@@@@....@@@@@@@@@@@@@@@@@@@@@@@
@@@@@@@@@@@......T@@@@.T.......T@@@@@@TT.T@@@@@@@@@@@@@@@@@@@@@@
@@@@@@@@@@@@.T.....@@.T.TT.T...@@@@@@@@..T.@@@@@@@@@@@@@@@@@@@@@
@@@@@@@@@@@@@.TTT...T...T.......@@@@@@@@..@@@@@@@@@@@@@@@@@@@@@@
@@@@@@@@@@@@@@T......T........TT.@@@@@@@@@@@@@@@@@@@@@@@@@@@@@@@
@@@@@@@@@@@@@@@.T..TT.T....@@.T.T.@@@@@@@@@@@@@@@@@@@@@@@@@@@@@@
@@@@@@@@@@@@@@@@.T..T.....@@@@.T..T@@@@@@@@@@@@@@@@@@@@@@@@@@@@@
@@@@@@@@@@@@@@@@@.T..TT..@@@@@@T....@@@@@@@@@@@@@@@@@@@@@@@@@@@@
@@@@@@@@@@@@@@@@@@T.....@@@@@@@@TT...@@@@@@@@@@@@@@@@@@@@@@@@@@@
@@@@@@@@@@@@@@@@@@@...T..@@@@@@@@...@@@@@@@@@@@@@@@@@@@@@@@@@@@@
@@@@@@@@@@@@@@@@@@@@......@@@@@@@@.@@@@@@@@@@@@@@@@@@@@@@@@@@@@@
@@@@@@@@@@@@@@@@@@@@@T..TT.@@@@@@@@@@@@@@@@@@@@@@@@@@@@@@@@@@@@@
@@@@@@@@@@@@@@@@@@@@@@...TT.@@@@@@@@@@@@@@@@@@@@@@@@@@@@@@@@@@@@
@@@@@@@@@@@@@@@@@@@@@@@T....T@@@@@@@@@@@@@@@@@@@@@@@@@@@@@@@@@@@
@@@@@@@@@@@@@@@@@@@@@@@@...T..@@@@@@@@@@@@@@@@@@@@@@@@@@@@@@@@@@
@@@@@@@@@@@@@@@@@@@@@@@@@@@@@@@@@@@@@@@@@@@@@@@@@@@@@@@@@@@@@@@@
