type octile
height 64
width 60
map
@@@@@@@@@@@@@@@@@@@@@@@@@@@@@@@@@@@@@@@@@@@@@@@@@@@@@@@@@@@@
@@@@@@@@@@@@@@@@@@@@@@@@@@@@@@@@@@@@@@@@@@@@@@@@@@@@@@@@@@@@
@@@@@@@@@@@@@@@@@@@@@@@@@@@@@@@@@@@@@@@@@@@@@@@@@@@@@@@@@@@@
@@@@@@@@@@@@@@@@@@@@@@@@@@@@@@@@@@@@@@@@@@@@@@@@@@@@@@@@@@@@
@@@@@@@@@@@@@@@@@@@@@@@@@@@@@@@@@@@@@@@@@@@@@@@@@@@@@@@@@@@@
@@@@@@@@@@@@@@@@@@@@@@@@@@@@@@@@@@@@@@@@@@@@@@@@@@@@@@@@@@@@
@@@@@@@@@@@@@@@@@@@@@@@@@@@@@@@@@@@@@@@@@@@@@@@@@@@@@@@@@@@@
@@@@@@@@@@@@@@@@@@@@@@@@@@@@@@@@@@@@@@@@@@@@@@@@@@@@@@@@@@@@
@@@@@@@@@@@@@@@@@@@@@@@@@@@@@@@@@@@@@@@@@@@@@@@@@@@@@@@@@@@@
@@@@@@@@@@@@@@@@@@@@@@@@@@@@@@@@@@@@@@@@@@@@@@@@@@@@@@@@@@@@
@@@@@@@@@@@@@@@@@@@@@@@@@@@@@@@@@@@@@@@@@@@@@@@@@@@@@@@@@@@@
@@@@@@@@@@@@@@@@@@@@@@@@@@@@@@@@.@@@@@@@@@@@@@@@@@@@@@@@@@@@
@@@@@@@@@@@@@@@@@@@@@@@@@@@@@@@T.@@@@@@@@@@@@@@@@@@@@@@@@@@@
@@@@@@@@@@@@@@@@@@@@@@@@@@@@@@@..@@@@..T@@@@@@@@@@@@@@@@@@@@
@@@@@@@@@@@@@@@@@@@@@@@@@@@@@@@..@@@@@@T.@@@@@@@@@@@@@@@@@@@
@@@@@@@@@@@@@@@@@@@@@@@@@@@@@@@..@.@@@@@T.@@@@@@@@@@@@@@@@@@
@@@@@@@@@@@@@@@@@@@@@@@@@@@@@@@...T.@@@@@.T@@@@@@@@@@@@@@@@@
@@@@@@@@@@@@@@@@@@@@@@@@@@@@@@@..T...@@@@@..@@@@@@@@@@@@@@@@
@@@@@@@@@@@@@@@@@@@@@@@@@@@@@@@.T....@@@@@T..@@@@@@@@@@@@@@@
@@@@@@@@@@@@@@@@@@@@@@@@@@@@@@@@@.T.T@@@@TT..T..@@@@@@@@@@@@
@@@@@@@@@@@@@@@@@@@@@@@@@@@@@@@@@...TT.......T@.T@@@@@@@@@@@
@@@@@@@@@@@@@@@@@@@@@@@@@@@@@@@TT..T...T.....@@@..@@@@@@@@@@
@@@@@@@@@@@@@@@@@@@@@@@@@@@@@@..TT..T.T...T.@@@...T@@@@@@@@@
@@@@@@@@@@@@@@@@@@@@@@@@@@@@@TT.TT.T.T....T@@@@@....@@@@@@@@
@@@@@@@@@@@@@@@@@@@@@@@@@@..@@.T......T..T.@@@@@@@@..@@@@@@@
@@@@@@@@@@@@@@@@@@@@@@@.@@T@@@T.........T.@@@@@@@@@...@@@@@@
@@@@@@@@@@@@@@@@@@@@@@@.....TT..........TT@@@.@@TT.....@@@@@
@@@@@@@@@@@@@@@@@@@@@@.......T...TT@@@T........T..TT....@@@@
@@@@@@@@@@@@@@@@@@@@T..T..T..T..TT.@@@...TTT..T.......T.@@@@
@@@@@@@@@@@@@@@@@@@.T.T.T.....T.....T..............TTT.@@@@@
@@@@@@@@@@@@@@@@@@..T..@@............TT.......T....TTT@@@@@@
@@@@@@@@@@@@@@@@@..TT.@@@@..@@TT.T...T.......T..T....@@@@@@@
@@@@@@@@@@@@@@@@@....@@@@@@@@@..T.TT...........TT...@@@@@@@@
@@@@@@@T@@@@@@@@.TT@@@@@@@@@.T........T......T...T.@@@@@@@@@
@@@@@@.T.@@@@@@T..@@@@@@@@@@@..@@T...........TT..T@@@@@@@@@@
@@@@@.....@@@@T....@@@@@@@@@@@@@@...T.T.T.T....T.@@@@@@@@@@@
@@@@.....T@@@.T..T.@@@@@@@@@@@@.T.....TT.T.....T@@@@@@@@@@@@
@@@@....TT.@T...T...@.T@@@@@@@@@....T....T.T...@@@@@@@@@@@@@
@@@@@.T..TT@...T..T.....@@@@@@@@@.TT......T...@@@@@@@@@@@@@@
@@@@@TT.T..@@.T.T....TTT@@@@@@@@@@T..T.......@@@@@@@@@@@@@@@
@@@@@@......@.T....T....@@@@@@@@.TT.........@@@@@@@@@@@@@@@@
@@@@@@.....T@@.T.TT..T.@@@@@@@@.T.T..TT....@@@@@@@@@@@@@@@@@
@@@@@@.......@.T.TT...@@@@@@@@...T.....T..@@@@@@@@@@@@@@@@@@
@@@@@...TT..T@@T.T..T@@@@@@@@@@.....T.T..@@@@@@@@@@@@@@@@@@@
@@@@T.T.......@..T..@@@@@@@@@@...TT..TT.@@@@@@@@@@@@@@@@@@@@
@@@@.....T....@.T.T@@@@@@@@T.......T...@@@@@@@@@@@@@@@@@@@@@
@@@@@TT...T..TT..T@@@@@@@@@@.T........@@@@@@@@@@@@@@@@@@@@@@
@@@@@@..T...T....@@@@@@@@.@..T..T..T.@@@@@@@@@@@@@@@@@@@@@@@
@@@@@@@.T.T..T..@@@@@@@@........T...@@@@@@@@@@@@@@@@@@@@@@@@
@@@@@@@@T....T.@@@@@@@@TT..T.......@@@@@@@@@@@@@@@@@@@@@@@@@
@@@@@@@@@T..T.@@@@@@@@@...T...T...@@@@@@@@@@@@@@@@@@@@@@@@@@
@@@@@@@@@@...T.@@@@@@@....TT.....@@@@@@@@@@@@@@@@@@@@@@@@@@@
@@@@@@@@@@@.....@@@@.......T....@@@@@@@@@@@@@@@@@@@@@@@@@@@@
@@@@@@@@@@@@T.T.T@@T..T.TTTT...@@@@@@@@@@@@@@@@@@@@@@@@@@@@@
@@@@@@@@@@@@@.....TT..........@@@@@@@@@@@@@@@@@@@@@@@@@@@@@@
@@@@@@@@@@@@@@T......TT.....@@@@@@@@@@@@@@@@@@@@@@@@@@@@@@@@
@@@@@@@@@@@@@@@T.....T...T.@@@@@@@@@@@@@@@@@@@@@@@@@@@@@@@@@
@@@@@@@@@@@@@@@@...T...TT.@@@@@@@@@@@@@@@@@@@@@@@@@@@@@@@@@@
@@@@@@@@@@@@@@@@@....T...@@@@@@@@@@@@@@@@@@@@@@@@@@@@@@@@@@@
@@@@@@@@@@@@@@@@@@@...T.@@@@@@@@@@@@@@@@@@@@@@@@@@@@@@@@@@@@
@@@@@@@@@@@@@@@@@@@@..T@@@@@@@@@@@@@@@@@@@@@@@@@@@@@@@@@@@@@
@@@@@@@@@@@@@@@@@@@@@@@@@@@@@@@@@@@@@@@@@@@@@@@@@@@@@@@@@@@@
@@@@@@@@@@@@@@@@@@@@@@@@@@@@@@@@@@@@@@@@@@@@@@@@@@@@@@@@@@@@
@@@@@@@@@@@@@@@@@@@@@@@@@@@@@@@@@@@@@@@@@@@@@@@@@@@@@@@@@@@@
