type octile
height 112
width 100
map
@@@@@@@@@@@@@@@@@@@@@@@@@@@@@@@@@@@@@@@@@@@@@@@@@@@@@@@@@@@@@@@@@@@@@@@@@@@@@@@@@@@@@@@@@@@@@@@@@@@@
@@@@@@@@@@@@@@@@@@@@@@@@@@@@@@@@@@@@@@@@@@@@@@@@@@@@@@@@@@@@@@@@@@@@@@@@@@@@@@@@@@@@@@@@@@@@@@@@@@@@
@@@@@@@@@@@@@@@@@@@@@@@@@@@@@@@@@@@@@@@@@@@@@@@@@@@@@@@@@@@@@@@@@@@@@@@@@@@@@@@@@@@@@@@@@@@@@@@@@@@@
@T.T..@@@@@@@@@@@@@@@@@@@@@@@@@@@@@@@@@@@@@@@@@@@@@@@@@@@@@@@@@@@@@@@@@@@@@@@@@@@@@@@@@@@@@@@@@@@@@@
@.T.TT@@@@@@@@@@@@@@@@@@@@@@@@@@@@@@@@@@@@@@@@@@@@@@@@@@@@@@@@@@@@@@@@@@@@@@@@@@@@@@@@@@@@@@@@@@@@@@
@T....@@@@@@@@@@@@@@@@@@@@@@@@@@@@@@@@@@@@@@@@@@@@@@@@@@@@@@@@@@@@@@@@@@@@@@@@@@@@@@@@@@@@@@@@@@@@@@
@....T@@@@@@@@@@@@@@@@@@@@@@@@@@@@@@@@@@@@@@@@@@@@@@@@@@@@@@@@@@@@@@@@@@@@@@@@@@@@@@@@@@@@@@@@@@@@@@
@T....@@@@@@@@@@@@@@@@@@@@@@@@@@@@@@@@@@@@@@@@@@@@@@@@@@@@@@@@@@@@@@@@@@@@@@@@@@@@@@@@@@@@@@@@@@@@@@
@@@@@@@@@@@@@@@@@@@@@@@@@@@@@@@@@@@@@@@@@@@@@@@@@@@@@@@@@@@@@@@@@@@@@@@@@@@@@@@@@@@@@@@@@@@@@@@@@@@@
@@@@@@@@@@@@@@@@@@@@@@@@@@@@@@@@@@@@@@@@@@@@@@@@@@@@@@@@@@@@@@@@@@@@@@@@@@@@@@@@@@@@@@@@@@@@@@@@@@@@
@@@@@@@@@@@@@@@@@@@@@@@@@@@@@@@@@@@@@@@@@@@@@@@@@@@@@@@@@@@@@@@@@@@@@@@@@@@@@@@@@@@@@@@@@@@@@@@@@@@@
@@@@@@@@@@@@@@@@@@@@@@@@@@@@@@@@@@@@@@@@@@@@@@@@@@@@@@@@@@@@@@@@@@@@@@@@@@@@@@@@@@@@@@@@@@@@@@@@@@@@
@@@@@@@@@@@@@@@@@@@@@@@@@@@@@@@@@@@@@@@@@@@@@@@@@@@@@@@@@@@@@@@@@@@@@@@@@@@@@@@@@@@@@@@@@@@@@@@@@@@@
@@@@@@@@@@@@@@@@@@@@@@@@@@@@@@@@@@@@@@@@@@@@@@@@@@@@@@@@@@@@@@@@@@@@@@@@@@@@@@@@@@@@@@@@@@@@@@@@@@@@
@@@@@@@@@@@@@@@@@@@@@@@@@@@@@@@@@@@@@@@@@@@@@@@@@@@@@@@@@@@@@@@@@@@@@@@@@@@@@@@@@@@@@@@@@@@@@@@@@@@@
@@@@@@@@@@@@@@@@@@@@@@@@@@@@@@@@@@@@@@@@@@@@@@@@@@@@@@@@@@@@@@@@@@@@@@@@@@@@@@@@@@@@@@@@@@@@@@@@@@@@
@@@@@@@@@@@@@@@@@@@@@@@@@@@@@@@@@@@@@@@@@@@@@@@@@@@@@@@@@@@@@@@@@@@@@@@@@@@@@@@@@@@@@@@@@@@@@@@@@@@@
@@@@@@@@@@@@@@@@@@@@@@@@@@@@@@@@@@@@@@@@@@@@@@@@@@@@@@@@@@@@@@@@@@@@@@@@@@@@@@@@@@@@@@@@@@@@@@@@@@@@
@@@@@@@@@@@@@@@@@@@@@@@@@@@@@@@@@@@@@@@@@@@@@@@@@@@@@@@@@@@@@@@@@@@@@@@@@@@@@@@@@@@@@@@@@@@@@@@@@@@@
@@@@@@@@@@@@@@@@@@@@@@@@@@@@@@@@@@@@@@@@@@@@@@@@@@@@@@@@@@@@@@@@@@@@@@@@@@@@@@@@@@@@@@@@@@@@@@@@@@@@
@@@@@@@@@@@@@@@@@@@@@@@@@@@@@@@@@@@@@@@@@@@@@@@@@@@@@@@@@@@@@@@@@@@@@@@@@@@@@@@@@@@@@@@@@@@@@@@@@@@@
@@@@@@@@@@@@@@@@@@@@@@@@@@@@@@@@@@@@@@@@@@@@@@@@@@@@@@@@@@@@@@@@@@@@@@@@@@@@@@@@@@@@@@@@@@@@@@@@@@@@
@@@@@@@@@@@@@@@@@@@@@@@@@@@@@@@@@@@@@@@@@@@@@@@@@@@@@@@@@@@@@@@@@@@@@@@@@@@@@@@@@@@@@@@@@@@@@@@@@@@@
@@@@@@@@@@@@@@@@@@@@@@@@@@@@@@@@@@@@@@@@@@@@@@@@@@@@@@@@@@@@@@@@@@@@@@@@@@@@@@@@@@@@@@@@@@@@@@@@@@@@
@@@@@@@@@@@@@@@@@@@@@@@@@@@@@@@@@@@@@@@@@@@@@@@@@@@@@@@@@@@@@@@@@@@@@@@@@@@@@@@@@@@@@@@@@@@@@@@@@@@@
@@@@@@@@@@@@@@@@@@@@@@@@@@@@@@@@@@@@@@@@@@@@@@@@@@@@@@@@@@@@@@@@@@@@@@@@@@@@@@@@@@@@@@@@@@@@@@@@@@@@
@@@@@@@@@@@@@@@@@@@@@@@@@@@@@@@@@@@@@@@@@@.@@@@@@@@@@@@@@@@@@@@@@@@@@@@@@@@@@@@@@@@@@@@@@@@@@@@@@@@@
@@@@@@@@@@@@@@@@@@@@@@@@@@@@@@@@@@@@..@@@T..@@@@@@@@@@@@@@@@@@@@@@@@@@@@@@@@@@@@@@@@@@@@@@@@@@@@@@@@
@@@@@@@@@@@@@@@@@@@@@@@@@@@@@@@@@@@T....TT..T@@@@@@@@@@@@@@@@@@@@@@@@@@@@@@@@@@@@@@@@@@@@@@@@@@@@@@@
@@@@@@@@@@@@@@@@@@@@@@@@@@@@@@@@@@..TT..T.....@@@@@@@@@@@@@@@@@@@@@@@@@@@@@@@@@@@@@@@@@@@@@@@@@@@@@@
@@@@@@@@@@@@@@@@@@@@@@@@@@@@@@@@@.........T........T@@@@@@@@@@@@@@@@@@@@@@@@@@@@@@@@@@@@@@@@@@@@@@@@
@@@@@@@@@@@@@@@@@@@@@@@@@@@@@@@@T.T.....T..T.TTT.....@@@@@@@@@@@@@@@@@@@@@@@@@@@@@@@@@@@@@@@@@@@@@@@
@@@@@@@@@@@@@@@@@@@@@@@@@@@@@@@@@....T..TT......T.....@@@@@@@@@@@@@@@@......@@@@@@@@@@@@@@@@@@@@@@@@
@@@@@@@@@@@@@@@@@@@@@@@@@@@@@@@@@....TT.T..T.T....TT...@@@@@@@@@@@@@@T.......@@@@@@@@@@@@@@@@@@@@@@@
@@@@@@@@@@@@@@@@@@@@@@@@@@@@@@@@...T.....@@@..T........@@@@@@@@@@@@......@@@..@@@@@@@@@@@@@@@@@@@@@@
@@@@@@@@@@@@@@@@@@@@@@@@@@@@@@@.T...@@T..@@@.T.T....T..@@@@@@@@@@@....T.@@@@T..@@@@@@@@@@@@@@@@@@@@@
@@@@@@@@@@@@@@@@@@@@@@@@@@T.@@..T...@@@@@@@@.T.T...T..@@@@@@@@@@@......T@@@@..T.@@@@@@@@@@@@@@@@@@@@
@@@@@@@@@@@@@@@@@@@@@@@@@@T.TTTTT...@@.@@@@....T..T....@@@@@@@@@.T.....T@@@...T.@@@@@@@@@@@@@@@@@@@@
@@@@@@@@@@@@@@@@@@@@@@@@@....T..TT....T@@@@TT...........@@@@@@@@@TT...........T.@@@@@@@@@@@@@@@@@@@@
@@@@@@@@@@@@@@@@@@@@@@@@T.....@@@..T..T.@@@....T..T..T..TT...@@@@.....T..@@@....@@@@@@@@@@@@@@@@@@@@
@@@@@@@@@@@@@@@@@@@@@@@.....T@@@@@.T.T...@@.TT...T....T....T.@@@........@@@@@TT.@@@@@@@@@@@@@@@@@@@@
@@@@@@@@@@@@@@@@@@@@@@@....T@@@@@@@.......@@@............T.....T........@@@@@.T.@@@@@@@@@@@@@@@@@@@@
@@@@@@@@@@@@@@@@@@@@@@@.T.T@@@@@@@@......T@@@..T........TT....TTT.T.TT..@@@@@.T@@@@@@@@@@@@@@@@@@@@@
@@@@@@@@@@@@@@@@@@@@@@@T..@@@@@@@@@T.T.T.TTTT.T.TT......TT..........T..T.@@@.T@@@@@@@@@@@@@@@@@@@@@@
@@@@@@@@@@@@@@@@@@@@@@...@@@@@@@@@@...T...T..........T....T..................@@@@@@@@@@@@@@@@@@@@@@@
@@@@@@@@@@@@@@@@@@@@@T..@@@@@@@@@@..T...T...TTT.TT......T..T..T.....T...T...@@@@@@@@@@@@@@@@@@@@@@@@
@@@@@@@@@@@@@@@@@@@@.T.@@@@@@@@@@@..T..T...TTT........TTT.............T....@@@@@@@@@@@@@@@@@@@@@@@@@
@@@@@@@@@@@@@@@@..T.T..@@@@@@@@@@@....T.T......T...@@@@..T.....T....T...TT@@@@@@@@@@@@@@@@@@@@@@@@@@
@@@@@@@@@@@@@@@.T.......@@@@@@@@@@@.T...T.......T.@@@@@@.......T......T..@@@@@@@@@@@@@@@@@@@@@@@@@@@
@@@@@@@@@@@@@......T.....@@@@@@@@@T..........T...@@@@@@@.T.T..T....TT...@@@@@@@@@@@@@@@@@@@@@@@@@@@@
@@@@@@@@@@@@...T..@@@...TT@@@TT@@...TT.T.@@T..T.@@@..@@.TT....T..........@@@@@@@@@@@@@@@@@@@@@@@@@@@
@@@@@@@@@@@@@...T.@@@T..T..@.....T...TT.@@@.TT.@@@..T...........T.........@@@@@@@@@@@@@@@@@@@@@@@@@@
@@@@@@@@@@@@@..T...@@.........T.T.T..T.@@@....@@@..T........T..TT.......T..@@@@@@@@@@@@@@@@@@@@@@@@@
@@@@@@@@@@@@@.TT..T@@..T.T.....TTT.....@@..T.@@@......T........T.....T..T.@@@@@@@@@@@@@@@@@@@@@@@@@@
@@@@@@@@@@@@......T@@...T...TT....TT.@.@....@@@T.....T.TT........TTT....TT@@@@@@@@@@@@@@@@@@@@@@@@@@
@@@@@@@.@@@T.......@@@@T......T.T...@@.....@@@.T..TT.........T...T..T...T.@@@@@@@@@@@@@@@@@@@@@@@@@@
@@@@@@...@.T......T@@@@@.T.........@@@.T..@@........T..........T.@....T..T.@@@@@@@@@@@@@@@@@@@@@@@@@
@@@@@.T...T...T.....@@@@.....T.T..@@@....@@...T.T..TTTT.......T.@@...T...T..@@@@@@@@@@@@@@@@@@@@@@@@
@@@@@@.TTT.T......@@@@@@@@@....T.@@@TT..@@T...........T....T.T.@@@@..T.T...T.T....@@@@@@@@@@@@@@@@@@
@@@@@@@.T..T.T....@@@T..@@@...TT.@@....@@T.TTT.................@@@TT.......T.T.....@@@@@@@@@@@@@@@@@
@@@@@@@@T.TTT...TT...TT...T....T......@@.T...T..T..........TTTT.@@....T....T.......T@@@@@@@@@@@@@@@@
@@@@@@@@@.....T.........TT.T...T..TTT@@.T..T...T........T...T..@@T..T....T.....T....@@@@@@@@@@@@@@@@
@@@@@@@@@@.T.....T......T.T....T....@@.T...T....T.T.T...TT..T.@@....T....T..TT......@@@@@@@@@@@@@@@@
@@@@@@@@@@@T..T..T.T......T........@@.....T.TTT.T......T...T.@@T...TT.......T......T@@@@@@@@@@@@@@@@
@@@@@@@@@@@@.........TT.....T.T..T@@...........T.....TTTT.TT@@.....@.T..T....T......@@@@@@@@@@@@@@@@
@@@@@@@@@@@@@..T....T..T.T.....T.@@TT......T....T........T.@@.....@@@...........T..TT@@@@@@@@@@@@@@@
@@@@@@@@@@@@@@....T.....TT......@@......TT..T......T......@@.T...@@@@@.........T.....T@@@.@@@@@@@@@@
@@@@@@@@@@@@@@@....T......T...TT@......T..T....T.T..T...T@@.....@@@@@..T.....T......T.T.T..@@@@@@@@@
@@@@@@@@@@@@@@@@T..TT........T.@@@.T....T...TTT...TT..T.@@.TT..@@@@@T.T@T....T............@@@@@@@@@@
@@@@@@@@@@@@@@@@@....T.T...TTT........................T@@.....@@@@@.TT@@@..........TT...T@@@@@@@@@@@
@@@@@@@@@@@@@@@@@...T.......T...T....T..TT......TT.T.T@@T..T...@@@.T.@@@@@..T..T.T..T..T@@@@@@@@@@@@
@@@@@@@@@@@@@@@@@@...T..........T..T.T...T..TTTT.T...@@T..T@@@..@...@@@@@@@TT....T.....@@@@@@@@@@@@@
@@@@@@@@@@@@@@@@@@@...........TT.T......T.....TT.T..@@T.TT@@@@@....@@@@@@@@@..........@@@@@@@@@@@@@@
@@@@@@@@@@@@@@@@@@@@.T.T...T.......TTT..T.....T...T@@.....@@@@.T.T.T@@@@@@@.....T....@@@@@@@@@@@@@@@
@@@@@@@@@@@@@@@@@@@@@TTT.TT.T.T..T..TTT.T.T....T..@@T..T.@@@@..T.....@@@@@...T......@@@@@@@@@@@@@@@@
@@@@@@@@@@@@@@@@@@@@...T....T.T...T.TTT..T.......@@.....@@@@..T.@..T..@@@..T...T.TT@@@@@@@@@@@@@@@@@
@@@@@@@@@@@@@@@@@@@.........T...T...T...T....T..@@T....@@@@....@@@................@@@@@@@@@@@@@@@@@@
@@@@@@@@@@@@@@@@@@..T...T..T..TT.T......TT....T@@....T..@@..T.@@@@@...T.T.TT....T@@@@@@@@@@@@@@@@@@@
@@@@@@@@@@@@@@@@@...T...T....T...........T.@..@@.....@@....T.@@@@@@@.T.T..T.T...@@@@@@@@@@@@@@@@@@@@
@@@@@@@@@@@@@@@@@T...TT.T..T..T.TT.TT.TTTT@@@@@T....@@@@T.TT@@@@@@@@@...T...T.@@@@@@@@@@@@@@@@@@@@@@
@@@@@@@@@@@@@@@@@..T..TT...TT..T..T.T....TTT....T..@@@@.....@@@@@@@@....T....@@@@@@@@@@@@@@@@@@@@@@@
@@@@@@@@@@@@@@@@@@...T.............T.T....T.....T.@@@@..T.T..@@@@@@...T.T...@@@@@@@@@@@@@@@@@@@@@@@@
@@@@@@@@@@@@@@@@@@@..T...T.T.T..TT..TTT...T...T..@@@@.TT@@..T.@@@@T........@@@@@@@@@@@@@@@@@@@@@@@@@
@@@@@@@@@@@@@@@@@@@@T..T...T...TT.T....T..TT....@@@@.TT@@@@...T...T......T@@@@@@@@@@@@@@@@@@@@@@@@@@
@@@@@@@@@@@@@@@@@@@@@....T..T.T......T.TT..T.....@@...@@@@@@...T..T......@@@@@@@@@@@@@@@@@@@@@@@@@@@
@@@@@@@@@@@@@@@@@@@@@@.........T.........T.TT...TT..T@@@@@@@@.T...T.T...@@@@@@@@@@@@@@@@@@@@@@@@@@@@
@@@@@@@@@@@@@@@@@@@@@@@T.T.T...T...T.TT.T.....T.....@@@@@@@@@T.........@@@@@@@@@@@@@@@@@@@@@@@@@@@@@
@@@@@@@@@@@@@@@@@@@@@@@@.T...T....T..T...T...T.......@@@@@@@T.TT.T..T.@@@@@@@@@@@@@@@@@@@@@@@@@@@@@@
@@@@@@@@@@@@@@@@@@@@@@@@@....T...@@@....T..T...T.T..T.@@@@@.T..T..T.T@@@@@@@@@@@@@@@@@@@@@@@@@@@@@@@
@@@@@@@@@@@@@@@@@@@@@@@@@@....T.@@@@@.....T....TT...TT.@@@..T.T.....@@@@@@@@@@@@@@@@@@@@@@@@@@@@@@@@
@@@@@@@@@@@@@@@@@@@@@@@@@@@TT.T@@@@@@@@...TT..T.T...TTTT......T..T.@@@@@@@@@@@@@@@@@@@@@@@@@@@@@@@@@
@@@@@@@@@@@@@@@@@@@@@@@@@@@@@@@@@@@@@@@@.............T.....T.T.T..@@@@@@@@@@@@@@@@@@@@@@@@@@@@@@@@@@
@@@@@@@@@@@@@@@@@@@@@@@@@@@@@@@@@@@@@@@@@T....T....T..T.T..T.....@@@@@@@@@@@@@@@@@@@@@@@@@@@@@@@@@@@
@@@@@@@@@@@@@@@@@@@@@@@@@@@@@@@@@@@@@@@@@@T.......T.T..T..TT..TT@@@@@@@@@@@@@@@@@@@@@@@@@@@@@@@@@@@@
@@@@@@@@@@@@@@@@@@@@@@@@@@@@@@@@@@@@@@@@@@@T.T..TT.......T..T..@@@@@@@@@@@@@@@@@@@@@@@@@@@@@@@@@@@@@
@@@@@@@@@@@@@@@@@@@@@@@@@@@@@@@@@@@@@@@@@@@@T.T......T....T..T@@@@@@@@@@@@@@@@@@@@@@@@@@@@@@@@@@@@@@
@@@@@@@@@@@@@@@@@@@@@@@@@@@@@@@@@@@@@@@@@@@@@..T....TTT.TT.T.@@@@@@@@@@@@@@@@@@@@@@@@@@@@@@@@@@@@@@@
@@@@@@@@@@@@@@@@@@@@@@@@@@@@@@@@@@@@@@@@@@@@@@@........T....@@@@@@@@@@@@@@@@@@@@@@@@@@@@@@@@@@@@@@@@
@@@@@@@@@@@@@@@@@@@@@@@@@@@@@@@@@@@@@@@@@@@@@@@@.....T....T@@@@@@@@@@@@@@@@@@@@@@@@@@@@@@@@@@@@@@@@@
@@@@@@@@@@@@@@@@@@@@@@@@@@@@@@@@@@@@@@@@@@@@@@@@@..T......@@@@@@@@@@@@@@@@@@@@@@@@@@@@@@@@@@@@@@@@@@
@@@@@@@@@@@@@@@@@@@@@@@@@@@@@@@@@@@@@@@@@@@@@@@@@@.T.....@@@@@@@@@@@@@@@@@@@@@@@@@@@@@@@@@@@@@@@@@@@
@@@@@@@@@@@@@@@@@@@@@@@@@@@@@@@@@@@@@@@@@@@@@@@@@@@....T@@@@@@@@@@@@@@@@@@@@@@@@@@@@@@@@@@@@@@@@@@@@
@@@@@@@@@@@@@@@@@@@@@@@@@@@@@@@@@@@@@@@@@@@@@@@@@@@@...@@@@@@@@@@@@@@@@@@@@@@@@@@@@@@@@@@@@@@@@@@@@@
@@@@@@@@@@@@@@@@@@@@@@@@@@@@@@@@@@@@@@@@@@@@@@@@@@@@@@@@@@@@@@@@@@@@@@@@@@@@@@@@@@@@@@@@@@@@@@@@@@@@
@@@@@@@@@@@@@@@@@@@@@@@@@@@@@@@@@@@@@@@@@@@@@@@@@@@@@@@@@@@@@@@@@@@@@@@@@@@@@@@@@@@@@@@@@@@@@@@@@@@@
@@@@@@@@@@@@@@@@@@@@@@@@@@@@@@@@@@@@@@@@@@@@@@@@@@@@@@@@@@@@@@@@@@@@@@@@@@@@@@@@@@@@@@@@@@@@@@@@@@@@
@@@@@@@@@@@@@@@@@@@@@@@@@@@@@@@@@@@@@@@@@@@@@@@@@@@@@@@@@@@@@@@@@@@@@@@@@@@@@@@@@@@@@@@@@@@@@@@@@@@@
@@@@@@@@@@@@@@@@@@@@@@@@@@@@@@@@@@@@@@@@@@@@@@@@@@@@@@@@@@@@@@@@@@@@@@@@@@@@@@@@@@@@@@@@@@@@@@@@@@@@
@@@@@@@@@@@@@@@@@@@@@@@@@@@@@@@@@@@@@@@@@@@@@@@@@@@@@@@@@@@@@@@@@@@@@@@@@@@@@@@@@@@@@@@@@@@@@@@@@@@@
@@@@@@@@@@@@@@@@@@@@@@@@@@@@@@@@@@@@@@@@@@@@@@@@@@@@@@@@@@@@@@@@@@@@@@@@@@@@@@@@@@@@@@@@@@@@@@@@@@@@
@@@@@@@@@@@@@@@@@@@@@@@@@@@@@@@@@@@@@@@@@@@@@@@@@@@@@@@@@@@@@@@@@@@@@@@@@@@@@@@@@@@@@@@@@@@@@@@@@@@@
@@@@@@@@@@@@@@@@@@@@@@@@@@@@@@@@@@@@@@@@@@@@@@@@@@@@@@@@@@@@@@@@@@@@@@@@@@@@@@@@@@@@@@@@@@@@@@@@@@@@
