type octile
height 134
width 124
map
@@@@@@@@@@@@@@@@@@@@@@@@@@@@@@@@@@@@@@@@@@@@@@@@@@@@@@@@@@@@@@@@@@@@@@@@@@@@@@@@@@@@@@@@@@@@@@@@@@@@@@@@@@@@@@@@@@@@@@@@@@@@
@.......@@@@@@@@@@@@@@@@@@@@@@@@@@@@@@@@@@@@@@@@@@@@@@@@@@@@@@@@@@@@@@@@@@@@@@@@@@@@@@@@@@@@@@@@@@@@@@@@@@@@@@@@@@@@@@@@@@@@
@.......@@@@@@@@@@@@@@@@@@@@@@@@@@@@@@@@@@@@@@@@@@@@@@@@@@@@@@@@@@@@@@@@@@@@@@@@@@@@@@@@@@@@@@@@@@@@@@@@@@@@@@@@@@@@@@@@@@@@
@..T...T@@@@@@@@@@@@@@@@@@@@@@@@@@@@@@@@@@@@@@@@@@@@@@@@@@@@@@@@@@@@@@@@@@@@@@@@@@@@@@@@@@@@@@@@@@@@@@@@@@@@@@@@@@@@@@@@@@@@
@T.TT.TT@@@@@@@@@@@@@@@@@@@@@@@@@@@@@@@@@@@@@@@@@@@@@@@@@@@@@@@@@@@@@@@@@@@@@@@@@@@@@@@@@@@@@@@@@@@@@@@@@@@@@@@@@@@@@@@@@@@@
@.T.....@@@@@@@@@@@@@@@@@@@@@@@@@@@@@@@@@@@@@@@@@@@@@@@@@@@@@@@@@@@@@@@@@@@@@@@@@@@@@@@@@@@@@@@@@@@@@@@@@@@@@@@@@@@@@@@@@@@@
@...TT..@@@@@@@@@@@@@@@@@@@@@@@@@@@@@@@@@@@@@@@@@@@@@@@@@@@@@@@@@@@@@@@@@@@@@@@@@@@@@@@@@@@@@@@@@@@@@@@@@@@@@@@@@@@@@@@@@@@@
@......T@@@@@@@@@@@@@@@@@@@@@@@@@@@@@@@@@@@@@@@@@@@@@@@@@@@@@@@@@@@@@@@@@@@@@@@@@@@@@@@@@@@@@@@@@@@@@@@@@@@@@@@@@@@@@@@@@@@@
@@@@@@@@@@@@@@@@@@@@@@@@@@@@@@@@@@@@@@@@@@@@@@@@@@@@@@@@@@@@@@@@@@@@@@@@@@@@@@@@@@@@@@@@@@@@@@@@@@@@@@@@@@@@@@@@@@@@@@@@@@@@
@@@@@@@@@@@@@@@@@@@@@@@@@@@@@@@@@@@@@@@@@@@@@@@@@@@@@@@@@@@@@@@@@@@@@@@@@@@@@@@@@@@@@@@@@@@@@@@@@@@@@@@@@@@@@@@@@@@@@@@@@@@@
@@@@@@@@@@@@@@@@@@@@@@@@@@@@@@@@@@@@@@@@@@@@@@@@@@@@@@@@@@@@@@@@@@@@@@@@@@@@@@@@@@@@@@@@@@@@@@@@@@@@@@@@@@@@@@@@@@@@@@@@@@@@
@@@@@@@@@@@@@@@@@@@@@@@@@@@@@@@@@@@@@@@@@@@@@@@@@.@@@@@@@@@@@@@@@@@@@@@@@@@@@@@@@@@@@@@@@@@@@@@@@@@@@@@@@@@@@@@@@@@@@@@@@@@@
@@@@@@@@@@@@@@@@@@@@@@@@@@@@@@@@@@@@@@@@@@@@@@@@T..@@@@@@@@@@@@@@@@@@@@@@@@@@@@@@@@@@@@@@@@@@@@@@@@@@@@@@@@@@@@@@@@@@@@@@@@@
@@@@@@@@@@@@@@@@@@@@@@@@@@@@@@@@@@@@@@@@@@@@@@..T...@@@@@@@@@@@@@@@@@@@@@@@@@@@@@@@@@@@@@@@@@@@@@@@@@@@@@@@@@@@@@@@@@@@@@@@@
@@@@@@@@@@@@@@@@@@@@@@@@@@@@@@@@@@@@@@@@@@@@@T..T...T@@@@@@@@@@@@@@@@@@@@@@@@@@@@@@@@@@@@@@@@@@@@@@@@@@@@@@@@@@@@@@@@@@@@@@@
@@@@@@@@@@@@@@@@@@@@@@@@@@@@@@@@@@@@@@@@@@@@..........@@@@@@@@@@@@@@@@@@@@@@@@@@@@@@@@@@@@@@@@@@@@@@@@@@@@@@@@@@@@@@@@@@@@@@
@@@@@@@@@@@@@@@@@@@@@@@@@@@@@@@@@@@@@@@@@@@.T.TT..TT..T@@@@@@@@@@@@@@@@@@@@@@@@@@@@@@@@@@@@@@@@@@@@@@@@@@@@@@@@@@@@@@@@@@@@@
@@@@@@@@@@@@@@@@@@@@@@@@@@@@@@@@@@@@@@@@@@..T...@@......@@@@@@@@@@@@@@@@@@@@@@@@@@@@@@@@@@@@@@@@@@@@@@@@@@@@@@@@@@@@@@@@@@@@
@@@@@@@@@@@@@@@@@@@@@@@@@@@@@@@@@@@@@@@@@...T.T@@@@.....T@@@@@@@@@@@@@@@@@@@@@@@@@@@@@@@@@@@@@@@@@@@@@@@@@@@@@@@@@@@@@@@@@@@
@@@@@@@@@@@@@@@@@@@@@@@@@@@@@@@@@@@@@@@@.....T@@@@@..TT...@@@@@@@@@@@@@@@@@@@@@@@@@@@@@@@@@@@@@@@@@@@@@@@@@@@@@@@@@@@@@@@@@@
@@@@@@@@@@@@@@@@@@@@@@@@@@@@@@@@@@@@@@@..T...@@@@@@@T...TT.@@@@@@@@@@@@@@@@@@@@@@@@@@@@@@@@@@@@@@@@@@@@@@@@@@@@@@@@@@@@@@@@@
@@@@@@@@@@@@@@@@@@@@@@@@@@@@@@@@@@@@@@.T...T@@@@@@@@.T...T..T@@@@@@@@@@@@@@@@@@@@@@@@@@@@@@@@@@@@@@@@@@@@@@@@@@@@@@@@@@@@@@@
@@@@@@@@@@@@@@@@@@@@@@@@@@@@@@@@@@@@@......@@@@@@@@@.....TT...@@@@@@@@@@@@@@@@@@@@@@@@@@@@@@@@@@@@@@@@@@@@@@@@@@@@@@@@@@@@@@
@@@@@@@@@@@@@@@@@@@@@@@@@@@@@@@@@@@@......@@@@@@@@@@@.....TT...@@@@@@@@@@@@@@@@@@@@@@@@@@@@@@@@@@@@@@@@@@@@@@@@@@@@@@@@@@@@@
@@@@@@@@@@@@@@@@@@@@@@@@@@@@@@@@@@...T..T@@@@@@@.T@@@.T.........@@@@@@@@@@@@@@@@@@@@@@@@@@@@@@@@@@@@@@@@@@@@@@@@@@@@@@@@@@@@
@@@@@@@@@@@@@@@@@@@@@@@@@@@@@@@@@.T..T..@@@@@@@....@@..TT.....T.@@@@@@@@@@@@@@@@@@@@@@@@@@@@@@@@@@@@@@@@@@@@@@@@@@@@@@@@@@@@
@@@@@@@@@@@@@@@@@@@@@@@@@@@@@@@@....T..@@@@@@@T.TT.....@@@@...T..T@@@@@@@@@@@@@@@@@@@@@@@@@@@@@@@@@@@@@@@@@@@@@@@@@@@@@@@@@@
@@@@@@@@@@@@@@@@@@@@@@@@@@@@@@@.......@@@@@@@.......T.T@@@@@...T...@@@@@@@@@@@@@@@@@@@@@@@@@@@@@@@@@@@@@@@@@@@@@@@@@@@@@@@@@
@@@@@@@@@@@@@@@@@@@@@@@@@@@@@@@T.TT.T@@@@@@@...T........@@@@@.T....T@@@@@@@@@@@@@@@@@@@@@@@@@@@@@@@@@@@@@@@@@@@@@@@@@@@@@@@@
@@@@@@@@@@@@@@@@@@@@@@@@@@@@@T......@@@@@@@......T..T.T@@@@@@.....T..@@@@@@@@@@@@@@@@@@@@@@@@@@@@@@@@@@@@@@@@@@@@@@@@@@@@@@@
@@@@@@@@@@@@@@@@@@@@@@@@@@@@T..T.T.@@@@@@@@...........@@@@@@@.......T.@@@@@@@@@@@@@@@@@@@@@@@@@@@@@@@@@@@@@@@@@@@@@@@@@@@@@@
@@@@@@@@@@@@@@@@@@@@@@@@@@@T......@@@@@@@@@@T....TTT.@@@@@@@@.T.T...T.T@@@@@@@@@@@@@@@@@@@@@@@@@@@@@@@@@@@@@@@@@@@@@@@@@@@@@
@@@@@@@@@@@@@@@@@@@@@@@@@@..T.....@@@@@@@@@@@T..TT.T@@@@@@@@@T..T..T.T..@@@@@@@@@@@@@@@@@@@@@@@@@@@@@@@@@@@@@@@@@@@@@@@@@@@@
@@@@@@@@@@@@@@@@@@@@@@@@@....T....@@@@@@@@@@@@..T..@@@@@@@TT@T.T.T.T..TT.@@@@@@@@@@@@@@@@@@@@@@@@@@@@@@@@@@@@@@@@@@@@@@@@@@@
@@@@@@@@@@@@@@@@@@@@@@@@T..T..T..T@@@TT@@@@@@@@...@@@@@@@.....T.@@...TT..T@@@@@@@@@@@@@@@@@@@@@@@@@@@@@@@@@@@@@@@@@@@@@@@@@@
@@@@@@@@@@@@@@@@@@@@@@@TT..T.T@T.T@@TT.@@@@@@@@@.@@@@@@@@.T....@@@@@T...T.T@@@@@@@@@@@@@@@@@@@@@@@@@@@@@@@@@@@@@@@@@@@@@@@@@
@@@@@@@@@@@@@@@@@@@@@@.TT....@@@..@.....@@@@@@@@@@@@@@@@@...T...@@@@..T....T@@@@@@@@@@@@@@@@@@@@@@@@@@@@@@@@@@@@@@@@@@@@@@@@
@@@@@@@@@@@@@@@@@@@@@...T.T.@@@@..T......@@@@@@@@@@@@@@@..T..T.@@@@@@........@@@@@@@@@@@@@@@@@@@@@@@@@@@@@@@@@@@@@@@@@@@@@@@
@@@@@@@@@@@@@@@@@@@@..TT...@@@@@.TTT.TT.T.@@@@@@@@@@@@@...T...@@@@@@@.......T..@@@@@@@@@@@@@@@@@@@@@@@@@@@@@@@@@@@@@@@@@@@@@
@@@@@@@@@@@@@@@@@@@.TT....@@@@@.T........TT@@@@@@@@@@@@......@@@@@@@@@.TT......T@@@@@@@@@@@@@@@@@@@@@@@@@@@@@@@@@@@@@@@@@@@@
@@@@@@@@@@@@@@@@@@T......@@@@@@......T.T..T@@@@@@@@@@.TTT...@@@@@@@@@@.....T.T...@@@@@@@@@@@@@@@@@@@@@@@@@@@@@@@@@@@@@@@@@@@
@@@@@@@@@@@@@@@@@.......@@@@@@@@T.....T...@@@@@@@@@@@@TT..T@@@@@@@TT.@.T.T....TT..@@@@@@@@@@@@@@@@@@@@@@@@@@@@@@@@@@@@@@@@@@
@@@@@@@@@@@@@@@@T.T..T..@@@@@@@@@.T.T....@@@@@@@@@@@@@@...@@@@@@@.........T..T.T..@@@@@@@@@@@@@@@@@@@@@@@@@@@@@@@@@@@@@@@@@@
@@@@@@@@@@@@@@@T.T.T...@@@@@@@@@@@T.T...@@@@@@@@@@@@@@@@.@@@@@@@.T..TT.T@@.....T....@@@@@@@@@@@@@@@@@@@@@@@@@@@@@@@@@@@@@@@@
@@@@@@@@@@@@@@.........@@@@@@@@@@@@T...@@@@@@@@T@@@@@@@@@@@@@@@@@....T...@@.......T..@@@@@@@@@@@@@@@@@@@@@@@@@@@@@@@@@@@@@@@
@@@@@@@@@@@@@.T..T....T@@@.@@@@@@@@@@.@@@@@@@@@T.T.@@@@@@@@@@@@@T.T...TT@@@@.....T..T.@@@@@@@@@@@@@@@@@@@@@@@@@@@@@@@@@@@@@@
@@@@@@@@@@@....T.......@@..T@@@@@@@@@@@@@@@@@@TTTT.@@@@@@@@@@@@..T.....@@@@@@...TTTT.@@@@@@@@@@@@@@@@@@@@@@@@@@@@@@@@@@@@@@@
@@@@@@@@@@.....T..@@.TTT.T.T.@@@@@@@@@@@@@@@.........@@@@@@@@@..T.TT.T@@@@@@@T.TT..T@@@@@@@@@@@@@@@@@@@@@@@@@@@@@@@@@@@@@@@@
@@@@@@@@@@..T..T.@@@@....TTTT.@@@@@@@@@@@@@..........@@@@@@@@..TT..T.@@@@@@@.TT....@@@@@@@@@@@@@@@@@@@@@@@@@@@@@@@@@@@@@@@@@
@@@@@@@@@...T.T..@@@@T....T...T@@@@@@@@@@@.T.TT....T..@@@@@@@@....T.@@@@@@@..TT...@@@@@@@@@@@@@@@@@@@@@@@@@@@@@@@@@@@@@@@@@@
@@@@@@@@T.......@@@....T.T......@@@@@@@@@T..........T...@@@@@@@.T..@@@@@@@@..T..T@@@@@@@@@@@@@@@@@@@@@@@@@@@@@@@@@@@@@@@@@@@
@@@@@@@.......T@@@@@....TT......@@@@@@@@.........T.......@@@@@@@..@@@@@@@@...TTT@@@@@@@@@@@@@@@@@@@@@@@@@@@@@@@@@@@@@@@@@@@@
@@@@@@........@@@@@@@.T.T.....T@@@@@@@@...TT....T.TT..T...@@@@@@@@@@@@@@@T...T.@@@@@@@@@@@@@@@@@@@@@@@@@@@@@@@@@@@@@@@@@@@@@
@@@@@.T.......@@@@@@@@T.T.....@@@@@@@@.TT...T..T......T...@@@@@@@@@@@@@@..T..T@@@@@@@@@@@@@@@@@@@@@@@@@@@@@@@@@@@@@@@@@@@@@@
@@@@.......T..@@@@@@@@@.T..T.@@@@@@@@T.T.......@@.T.T...T...@@@@@@@@@@@@..T..@@@@@@@@@@@@@..@@@@@@@@@@@@@@@@@@@@@@@@@@@@@@@@
@@@TT.....T..T.@@@@@@@@@.T..@@@@@@@@T..T.T....@@@@...T......T@@@@@@@@@@T.T..@@@@@@@@@@@@@@..T@@@@@@@@@@@@@@@@@@@@@@@@@@@@@@@
@@@@TT.T..T..T..@@@@@@@@@T.@@@@@@@@...T.TT..T@@@@@@..T.TT...@@@@@@@@@@@T...@@@@@@@@@@@@@@@@...@@@@@@@@@@@@@@@@@@@@@@@@@@@@@@
@@@@@....T..TT...@@@@@@@@@@@@@@@@@T.........@@@@@@@@......T@@@@@@@@@@@.T...@@@@@@@@@@@@@@@@@T.T@@@@@@@@@@@@@@@@@@@@@@@@@@@@@
@@@@@@T.T..T..T...@@@@@@@@@@@@@@@T..T......@@@@@@@@@.TT...@@@@@@@@@@@.T..TT@@@@@@@@@@@@@@@@@@...@@@@@@@@@@@@@@@@@@@@@@@@@@@@
@@@@@@@...T..TT....@@@@@@@@@@@@@...T.....T@@@@@@@@@...T..@@@@@@@@@@@@....T.@@@@@@@@@@.@@@@@@@...@@@@@@@@@@@@@@@@@@@@@@@@@@@@
@@@@@@@@....T.....TT@@@@@@@@@@@TT......T.@@@@@@@@@@..T..@@@@@@@@@@@@@.....T@@@@@@@@@...@@@@@T..@@@@@@@@@@@@@@@@@@@@@@@@@@@@@
@@@@@@@@@T.TT....T.T.@@@@@@@@@@..T..T....@@@@@@@@@TT.T.@@@@@@@@@@@@.T......@@@@@@@@@...T@@...T..@@@@@@@@@@@@@@@@@@@@@@@@@@@@
@@@@@@@@@@...TT..T....@@@@@@@@@T....TT....@@@@@@@...TT@@@@@@@@@@@@..T.T...@@@@@@@@@TT.T.@@.T..TT.T..T@@@@@@@@@@@@@@@@@@@@@@@
@@@@@@@@@@@TT.T.TTTT...@@@@@@@@T.....T.T...@@@@@...T.@@@@@@@@@@@@.T....T.@@@@@@@@@@..TT......TT.......@@@@@@@@@@@@@@@@@@@@@@
@@@@@@@@@@@@...TTT.T....@@@@@@@@T.TT..TT..T@@@@....T@@@@@@@@@@@@....T.T.@@@@@@@@@@@@..T..TTT..T@.T....T@@@@@@@@@@@@@@@@@@@@@
@@@@@@@@@@@@@......T.....@@@@@@@T.......TTT........@@@@@@@@@@@@T.T...T.T.@@@@@@@@@@@@.T.....T.@@@..T...@@@@@@@@@@@@@@@@@@@@@
@@@@@@@@@@@@@@.TT.T.....TT@@@@@@..T.T...T....TT...@@@@@@@@@@@.T...T..T.T@@@@@@@@@@@@@@@.T...T@@@@@..T..@@@@@@@@@@@@@@@@@@@@@
@@@@@@@@@@@@@@@...TT.......@@@@@TT.....T.....T...@@@@@@@@@@@T...T.T....@@@@@@@@@@@@@@@@@..T.@@@@@@@T...@@@@@@@@@@@@@@@@@@@@@
@@@@@@@@@@@@@@@@.TT......TT.@@@@.TT.......T...T.@@@@@@@@@@@@T.T........@@@@@@@@@@@@@@@@@@..@@@@@@@@@T...@@T@@@@@@@@@@@@@@@@@
@@@@@@@@@@@@@@@@@..T.....TT...@@.T.....TT..TT..@@@@@@@@@@@@..T..TT...T.@@@@@@@@@@@@@@@@@@@@@@@@@@@@@..T.....@@@@@@@@@@@@@@@@
@@@@@@@@@@@@@@@@@@..T...T.T.......T.@@@@..T...@@@@@@@@@@@.T.T....T.T...T.@@@@@@@@@@@@@@@@@@@@@@@@@@@.T.T...@@@@@@@@@@@@@@@@@
@@@@@@@@@@@@@@@@@@@@@@@@@.....T.TTT@@@@@@TT.@@@@@@@@@@@@.T....T.T...TTT...@@@@@@@@@@@@@@@@@@@@@@@@@@.....T.@@@@@@@@@@@@@@@@@
@@@@@@@@@@@@@@@@@@@@@@@@@@.......TT@@@@@@@.@@@@@@@@@@@@T............T.T..T@@@@@@@@@@@@@@@@@@@@@@@@@@....TT...@@@@@@@@@@@@@@@
@@@@@@@@@@@@@@@@@@@@@@@@@@@.....TT.T@@@@@@@@@@@@@@@@@@@......T..T..T...T.....@@@@@@@@@@@@@@@@@@@@@@@T..T....T.@@@@@@@@@@@@@@
@@@@@@@@@@@@@@@@@@@@@@@@@@@@..TT.TTT.@@@@@@@@@@@@@@@@..T.......T.TTT..TT.T.TT@@@@@@@@@@@@@@@@@@@@@@@...T.TT.@T.@@@@@@@@@@@@@
@@@@@@@@@@@@@@@@@@@@@@@@@@@@@.TT......@@@@@@@@@@@@@@....T.....T.....T.T.......@@@@@@@@@@@@@@@@@@@@@@T.T....@@@....@@@@@@@@@@
@@@@@@@@@@@@@@@@@@@@@@@@@@@@@..T......@@@@@@@@@@@@@T...TT.T.TTT...T.T..T......T.@@@@@@@@@@@@@@@@@@@@......@@@@@..T.@@@@@@@@@
@@@@@@@@@@@@@@@@@@@@@@@@@@@@@TTT...TT.T@@@@@@@@@@@......TT........T.......TT..TTT@@@@@@@@@@@@@@@@@@.TTTT.@@@@@@@T.T.@@@@@@@@
@@@@@@@@@@@@@@@@@@@@@@@@@@@@@.......TT..@@@@@@@@@@.T......TT........T....T..T.....@@@@@@@@@@@@@@@@TT..TT.@@@@@@@T..T.@@@@@@@
@@@@@@@@@@@@@@@@@@@@@@@@@.@@@T...T...T..@@@@@@@@@.TTT...T.T.T....TT....T..T...TT..@@@@@@@@@@@@@.........T.T@@@@@...T..@@@@@@
@@@@@@@@@@@@@@@@@@@@@@@@...@@..T..T...T..@@@@@@@@@TT......T.T..........T.TT......T..@@@@@@@@@@@.........TT@@@@@TT...T..@@@@@
@@@@@@@@@@@@@@@@@@@@@@@T...T.....T.T......@@@@@@@@@..T....T...........TTT......T.T...@@@@@@@@@@T...T....T.@@@@TT...T...@@@@@
@@@@@@@@@@@@@@@@@@@@@@.........T.@TT......@@@@@@@@@@..T..T..T.T..TTT.T.......T...T..T@@@@@@@@@@...T.T@@T.T@@@.......T.@@@@@@
@@@@@@@@@@@@@@@@@@@@@.......T...@@@...T...@@@@@@@@@@@..T........T..T..T..........T.T...@@@@@@@@..T..@@@@@............@@@@@@@
@@@@@@@@@@@@@@@@@@@@...T....T.TT.@@@T.TT..@@@@@@@@@@@@.........T.T.......T...T.........T@@@@.@@..T.@@@@@@@T..T.....T@@@@@@@@
@@@@@@@@@@@@@@@@@@..TTTTT...TTTT@@@@....T.T@@@@@@@@@@@@.TTT..T..T.TT.T....T.T.T...T...T.@@@T...T...@@@@@@@@..TT..TT@@@@@@@@@
@@@@@@@@@@@@@@@@@...T.T........@@@@@..T..T..@@@@@@@@@@@@.T..T..T.T...T.T.....T....T....T.T........@@@@@@@@@@TT..T.@@@@@@@@@@
@@@@@@@@@@@@@@@@..T.....T.....@@@@@@@T....T..@@@@@@@@@@@@..............T...T.T....T.TT.....T....TT@@@@@@@@@@@TTTT@@@@@@@@@@@
@@@@@@@@@@@@@@@.T.T..T...T..T@@@@@@@@T...T...T@@@@@@@@@@@@TT....T.TT.T.T.......T..T.....T.........@@@@@@@@@@@@..@@@@@@@@@@@@
@@@@@@@@@@@@@@@...........T.@@@@@@@@@@..T.T....@@@@@@@@@@@@.TT....TT..T.T.T....T......TT.T.....TTT@@@@@@@@@@@@@@@@@@@@@@@@@@
@@@@@@@@@@@@@@@@T...T.T....@@@@@@@@@@@..T..T....@@@@@@@@@@@@....T...T....T.....TT.T.....T.....T..@@@@@@@@@@@@@@@@@@@@@@@@@@@
@@@@@@@@@@@@@@@@@...T....@@@@@@@@@@@@...T....T..T@@@@@@@@@@@@...TT.T..........T.....T....T..TT.T@@@@@@@@@@@@@@@@@@@@@@@@@@@@
@@@@@@@@@@@@@@@@@@...TTT@@@@@@@@@@@@.T...T.TT.....@@@@@@@@@@@@......TT....T............T.TT...TT@@@@@@@@@@@@@@@@@@@@@@@@@@@@
@@@@@@@@@@@@@@@@@@@T..T@@@@@@@@@@@@......T....T...T.@@@@@@@@@@@....TT......T.......T.T..T........@@@@@@@@@@@@@@@@@@@@@@@@@@@
@@@@@@@@@@@@@@@@@@@@..@@@@@@@@@@@@....T..T...........@@@@@@@@@@@.......T...TT.TTT.....TT.T...T.....@@@@@@@@@@@@@@@@@@@@@@@@@
@@@@@@@@@@@@@@@@@@@@@@@@@@@@@@@@@....T.T.TTTT@@.T.TT..@@@@@@@@@@@T.......T..............T..T....T.T@@@@@@@@@@@@@@@@@@@@@@@@@
@@@@@@@@@@@@@@@@@@@@@@@@@@@@@@@@T.........T.T@@@.TT....@@@@@@@@@@@........T....T...T...T...T.......T@@@@@@@@@@@@@@@@@@@@@@@@
@@@@@@@@@@@@@@@@@@@@@@@@@@@@@@@.............@@@@T.T..TT.@@@@@@@@@@@......T..T.................T....T..@@@@@@@@@@@@@@@@@@@@@@
@@@@@@@@@@@@@@@@@@@@@@@@@@@@@@T...T.T..T.TT.@@@@........T@@@@@@@@@@@TT....T..T..T.......TT..TT.T.....T.@@@@@@@@@@@@@@@@@@@@@
@@@@@@@@@@@@@@@@@@@@@@@@@@@@@T..T........@@@@@@@..T.......@@@@@@@@@@@TT..T.T.T.TT.T.....T.TTT..T...TTTT.@@@@@@@@@@@@@@@@@@@@
@@@@@@@@@@@@@@@@@@@@@@@@@@@@...TT....T...@@@@@@@@@@@@@@..T.@@@@@@@@@@@TT...T........T....T..T..T.T..TT..T@@@@@@@@@@@@@@@@@@@
@@@@@@@@@@@@@@@@@@@@@@@@@@@.T....T.......@@@@@@@@@@@@@@@....@@@@@@@@@@@..T.T.........T.T...TTT.......T..@@@@@@@@@@@@@@@@@@@@
@@@@@@@@@@@@@@@@@@@@@@@@@@@..T...........@@@@@@@@@@@@@@@.....@@@@@@@@@@@............TT....T........T...@@@@@@@@@@@@@@@@@@@@@
@@@@@@@@@@@@@@@@@@@@@@@@@@@@......TT.....@@@@@@@@@@@@@@@T...T.@@@@@@@@@@@T......T.....T.TTT...........@@@@@@@@@@@@@@@@@@@@@@
@@@@@@@@@@@@@@@@@@@@@@@@@@@@@.......T...TT@@@@@@@@@@@@@@..T..T.@@@@@@@@@@@..T..TT.....TT.......T....TT.@@@@@@@@@@@@@@@@@@@@@
@@@@@@@@@@@@@@@@@@@@@@@@@@@@@@....T..T....T...@@@@@@@@@@.....T..@@@@@@@@@@@..TT..T.T.........TT....TT..@@@@@@@@@@@@@@@@@@@@@
@@@@@@@@@@@@@@@@@@@@@@@@@@@@@@@T...T....T......TT.@@@@@@@.TT..T.T@@@@@@@@@@@..T....T.TT.TT.T......T.T..@@@@@@@@@@@@@@@@@@@@@
@@@@@@@@@@@@@@@@@@@@@@@@@@@@@@@@....T.......T......@@@@@@.........@@@@@@@@@@@.T.T..T.....T...TT.......@@@@@@@@@@@@@@@@@@@@@@
@@@@@@@@@@@@@@@@@@@@@@@@@@@@@@@@@.T.TT..T.....TT.T..@@@@@.T...T....@@@@@@@@@@.T.....T..T.TTT...T.T...@@@@@@@@@@@@@@@@@@@@@@@
@@@@@@@@@@@@@@@@@@@@@@@@@@@@@@@@@@......TTT......T.T@@@@@..T@TTTT...@@@@@@@@@@.T.TT.....T.....TT....@@@@@@@@@@@@@@@@@@@@@@@@
@@@@@@@@@@@@@@@@@@@@@@@@@@@@@@@@@@@.T.T......T...T...T@@@T.@@@@T..T..@@@@@@@@@@...T.......T.T...T.T@@@@@@@@@@@@@@@@@@@@@@@@@
@@@@@@@@@@@@@@@@@@@@@@@@@@@@@@@@@@@@T.T.T...........@@@@@.T@@@@T.T..T.@@@@@@@@@T.TTTT.........T@T.@@@@@@@@@@@@@@@@@@@@@@@@@@
@@@@@@@@@@@@@@@@@@@@@@@@@@@@@@@@@@@@@..TT.T........@@@@@..T@@@@........@@@@@@@@@........T....T@@@@@@@@@@@@@@@@@@@@@@@@@@@@@@
@@@@@@@@@@@@@@@@@@@@@@@@@@@@@@@@@@@@@@......T...T...@@@@...@@.......TT.T@@@@@@@@@T.T........T@@@@@@@@@@@@@@@@@@@@@@@@@@@@@@@
@@@@@@@@@@@@@@@@@@@@@@@@@@@@@@@@@@@@@@@......T.....TT@@@......T.T.......@@@@@@@@@@....T.TT.T@@@@@@@@@@@@@@@@@@@@@@@@@@@@@@@@
@@@@@@@@@@@@@@@@@@@@@@@@@@@@@@@@@@@@@@@@.T...T...T...T@@.....TT.....T..@@@@@@@@@@@@........@@@@@@@@@@@@@@@@@@@@@@@@@@@@@@@@@
@@@@@@@@@@@@@@@@@@@@@@@@@@@@@@@@@@@@@@@@@T.T.T.......T.T............T.@@@@@@@@@@@@@@TT....@@@@@@@@@@@@@@@@@@@@@@@@@@@@@@@@@@
@@@@@@@@@@@@@@@@@@@@@@@@@@@@@@@@@@@@@@@@@@.......T.....TT.T.T....T...@@@@@@@@@@@@@@@@T...@@@@@@@@@@@@@@@@@@@@@@@@@@@@@@@@@@@
@@@@@@@@@@@@@@@@@@@@@@@@@@@@@@@@@@@@@@@@@@@........T....T..........T@@@@@@@@@@@@@@@@@@..@@@@@@@@@@@@@@@@@@@@@@@@@@@@@@@@@@@@
@@@@@@@@@@@@@@@@@@@@@@@@@@@@@@@@@@@@@@@@@@@@..TT.............T.T...@@@@@@@@@@@@@@@@@@@@@@@@@@@@@@@@@@@@@@@@@@@@@@@@@@@@@@@@@
@@@@@@@@@@@@@@@@@@@@@@@@@@@@@@@@@@@@@@@@@@@@@...............T..TT.@@@@@@@@@@@@@@@@@@@@@@@@@@@@@@@@@@@@@@@@@@@@@@@@@@@@@@@@@@
@@@@@@@@@@@@@@@@@@@@@@@@@@@@@@@@@@@@@@@@@@@@@@..T......T.TT...TT.@@@@@@@@@@@@@@@@@@@@@@@@@@@@@@@@@@@@@@@@@@@@@@@@@@@@@@@@@@@
@@@@@@@@@@@@@@@@@@@@@@@@@@@@@@@@@@@@@@@@@@@@@@@.........T.T..T..@@@@@@@@@@@@@@@@@@@@@@@@@@@@@@@@@@@@@@@@@@@@@@@@@@@@@@@@@@@@
@@@@@@@@@@@@@@@@@@@@@@@@@@@@@@@@@@@@@@@@@@@@@@@@....T.T.......T@@@@@@@@@@@@@@@@@@@@@@@@@@@@@@@@@@@@@@@@@@@@@@@@@@@@@@@@@@@@@
@@@@@@@@@@@@@@@@@@@@@@@@@@@@@@@@@@@@@@@@@@@@@@@@@...TT..T....T@@@@@@@@@@@@@@@@@@@@@@@@@@@@@@@@@@@@@@@@@@@@@@@@@@@@@@@@@@@@@@
@@@@@@@@@@@@@@@@@@@@@@@@@@@@@@@@@@@@@@@@@@@@@@@@@@.........T.@@@@@@@@@@@@@@@@@@@@@@@@@@@@@@@@@@@@@@@@@@@@@@@@@@@@@@@@@@@@@@@
@@@@@@@@@@@@@@@@@@@@@@@@@@@@@@@@@@@@@@@@@@@@@@@@@@@.T.T.TT..@@@@@@@@@@@@@@@@@@@@@@@@@@@@@@@@@@@@@@@@@@@@@@@@@@@@@@@@@@@@@@@@
@@@@@@@@@@@@@@@@@@@@@@@@@@@@@@@@@@@@@@@@@@@@@@@@@@@@.......@@@@@@@@@@@@@@@@@@@@@@@@@@@@@@@@@@@@@@@@@@@@@@@@@@@@@@@@@@@@@@@@@
@@@@@@@@@@@@@@@@@@@@@@@@@@@@@@@@@@@@@@@@@@@@@@@@@@@@@.....@@@@@@@@@@@@@@@@@@@@@@@@@@@@@@@@@@@@@@@@@@@@@@@@@@@@@@@@@@@@@@@@@@
@@@@@@@@@@@@@@@@@@@@@@@@@@@@@@@@@@@@@@@@@@@@@@@@@@@@@@...@@@@@@@@@@@@@@@@@@@@@@@@@@@@@@@@@@@@@@@@@@@@@@@@@@@@@@@@@@@@@@@@@@@
@@@@@@@@@@@@@@@@@@@@@@@@@@@@@@@@@@@@@@@@@@@@@@@@@@@@@@@T@@@@@@@@@@@@@@@@@@@@@@@@@@@@@@@@@@@@@@@@@@@@@@@@@@@@@@@@@@@@@@@@@@@@
@@@@@@@@@@@@@@@@@@@@@@@@@@@@@@@@@@@@@@@@@@@@@@@@@@@@@@@@@@@@@@@@@@@@@@@@@@@@@@@@@@@@@@@@@@@@@@@@@@@@@@@@@@@@@@@@@@@@@@@@@@@@
@@@@@@@@@@@@@@@@@@@@@@@@@@@@@@@@@@@@@@@@@@@@@@@@@@@@@@@@@@@@@@@@@@@@@@@@@@@@@@@@@@@@@@@@@@@@@@@@@@@@@@@@@@@@@@@@@@@@@@@@@@@@
@@@@@@@@@@@@@@@@@@@@@@@@@@@@@@@@@@@@@@@@@@@@@@@@@@@@@@@@@@@@@@@@@@@@@@@@@@@@@@@@@@@@@@@@@@@@@@@@@@@@@@@@@@@@@@@@@@@@@@@@@@@@
