type octile
height 86
width 80
map
@@@@@@@@@@@@@@@@@@@@@@@@@@@@@@@@@@@@@@@@@@@@@@@@@@@@@@@@@@@@@@@@@@@@@@@@@@@@@@@@
@@@@@@@@@@@@@@@@@@@@@@@@@@@@@@@@@@@@@@@@@@@@@@@@@@@@@@@@@@@@@@@@@@@@@@@@@@@@@@@@
@@@@@@@@@@@@@@@@@@@@@@@@@@@@@@@@@@@@@@@@@@@@@@@@@@@@@@@@@@@@@@@@@@@@@@@@@@@@@@@@
@@@@@@@@@@@@@@@@@@@@@@@@@@@@@@@@@@@@@@@@@@@@@@@@@@@@@@@@@@@@@@@@@@@@@@@@@@@@@@@@
@@@@@@@@@@@@@@@@@@@@@@@@@@@@@@@@@@@@@@@@@@@@@@@@@@@@@@@@@@@@@@@@@@@@@@@@@@@@@@@@
@@@@@@@@@@@@@@@@@@@@@@@@@@@@@@@@@@@@@@@@@@@@@@@@@@@@@@@@@@@@@@@@@@@@@@@@@@@@@@@@
@@@@@@@@@@@@@@@@@@@@@@@@@@@@@@@@@@@@@@@@@@@@@@@@@@@@@@@@@@@@@@@@@@@@@@@@@@@@@@@@
@@@@@@@@@@@@@@@@@@@@@@@@@@@@@@@@@@@@@@@@@@@@@@@@@@@@@@@@@@@@@@@@@@@@@@@@@@@@@@@@
@@@@@@@@@@@@@@@@@@@@@@@@@@@@@@@@@@@@@@@@@@@@@@@@@@@@@@@@@@@@@@@@@@@@@@@@@@@@@@@@
@@@@@@@@@@@@@@@@@@@@@@@@@@@@@@@@@@@@@@@@@@@@@@@@@@@@@@@@@@@@@@@@@@@@@@@@@@@@@@@@
@@@@@@@@@@@@@@@@@@@@@@@@@@@@@@@@@@@@@@@@@@@@@@@@@@@@@@@@@@@@@@@@@@@@@@@@@@@@@@@@
@@@@@@@@@@@@@@@@@@@@@@@@@@@@@@@@@@@@@@@@@@@@@@@@@@@@@@@@@@@@@@@@@@@@@@@@@@@@@@@@
@@@@@@@@@@@@@@@@@@@@@@@@@@@@@@@@@@@@@@@@@@@@@@@@@@@@@@@@@@@@@@@@@@@@@@@@@@@@@@@@
@@@@@@@@@@@@@@@@@@@@@@@@@..@@@@@..@@@@@@@@@@@@@@@@@@@@@@@@@@@@@@@@@@@@@@@@@@@@@@
@@@@@@@@@@@@@@@@@@@@@@@@...@@.T...@@@@@@@@@@@@@@@@@@@@@@@@@@@@@@@@@@@@@@@@@@@@@@
@@@@@@@@@@@@@@@@@@@@@@@.T.T@@...T...@@@@@@@@@@@@@@@@@@@@@@@@@@@@@@@@@@@@@@@@@@@@
@@@@@@@@@@@@@@@@@@@@@@T..T.@@@..T.T.@@@@@@@@@@@@@@@@@@@@@@@@@@@@@@@@@@@@@@@@@@@@
@@@@@@@@@@@@@@@@@@@@@@@@@@...T.T....T...@@@@@@@@@@@@@@@@@@@@@@@@@@@@@@@@@@@@@@@@
@@@@@@@@@@@@@@@@@@@@@@@..@.........T....@@@@@@@@@@@@@@@@@@@@@@@@@@@@@@@@@@@@@@@@
@@@@@@@@@@@@@@@@@@@@@@@TT.T@.TT.T.T@TT.TT@@@@@@@@@@@@@@@@@@@@@@@@@@@@@@@@@@@@@@@
@@@@@@@@@@@@@@@@@@@@@@TTTT@@@.T.T..@@@@...@@@@@@@@@@@@@@@@@@@@@@@@@@@@@@@@@@@@@@
@@@@@@@@@@@@@@@@@@@@@.T.........T...@@@@TT.@@@@@@@@@@@@@@@@@@@@@@@@@@@@@@@@@@@@@
@@@@@@@@@@@@@@@@@@@@.T...@@@.....T..@@@@@...@@@@@@@@@@@@@@@@@@@@@@@@@@@@@@@@@@@@
@@@@@@@@@@@@@@@@@@@T...T..@..TT.T...T@@@@@....@@@@@@@@@@@@@@@@@@@@@@@@@@@@@@@@@@
@@@@@@@@@@@@@@@@@@....T.T@@@T.........@@@@@.....@@@@@@@@@@@@@@@@@@@@@@@@@@@@@@@@
@@@@@@@@@@@@@.@@@..T.@@..T@...T.T......T@@@@T..T.@@@@@@@@@@@@@@@@@@@@@@@@@@@@@@@
@@@@@@@@@@@@..T.T.TTT.......T..T@@....T.@@@@@.TT.@@@@@@@@@@@@@@@@@@@@@@@@@@@@@@@
@@@@@@@@@@@.....T.........T.T..@@@@.T.T..@@@@T....@@@@@@@@@@@@@@@@@@@@@@@@@@@@@@
@@@@@@@@@@.T..TT.T.TT.........@@@@@@....T.@T....@@@@@@@@@@@@@@@@@@@@@@@@@@@@@@@@
@@@@@@@@@@@@...T@@.@......T..@@@@@@@..TTT...T...@@@@@@@@@@@@@@@@@@@@@@@@@@@@@@@@
@@@@@@@@@@@@@..T@@@@...TT.TT@@@@@@@.TTTT....T.T..@@@@@@@@@@@@@@@@@@@@@@@@@@@@@@@
@@@@@@@@@@@@.T........T...T@@@@@@@..........T.....@@@@@@@@@@@@@@@@@@@@@@@@@@@@@@
@@@@@@@@@@@@.T....T...TT..@@@@@@@@@.TT..T.T......@@@@@@@@@@@@@@@@@@@@@@@@@@@@@@@
@@@@@@@@@@@........T.....@@@@@@@@@@..TTT........@@@@@@@@@@@@@@@@@@@@@@@@@@@@@@@@
@@@@@@@@@@............T.@@@@@@@@@@......T..T...T.@@@@@@@@@@@@@@@@@@@@@@@@@@@@@@@
@@@@@@@@@@...T...@T....@@@@@@@@@@TT..T.@.T...T...@@@@@@@@@@@@@@@@@@@@@@@@@@@@@@@
@@@@@@@@@..T.T.T@@...TT@@@@@@@@.......@@@...@@T..@@@@@@@@@@@@@@@@@@@@@@@@@@@@@@@
@@@@@@@@@.TT...@@TT..T..@@@@@@@.TTT..@@@@@@@@@@T..@@@@@@@@@@@@@@@@@@@@@@@@@@@@@@
@@@@@@@@T.....@@@T....T...@@@@.T.....@@@@@@@@@@...@@@@@@@@@@@@@@@@@@@@@@@@@@@@@@
@@@@@@@@.....@@@...TT....TTT.T......T@@@@@@@@@@@.T@@@@@.@@@@@@@@@@@@@@@@@@@@@@@@
@@@@@@@@..T.@@@T.....T@............TT@@@@@@@@@@@T..@.T@.T@@@@@@@@@@@@@@@@@@@@@@@
@@@@@@@@..T@@@@......@@.T...T.T....T.@@@@@@@@@@@@.T@@T@...@@@@@@@@@@@@@@@@@@@@@@
@@@@@@@@@.@@@....TTT.@@...TTT....@@@@@@@@@@@@@@@@.T.@.......@@@@@@@@@@@@@@@@@@@@
@@@@@@@@@@@@.....T..@@@@.........@@@@@@@@@@@@@@@@...@@T..T..T@@@@@@@@@@@@@@@@@@@
@@@@@@@@@@@.TTT.TT.@@@@@TT.......@@@@@@@@@@@@@@.@@...@........@@@@@@@@@@@@@@@@@@
@@@@@@@@@@@@T..T..@@@....T....T..@@@@@@@@@@@@@...@..T@..@@....@@@@@@@@@@@@@@@@@@
@@@@@@@@@@@@@....@@@.T..TT.......@@@@@@@@@@@T.T.T@@TT...@@....@@@@@@@@@@@@@@@@@@
@@@@@@@@@@@@@@.T@@@@T.....T...TT@@@@@@@@@@@.TT@@.@@.....T....@@@@.@@@@@@@@@@@@@@
@@@@@@@@@@@@@@@@@@@.T......T...T@@@@@@@@@@.TT@@@T.@@...TT..@@@.....@@@@@@@@@@@@@
@@@@@@@@@@@@@@@@@@.........@....T@@@@@@@@.T..@@@@.@@.T....@@.....T.T@@@@@@@@@@@@
@@@@@@@@@@@@@@@@@..T..T...@@@@@..@@@@@@@T.....@@@.@..T.......TT.TT..@@@@@@@@@@@@
@@@@@@@@@@@@@@@@@@....TTTT@@@@@...@@@@@.T.....T@@...T......TT......@@@@@@@@@@@@@
@@@@@@@@@@@@@@@@@@@.......@@@@@@T.@@@@...T.T..@@@@@.........TT.@..@@@@@@@@@@@@@@
@@@@@@@@@@@@@@@@@@@@.TTT.@@@@@@@...@.T..TTT..@@@@@@...T.T......@.@@@@@@@@@@@@@@@
@@@@@@@@@@@@@@@@@@@@@...@@@@@@@@@..@@.T.@@..@@@@@@@.T...T...TT.@@@@@@@@@@@@@@@@@
@@@@@@@@@@@@@@@@@@@@@@.@@@@@@@@@@..T@..@@@@@@@@@@..........T...@@.@@@@@@@@@@@@@@
@@@@@@@@@@@@@@@@@@@@@@@@@@@@@@@@@@..@@.@@@@@@@@@@..T...T...T.......@@@@@T@@@@@@@
@@@@@@@@@@@@@@@@@@@@@@@@@@@@@@@@@@...@..@@@@@@.T......TT...T.T......@@@..T@@@@@@
@@@@@@@@@@@@@@@@@@@@@@@@@@@@@@@@@@@T.@@....@.........T@@..T.....T..TT......@@@@@
@@@@@@@@@@@@@@@@@@@@@@@@@@@@@@@..@@...@...TT.....T..T@@@@....T..TT......T...@@@@
@@@@@@@@@@@@@@@@@@@@@@@@@@@@@@...T@@..T..T.....T..T.@@@@@@@.....T..T.....T.T@@@@
@@@@@@@@@@@@@@@@@@@@@@@@@@@@.T...@@@.......T......TT@@@@@@@...T..T.......T.@@@@@
@@@@@@@@@@@@@@@@@@@@@@@@@@@.....T@@@@T....T@@T...T...@@@@@@..T....T..T...T@@@@@@
@@@@@@@@@@@@@@@@@@@@@@@@@@T.......@.T.T.T@@@@@.T..T..T@@@T@T..T.T...T...T@@@@@@@
@@@@@@@@@@@@@@@@@@@@@@@@@@@.T..TT.T.....T@@@@@@T.T.T.T@@@.@T.T......T...@@@@@@@@
@@@@@@@@@@@@@@@@@@@@@@@@@@@@......T.......@@@@@@..T......TTT........T..@@@@@@@@@
@@@@@@@@@@@@@@@@@@@@@@@@@@@@@..T.T.T....T..@@@@@@T....T...........T...@@@@@@@@@@
@@@@@@@@@@@@@@@@@@@@@@@@@@@@@@.......T..TT..@@@@@@TT..T.......T......@@@@@@@@@@@
@@@@@@@@@@@@@@@@@@@@@@@@@@@@@@@............T..@@@@@T@@.T...T..T.....@@@@@@@@@@@@
@@@@@@@@@@@@@@@@@@@@@@@@@@@@@@@@TT.T....TT..TT@@@@@@@@TT...T.TT...T@@@@@@@@@@@@@
@@@@@@@@@@@@@@@@@@@@@@@@@@@@@@@@@...T...T.T.....@@@@@@.T...T..T...@@@@@@@@@@@@@@
@@@@@@@@@@@@@@@@@@@@@@@@@@@@@@@@@@T..T@......T.T.T@@@TT..TTT.T...@@@@@@@@@@@@@@@
@@@@@@@@@@@@@@@@@@@@@@@@@@@@@@@@@@@..@@.T.T.....T.T@..........T.@@@@@@@@@@@@@@@@
@@@@@@@@@@@@@@@@@@@@@@@@@@@@@@@@@@@@.@@@@....TTTT..T.T.T..T....@@@@@@@@@@@@@@@@@
@@@@@@@@@@@@@@@@@@@@@@@@@@@@@@@@@@@@@@@@@.TT...T......T......T@@@@@@@@@@@@@@@@@@
@@@@@@@@@@@@@@@@@@@@@@@@@@@@@@@@@@@@@@@@@@.TT...T..T....T...T@@@@@@@@@@@@@@@@@@@
@@@@@@@@@@@@@@@@@@@@@@@@@@@@@@@@@@@@@@@@@@@...T....TTTT..TTT@@@@@@@@@@@@@@@@@@@@
@@@@@@@@@@@@@@@@@@@@@@@@@@@@@@@@@@@@@@@@@@@@....@.T........@@@@@@@@@@@@@@@@@@@@@
@@@@@@@@@@@@@@@@@@@@@@@@@@@@@@@@@@@@@@@@@@@T...@@.TT..T...@@@@@@@@@@@@@@@@@@@@@@
@@@@@@@@@@@@@@@@@@@@@@@@@@@@@@@@@@@@@@@@@@@.TT.@@..T.T...@@@@@@@@@@@@@@@@@@@@@@@
@@@@@@@@@@@@@@@@@@@@@@@@@@@@@@@@@@@@@@@@@@@T..T@..TT...T@@@@@@@@@@@@@@@@@@@@@@@@
@@@@@@@@@@@@@@@@@@@@@@@@@@@@@@@@@@@@@@@@@@@@..T.TT..T.T@@@@@@@@@@@@@@@@@@@@@@@@@
@@@@@@@@@@@@@@@@@@@@@@@@@@@@@@@@@@@@@@@@@@@@@.TT....TT@@@@@@@@@@@@@@@@@@@@@@@@@@
@@@@@@@@@@@@@@@@@@@@@@@@@@@@@@@@@@@@@@@@@@@@@@T..T...@@@@@@@@@@@@@@@@@@@@@@@@@@@
@@@@@@@@@@@@@@@@@@@@@@@@@@@@@@@@@@@@@@@@@@@@@@@T....@@@@@@@@@@@@@@@@@@@@@@@@@@@@
@@@@@@@@@@@@@@@@@@@@@@@@@@@@@@@@@@@@@@@@@@@@@@@@@@@@@@@@@@@@@@@@@@@@@@@@@@@@@@@@
