type octile
height 80
width 80
map
@@@@@@@@@@@@@@@@@@@@@@@@@@@@@@@@@@@@@@@@@@@@@@@@@@@@@@@@@@@@@@@@@@@@@@@@@@@@@@@@
@@@@@@@@@@@@@@@@@@@@@@@@@@@@@@@@@@@@@@@@@@@@@@@@@@@@@@@@@@@@@@@@@@@@@@@@@@@@@@@@
@@@@@@@@@@@@@@@@@@@@@@@@@@@@@@@@@@@@@@@@@@@@@@@@@@@@@@@@@@@@@@@@@@@@@@@@@@@@@@@@
@@@@@@@@@@@@@@@@@@@@@@@@@@@@@@@@@@@@@@@@@@@@@@@@@@@@@@@@@@@@@@@@@@@@@@@@@@@@@@@@
@@@@@@@@@@@@@@@@@@@@@@@@@@@@@@@@@@@@@@@@@@@@@@@@@@@@@@@@@@@@@@@@@@@@@@@@@@@@@@@@
@@@@@@@@@@@@@@@@@@@@@@@@@@@@@@@@@@@@@@@@@@@@@@@@@@@@@@@@@@@@@@@@@@@@@@@@@@@@@@@@
@@@@@@@@@@@@@@@@@@@@@@@@@@@@@@@@@@@@@@@@@@@@@@@@@@@@@@@@@@@@@@@@@@@@@@@@@@@@@@@@
@@@@@@@@@@@@@@@@@@@@@@@@@@@@@@@@@@@@@@@@@@@@@@@@@@@@@@@@@@@@@@@@@@@@@@@@@@@@@@@@
@@@@@@@@@@@@@@@@@@@@@@@@@@@@@@@@@@@@@@@@@@@@@@@@@@@@@@@@@@@@@@@@@@@@@@@@@@@@@@@@
@@@@@@@@@@@@@@@@@@@@@@@@@@@@@@@@@@@@@@@@@@@@@@@@@@@@@@@@@@@@@@@@@@@@@@@@@@@@@@@@
@@@@@@@@@@@@@@@@@@@@@@@@@@@@@@@@@@@@@@@@@@@@@@@@@@@@@@@@@@@@@@@@@@@@@@@@@@@@@@@@
@@@@@@@@@@@@@@@@@@@@@@@@@@@@@@@@@@@@@@@@@@@@@@@@@@@@@@@@@@@@@@@@@@@@@@@@@@@@@@@@
@@@@@@@@@@@@@@@@@@@@@@@@@@@@@@@@@@@@@@@@@@@@@@@@@@@@@@@@@@@@@@@@@@@@@@@@@@@@@@@@
@@@@@@@@@@@@@@@@@@@@@@@@@@@@@@@@@@@@@@@@@@@@@@@@@@@@@@@@@@@@@@@@@@@@@@@@@@@@@@@@
@@@@@@@@@@@@@@@@@@@@@@@@@@@@@@@@@@@@@@@@@@@@@@@@@@@T.T@@@@@@@@@@@@@@@@@@@@@@@@@@
@@@@@@@@@@@@@@@@@@@@@@@@@@@@@@@@@@@@@@@@@@@@@@@@@@.T...@@@@@@@@@@@@@@@@@@@@@@@@@
@@@@@@@@@@@@@@@@@@@@@@@@@@@@@@@@@@@@@@@@@@@@@@@@@T.T..TT@@@@@@@@@@@@@@@@@@@@@@@@
@@@@@@@@@@@@@@@@@@@@@@@@@@@@@@@@@@@@@@@@@@@@@@@@...T.....@@@@@@@@@@@@@@@@@@@@@@@
@@@@@@@@@@@@@@@@@@@@@@@@@@@@@@@@@@@@@@@@@@@@@@@..TTT......@@@@@@@@@@@@@@@@@@@@@@
@@@@@@@@@@@@@@@@@@@@@@@@@@@@@@@@@@@@@@@@@@@@.@.T.T...T.TT.T@@@@@@@@@@@@@@@@@@@@@
@@@@@@@@@@@@@@@@@@@@@@@@@@@@@@@@@@@@@@@@@@@@.T.....T....T..T..@@@@@@@@@@@@@@@@@@
@@@@@@@@@@@@@@@@@@@@@@@@@@@@@@@@@@@@@@@@@@@.T...TTT....TT..T...@@@@@@@@@@@@@@@@@
@@@@@@@@@@@@@@@@@@@@@@@@@@@@@@@@@@@@@@@@@@.T...T........TT...T@@@@@@@@@@@@@@@@@@
@@@@@@@@@@@@@@@@@@@@@@@@@@@@@@@@@@@@@@@@.T...TTT.TTT.......TT@@@@..@@@@@@@@@@@@@
@@@@@@@@@@@@@@@@@@@@@@@@@@@@@@@@@@@@@@@..T.T.T..TTT.T.T.....@@@@TT.T@@@@@@@@@@@@
@@@@@@@@@@@@@@@@@@@@@@@@@@@@@@@@@@@@@@@T.....T..T.......TT.@@@@T.T...@@@@@@@@@@@
@@@@@@@@@@@@@@@@@@@@@@@@@@@@@@@@@@@@@@@@...T..TT.TT.......@@@@..T.....@@@@@@@@@@
@@@@@@@@@@@@@@@@@@@@@@@@@@@@@@@@@@@@@@@@@...T.........T..@@@@.....T.TT.@@@@@@@@@
@@@@@@@@@@@@@@@@@@@@@@@@@@@@@@@@@@@@T@@@@..T..T.....T.TT@@@T.T..@@..TTTT@@@@@@@@
@@@@@@@@@@@@@@@@@@@@@@@@@@@@@@@@@@TT...@@@..T.T.......T@@@.T....@@@@.....@@@@@@@
@@@@@@@@@@@@@@@@@@@@@@@@@@@@@@@@@.....T.TT............@@@TT....@@@@@....T.@@@@@@
@@@@@@@@@@@@@@@@@@@@@@@@@@@@@..@@.T....TT......TTT...@@@....T.T@@@@@....T..@@@@@
@@@@@@@@@@@@@@@@@@@@@@@@@@@@.....T.T......T.T......T@@@..T.....@@@@@@..T....@@@@
@@@@@@@@@@@@@@@@@@@@@@@@@@@...T@@@.T...TTTT@@@...T.@@@......T..@@@@@@..T..T..@@@
@@@@@@@@@@@@@@@@@@@@@@@@@@...@@@@@@@.T......@@@..T@@@T.........@@..@..T.T.....@@
@@@@@@@@@@@@@@@@@@@@@@@@@TT..@@@@@@@@...T....@@@.@@@.....T.....T.T.....T.T...@@@
@@@@@@@@@@@@@@@@@@@@@@@@......@@@@@@@@........@@@@@....@@@@T......T......T..@@@@
@@@@@@@@@@@@@@@@@@@@@@@.T.T.....@@@@@@@......T.@@@.T...@@@@T..T.....T..T..T@@@@@
@@@@@@@@@@@@@@@@@@@@@@.T@@@@T....@@@@@@@T....T..@...T..@@@@@....TTT....TT.@@@@@@
@@@@@@@@@@@@@@@@@@@@@T.@@@@@@..T..@@@@@@@...........T..@@@@@@T..........T@@@@@@@
@@@@@@@@@@@@@@@@@@@@...@@@@@@....T.@@@@@@@.T.....T..T..@@@@@@.TTT..T...T@@@@@@@@
@@@@@@@@@@@@@@@@@@@.....@@@@@...T...@@@@@@........TTT..@@@@@@......T..T@@@@@@@@@
@@@@@@@@@@@@@@@@@@.T...@@@@@@@.T.....@@@@@@.T......T.TT...T...T..T.T.T@@@@@@@@@@
@@@@@@@@@@@@@@@@@..@@T.@@@@@@@.....T..@@@@@.T..T....T.....T...TT..TT.@@@@@@@@@@@
@@@@@@@@@@@@@@@@T..@@T..T..T...T..T....@@@TT...TT........TTT..T..T..@@@@@@@@@@@@
@@@@@@@@@@@@@@@..T.@@T..T..TTT..T...T....@.T...T.....T.....T....T..@@@@@@@@@@@@@
@@@@@@@@@@@@@@.TT.T.T...T.....T.........TT.T.....T.......T......T.@@@@@@@@@@@@@@
@@@@@@@@@@@@@T.T.T.....T...T...@@@@@.TT.......T......TTTT........@@@@@@@@@@@@@@@
@@@@@@@@@@@.@@...........TT.T..@@@@@@TT.T......T......T.T..T...T@@@@@@@@@@@@@@@@
@@@@@@@@@@...@...TT..........TT.@@@@@T.....T......T...T.TT.T...@@@@@@@@@@@@@@@@@
@@@@@@@@@T.T.@@..@@@@.T......TT.@@@@@@T.TT.....T.....T..T.....@@@@@@@@@@@@@@@@@@
@@@@@@@@..T.TT@.@@@@@@.T.T.T.....@@@@@.T...T..T.T....T.T...TT@@@@@@@@@@@@@@@@@@@
@@@@@@@.T...T.@.@@@@@@..........T..@@T.......T..............@@@@@@@@@@@@@@@@@@@@
@@@@@@.T......@@@@@@@@T.T....TT..TTTT..T.........TT..T..TT.@@@@@@@@@@@@@@@@@@@@@
@@@@@.T.TTT.T..@@@@@@@.......TT.........T.....TT...@......@@@@@@@@@@@@@@@@@@@@@@
@@@@@@.........@@@.@@...T..@......T.........T....TT@T.T..@@@@@@@@@@@@@@@@@@@@@@@
@@@@@@T....T.TT.T......T..T@TTT........T..T...TT........@@@@@@@@@@@@@@@@@@@@@@@@
@@@@@@@....T.....T..........T..TTTT.T....T........TT.T.@@@@@@@@@@@@@@@@@@@@@@@@@
@@@@@@@TT....T.T...............TTT@@@@T........T..T...@@@@@@@@@@@@@@@@@@@@@@@@@@
@@@@@@@@.T.T........T.T..T......TT@@@@@@@.......TT.T.@@@@@@@@@@@@@@@@@@@@@@@@@@@
@@@@@@@@.T....T..T....T.....T@....T.T@@@@.....T.TTT.@@@@@@@@@@@@@@@@@@@@@@@@@@@@
@@@@@@@@@.....T...TT..TTT..@@@@@..T.....T..T.......@@@@@@@@@@@@@@@@@@@@@@@@@@@@@
@@@@@@@@@......T...T.......@@@@@.T..T....T.....T.T@@@@@@@@@@@@@@@@@@@@@@@@@@@@@@
@@@@@@@@@@.TT....T........T@@@@@.T.TT...T......TT@@@@@@@@@@@@@@@@@@@@@@@@@@@@@@@
@@@@@@@@@@..T.TT...........@@@@@.T.......TT...T.@@@@@@@@@@@@@@@@@@@@@@@@@@@@@@@@
@@@@@@@@@@....T...T.......T..@@@..T..T..T......@@@@@@@@@@@@@@@@@@@@@@@@@@@@@@@@@
@@@@@@@@@@.T..TT...T.........T.........T.T....@@@@@@@@@@@@@@@@@@@@@@@@@@@@@@@@@@
@@@@@@@@@@...T.......T..TT..............T..T.@@@@@@@@@@@@@@@@@@@@@@@@@@@@@@@@@@@
@@@@@@@@@@@...T....T......TT................@@@@@@@@@@@@@@@@@@@@@@@@@@@@@@@@@@@@
@@@@@@@@@@@@...T......TTT.TTTT..T.TT.......@@@@@@@@@@@@@@@@@@@@@@@@@@@@@@@@@@@@@
@@@@@@@@@@@@@T.......T..T.T..T....T...T...@@@@@@@@@@@@@@@@@@@@@@@@@@@@@@@@@@@@@@
@@@@@@@@@@@@@@..TTT.........T..T...T....T@@@@@@@@@@@@@@@@@@@@@@@@@@@@@@@@@@@@@@@
@@@@@@@@@@@@@@@....T.T....@@@..T...T.T.T@@@@@@@@@@@@@@@@@@@@@@@@@@@@@@@@@@@@@@@@
@@@@@@@@@@@@@@@@.TT.T....T@@@.......TT.@@@@@@@@@@@@@@@@@@@@@@@@@@@@@@@@@@@@@@@@@
@@@@@@@@@@@@@@@@@................T....@@@@@@@@@@@@@@@@@@@@@@@@@@@@@@@@@@@@@@@@@@
@@@@@@@@@@@@@@@@@@.........T......T..@@@@@@@@@@@@@@@@@@@@@@@@@@@@@@@@@@@@@@@@@@@
@@@@@@@@@@@@@@@@@@@.............T.T.@@@@@@@@@@@@@@@@@@@@@@@@@@@@@@@@@@@@@@@@@@@@
@@@@@@@@@@@@@@@@@@@@T............T.@@@@@@@@@@@@@@@@@@@@@@@@@@@@@@@@@@@@@@@@@@@@@
@@@@@@@@@@@@@@@@@@@@@........TT...@@@@@@@@@@@@@@@@@@@@@@@@@@@@@@@@@@@@@@@@@@@@@@
@@@@@@@@@@@@@@@@@@@@@@@@@@@@@@@@@@@@@@@@@@@@@@@@@@@@@@@@@@@@@@@@@@@@@@@@@@@@@@@@
