type octile
height 54
width 52
map
@@@@@@@@@@@@@@@@@@@@@@@@@@@@@@@@@@@@@@@@@@@@@@@@@@@@
@@@@@@@@@@@@@@@@@@@@@@@@@@@@@@@@@@@@@@@@@@@@@@@@@@@@
@@@@@@@@@@@@@@@@@@@@@@@@@@@@@@@@@@@@@@@@@@@@@@@@@@@@
@@@@@@@@@@@@@@@@@@@@@@@@@@@@@@@@@@@@@@@@@@@@@@@@@@@@
@@@@@@@@@@@@@@@@@@@@@@@@@@@@@@@@@@@@@@@@@@@@@@@@@@@@
@@@@@@@@@@@@@@@@@@@@@@@@@@@@@@@@@@@@@@@@@@@@@@@@@@@@
@@@@@@@@@@@@@@@@@@@@@@@@@@@@@@@@@@@@@@@@@@@@@@@@@@@@
@@@@@@@@@@@@@@@@@@@@@@@@@@@@@@@@@@@@@@@@@@@@@@@@@@@@
@@@@@@@@@@@@@@@@@@@@@@@@@@@@@@@@@@@@@@@@@@@@@@@@@@@@
@@@@@@@@@@@@@@@@@@@@@@@@@@@@@@@@@@@@@@@@@@@@@@@@@@@@
@@@@@@@@@@@@@@@@@@@@@@@@@@@@@@@@@@@@@@@@@@@@@@@@@@@@
@@@@@@@@@@@@@@@@@@@@@@@@@@@@@@@.@@@@@@@@@@@@@@@@@@@@
@@@@@@@@@@@@@@@@@@@@@@@@@@@@@@T..@@@@@@@@@@@@@@@@@@@
@@@@@@@@@@@@@@@@@@@@@@@@@@@@@...T.@@@@@@@@@@@@@@@@@@
@@@@@@@@@@@@@@@@@@@@@@@@@@@@@......@@@@@@@@@@@@@@@@@
@@@@@@@@@@@@@@@@@@@@@@@@@@@@......@@@@@@@@@@@@@@@@@@
@@@@@@@@@@@@@@@@@@@@@@@@@@@..TT.TTT@@@@@@@@@@@@@@@@@
@@@@@@@@@@@@@@@@@@@@@@@@@...T....TTT@@@@@@@@@@@@@@@@
@@@@@@@@@@@@@@@@@@@@@@@@TTTT.........@@.@@@@@@@@@@@@
@@@@@@@@@@@@@@@@@@@@@@@.T....T..T..TT....@@@@@@@@@@@
@@@@@@@@@@@@@@@@@@@@@@..TT......@@T......@@@@@@@@@@@
@@@@@@@@@@@@@@@@@@@@@TT.....T.@@@@.T.TT.@@@@@@@@@@@@
@@@@@@@@@@@@@@@@@@@@@@.T..T.@@@@@@T.T..@@@@@@@@@@@@@
@@@@@@@@@@@@@@@@@@@@@@..T...@@@@@@T.T.T@@@@@@@@@@@@@
@@@@@@@@@@@@@@@@@@@@@T..TT.T.@@@@@@.....@@@@@@@@@@@@
@@@@@@@@@@@@@@@@@@@@T..T.T....@@@@@......@@@@@@@@@@@
@@@@@@@@@@@@@@@@@@@..T..TT..T....@@.T..TTT@@@@@@@@@@
@@@@@@@@@@@@@@@@@@...T.T...T..T........TT.T@@@@@@@@@
@@@@@@@@@@@@@T@@.T....T.T..T.T...T.TTT......@@@@@@@@
@@@@@@@@@..T.TT...TTT.T.T.T..T.TTTT........@@@@@@@@@
@@@@@@@@@@.....T..@T..TTTTT....TT.........@@@@@@@@@@
@@@@@@@@@@@@...T.@@@..T.....T.......T...T@@@@@@@@@@@
@@@@@@@@@@@@@@..@@@@@....TT........T.T.T@@@@@@@@@@@@
@@@@@@@@@@@@@@@@@@@@@@T.T..TTTT.....TT.@@@@@@@@@@@@@
@@@@@@@@@@@@@@@@@@@@@@@TT.T...T.T.....@@@@@@@@@@@@@@
@@@@@@@@@@@@@@@@@@@@@@@@.....T..T..TT@@@@@@@@@@@@@@@
@@@@@@@@@@@@@@@@@@@@@@@@@...T......T@@@@@@@@@@@@@@@@
@@@@@@@@@@.@@@@@@@@@@@@@@@....T..TT@@@@@@@@@@@@@@@@@
@@@@@@@@@...@@@@@@@@@@@@@@T..TT..T@@@@@@@@@@@@@@@@@@
@@@@@@@@@.TT.@@@@@@@@@@@@.T..T...@@@@@@@@@@@@@@@@@@@
@@@@@@@@@@T...@@@@@@@@@@..T...T.@@@@@@@@@@@@@@@@@@@@
@@@@@@@@@@@....@@@@@@@@.TT....T@@@@@@@@@@@@@@@@@@@@@
@@@@@@@@@@@@....@@@@@@........@@@@@@@@@@@@@@@@@@@@@@
@@@@@@@@@@@@@....@@@@.......T@@@@@@@@@@@@@@@@@@@@@@@
@@@@@@@@@@@@@@....@@.......T@@@@@@@@@@@@@@@@@@@@@@@@
@@@@@@@@@@@@@@@T..........T@@@@@@@@@@@@@@@@@@@@@@@@@
@@@@@@@@@@@@@@@@...T.....T@@@@@@@@@@@@@@@@@@@@@@@@@@
@@@@@@@@@@@@@@@@@T.TTTT..@@@@@@@@@@@@@@@@@@@@@@@@@@@
@@@@@@@@@@@@@@@@@@.T....@@@@@@@@@@@@@@@@@@@@@@@@@@@@
@@@@@@@@@@@@@@@@@@@.T..@@@@@@@@@@@@@@@@@@@@@@@@@@@@@
@@@@@@@@@@@@@@@@@@@@@@@@@@@@@@@@@@@@@@@@@@@@@@@@@@@@
@@@@@@@@@@@@@@@@@@@@@@@@@@@@@@@@@@@@@@@@@@@@@@@@@@@@
@@@@@@@@@@@@@@@@@@@@@@@@@@@@@@@@@@@@@@@@@@@@@@@@@@@@
@@@@@@@@@@@@@@@@@@@@@@@@@@@@@@@@@@@@@@@@@@@@@@@@@@@@
