type octile
height 64
width 60
map
@@@@@@@@@@@@@@@@@@@@@@@@@@@@@@@@@@@@@@@@@@@@@@@@@@@@@@@@@@@@
@@@@@@@@@@@@@@@@@@@@@@@@@@@@@@@@@@@@@@@@@@@@@@@@@@@@@@@@@@@@
@@@@@@@@@@@@@@@@@@@@@@@@@@@@@@@@@@@@@@@@@@@@@@@@@@@@@@@@@@@@
@@@@@@@@@@@@@@@@@@@@@@@@@@@@@@@@@@@@@@@@@@@@@@@@@@@@@@@@@@@@
@@@@@@@@@@@@@@@@@@@@@@@@@@@@@@@@@@@@@@@@@@@@@@@@@@@@@@@@@@@@
@@@@@@@@@@@@@@@@@@@@@@@@@@@@@@@@@@@@@@@@@@@@@@@@@@@@@@@@@@@@
@@@@@@@@@@@@@@@@@@@@@@@@@@@@@@@@@@@@@@@@@@@@@@@@@@@@@@@@@@@@
@@@@@@@@@@@@@@@@@@@@@@@@@@@@@@@@@@@@@@@@@@@@@@@@@@@@@@@@@@@@
@@@@@@@@@@@@@@@@@@@@@@@@@@@@@@@@@@@@@@@@@@@@@@@@@@@@@@@@@@@@
@@@@@@@@@@@@@@@@@@@@@@@@@@@@@@@@@@@@@@@@@@@@@@@@@@@@@@@@@@@@
@@@@@@@@@@@@@@@@@@@@@@@@@@@@@@@@@@@@@@@@@@@@@@@@@@@@@@@@@@@@
@@@@@@@@@@@@@@@@@@@@@@@@@@@@@@@@.@@@@@@@@@@@@@@@@@@@@@@@@@@@
@@@@@@@@@@@@@@@@@@@@@@@@@@@@@@@..@@@@@@@@@@@@@@@@@@@@@@@@@@@
@@@@@@@@@@@@@@@@@@@@@@@@@@@@@@@..@@@@...@@@@@@@@@@@@@@@@@@@@
@@@@@@@@@@@@@@@@@@@@@@@@@@@@@@@..@@@@@@..@@@@@@@@@@@@@@@@@@@
@@@@@@@@@@@@@@@@@@@@@@@@@@@@@@@..@.@@@@@.T@@@@@@@@@@@@@@@@@@
@@@@@@@@@@@@@@@@@@@@@@@@@@@@@@@.....@@@@@..@@@@@@@@@@@@@@@@@
@@@@@@@@@@@@@@@@@@@@@@@@@@@@@@@TT.T..@@@@@.T@@@@@@@@@@@@@@@@
@@@@@@@@@@@@@@@@@@@@@@@@@@@@@@@.T.T..@@@@@.T.@@@@@@@@@@@@@@@
@@@@@@@@@@@@@@@@@@@@@@@@@@@@@@@@@....@@@@......T@@@@@@@@@@@@
@@@@@@@@@@@@@@@@@@@@@@@@@@@@@@@@@....T..T..T..@..@@@@@@@@@@@
@@@@@@@@@@@@@@@@@@@@@@@@@@@@@@@..T......T..TT@@@.T@@@@@@@@@@
@@@@@@@@@@@@@@@@@@@@@@@@@@@@@@.TT........TT.@@@.T.T@@@@@@@@@
@@@@@@@@@@@@@@@@@@@@@@@@@@@@@.T.........TT.@@@@@....@@@@@@@@
@@@@@@@@@@@@@@@@@@@@@@@@@@.T@@.............@@@@@@@@TT@@@@@@@
@@@@@@@@@@@@@@@@@@@@@@@.@@.@@@..T....T.T..@@@@@@@@@..T@@@@@@
@@@@@@@@@@@@@@@@@@@@@@@T.....T...T.T......@@@.@@...T...@@@@@
@@@@@@@@@@@@@@@@@@@@@@.....T.....TT@@@TTT.TT.......T.T..@@@@
@@@@@@@@@@@@@@@@@@@@..TT..T........@@@.....T....T...TT..@@@@
@@@@@@@@@@@@@@@@@@@.T.T.........T..T.T..T..T..T.TTTT...@@@@@
@@@@@@@@@@@@@@@@@@T....@@.....T.TT..TT.T.T...TT.T.....@@@@@@
@@@@@@@@@@@@@@@@@T....@@@@TT@@T..T..TT.......TT......@@@@@@@
@@@@@@@@@@@@@@@@@..T.@@@@@@@@@T........T...T........@@@@@@@@
@@@@@@@.@@@@@@@@...@@@@@@@@@.T.........T.TT.....T.T@@@@@@@@@
@@@@@@T..@@@@@@TT.@@@@@@@@@@@T.@@.....T...T...T...@@@@@@@@@@
@@@@@..T.T@@@@.....@@@@@@@@@@@@@@.T..........T...@@@@@@@@@@@
@@@@T...TT@@@T.T...@@@@@@@@@@@@..T...TT.....TT..@@@@@@@@@@@@
@@@@.T....T@TTTTTTT.@.T@@@@@@@@@T.T.T.....T..T.@@@@@@@@@@@@@
@@@@@T....T@.......T..T.@@@@@@@@@...........TT@@@@@@@@@@@@@@
@@@@@....TT@@T..T...TTTT@@@@@@@@@@.T..TT..T..@@@@@@@@@@@@@@@
@@@@@@T....T@....T.T.TT.@@@@@@@@..........TT@@@@@@@@@@@@@@@@
@@@@@@......@@.T.......@@@@@@@@....TT......@@@@@@@@@@@@@@@@@
@@@@@@T..T...@.T.TT...@@@@@@@@..TT.T..TT..@@@@@@@@@@@@@@@@@@
@@@@@.T......@@......@@@@@@@@@@.......T..@@@@@@@@@@@@@@@@@@@
@@@@.TT.T.....@.....@@@@@@@@@@..........@@@@@@@@@@@@@@@@@@@@
@@@@....T...T.@T...@@@@@@@@TT.....TT.TT@@@@@@@@@@@@@@@@@@@@@
@@@@@TT.T.....T...@@@@@@@@@@T.T...T...@@@@@@@@@@@@@@@@@@@@@@
@@@@@@T.T..T.....@@@@@@@@.@.....T..T.@@@@@@@@@@@@@@@@@@@@@@@
@@@@@@@..TTT..T.@@@@@@@@...........T@@@@@@@@@@@@@@@@@@@@@@@@
@@@@@@@@.....T.@@@@@@@@...T...T....@@@@@@@@@@@@@@@@@@@@@@@@@
@@@@@@@@@.T...@@@@@@@@@T..T.....T.@@@@@@@@@@@@@@@@@@@@@@@@@@
@@@@@@@@@@...T.@@@@@@@.........TT@@@@@@@@@@@@@@@@@@@@@@@@@@@
@@@@@@@@@@@...T.@@@@............@@@@@@@@@@@@@@@@@@@@@@@@@@@@
@@@@@@@@@@@@.....@@.....T..T.TT@@@@@@@@@@@@@@@@@@@@@@@@@@@@@
@@@@@@@@@@@@@.T.TTT..T.T...T..@@@@@@@@@@@@@@@@@@@@@@@@@@@@@@
@@@@@@@@@@@@@@.T..T....TTT..@@@@@@@@@@@@@@@@@@@@@@@@@@@@@@@@
@@@@@@@@@@@@@@@..T.T.....TT@@@@@@@@@@@@@@@@@@@@@@@@@@@@@@@@@
@@@@@@@@@@@@@@@@...T...T.T@@@@@@@@@@@@@@@@@@@@@@@@@@@@@@@@@@
@@@@@@@@@@@@@@@@@.T......@@@@@@@@@@@@@@@@@@@@@@@@@@@@@@@@@@@
@@@@@@@@@@@@@@@@@@@T....@@@@@@@@@@@@@@@@@@@@@@@@@@@@@@@@@@@@
@@@@@@@@@@@@@@@@@@@@...@@@@@@@@@@@@@@@@@@@@@@@@@@@@@@@@@@@@@
@@@@@@@@@@@@@@@@@@@@@@@@@@@@@@@@@@@@@@@@@@@@@@@@@@@@@@@@@@@@
@@@@@@@@@@@@@@@@@@@@@@@@@@@@@@@@@@@@@@@@@@@@@@@@@@@@@@@@@@@@
@@@@@@@@@@@@@@@@@@@@@@@@@@@@@@@@@@@@@@@@@@@@@@@@@@@@@@@@@@@@
