type octile
height 54
width 52
map
@@@@@@@@@@@@@@@@@@@@@@@@@@@@@@@@@@@@@@@@@@@@@@@@@@@@
@@@@@@@@@@@@@@@@@@@@@@@@@@@@@@@@@@@@@@@@@@@@@@@@@@@@
@@@@@@@@@@@@@@@@@@@@@@@@@@@@@@@@@@@@@@@@@@@@@@@@@@@@
@@@@@@@@@@@@@@@@@@@@@@@@@@@@@@@@@@@@@@@@@@@@@@@@@@@@
@@@@@@@@@@@@@@@@@@@@@@@@@@@@@@@@@@@@@@@@@@@@@@@@@@@@
@@@@@@@@@@@@@@@@@@@@@@@@@@@@@@@@@@@@@@@@@@@@@@@@@@@@
@@@@@@@@@@@@@@@@@@@@@@@@@@@@@@@@@@@@@@@@@@@@@@@@@@@@
@@@@@@@@@@@@@@@@@@@@@@@@@@@@@@@@@@@@@@@@@@@@@@@@@@@@
@@@@@@@@@@@@@@@@@@@@@@@@@@@@@@@@@@@@@@@@@@@@@@@@@@@@
@@@@@@@@@@@@@@@@@@@@@@@@@@@@@@@@@@@@@@@@@@@@@@@@@@@@
@@@@@@@@@@@@@@@@@@@@@@@@@@@@@@@@@@@@@@@@@@@@@@@@@@@@
@@@@@@@@@@@@@@@@@@@@@@@@@@@@@@@@@@@@@@@@@@@@@@@@@@@@
@@@@@@@@@@@@@@@@@@@@@@@@@@@@@@@@@@@@@@@@@@@@@@@@@@@@
@@@@@@@@@@@@@@@@@@@@@@@@@@@@@@@@@@@@@@@@@@@@@@@@@@@@
@@@@@@@@@@@@@@@@@@@@@@@@@@@@@@@@@@@@@@@@@@@@@@@@@@@@
@@@@@@@@@@@@@@@@@@@@@@@@@@@@@@@@@@@@@@@@@@@@@@@@@@@@
@@@@@@@@@@@@@@@@@@@@@@@@@@@@.@@@@..@@@@@@@@@@@@@@@@@
@@@@@@@@@@@@@@@@@@@@@@@@@@@...@@...T.@@@@@@@@@@@@@@@
@@@@@@@@@@@@@@@@@@@@@@@@@@.....TT.TT.T@@@@@@@@@@@@@@
@@@@@@@@@@@@@@@@@@@@@@@@@@......T.T.T..@@@@@@@@@@@@@
@@@@@@@@@@@@@@@@@@@@@@@@@.....T.@@......@@@@@@@@@@@@
@@@@@@@@@@@@@@@@@@@@@@@TTT.....@@@@@...T.@@@@@@@@@@@
@@@@@@@@@@@@@@@@@@@@@@.TT....T.@@@@@@@..TT@@@@@@@@@@
@@@@@@@@@@@@@@@@@@@@@..T..T..T.@@@@@@@TTT@@@@@@@@@@@
@@@@@@@@@@@@@@@@@@@@@@.........@@@@.....@@@@@@@@@@@@
@@@@@@@@@@@@@@@@@@@@@@@.T.....TT@......@@@@@@@@@@@@@
@@@@@@@@@@@@@@@@@@@@@@@@.........TT.TTT@@@@@@@@@@@@@
@@@@@@@@@@@@@@@@@..@@@@@@.T........TT..@@@@@@@@@@@@@
@@@@@@@@@@@@@@@@....@@@@@.......T.T..T.T@@@@@@@@@@@@
@@@@@@@@@@@@@@@..TT.T@@@@...........T..T.@@@@@@@@@@@
@@@@@@@@@@@@@@@@..T..@@@.T....T..T.TT.T..T@@@@@@@@@@
@@@@@@@@@@@@@@@@@..T.T..........T..T.....@@@@@@@@@@@
@@@@@@@@@@@@@@@@@@.T.T.TT..TT......T...T@@@@@@@@@@@@
@@@@@@@@@@@@@@@@@@@TT..T.....T...T.T.T.@@@@@@@@@@@@@
@@@@@@@@@@@@.@@@@@@...T.......T.T.....@@@@@@@@@@@@@@
@@@@@@@@.@@.T.@@@@@....T.T....TT.....@@@@@@@@@@@@@@@
@@@@@@@TT...T..@@@..........TT......@@@@@@@@@@@@@@@@
@@@@@@.......T.T.....T...T.......T.@@@@@@@@@@@@@@@@@
@@@@@@.....T....T....@@.T.TT..T..T@@@@@@@@@@@@@@@@@@
@@@@@@@T..T.....TT..@@@.....T.TT.@@@@@@@@@@@@@@@@@@@
@@@@@@@@.T.T.T..TT.@@T.TTT...T.T@@@@@@@@@@@@@@@@@@@@
@@@@@@@@@....T.TTT@@..T.T......@@@@@@@@@@@@@@@@@@@@@
@@@@@@@@@@..T...T@@T.T...TT.T.@@@@@@@@@@@@@@@@@@@@@@
@@@@@@@@@@@.T.T.@@T.....T..T.@@@@@@@@@@@@@@@@@@@@@@@
@@@@@@@@@@@@...@@.......T.T.@@@@@@@@@@@@@@@@@@@@@@@@
@@@@@@@@@@@@@.@@.TT...TT.T.@@@@@@@@@@@@@@@@@@@@@@@@@
@@@@@@@@@@@@@@@..T.T......@@@@@@@@@@@@@@@@@@@@@@@@@@
@@@@@@@@@@@@@@@.T.T..T.T.@@@@@@@@@@@@@@@@@@@@@@@@@@@
@@@@@@@@@@@@@@@@..TTT..T@@@@@@@@@@@@@@@@@@@@@@@@@@@@
@@@@@@@@@@@@@@@@@T.....@@@@@@@@@@@@@@@@@@@@@@@@@@@@@
@@@@@@@@@@@@@@@@@@....@@@@@@@@@@@@@@@@@@@@@@@@@@@@@@
@@@@@@@@@@@@@@@@@@@.T@@@@@@@@@@@@@@@@@@@@@@@@@@@@@@@
@@@@@@@@@@@@@@@@@@@@@@@@@@@@@@@@@@@@@@@@@@@@@@@@@@@@
@@@@@@@@@@@@@@@@@@@@@@@@@@@@@@@@@@@@@@@@@@@@@@@@@@@@
