type octile
height 50
width 50
map
@@@@@@@@@@@@@@@@@@@@@@@@@@@@@@@@@@@@@@@@@@@@@@@@@@
@@@@@@@@@@@@@@@@@@@@@@@@@@@@@@@@@@@@@@@@@@@@@@@@@@
@@@@@@@@@@@@@@@@@@@@@@@@@@@@@@@@@@@@@@@@@@@@@@@@@@
@@@@@@@@@@@@@@@@@@@@@@@@@@@@@@@@@@@@@@@@@@@@@@@@@@
@@@@@@@@@@@@@@@@@@@@@@@@@@@@@@@@@@@@@@@@@@@@@@@@@@
@@@@@@@@@@@@@@@@@@@@@@@@@@@@@@@@@@@@@@@@@@@@@@@@@@
@@@@@@@@@@@@@@@@@@@@@@@@@@@@@@@@@@@@@@@@@@@@@@@@@@
@@@@@@@@@@@@@@@@@@@@@@@@@@@@@@@@@@@@@@@@@@@@@@@@@@
@@@@@@@@@@@@@@@@@@@@@@@@@@@@@@@@@@@@@@@@@@@@@@@@@@
@@@@@@@@@@@@@@@@@@@@@@@@@@@@@@@@@@@@@@@@@@@@@@@@@@
@@@@@@@@@@@@@@@@@@@@@@@@@@@@@@@@@@@@@@@@@@@@@@@@@@
@@@@@@@@@@@@@@@@@@@@@@@@@@@@@@@@@@@@@@@@@@@@@@@@@@
@@@@@@@@@@@@@@@@@@@@@@@@@@@@@@@@@@@@@@@@@@@@@@@@@@
@@@@@@@@@@@@@@@@@@@@@@@@@@@@@@@@@@@@@@@@@@@@@@@@@@
@@@@@@@@@@@@@@@@@@@@@@@@@@@@@@@@@@@@@@@@@@@@@@@@@@
@@@@@@@@@@@@@@@@@@@@@@@@@@@@@@@@@@@@@@@@@@@@@@@@@@
@@@@@@@@@@@@@@@@@@@@@@@@@@@@@@@@@@@@@@@@@@@@@@@@@@
@@@@@@@@@@@@@@@@@@@@@@@@@@@@@@@@@@@@@@@@@@@@@@@@@@
@@@@@@@@@@@@@@@@@@@@@@@@@@@@@@@@@@@@@@@@@@@@@@@@@@
@@@@@@@@@@@@@@@@@@@@@@@@@@@@@@@@@@@@@@@@@@@@@@@@@@
@@@@@@@@@@@@@@@@@@@@@@@@@@@@@@@@@@@@@@@@@@@@@@@@@@
@@@@@@@@@@@@@@@@@@@@@@@@@@@@@@@@@@@@@@@@@@@@@@@@@@
@@@@@@@@@@@@@@@@@@@@@@@@@@@.@@@@@@@@@@@@@@@@@@@@@@
@@@@@@@@@@@@@@@@@@@@@@@@@....@@@@@@@@@@@@@@@@@@@@@
@@@@@@@@@@@@@@@@@@@@@@@@.T.T..@@@@@@@@@@@@@@@@@@@@
@@@@@@@@@@@@@@@@@@@@@@@..@T.TT.@@@@@@@@@@@@@@@@@@@
@@@@@@@@@@@@@@@@@@@@@@..@@@.T.@@@@@@@@@@@@@@@@@@@@
@@@@@@@@@@@@@@@@@@@@@..@@@@@@..TT.@@@@@@@@@@@@@@@@
@@@@@@@@@@@@@@@@@@@@..@@@@@@@@....T@@@@@@@@@@@@@@@
@@@@@@@@@@@@@@@@@@@T.T.@@@@@@@@.T..T.@@@@@@@@@@@@@
@@@@@@@@@@@@@@@@@@...@.TT@@@@@@TTT....@@@@@@@@@@@@
@@@@@@@@@@@@@@@@@TT.@@@..T@@@@T.....T.T@@@@@@@@@@@
@@@@@@@@@@@@@@@@@...@@@@@TT@@.......T.@@@@@@@@@@@@
@@@@@@@@@@@@@@@@.TTT.@@@@@..T.TT.....@@@@@@@@@@@@@
@@@@@@@@@@@@@@@..T.T..@@@@.T......T.@@@@@@@@@@@@@@
@@@@@@@@@@@@@@..TTT....@@..T.T.....@@@@@@@@@@@@@@@
@@@@@@@@@@@@...T..........TT.....T@@@@@@@@@@@@@@@@
@@@@@@@@@@@TT...T..TT...........T@@@@@@@@@@@@@@@@@
@@@@@@@@@@..T....T.T..T..T.T.T..@@@@@@@@@@@@@@@@@@
@@@@@@@@@@T.....TT....TT..T....@@@@@@@@@@@@@@@@@@@
@@@@@@@@@...............T..TT.T@@@@@@@@@@@@@@@@@@@
@@@@@@@@@@....T........T......@@@@@@@@@@@@@@@@@@@@
@@@@@@@@@@@..T....TT.........@@@@@@@@@@@@@@@@@@@@@
@@@@@@@@@@@@...T...T..T...T.@@@@@@@@@@@@@@@@@@@@@@
@@@@@@@@@@@@@.T............@@@@@@@@@@@@@@@@@@@@@@@
@@@@@@@@@@@@@@...T.TT.....@@@@@@@@@@@@@@@@@@@@@@@@
@@@@@@@@@@@@@@@T.T.TTT...@@@@@@@@@@@@@@@@@@@@@@@@@
@@@@@@@@@@@@@@@@........@@@@@@@@@@@@@@@@@@@@@@@@@@
@@@@@@@@@@@@@@@@@......@@@@@@@@@@@@@@@@@@@@@@@@@@@
@@@@@@@@@@@@@@@@@@@@@@@@@@@@@@@@@@@@@@@@@@@@@@@@@@
