type octile
height 64
width 64
map
@@@@@@@@@@@@@@@@@@@@@@@@@@@@@@@@@@@@@@@@@@@@@@@@@@@@@@@@@@@@@@@@
@@@@@@@@@@@@@@@@@@@@@@@@@@@@@@@@@@@@@@@@@@@@@@@@@@@@@@@@@@@@@@@@
@@@@@@@@@@@@@@@@@@@@@@@@@@@@@@@@@@@@@@@@@@@@@@@@@@@@@@@@@@@@@@@@
@@@@@@@@@@@@@@@@@@@@@@@@@@@@@@@@@@@@@@@@@@@@@@@@@@@@@@@@@@@@@@@@
@@@@@@@@@@@@@@@@@@@@@@@@@@@@@@@@@@@@@@@@@@@@@@@@@@@@@@@@@@@@@@@@
@@@@@@@@@@@@@@@@@@@@@@@@@@@@@@@@@@@@@@@@@@@@@@@@@@@@@@@@@@@@@@@@
@@@@@@@@@@@@@@@@@@@@@@@@@@@@@@@@@@@@@@@@@@@@@@@@@@@@@@@@@@@@@@@@
@@@@@@@@@@@@@@@@@@@@@@@@@@@@@@@@@@@@@@@@@@@@@@@@@@@@@@@@@@@@@@@@
@@@@@@@@@@@@@@@@@@@@@@@@@@@@@@@@@@@@@@@@@@@@@@@@@@@@@@@@@@@@@@@@
@@@@@@@@@@@@@@@@@@@@@@@@@@@@@@@@@@@@.@@@@@@@@@@@@@@@@@@@@@@@@@@@
@@@@@@@@@@@@@@@@@@@@@@@@@@@@@@@@@@@..T@@@@@@@@@@@@@@@@@@@@@@@@@@
@@@@@@@@@@@@@@@@@@@@@@@@@@@@@@@@@@T....@@@@@@@@@@@@@@@@@@@@@@@@@
@@@@@@@@@@@@@@@@@@@@@@@@@@@@@@@@@TTT....@@@@@@@@@@@@@@@@@@@@@@@@
@@@@@@@@@@@@@@@@@@@@@@@@@@@@@@@@...T...TT@@@@@@@@@@@@@@@@@@@@@@@
@@@@@@@@@@@@@@@@@@@@@@@@@@@@@@@.......T.T.@@@@@@@@@@@@@@@@@@@@@@
@@@@@@@@@@@@@@@@@@@@@@@@@@@@@@.....TTT.T.T.@@@@@@@@@@@@@@@@@@@@@
@@@@@@@@@@@@@@@@@@@@@@@@@@@@@TT...T..TT.T.T@@@@@@@@@@@@@@@@@@@@@
@@@@@@@@@@@@@@@@@@@@@@@@@@@@....@@.TTT..TT@@T@@@@@@@@@@@@@@@@@@@
@@@@@@@@@@@@@@@@@@@@@@@@@@@.T..TT@@...T.T@@...@@@@@@@@@@@@@@@@@@
@@@@@@@@@@@@@@@@@@@@@@@@@.........@@.T.T@@.....@@@@@@@@@@@@@@@@@
@@@@@@@@@@@@@@@@@@@@@@@@@.TTT.T...T@@..@@.T.T...@@@@@@@@@@@@@@@@
@@@@@@@@@@@@@@@@@@@@@@@@@T.T.T..T..T@@@@T........@@@@@@@@@@@@@@@
@@@@@@@@@@@@@@@@@@@@@@@@@@TT.T...T...@@........T...@@@@@@@@@@@@@
@@@@@@@@@@@@@@@@@@@@@@@@@@@......T...T...TT.....TT..@@@@@@@@@@@@
@@@@@@@@@@@@@@@@@@@@@@@@@@@@..T..T..........T..T....T@@@@@@@@@@@
@@@@@@@@@@@@@@@@@@@@@@@@@@@@@.T.....................T.@@@@@@@@@@
@@@@@@@@@@@@@@@@@@@@@@@@@@@@@@..T..T..T.T..............@@@@@@@@@
@@@@@@@@@@@@@@@@@@@@@@@@@@.@@@@...T.T.T.T..........TT...@@@@@@@@
@@@@@@@@@@@@@@@@@@@.@@@@@..T@@@@T.T.T..TT...T...T.....TT.@@@@@@@
@@@@@@@@@@@@@@@@@@.T.@@@..T.T@@@@.....TTT....TT..T......T.@@@@@@
@@@@@@@@@@@@@@@@@@.....TT.....@@@@..T....T.....T..T.T..T...@@@@@
@@@@@@@@@@@@@@@@@@@............@@.....T.T.T.T........T.T..T.@@@@
@@@@@@@@@@@@@@@@@@@@T..TT....T.....T..T.T...T............TT..@@@
@@@@@@@@@@@@@@@@@@@@..T.....T.....T.@.....T.T..T.T.T..T.....@@@@
@@@@@@@@@@@@.T@@@@.TT...TT.........@@@....TT...T...T.T..T..@@@@@
@@@@@@@@@@@..T.@@...T..TT....@....T@@@@.T..T....TT.T......@@@@@@
@@@@@@@@@@@T.T...T..T.....T.@@....TT@@@@TT..T..........T.@@@@@@@
@@@@@@@@@@@@.......T.......@@@@......@@@@..............T@@@@@@@@
@@@@@.@@@@@@@...T.......T.@@@@@@..T.TT@@@@...T...T.TT.T@@@@@@@@@
@@@@T..@@@@@@..T....T...T@@@@@@@....T.T@@@@.T.T....T.T@@@@@@@@@@
@@@...T.@@@@T..T..T..TT.@@@@@@@@T.TT...T.@@@T..TTT...@@@@@@@@@@@
@@@.T..TT@@......T......@@@@@@@....T....@@@@@@.T....@@@@@@@@@@@@
@@@@T..T........T...TT.@@@@@@@....T.TT.@@@@@@@@..T.@@@@@@@@@@@@@
@@@@@..T...T.T.TT..T@..@@@@@@....T...T@@@@@@@@@@.T@@@@@@@@@@@@@@
@@@@@@.....TT......@@@..@@T.......TT..@@@@@@@@@@@@@@@@@@@@@@@@@@
@@@@@@@....TTTTT.T@@@@@....TT.........@@@@@@@@@@@@@@@@@@@@@@@@@@
@@@@@@@@.T..T.TT.@@@@@@@T..............@@@@@@@@@@@@@@@@@@@@@@@@@
@@@@@@@@@....T..@@@@@@@@.T.T....T.@@..T.@@@@@@@@@@@@@@@@@@@@@@@@
@@@@@@@@@@TT...T.@@@@@@.....T...T@@@@.T..@@@@@@@@@@@@@@@@@@@@@@@
@@@@@@@@@@@....T..@@@@..........@@@@@@....@@@@@@@@@@@@@@@@@@@@@@
@@@@@@@@@@@@..T...T@@...T....T.@@@@@@@@....@@@@@@@@@@@@@@@@@@@@@
@@@@@@@@@@@@@T.T...T...TT...T...@@@@@@@@TT@@@@@@@@@@@@@@@@@@@@@@
@@@@@@@@@@@@@@..................T@@@@@@@@@@@@@@@@@@@@@@@@@@@@@@@
@@@@@@@@@@@@@@@..T.TT...T..@@.T.TT@@@@@@@@@@@@@@@@@@@@@@@@@@@@@@
@@@@@@@@@@@@@@@@T........T@@@@T....@@@@@@@@@@@@@@@@@@@@@@@@@@@@@
@@@@@@@@@@@@@@@@@..T...TT@@@@@@T..T.@@@@@@@@@@@@@@@@@@@@@@@@@@@@
@@@@@@@@@@@@@@@@@@T.TT..@@@@@@@@TT...@@@@@@@@@@@@@@@@@@@@@@@@@@@
@@@@@@@@@@@@@@@@@@@T.T...@@@@@@@@T.T@@@@@@@@@@@@@@@@@@@@@@@@@@@@
@@@@@@@@@@@@@@@@@@@@......@@@@@@@@.@@@@@@@@@@@@@@@@@@@@@@@@@@@@@
@@@@@@@@@@@@@@@@@@@@@..TT.T@@@@@@@@@@@@@@@@@@@@@@@@@@@@@@@@@@@@@
@@@@@@@@@@@@@@@@@@@@@@......@@@@@@@@@@@@@@@@@@@@@@@@@@@@@@@@@@@@
@@@@@@@@@@@@@@@@@@@@@@@TTT...@@@@@@@@@@@@@@@@@@@@@@@@@@@@@@@@@@@
@@@@@@@@@@@@@@@@@@@@@@@@.T...T@@@@@@@@@@@@@@@@@@@@@@@@@@@@@@@@@@
@@@@@@@@@@@@@@@@@@@@@@@@@@@@@@@@@@@@@@@@@@@@@@@@@@@@@@@@@@@@@@@@
