type octile
height 86
width 80
map
@@@@@@@@@@@@@@@@@@@@@@@@@@@@@@@@@@@@@@@@@@@@@@@@@@@@@@@@@@@@@@@@@@@@@@@@@@@@@@@@
@@@@@@@@@@@@@@@@@@@@@@@@@@@@@@@@@@@@@@@@@@@@@@@@@@@@@@@@@@@@@@@@@@@@@@@@@@@@@@@@
@@@@@@@@@@@@@@@@@@@@@@@@@@@@@@@@@@@@@@@@@@@@@@@@@@@@@@@@@@@@@@@@@@@@@@@@@@@@@@@@
@@@@@@@@@@@@@@@@@@@@@@@@@@@@@@@@@@@@@@@@@@@@@@@@@@@@@@@@@@@@@@@@@@@@@@@@@@@@@@@@
@@@@@@@@@@@@@@@@@@@@@@@@@@@@@@@@@@@@@@@@@@@@@@@@@@@@@@@@@@@@@@@@@@@@@@@@@@@@@@@@
@@@@@@@@@@@@@@@@@@@@@@@@@@@@@@@@@@@@@@@@@@@@@@@@@@@@@@@@@@@@@@@@@@@@@@@@@@@@@@@@
@@@@@@@@@@@@@@@@@@@@@@@@@@@@@@@@@@@@@@@@@@@@@@@@@@@@@@@@@@@@@@@@@@@@@@@@@@@@@@@@
@@@@@@@@@@@@@@@@@@@@@@@@@@@@@@@@@@@@@@@@@@@@@@@@@@@@@@@@@@@@@@@@@@@@@@@@@@@@@@@@
@@@@@@@@@@@@@@@@@@@@@@@@@@@@@@@@@@@@@@@@@@@@@@@@@@@@@@@@@@@@@@@@@@@@@@@@@@@@@@@@
@@@@@@@@@@@@@@@@@@@@@@@@@@@@@@@@@@@@@@@@@@@@@@@@@@@@@@@@@@@@@@@@@@@@@@@@@@@@@@@@
@@@@@@@@@@@@@@@@@@@@@@@@@@@@@@@@@@@@@@@@@@@@@..@@@@@@@@@@@@@@@@@@@@@@@@@@@@@@@@@
@@@@@@@@@@@@@@@@@@@@@@@@@@@@@@@@@@@@@@@@@@@@..@@@@@@@@@@@@@@@@@@@@@@@@@@@@@@@@@@
@@@@@@@@@@@@@@@@@@@@@@@@@@@@@@@@@@@@@@@@@@@..@@@@@@@@@@@@@@@@@@@@@@@@@@@@@@@@@@@
@@@@@@@@@@@@@@@@@@@@@@@@@@@@@@@@@@@@@@@@@@..T@@@@@@@@@@@@@@@@@@@@@@@@@@@@@@@@@@@
@@@@@@@@@@@@@@@@@@@@@@@@@@@@@@@@@@@@@@@@@T.T..@@...@@@@@@@@@@@@@@@@@@@@@@@@@@@@@
@@@@@@@@@@@@@@@@@@@@@@@@@@@@@@@@@@@@@@@@......T.T..T@@@@@@@@@@@@@@@@@@@@@@@@@@@@
@@@@@@@@@@@@@@@@@@@@@@@@@@@@@@@@@@@@@@@...T..TT@...TT.@@@@@@@@@@@@@@@@@@@@@@@@@@
@@@@@@@@@@@@@@@@@@@@@@@@@@@@@@@@@@@@@@@T.T.TTT@@@......@@@@@@@@@@@@@@@@@@@@@@@@@
@@@@@@@@@@@@@@@@@@@@@@@@@@@@@@@@@@@@@@@@......@@@@.@@..T@@..@@@@@@@@@@@@@@@@@@@@
@@@@@@@@@@@@@@@@@@@@@@@@@@@@@@@@@@@@@@@@@@..@@@@@@@@@@.......@@@@@@@@@@@@@@@@@@@
@@@@@@@@@@@@@@@@@@@@@@@@@@@@@@@@@@@@@.@@@@.T@@@@@@@@@@T.T....@@@@@@@@@@@@@@@@@@@
@@@@@@@@@@@@@@@@@@@@@@@@@@@@@@@@@@@@TT.@@TT..@@@@...TT.TT...@@@@@@@@@@@@@@@@@@@@
@@@@@@@@@@@@@@@@@@@@@@@@@@@@@@@@@@@T.T.T.TT...@@....TTTT.TT@@@@@@@@@@@@@@@@@@@@@
@@@@@@@@@@@@@@@@@@@@@@@@@@@@@@@@@@@@.............TT..TT...@@@@@@@@@@@@@@@@@@@@@@
@@@@@@@@@@@@@@@@@@@@@@@@@@@@@@@@.@@@T.......T..TTT.......@@@@@@T.@@@@@@@@@@@@@@@
@@@@@@@@@@@@@@@@@@@@@@@@@@@@@@@..@@@.........T..TT...T..@@@@@@.T.@@@@@@@@@@@@@@@
@@@@@@@@@@@@@@@@@@@@@@@@@@@@@@....TT....T..TT..........@@@@@@.T.TT@@@@@@@@@@@@@@
@@@@@@@@@@@@@@@@@@@@@@@@@@@@@@.T.T.T.T..TTT.....T...T.@@@@@@.T...T.@@@@@@@@@@@@@
@@@@@@@@@@@@@@@@@@@@@@@@@@@@@@@........T...TT.......T@@@@@@..T.T.T..T@@@@@@@@@@@
@@@@@@@@@@@@@@@@@@@@@@@@@@@@@@@@.T...T...TTT...TT.TT@@@@@@..T.........@@@@@@@@@@
@@@@@@@@@@@@@@@@@@@@@@@@@@@@@@@@@..T..T....T..T....@@@@@TT..T.T..TT.T..T.@@@@@@@
@@@@@@@@@@@@@@@@@@@@@@@@@@@@@@@@@.....TTT..........@@@.T..TT..TT..TT...T..@@@@@@
@@@@@@@@@@@@@@@@@@@@@@@@@@@@@@@....T.T...T.T....T...@..T...TT.T..T....T..T..@@@@
@@@@@@@@@@@@@@@@@@@@@@@@@@@@@@..........T..T.T.T@@.....T.......T.@@@.@@@T....@@@
@@@@@@@@@@@@@@@@@@@@@@@@@@@@@....T.T..TTTT..TT@@@@.T..TT@@@@..T.@@@@@@@@....TT.@
@@@@@@@@@@@@@@@@@@@@@@@@@@@.T.........TT.T...@@@@@..T.TT@@@@@@@@@@@@@@.......T.@
@@@@@@@@@@@@@@@@@@@@@@@@@@.....T.......TT...@@@@@@..T.T.T@@@@@@@@@@@@@@...T.T..@
@@@@@@@@@@@@@@@@@@@@@@@@@@@.TTT.....T.T....@@@@@@..T.T..@@@@@@@@T@@@@@@T.T.T...@
@@@@@@@@@@@@@@@@@@@@@@@T@@@@.....TT.....T.@@@@@@.....TT@@@@@@@@..T@@@@@..T...T@@
@@@@@@@@@@@@@@.@@@@@@@..TT.@@..T.T..T....@@@@@@....T.T@@@@@@@@@TT.@@@@@@.T..T@@@
@@@@@@@@@@@@@@..@@@@@....T...T....TTTT.T@@@@@@T.T.T..T@@@@@@@@@..@@@@@@@@...@@@@
@@@@@@@@@@@@@@T...@@@.T..T...T.@TTTT...@@@@@@....TTTT@@@@@@@@@.T.@@@@@@@@@.@@@@@
@@@@@@@@@@@@@@...T.........T.T@@@.....@@@@@@T.T.......@@@@@@@....@@@@@@@@@@@@@@@
@@@@@@@@@@@@@T....TTT.....T....@@@@TT@@@@@@T...T......TT..@@@...@@@@@@@@@@@@@@@@
@@@@@@@@@@@@....T.T.....T...T...T@@@@@@@@@.T....T...T...T.@@@.T.@@@@@@@@@@@@@@@@
@@@@@@@@@..TT.....T.....T.T.T.T.T.@@@@@@@..T........T.....@@TTT@@@@@@@@@@@@@@@@@
@@@@@@@@@...T........T......T...T.@@@@@@...T....T.........@....@@@@@@@@@@@@@@@@@
@@@@@@@@T.T.T.T..TT.......T......@@@@@@..TT.........T.T...TTT.@@@@@@@@@@@@@@@@@@
@@@@@@@T.T....T...T...T.....T...@@@@@@.....T..T.....T..T.T....@@@@@@@@@@@@@@@@@@
@@@@@@T.T..@@...T..T......T....@@@@@@........TTT......T.T....@@@@@@@@@@@@@@@@@@@
@@@@@..T..@@.........TTTT....T@@@@@@.....TT.....T.T..T.TT.....@@@@@@@@@@@@@@@@@@
@@@@T.TTT@@TT.T.........T....@@@@@@..T......T....T......TT.TT.T@@@@@@@@@@@@@@@@@
@@@@.T..@@@@@T..T.T....T.T@@@@@@@@..................TT......T...@@@@@@@@@@@@@@@@
@@@@...@@@@@@@@@..........@@@.@@@........T@@@...T.T.T........T.@@@@@@@@@@@@@@@@@
@@@@.T@@@@@@@@@@@@TT.T.....@.T@@...TT.....@@@.....TT.TT.TT..T.@@@@@@@@@@@@@@@@@@
@@@@@@@@@@@@@@@@@@........T.T......T.@@..T@@@.T...T...T......@@@@@@@@@@@@@@@@@@@
@@@@@@@@@@@@@@@@@@.T..T@@.TT.....T..@@@@@.TT..TT.TT.T...T...@@@@@@@@@@@@@@@@@@@@
@@@@@@@@@@@@@@@@@@...T@@@@.........@@@@@@.T.T.T.T.....T....@@@@@@@@@@@@@@@@@@@@@
@@@@@@@@@@@@@@@@@@..T@@@@@........@@@@@@@@TT.........TT...@@@@@@@@@@@@@@@@@@@@@@
@@@@@@@@@@@@@@@@@@.T@@@@@@.T....@@@@@@@@@@@@..T..T.......@@@@@@@@@@@@@@@@@@@@@@@
@@@@@@@@@@@@@@@@@@.@@@@@@..T..@@@@@@@@@@@@@@.......T....@@@@@@@@@@@@@@@@@@@@@@@@
@@@@@@@@@@@@@@@@@@@@@@@@@.....@@@@@@@@@@@@@@T..T.....T.@@@@@@@@@@@@@@@@@@@@@@@@@
@@@@@@@@@@@@@@@@@@@@@@@@.....T@@@@@@@@@@@@...T.T..TTT.@@@@@@@@@@@@@@@@@@@@@@@@@@
@@@@@@@@@@@@@@@@@@@@@@.........T...@@@@@@.TTT........@@@@@@@@@@@@@@@@@@@@@@@@@@@
@@@@@@@@@@@@@@@@@@@@@T....TTTT....@@@@@@..TT.TT....T@@@@@@@@@@@@@@@@@@@@@@@@@@@@
@@@@@@@@@@@@@@@@@@@@@.........T...T@@@@TT.T....T..T@@@@@@@@@@@@@@@@@@@@@@@@@@@@@
@@@@@@@@@@@@@@@@@@@@..T.T...TT..T..@@@T.T.....TT..@@@@@@@@@@@@@@@@@@@@@@@@@@@@@@
@@@@@@@@@@@@@@@@@@...TT.......T....@@T...........@@@@@@@@@@@@@@@@@@@@@@@@@@@@@@@
@@@@@@@@@@@@@@@@@@...T.......T............T.....@@@@@@@@@@@@@@@@@@@@@@@@@@@@@@@@
@@@@@@@@@@@@@@@@@....T.....T...T..T..T..T.T....@@@@@@@@@@@@@@@@@@@@@@@@@@@@@@@@@
@@@@@@@@@@@@@@@@.....TT..T............T@TTT...@@@@@@@@@@@@@@@@@@@@@@@@@@@@@@@@@@
@@@@@@@@@@@@@@@@T..T........T.T.T......@@@...@@@@@@@@@@@@@@@@@@@@@@@@@@@@@@@@@@@
@@@@@@@@@@@@@@@@@TT......T..TT.T...T....@@@@@@@@@@@@@@@@@@@@@@@@@@@@@@@@@@@@@@@@
@@@@@@@@@@@@@@@@@@...T..T..TT..........T.@@@@@@@@@@@@@@@@@@@@@@@@@@@@@@@@@@@@@@@
@@@@@@@@@@@@@@@@@@@....TT.T.T....T.T.T....@@@@@@@@@@@@@@@@@@@@@@@@@@@@@@@@@@@@@@
@@@@@@@@@@@@@@@@@@@@......T..TTT.T..TT...@@@@@@@@@@@@@@@@@@@@@@@@@@@@@@@@@@@@@@@
@@@@@@@@@@@@@@@@@@@@@..TTT......T...TT.T@@@@@@@@@@@@@@@@@@@@@@@@@@@@@@@@@@@@@@@@
@@@@@@@@@@@@@@@@@@@@@@TT......T@@.......@@@@@@@@@@@@@@@@@@@@@@@@@@@@@@@@@@@@@@@@
@@@@@@@@@@@@@@@@@@@@@@@TT.T....@@@....T@@@@@@@@@@@@@@@@@@@@@@@@@@@@@@@@@@@@@@@@@
@@@@@@@@@@@@@@@@@@@@@@@@..T...T@@@@.T.T@@@@@@@@@@@@@@@@@@@@@@@@@@@@@@@@@@@@@@@@@
@@@@@@@@@@@@@@@@@@@@@@@@@.T.T.T@@@@@..@@@@@@@@@@@@@@@@@@@@@@@@@@@@@@@@@@@@@@@@@@
@@@@@@@@@@@@@@@@@@@@@@@@@@@TT.T@@@@@@@@@@@@@@@@@@@@@@@@@@@@@@@@@@@@@@@@@@@@@@@@@
@@@@@@@@@@@@@@@@@@@@@@@@@@@@@@@@@@@@@@@@@@@@@@@@@@@@@@@@@@@@@@@@@@@@@@@@@@@@@@@@
@@@@@@@@@@@@@@@@@@@@@@@@@@@@@@@@@@@@@@@@@@@@@@@@@@@@@@@@@@@@@@@@@@@@@@@@@@@@@@@@
@@@@@@@@@@@@@@@@@@@@@@@@@@@@@@@@@@@@@@@@@@@@@@@@@@@@@@@@@@@@@@@@@@@@@@@@@@@@@@@@
@@@@@@@@@@@@@@@@@@@@@@@@@@@@@@@@@@@@@@@@@@@@@@@@@@@@@@@@@@@@@@@@@@@@@@@@@@@@@@@@
