type octile
height 64
width 60
map
@@@@@@@@@@@@@@@@@@@@@@@@@@@@@@@@@@@@@@@@@@@@@@@@@@@@@@@@@@@@
@@@@@@@@@@@@@@@@@@@@@@@@@@@@@@@@@@@@@@@@@@@@@@@@@@@@@@@@@@@@
@@@@@@@@@@@@@@@@@@@@@@@@@@@@@@@@@@@@@@@@@@@@@@@@@@@@@@@@@@@@
@@@@@@@@@@@@@@@@@@@@@@@@@@@@@@@@@@@@@@@@@@@@@@@@@@@@@@@@@@@@
@@@@@@@@@@@@@@@@@@@@@@@@@@@@@@@@@@@@@@@@@@@@@@@@@@@@@@@@@@@@
@@@@@@@@@@@@@@@@@@@@@@@@@@@@@@@@@@@@@@@@@@@@@@@@@@@@@@@@@@@@
@@@@@@@@@@@@@@@@@@@@@@@@@@@@@@@@@@@@@@@@@@@@@@@@@@@@@@@@@@@@
@@@@@@@@@@@@@@@@@@@@@@@@@@@@@@@@@@@@@@@@@@@@@@@@@@@@@@@@@@@@
@@@@@@@@@@@@@@@@@@@@@@@@@@@@@@@@@@@@@@@@@@@@@@@@@@@@@@@@@@@@
@@@@@@@@@@@@@@@@@@@@@@@@@@@@@@@@@@@@@@@@@@@@@@@@@@@@@@@@@@@@
@@@@@@@@@@@@@@@@@@@@@@@@@@@@@@@@@@@@@@@@@@@@@@@@@@@@@@@@@@@@
@@@@@@@@@@@@@@@@@@@@@@@@@@@@@@@@@@@@@@@@@@@@@@@@@@@@@@@@@@@@
@@@@@@@@@@@@@@@@@@@@@@@@@@@@@@@@@@@@@@@@@@@@@@@@@@@@@@@@@@@@
@@@@@@@@@@@@@@@@@@@@@@@@@@@....@@@@@@@@@@@@@@@@@@@@@@@@@@@@@
@@@@@@@@@@@@@@@@@@@@@@@@@@T.......@@@@@@@@@@@@@@@@@@@@@@@@@@
@@@@@@@@@@@@@@@@@@@@@@@@@@....T..T.@@@@@@@@@@@@@@@@@@@@@@@@@
@@@@@@@@@@@@@@@@@@@@@@@@@@TT.T.....T.@@@@@@@@@@@@@@@@@@@@@@@
@@@@@@@@@@@@@@@@@@@@@@@@@@T..T.....T...@@@@@@@@@@@@@@@@@@@@@
@@@@@@@@@@@@@@@@@@@@@@@@@@T..T..TT...T.T@@@@@@@@@@@@@@@@@@@@
@@@@@@@@@@@@@@@@@@@@@@@@@@..T..T...T.....@@@@@@@@@@@@@@@@@@@
@@@@@@@@@@@@@@@@@@@@@@@@@@..........T.TT.@@@T@@@@@@@@@@@@@@@
@@@@@@@@@@@@@@@@@@@@@@@@@..T..TT...........T..@@@@@@@@@@@@@@
@@@@@@@@@@@@@@@@@@@@@@@@@T......T.T.T..T......@@@@@@@@@@@@@@
@@@@@@@@@@@@@@@.T.T.@@@@@T...T.....T.T.T.T@TT.T@@@@@@@@@@@@@
@@@@@@@@@@@@@@T......@@@T..T.......T@@@.T.@@.TT@@@@@@@@@@@@@
@@@@@@@@@@@@@@@..T.....T...@@@@..T.@@@@...@@TTT@@@@@@@@@@@@@
@@@@@@@@@@@@@@@..T........T@@@@TT@@@@@@T.@@@...@@@@@@@@@@@@@
@@@@@@@@@@@@@@@...T.T.....T@@@@@@@@@@@...@@@...@@@@@@@@@@@@@
@@@@@@@@@@@@@@@T......@@@@@@@@@@@@@@@@@@@@@....@@@@@@@@@@@@@
@@@@@@@@@@@@@@@.......@@@@@@@@@@@@@@@@@@@@.TT.T@@@@@@@@@@@@@
@@@@@@@@@@@@@.........@@@@@@@@@@@@@@@@@@@@T.T@@@@....@@@@@@@
@@@@@@@@@@@@@...T...T@@@@@@@@@@@@@@@@@@@@@T..@@@...T..@@@@@@
@@@@@@@@@@@@@..TT.T.T.@@@@@@@@@@@@@@@@@@@@@...@@....T.@@@@@@
@@@@@@@@@@@@@TT.T..T..T@@@@@@@@@@@@@@@@...@@..@@T..T..@@@@@@
@@@@@@@@@@@@@..T..T.T.@@@@@@@@@@@@@@@@@.TT@@T.....TTT.@@@@@@
@@@@@@@@@@@@@@...T...@@@@@@@.@@@@@@@@@@...@@@.TTTT....@@@@@@
@@@@@@@@@@@@@@@...TT@@@@@@@..T@@@@@@@@@TT...TT........@@@@@@
@@@@@@@@@@@@@@@@..TT@@@@@@@....@@@@@@@@T.T.T.TT..TTT..@@@@@@
@@@@@@@@@@@@@@@@@..@@@@@@@......@@@@@@............T...@@@@@@
@@@@@@@@@@@@@@@@@@@@@@@@@@..@@@..@@TT.....TT........T.@@@@@@
@@@@@@@@@@@@@@@@@@@@@@@@@.T@@@@@T@@.T....TT...TTT...T.@@@@@@
@@@@@@@@@@@@@@@@@@@@@@@@@..@@@@@.TT....T...T...TT...T.@@@@@@
@@@@@@@@@@@@@@@@@@@@@@@@...@@@@.T..T........T......TT@@@@@@@
@@@@@@@@@@@@@@@@@@@@@@@@TT.@@@@.TT..T.T....T..T.T...@@@@@@@@
@@@@@@@@....@...@@@@@@@@.T.TT....TT.........TTT..T..@@@@@@@@
@@@@@@@@.T..TTT..@@@@@@@@..TTTTT......T.T..T...T...@@@@@@@@@
@@@@@@@@..T.T.......@@@@....T....T...T...T...TT..T@@@@@@@@@@
@@@@@@@@..T.T.....T.@@...........T.T.............T@@@@@@@@@@
@@@@@@@@@..........T.................T...TT....T.@@@@@@@@@@@
@@@@@@@@@@......TT................TT.TT....T.TTTT@@@@@@@@@@@
@@@@@@@@@@@....T.......T......TTT..TT........T..@@@@@@@@@@@@
@@@@@@@@@@@@.T..T..T..TTT....T.T...T.T.........@@@@@@@@@@@@@
@@@@@@@@@@@@@..TTT....T...T............T....T.T@@@@@@@@@@@@@
@@@@@@@@@@@@@@...........TT.....T..T...TT...TT@@@@@@@@@@@@@@
@@@@@@@@@@@@@@@.........T.T...TT.T.TT..T...T.@@@@@@@@@@@@@@@
@@@@@@@@@@@@@@@@@.................TT.........@@@@@@@@@@@@@@@
@@@@@@@@@@@@@@@@@@@....TT.........TT..T.T...@@@@@@@@@@@@@@@@
@@@@@@@@@@@@@@@@@@@@@......T....T...........@@@@@@@@@@@@@@@@
@@@@@@@@@@@@@@@@@@@@@@@@.TT.T...T.TT.T....T@@@@@@@@@@@@@@@@@
@@@@@@@@@@@@@@@@@@@@@@@@@@.T.T...T........@@@@@@@@@@@@@@@@@@
@@@@@@@@@@@@@@@@@@@@@@@@@@@@@@........TT.@@@@@@@@@@@@@@@@@@@
@@@@@@@@@@@@@@@@@@@@@@@@@@@@@@@@@.T..T.T.@@@@@@@@@@@@@@@@@@@
@@@@@@@@@@@@@@@@@@@@@@@@@@@@@@@@@@@@@@@@@@@@@@@@@@@@@@@@@@@@
@@@@@@@@@@@@@@@@@@@@@@@@@@@@@@@@@@@@@@@@@@@@@@@@@@@@@@@@@@@@
