type octile
height 59
width 56
map
@@@@@@@@@@@@@@@@@@@@@@@@@@@@@@@@@@@@@@@@@@@@@@@@@@@@....
@@@@@@@@@@@@@@@@@@@@@@@@@@@@@@@@@@@@@@@@@@@@@@@@@@@@....
@@@@@@@@@@@@@@@@@@@@@@@@@@@@@@@@@@@@@@@@@@@@@@@@@@@@....
@@@@@@@@@@@@@@@@@@@@@@@@@@@@@@@@@@@@@@@@@@@@@@@@@@@@@...
@@@@@@@@@@@@@@@@@@@@@@@@@@@@@@@@@@@@@@@@@@@@@@@@@@@@@...
@@@@@@@@@@@@@@@@@@@@@@@@@@@@@@@@@@@@@@@@@@@@@@@@@@@@@...
@@@@@@@@@@@@@@@@@@@@@@@@@@@@@@@@@@@@@@@@@@@@@@@@@@@@@T..
@@@@@@@@@@@@@@@@@@@@@@@@@@@@@@@@@@@@@@@@@@@@@@@@@@@@@TT.
@@@@@@@@@@@@@@@@@@@@@@@@@@@@@@@@@@@@@@@@@@@@@@@@@@@@@..T
@@@@@@@@@@@@@@@@@@@@@@@@@@@@@@@@@@@@@@@@@@@@@@@@@@@@@...
@@@@@@@@@@@@@@@@@@@@@@@@@@@@@@@@@@@@@@@@@@@@@@@@@@@@@T..
@@@@@@@@@@@@@@@@@@@@@@@@@.T.....@@@@@@@@@@@@@@@@@@@@@...
@@@@@@@@@@@@@@@@@@@.................@@@@@..@@@@@@@@@@...
@@@@@@@@@@@@@@@@@@..T.........T.T.....@@@...@@@@@@@@@...
@@@@@@@@@@@@@@@@............T..........@@...@@@@@@@@@...
@@@@@@@@@@@@@@................T.......T.....@@@@@@@@@.T.
@@@@@@@@@@@@@..T...........T.........T......@@@@@@@@@@..
@@@@@@@@@@@@...............................T@@@@@@@@@@..
@@@@@@@@@@@.T...............................@@@@@@@@@@@.
@@@@@@@@@@.........................T.........@@@@@@@@@@@
@@@@@@@@@.........T........T..T.T.............@@@@@@@@@@
@@@@@@@@....T.......T...T......................@@@@@@@@@
@@@@@@@@...T.......T.......T...........T........@@@@@@@@
@@@@@@@@...................T......T..TT..........@@@@@@.
@@@@@@@...........T...T....T.T..T..T.............@@@@@@.
@@@@@@@............TT...............T....T.......@@@@@@@
@@@@@@@T...T...T.................................@@@@@@@
@@@@@@@T...........T..T.........TT.T.............@@@@@@@
@@@@@@@.T.....TTT.....................T..T.......@@@@@@@
@@@@@@@.......T...........@@@............T.......@@@@@@@
@@@@@@@.............T.....@@@.....T..............@@@@@@@
@@@@@@@.T.................@@@....T...............@@@@@@@
@@@@@@@.................T........T...............@@@@@@@
@@@@@@@........T........................T.....T..@@@@@@@
@@@@@@@T.........T......T.....T............T.T.T.@@@@@@@
@@@@@@@.....................T.............T.T....@@@@@@@
@@@@@@@...................................T......@@@@@@@
@@@@@@@T.....................T.....T.T...........@@@@@@@
@@@@@@@........T...........................T.....@@@@@@@
@@@@@@@....T..........T...TTT....T......T........@@@@@@@
@@@@@@@.........T.........T.......T..............@@@@@@@
@@@@@@@@.T..................T...................T.@@@@@@
@@@@@@@@@...T...........TT..T......T.............@@@@@@@
@@@@@@@@@@.............T.......................T@@@@@@@@
@@@@@@@@@@@........T...................T.......@@@@@@@@@
@@@@@@@@@@@@................T.....T.....T...T.@@@@@@@@@@
@@@@@@@@@@@@@........................T.......@@@@@@@@@@@
@@@@@@@@@@@@@@............T.................@@@@@@@@@@@@
@@@@@@@@@@@@@@@@.T.T....T...T.........T....@@@@@@@@@@@@@
@@@@@@@@@@@@@@@@@@.......T...........T...@@@@@@@@@@@@@@@
@@@@@@@@@@@@@@@@@@@@T......T.......T...@@@@@@@@@@@@@@@@@
@@@@@@@@@@@@@@@@@@@@@@@....T........@@@@@@@@@@@@@@@@@@@@
@@@@@@@@@@@@@@@@@@@@@@@@@@@@@@@@@@@@@@@@@@@@@@@@@@@@@@@@
@@@@@@@@@@@@@@@@@@@@@@@@@@@@@@@@@@@@@@@@@@@@@@@@@@@@@@@@
@@@@@@@@@@@@@@@@@@@@@@@@@@@@@@@@@@@@@@@@@@@@@@@@@@@@@@@@
@@@@@@@@@@@@@@@@@@@@@@@@@@@@@@@@@@@@@@@@@@@@@@@@@@@@@@@@
@@@@@@@@@@@@@@@@@@@@@@@@@@@@@@@@@@@@@@@@@@@@@@@@@@@@@@@@
@@@@@@@@@@@@@@@@@@@@@@@@@@@@@@@@@@@@@@@@@@@@@@@@@@@@@@@@
@@@@@@@@@@@@@@@@@@@@@@@@@@@@@@@@@@@@@@@@@@@@@@@@@@@@@@@@
