type octile
height 118
width 112
map
@@@@@@@@@@@@@@@@@@@@@@@@@@@@@@@@@@@@@@@@@@@@@@@@@@@@@@@@@@@@@@@@@@@@@@@@@@@@@@@@@@@@@@@@@@@@@@@@@@@@@@@@@@@@@@@@
@@@@@@@@@@@@@@@@@@@@@@@@@@@@@@@@@@@@@@@@@@@@@@@@@@@@@@@@@@@@@@@@@@@@@@@@@@@@@@@@@@@@@@@@@@@@@@@@@@@@@@@@@@@@@@@@
@@@@@@@@@@@@@@@@@@@@@@@@@@@@@@@@@@@@@@@@@@@@@@@@@@@@@@@@@@@@@@@@@@@@@@@@@@@@@@@@@@@@@@@@@@@@@@@@@@@@@@@@@@@@@@@@
@@@@@@@@@@@@@@@@@@@@@@@@@@@@@@@@@@@@@@@@@@@@@@@@@@@@@@@@@@@@@@@@@@@@@@@@@@@@@@@@@@@@@@@@@@@@@@@@@@@@@@@@@@@@@@@@
@@@@@@@@@@@@@@@@@@@@@@@@@@@@@@@@@@@@@@@@@@@@@@@@@@@@@@@@@@@@@@@@@@@@@@@@@@@@@@@@@@@@@@@@@@@@@@@@@@@@@@@@@@@@@@@@
@@@@@@@@@@@@@@@@@@@@@@@@@@@@@@@@@@@@@@@@@@@@@@@@@@@@@@@@@@@@@@@@@@@@@@@@@@@@@@@@@@@@@@@@@@@@@@@@@@@@@@@@@@@@@@@@
@@@@@@@@@@@@@@@@@@@@@@@@@@@@@@@@@@@@@@@@@@@@@@@@@@@@@@@@@@@@@@@@@@@@@@@@@@@@@@@@@@@@@@@@@@@@@@@@@@@@@@@@@@@@@@@@
@@@@@@@@@@@@@@@@@@@@@@@@@@@@@@@@@@@@@@@@@@@@@@@@@@@@@@@@@@@@@@@@@@@@@@@@@@@@@@@@@@@@@@@@@@@@@@@@@@@@@@@@@@@@@@@@
@@@@@@@@@@@@@@@@@@@@@@@@@@@@@@@@@@@@@@@@@@@@@@@@@@@@@@@@@@@@@@@@@@@@@@@@@@@@@@@@@@@@@@@@@@@@@@@@@@@@@@@@@@@@@@@@
@@@@@@@@@@@@@@@@@@@@@@@@@@@@@@@@@@@@@@@@@@@@@@@@@@@@@@@@@@@@@@@@@@@@@@@@@@@@@@@@@@@@@@@@@@@@@@@@@@@@@@@@@@@@@@@@
@@@@@@@@@@@@@@@@@@@@@@@@@@@@@@@@@@@@@@@@@@@@@@@@@@@@@@@@@@@@@@@@@@@@..@@@@@@@@@@@@@@@@@@@@@@@@@@@@@@@@@@@@@@@@@@
@@@@@@@@@@@@@@@@@@@@@@@@@@@@@@@@@@@@@@@@@@@@@@@@@@@@@@@@@@@@@@@@@@@....@@@@@@@@@@@@@@@@@@@@@@@@@@@@@@@@@@@@@@@@@
@@@@@@@@@@@@@@@@@@@@@@@@@@@@@@@@@@@@@@@@@@@@@@@@@@@@@@@@@@@@@@@@@@...T..@@@@@@@@@@@@@@@@@@@@@@@@@@@@@@@@@@@@@@@@
@@@@@@@@@@@@@@@@@@@@@@@@@@@@@@@@@@@@@@@@@@@@@@@@@@@@@@@@@@@@@@@@@......T.@@@@@@@@@@@@@@@@@@@@@@@@@@@@@@@@@@@@@@@
@@@@@@@@@@@@@@@@@@@@@@@@@@@@@@@@@@@@@@@@@@@@@@@@@@@@@@@@@@@@@@@@...T......@@@@@@@@@@@@@@@@@@@@@@@@@@@@@@@@@@@@@@
@@@@@@@@@@@@@@@@@@@@@@@@@@@@@@@@@@@@@@@@@@@@@@@@@@@@@@@@@@@@@@@...TT.......@@@@@@@@@@@@@@@@@@@@@@@@@@@@@@@@@@@@@
@@@@@@@@@@@@@@@@@@@@@@@@@@@@@@@@@@@@@@@@@@@@@@@@@@@@@@@@@@@@@@......@.......@@@@@@@@@@@@@@@@@@@@@@@@@@@@@@@@@@@@
@@@@@@@@@@@@@@@@@@@@@@@@@@@@@@@@@@@@@@@@@@@@@@@@@@@@@@@@@@@@@......@@@.......@@@@@@@@@@@@@@@@@@@@@@@@@@@@@@@@@@@
@@@@@@@@@@@@@@@@@@@@@@@@@@@@@@@@@@@@@@@@@@@@@@@@@@@@@@@@@@@@.T....@@@@@.......@@@@@@@@@@@@@@@@@@@@@@@@@@@@@@@@@@
@@@@@@@@@@@@@@@@@@@@@@@@@@@@@@@@@@@@@@@@@@@@@@@@@@@@@@@@@@@T.....@@@@@@@.......@@@@@@@@@@@@@@@@@@@@@@@@@@@@@@@@@
@@@@@@@@@@@@@@@@@@@@@@@@@@@@@@@@@@@@@@@@@@@@@@@@@@@@@@@@@@......@@@@@@@@@.......@@@@@@@@@@@@@@@@@@@@@@@@@@@@@@@@
@@@@@@@@@@@@@@@@@@@@@@@@@@@@@@@@@@@@@@@@@@@@@@@@@@@@@@@@@.T....@@@@@@@@@@@........@@@@@@@@@@@@@@@@@@@@@@@@@@@@@@
@@@@@@@@@@@@@@@@@@@@@@@@@@@@@@@@@@@@@@@@@@@@@@@@@@@@@@@@......@@@@@@@@@@@@@........@@@@@@@@@@@@@@@@@@@@@@@@@@@@@
@@@@@@@@@@@@@@@@@@@@@@@@@@@@@@@@@@@@@@@@@@@@@@@@@@@@@@@......@@@@@@@@T.@@@@@T.......@@@@@@@@@@@@@@@@@@@@@@@@@@@@
@@@@@@@@@@@@@@@@@@@@@@@@@@@@@@@@@@@@@@@@@@@@@@@@@@@@@@....T.@@@@@@@..TT@@@@@@........@@@@@@@@@@@@@@@@@@@@@@@@@@@
@@@@@@@@@@@@@@@@@@@@@@@@@@@@@@@@@@@@@@@@@@@@@@@@@@@@@......@@@@@@@...T..@@@@@@........@@@@@@@@@@@@@@@@@@@@@@@@@@
@@@@@@@@@@@@@@@@@@@@@@@@@@@@@@@@@@@@@@@@@@@@@@@@@@@@......@@@@@@@.T..T...@@@@@@....T...@@@@@@@@@@@@@@@@@@@@@@@@@
@@@@@@@@@@@@@@@@@@@@@@@@@@@@@@@@@@@@@@@@@@@@@@@@@@.TT..T.@@@@@@@@T..T.....@@@@@@........@@@@@@@@@@@@@@@@@@@@@@@@
@@@@@@@@@@@@@@@@@@@@@@@@@@@@@@@@@@@@@@@@@@@@@@@@@.......@@@@@@@@.T...@@.....@@@@@........@@@@@@@@@@@@@@@@@@@@@@@
@@@@@@@@@@@@@@@@@@@@@@@@@@@@@@@@@@@@@@@@@@@@@@@@...T...@@@@@@@......@@@@.....@@@@@........@@@@@@@@@@@@@@@@@@@@@@
@@@@@@@@@@@@@@@@@@@@@@@@@@@@@@@@@@@@@@@@@@@@@@@T......@@@@@.T......@@@@@@.....@@@@@........@@@@@@@@@@@@@@@@@@@@@
@@@@@@@@@@@@@@@@@@@@@@@@@@@@@@@@@@@@@@@@@@.@@@......T@@@@@.T..T...@@@@@@@@..TT.@@@@@T.......@@@@@@@@@@@@@@@@@@@@
@@@@@@@@@@@@@@@@@@@@@@@@@@@@@@@@@@@@@@@@@..T@@T....T..@@@@@..T...@@@@@@@@@.T....@@@@@....T...@@@@@@@@@@@@@@@@@@@
@@@@@@@@@@@@@@@@@@@@@@@@@@@@@@@@@@@@@@@@T...T@.........@@@@@....@@@@@@@@......T..@@@@@@....T..@@@@@@@@@@@@@@@@@@
@@@@@@@@@@@@@@@@@@@@@@@@@@@@@@@@@@@@@@@.....@@.@@@......@@@@@.T@@@@@@@@@T....T....@@@@@@.......@@@@@@@@@@@@@@@@@
@@@@@@@@@@@@@@@@@@@@@@@@@......T..@@@@.....@@@@@@@@....T.@@@@@@@@@@@@@@@.......T.T.@@@@@@T......@@@@@@@@@@@@@@@@
@@@@@@@@@@@@@@@@@@@@@@T............@@@.....@@@@@@@........@@@@@@@@@@@.....T...@@...@@@@@@@..T....@@@@@@@@@@@@@@@
@@@@@@@@@@@@@@@@@@@@...............@@@....@@@@T@@........T.@@@@@@@@@....T....@@@@.T..@@@@@@..T....@@@@@@@@@@@@@@
@@@@@@@@@@@@@@@@@@@T...T........T.@@@@....@@@@.........T....@@@@@@@......T..@@@@@......@@@@@.......@@@@@@@@@@@@@
@@@@@@@@@@@@@@@@@@T..............T.@@.T..@@@@@....T.@........@@@@@@........@@@@@@.......@@@@........@@@@@@@@@@@@
@@@@@@@@@@@@@@@@@.....................T..@@@@@..T..@@@........@@@@@@......@@@@@@@........@@@@.T.T....@@@@@@..@@@
@@@@@@@@@@@@@@@@...T...........T.......T.@@@@@.T....T......T...@@@@@@....@@@@@@@@.........@@@@........@@@@...@@@
@@@@@@@@@@@@@@@.......T............T....@@@@@..........@@@......@@@@@@..@@@@@@@@........T.@@@@@......T.@@..T.@@@
@@@@@@@@@@@@@@.........TT..T........T..@@@@@..........@@@@@T..T.T@@@@@@@@@@@@@.........TT..@@@@@..T......T..@@@@
@@@@@@@@@@@@@@.T.......@@@@@@@T.........@@@............@@@@.TT...T@@@@@@@@@@@........T@@@...@@@@@..........@@@@@
@@@@@@@@@@@@@.........@@@@@@@@@.....T....@@..T.T....T.T.@@....T....@@@@@@@@.......T..@@@@.T.@@@@@@.....TT..@@@@@
@@@@@@@@@@@@@....T....@@@@@@@@@@.........T@.......T.......T.........@@@@@@..........@@@@@@TT.@@@@@@..T.....T@@@@
@@@@@@@@@@@@@.........@@@@@...@@@.........@.................@@.......@@@@@@........@@@@@@@T..T.@@@@@@........@@@
@@@@@@@@@@@@@..TT.....@@@@@@..T@@@........@@.T.....T.T.TT..@@@.....T..@@@@@@.T....@@@@@@@@...T..@@@@@.T.T....@@@
@@@@@@@@@@@@@@......T.@@@@@@..T.@@@........@@.T.......T.....T..........@@@@@@....@@@@@@@@T....T.@@@@.........@@@
@@@@@@@@@@@@@@.....T...@@@@@.....@@@.T.T....@..@@....T..........@@....T..@@@@@..@@@@@@@@..T.TT.@@@@.......T.@@@@
@@@@@@@@@@@@@@@...T....@@@@.......@@@..T..T.@..@@@.....T.......@@@@.......@@@@@@@@@@@@@.......@@@@.........@@@@@
@@@@@@@@@@@@@@@.........@@@........@@@.........@@@T............@@@@...T.T..@@@@@@@@@@@T.......@@@T......T.@@@@@@
@@@@@@@@@@@@@@@@........@@@.........@@.T........................@@..........@@@@@@@.T.....T...@@.........@@@@@@@
@@@@@@@@@@@@@@@@...T......@@.........@@..................T.....T.............@@@@@........T....@........@@@@@@@@
@@@@@@@@@@@@@@@@@..........@@.........@..........................T...@........@@@@@...T..@@@...........@@@@@@@@@
@@@@@@@@@@@@@@@@@@..T......T@@.....T.T@@....T......T................@@@........@@@@@....@@@@..........@@@@@@@@@@
@@@@@@@@@@@@@@@@@@@.T.T......@@.T............T................T.........TT.T.TT.@@@@@..@@@@@.T..TT...@@@@@@@@@@@
@@@@@@@@@@@@@@@@@@@@.T....T...@.........................@@T.T.....T.....@@@T.....@@@@@@@@@@T........@@@@@@@@@@@@
@@@@@@@@@@@@@@@@@@@@@.........@........T..T....TT.T..TT@@@..........T..@@@@@......@@@@@@@@..T......@@@@@@@@@@@@@
@@@@@@@@@@@@@@@@@@@@@@T.....T.@@.......TT..............@@@........T.T...@@@........@@@@@@.........@@@@@@@@@@@@@@
@@@@@@@@@@@@@@.@@..@@@@....T...@...T...TT.........T......................@T.....T...@@@@....T....@@@@@@@@@@@@@@@
@@@@@@@@@@@@@.......@@@@T......@@.........T.................T.......T..T......T.T....@@.........@@@@@@@@@@@@@@@@
@@@@@@@@@@@@.........@@@@.......@.....T...........T..........................@@..........T.....@@@@@@@@@@@@@@@@@
@@@@@@@@@@@...........@@@@....T................T............................@@@...............@@@@@@@@@@@@@@@@@@
@@@@@@@@@@...........T.@@@....T...................T......T...T..........T....T..T..TT.T......@@@@@@@@@@@@@@@@@@@
@@@@@@@@@......T........@@........T.........T.....TT.T.T.........@.T............@@@.........@@@@@@@@@@@@@@@@@@@@
@@@@@@@@......T..........@@........T..............T.............@@@............@@@@@.......@@@@@@@@@@@@@@@@@@@@@
@@@@@@@.............T.....@T.......T..T.....T.T..T..T.....T.....@@@.......T...T.@@@@..T.T.@@@@@@@@@@@@@@@@@@@@@@
@@@@@@..T.@...........T..........T....T...........T...T....T.......T.............@@......@@@@@@@@@@@@@@@@@@@@@@@
@@@@@....@@@.T...T.T......@@............................T.............T.T.T..............@@@@@@@@@@@@@@@@@@@@@@@
@@@@....@@@@@............@@@T.....T.T..T.............T.............T.....................@@@@@@@@@@@@@@@@@@@@@@@
@@@.....@@@@.............@@@@.........................T..T.......T........T..........TT..@@@@@@@@@@@@@@@@@@@@@@@
@@@@T....@@.......................................T..........TT.........T...............@@@@@@@@@@@@@@@@@@@@@@@@
@@@@@...............T........T.......TTT.....T...........T...T...........@@....T........@@@@@@@@@@@@@@@@@@@@@@@@
@@@@@@...TT...@.T......................T.......T.T......................@@@.............@@@@@@@@@@@@@@@@@@@@@@@@
@@@@@@@...T..@@@T.T..........T.T...T.....................T..............@@@@.....T.T....@@@@@@@@@@@@@@@@@@@@@@@@
@@@@@@@@..T....T.............T.T......T..........T...T.....T...........................@@@@@@@@@@@@@@@@@@@@@@@@@
@@@@@@@@@.......T@@@..........T...@@@.T.......T........T....................T..T......@@@@@@@@@@@@@@@@@@@@@@@@@@
@@@@@@@@@@......@@@@@...........T.@@@..........T.T........T...........T.........T...@@@@@@@@@@@@@@@@@@@@@@@@@@@@
@@@@@@@@@@@......@@@@.............@@@........T.................T.........T.......T.@@@@@@@@@@@@@@@@@@@@@@@@@@@@@
@@@@@@@@@@@@..T...@@.TT....T...T..........T............T.T....T......T...T........@@@@@@@@@@@@@@@@@@@@@@@@@@@@@@
@@@@@@@@@@@@@............T...................T.....................T.T........T...@@@@@@@@@@@@@@@@@@@@@@@@@@@@@@
@@@@@@@@@@@@@@........@@...T.............T..........T...TT.T.T.......T....T......@@@@@@@@@@@@@@@@@@@@@@@@@@@@@@@
@@@@@@@@@@@@@@@..T....@@......................T....TTT...........T.T..T..........@@@@@@@@@@@@@@@@@@@@@@@@@@@@@@@
@@@@@@@@@@@@@@@@........T..T.....T.....T......T.T...............................@@@@@@@@@@@@@@@@@@@@@@@@@@@@@@@@
@@@@@@@@@@@@@@@@@T........@@.......TT....T.@@..T..T............T............T.T.@@@@@@@@@@@@@@@@@@@@@@@@@@@@@@@@
@@@@@@@@@@@@@@@@@@.....T.T@@@...T...T...T.@@@@....T................T...........@@@@@@@@@@@@@@@@@@@@@@@@@@@@@@@@@
@@@@@@@@@@@@@@@@@@@........T..............@@@@T.....T....T...................@@@@@@@@@@@@@@@@@@@@@@@@@@@@@@@@@@@
@@@@@@@@@@@@@@@@@@@@........T...T..T......TT.........T......T....T.....T..T.@@@@@@@@@@@@@@@@@@@@@@@@@@@@@@@@@@@@
@@@@@@@@@@@@@@@@@@@@@.........T.....T.....TT...T.........T.................@@@@@@@@@@@@@@@@@@@@@@@@@@@@@@@@@@@@@
@@@@@@@@@@@@@@@@@@@@@@.........@..........T.T...T..........T..............@@@@@@@@@@@@@@@@@@@@@@@@@@@@@@@@@@@@@@
@@@@@@@@@@@@@@@@@@@@@@@.T.TT..@@@...T......T...T..T..........T..T........@@@@@@@@@@@@@@@@@@@@@@@@@@@@@@@@@@@@@@@
@@@@@@@@@@@@@@@@@@@@@@@@.........T.........T............................@@@@@@@@@@@@@@@@@@@@@@@@@@@@@@@@@@@@@@@@
@@@@@@@@@@@@@@@@@@@@@@@@@.........@@@.......T.T.....@T.................@@@@@@@@@@@@@@@@@@@@@@@@@@@@@@@@@@@@@@@@@
@@@@@@@@@@@@@@@@@@@@@@@@@@....T...@@@.............T@@@....T..........@@@@@@@@@@@@@@@@@@@@@@@@@@@@@@@@@@@@@@@@@@@
@@@@@@@@@@@@@@@@@@@@@@@@@@@......T...............TT@@@.....T.....@@@@@@@@@@@@@@@@@@@@@@@@@@@@@@@@@@@@@@@@@@@@@@@
@@@@@@@@@@@@@@@@@@@@@@@@@@@@..........T.......................T.@@@@@@@@@@@@@@@@@@@@@@@@@@@@@@@@@@@@@@@@@@@@@@@@
@@@@@@@@@@@@@@@@@@@@@@@@@@@@@.................TTT..........T...@@@@@@@@@@@@@@@@@@@@@@@@@@@@@@@@@@@@@@@@@@@@@@@@@
@@@@@@@@@@@@@@@@@@@@@@@@@@@@@@.........@......T...............@@@@@@@@@@@@@@@@@@@@@@@@@@@@@@@@@@@@@@@@@@@@@@@@@@
@@@@@@@@@@@@@@@@@@@@@@@@@@@@@@@........@@.T....T............@@@@@@@@@@@@@@@@@@@@@@@@@@@@@@@@@@@@@@@@@@@@@@@@@@@@
@@@@@@@@@@@@@@@@@@@@@@@@@@@@@@@@...............T..........@@@@@@@@@@@@@@@@@@@@@@@@@@@@@@@@@@@@@@@@@@@@@@@@@@@@@@
@@@@@@@@@@@@@@@@@@@@@@@@@@@@@@@@@.........@@@...........@@@@@@@@@@@@@@@@@@@@@@@@@@@@@@@@@@@@@@@@@@@@@@@@@@@@@@@@
@@@@@@@@@@@@@@@@@@@@@@@@@@@@@@@@@@........@@@..T.....@@@@@@@@@@@@@@@@@@@@@@@@@@@@@@@@@@@@@@@@@@@@@@@@@@@@@@@@@@@
@@@@@@@@@@@@@@@@@@@@@@@@@@@@@@@@@@@...............T@@@@@@@@@@@@@@@@@@@@@@@@@@@@@@@@@@@@@@@@@@@@@@@@@@@@@@@@@@@@@
@@@@@@@@@@@@@@@@@@@@@@@@@@@@@@@@@@@@@.........T...@@@@@@@@@@@@@@@@@@@@@@@@@@@@@@@@@@@@@@@@@@@@@@@@@@@@@@@@@@@@@@
@@@@@@@@@@@@@@@@@@@@@@@@@@@@@@@@@@@@@@@T.........@@@@@@@@@@@@@@@@@@@@@@@@@@@@@@@@@@@@@@@@@@@@@@@@@@@@@@@@@@@@@@@
@@@@@@@@@@@@@@@@@@@@@@@@@@@@@@@@@@@@@@@@........@@@@@@@@@@@@@@@@@@@@@@@@@@@@@@@@@@@@@@@@@@@@@@@@@@@@@@@@@@@@@@@@
@@@@@@@@@@@@@@@@@@@@@@@@@@@@@@@@@@@@@@@@@.....@@@@@@@@@@@@@@@@@@@@@@@@@@@@@@@@@@@@@@@@@@@@@@@@@@@@@@@@@@@@@@@@@@
@@@@@@@@@@@@@@@@@@@@@@@@@@@@@@@@@@@@@@@@@@...@@@@@@@@@@@@@@@@@@@@@@@@@@@@@@@@@@@@@@@@@@@@@@@@@@@@@@@@@@@@@@@@@@@
@@@@@@@@@@@@@@@@@@@@@@@@@@@@@@@@@@@@@@@@@@@@@@@@@@@@@@@@@@@@@@@@@@@@@@@@@@@@@@@@@@@@@@@@@@@@@@@@@@@@@@@@@@@@@@@@
@@@@@@@@@@@@@@@@@@@@@@@@@@@@@@@@@@@@@@@@@@@@@@@@@@@@@@@@@@@@@@@@@@@@@@@@@@@@@@@@@@@@@@@@@@@@@@@@@@@@@@@@@@@@@@@@
@@@@@@@@@@@@@@@@@@@@@@@@@@@@@@@@@@@@@@@@@@@@@@@@@@@@@@@@@@@@@@@@@@@@@@@@@@@@@@@@@@@@@@@@@@@@@@@@@@@@@@@@@@@@@@@@
@@@@@@@@@@@@@@@@@@@@@@@@@@@@@@@@@@@@@@@@@@@@@@@@@@@@@@@@@@@@@@@@@@@@@@@@@@@@@@@@@@@@@@@@@@@@@@@@@@@@@@@@@@@@@@@@
@@@@@@@@@@@@@@@@@@@@@@@@@@@@@@@@@@@@@@@@@@@@@@@@@@@@@@@@@@@@@@@@@@@@@@@@@@@@@@@@@@@@@@@@@@@@@@@@@@@@@@@@@@@@@@@@
@@@@@@@@@@@@@@@@@@@@@@@@@@@@@@@@@@@@@@@@@@@@@@@@@@@@@@@@@@@@@@@@@@@@@@@@@@@@@@@@@@@@@@@@@@@@@@@@@@@@@@@@@@@@@@@@
@@@@@@@@@@@@@@@@@@@@@@@@@@@@@@@@@@@@@@@@@@@@@@@@@@@@@@@@@@@@@@@@@@@@@@@@@@@@@@@@@@@@@@@@@@@@@@@@@@@@@@@@@@@@@@@@
@@@@@@@@@@@@@@@@@@@@@@@@@@@@@@@@@@@@@@@@@@@@@@@@@@@@@@@@@@@@@@@@@@@@@@@@@@@@@@@@@@@@@@@@@@@@@@@@@@@@@@@@@@@@@@@@
