type octile
height 59
width 56
map
@@@@@@@@@@@@@@@@@@@@@@@@@@@@@@@@@@@@@@@@@@@@@@@@@@@@@@@@
@@@@@@@@@@@@@@@@@@@@@@@@@@@@@@@@@@@@@@@@@@@@@@@@@@@@@@@@
@@@@@@@@@@@@@@@@@@@@@@@@@@@@@@@@@@@@@@@@@@@@@@@@@@@@@@@@
@@@@@@@@@@@@@@@@@@@@@@@@@@@@@@@@@@@@@@@@@@@@@@@@@@@@@@@@
@@@@@@@@@@@@@@@@@@@@@@@@@@@@@@@@@@@@@@@@@@@@@@@@@@@@@@@@
@@@@@@@@@@@@@@@@@@@@@@@@@@@@@@@@@@@@@@@@@@@@@@@@@@@@@@@@
@@@@@@@@@@@@@@@@@@@@@@@@@@@@@@@@@@@@@@@@@@@@@@@@@@@@@@@@
@@@@@@@@@@@@@@@@@@@@@T.@@@@@@@@@@@@@@@@@@@@@@@@@@@@@@@@@
@@@@@@@@@@@@@@@@@@@@..T.@@@@@@@@@@@@@@@@@@@@@@@@@@@@@@@@
@@@@@@@@@@@@@@@@@@@......@@@@@@@@@@@@@@@@@@@@@@@@@@@@@@@
@@@@@@@@@@@@@@@@@@........@@@@@@@@@@@@@@@@@@@@@@@@@@@@@@
@@@@@@@@@@@@@@@@@..........@@@@@@@@@@@@@@@@@@@@@@@@@@@@@
@@@@@@@@@@@@@@@@...........@@@@@@@@@@@@@@@@@@@@@@@@@@@@@
@@@@@@@@@@@@@@@.T..T......@@@@@@@@@@@@@@@@@@@@@@@@@@@@@@
@@@@@@@@@@@@@@@..........@@@@@@@@@@.....@@@@@@@@@@@@@@@@
@@@@@@@@@@@@@@..........@@@@@@@@@@.....T.@@@@@@@@@@@@@@@
@@@@@@@@@@@@@@.......T.@@@@@@@@@@.......T..@@@@@@@@@@@@@
@@@@@@@@@@@@@.........@@@@@@@@@@T...@.......@@@@@@@@@@@@
@@@@@@@@@@@@..T......@@@@@@@@@@@@T.@@...T..@@@@@@@@@@@@@
@@@@@@@@@@@.........@@@@@@@@@@@@@@@@@@@@@T....@@@@@@@@@@
@@@@@@@@@@..........@@@@@@....@@@@@@@@@@@...T..@@@@@@@@@
@@@@@@@@@..........@@@@.....T..@@@@@@@@@........@@@@@@@@
@@@@@@@@@.....T....@@.T.TT..............T..T..T..@@@@@@@
@@@@@@@@@T.T..T.....T.............TT..........T..@@@@@@@
@@@@@@@@@..............T.T.T........T.....T....@@@@@@@@@
@@@@@@@.......T.T.............T.@@@@...T...TT.@@@@@@@@@@
@@@@@@@.............T.....T@@@@@@@@@@.........@@@@@@@@@@
@@@@@@@............T....@@@@@@@@@@@@@@T......T@@@@@@@@@@
@@@@@@@T..T......T...@@@@@@@@@@@@@@@@@T.......@@@@@@@@@@
@@@@@@@.............@@@@@@@@@@@@@@@@@@@..TT...@@@@@@@@@@
@@@@@@@............@@@@@@@@@@@@@@@@@@@@....T..@@@@@@@@@@
@@@@@@@.....TT@@.T.@@@@@@@@@@@@@@@@@@@@........@@@@@@@@@
@@@@@@@...@@@@@@...@@@@@@@@@@@@@@@@@@@@@...T.T.@@@@@@@@@
@@@@@@@..@@@@@@@@.@@@@@@@@@@@@@@@@@@@@@@...T..T@@@@@@@@@
@@@@@@@....@@@@@@.@@@@@@@@@@@@@@@@@@@@@@.........T..@@@@
@@@@@@.T....@@@@@.@@@@@@@@@@@@@@@@@@@@@@............@@@@
@@@@@@...T..T@@@@.@@@@@@@@@@@@@@@@@@@@@@............@@@@
@@@@@@........@@@.@@@@@@@@@@@@@@@@@@@@@@.........T..@@@@
@@@@@@..........T..@@@@@@@@@@@@@@@@@@@@............T@@@@
@@@@@..............@@@@@@@@@@@@@@@@@@@@.............@@@@
@@@@@......@@@......@@@@@@@@@@@@@@@@@@..............@@@@
@@@@@..T.T.@@@@T.....@@@@@@@@@@@@@@@@@..T.T.........@@@@
@@@@@.......@@@.T.T.T@@@@@@@@@@@@@@@@@..............@@@@
@@@@@@.....T...........@@@@@@@@@@@@@@@@.TT....TT....@@@@
@@@@@@@...T.............@@@@@@@@@@@@@@..T...........@@@@
@@@@@@@@.T.......T.TT......@@@@@@@@@.T.T....T.TT....@@@@
@@@@@@@@@T...............T....@@TT....T............@@@@@
@@@@@@@@@@.....T...T....T.................T......T@@@@@@
@@@@@@@@@@@..T............T............T...T...@.@@@@@@@
@@@@@@@@@@@@@.............................T...@@@@@@@@@@
@@@@@@@@@@@@@@@...TT........................@@@@@@@@@@@@
@@@@@@@@@@@@@@@@.........T................@@@@@@@@@@@@@@
@@@@@@@@@@@@@@@@@.......................@@@@@@@@@@@@@@@@
@@@@@@@@@@@@@@@@@@@T......T....T.......@@@@@@@@@@@@@@@@@
@@@@@@@@@@@@@@@@@@@@@@.......T.TT....@@@@@@@@@@@@@@@@@@@
@@@@@@@@@@@@@@@@@@@@@@@@@@@@@@@@@@@@@@@@@@@@@@@@@@@@@@@@
@@@@@@@@@@@@@@@@@@@@@@@@@@@@@@@@@@@@@@@@@@@@@@@@@@@@@@@@
@@@@@@@@@@@@@@@@@@@@@@@@@@@@@@@@@@@@@@@@@@@@@@@@@@@@@@@@
@@@@@@@@@@@@@@@@@@@@@@@@@@@@@@@@@@@@@@@@@@@@@@@@@@@@@@@@
