type octile
height 70
width 68
map
@@@@@@@@@@@@@@@@@@@@@@@@@@@@@@@@@@@@@@@@@@@@@@@@@@@@@@@@@@@@@@@@@@@@
@@@@@@@@@@@@@@@@@@@@@@@@@@@@@@@@@@@@@@@@@@@@@@@@@@@@@@@@@@@@@@@@@@@@
@@@@@@@@@@@@@@@@@@@@@@@@@@@@@@@@@@@@@@@@@@@@@@@@@@@@@@@@@@@@@@@@@@@@
@@@@@@@@@@@@@@@@@@@@@@@@@@@@@@@@@@@@@@@@@@@@@@@@@@@@@@@@@@@@@@@@@@@@
@@@@@@@@@@@@@@@@@@@@@@@@@@@@@@@@@@@@@@@@@@@@@@@@@@@@@@@@@@@@@@@@@@@@
@@@@@@@@@@@@@@@@@@@@@@@@@@@@@@@@@@@@@@@@@@@@@@@@@@@@@@@@@@@@@@@@@@@@
@@@@@@@@@@@@@@@@@@@@@@@@@@@@@@@@@@@@@@@@@@@@@@@@@@@@@@@@@@@@@@@@@@@@
@@@@@@@@@@@@@@@@@@@@@@@@@@@@@@@@@@@@@@@@@@@@@@@@@@@@@@@@@@@@@@@@@@@@
@@@@@@@@@@@@@@@@@@@@@@@@@@@@@@@@@@@@@@@@@@@@@@@@@@@@@@@@@@@@@@@@@@@@
@@@@@@@@@@@@@@@@@@@@@@@@@@@@@@@@@@@@@@@@@@@@@@@@@@@@@@@@@@@@@@@@@@@@
@@@@@@@@@@@@@@@@@@@@@@@@@@@@@@@@.@@@@@@@@@@@@@@@@@@@@@@@@@@@@@@@@@@@
@@@@@@@@@@@@@@@@@@@@@@@@@@@@@@@...@@@@@@@@@@@@@@@@@@@@@@@@@@@@@@@@@@
@@@@@@@@@@@@@@@@@@@@@@@@@@@@@@...T.@@@@@@@@@@@@@@@@@@@@@@@@@@@@@@@@@
@@@@@@@@@@@@@@@@@@@@@@@@@@@@@T...T..@@@@@@@@@@@@@@@@@@@@@@@@@@@@@@@@
@@@@@@@@@@@@@@@@@@@@@@@@@@@@@....T..T@@@@@@@@@@@@@@@@@@@@@@@@@@@@@@@
@@@@@@@@@@@@@@@@@@@@@@@@@@@@@.........T.@@@@@@@@@@@@@@@@@@@@@@@@@@@@
@@@@@@@@@@@@@@@@@@@@@@@@@@@@T............@@@@@@@@@@@@@@@@@@@@@@@@@@@
@@@@@@@@@@@@@@@@@@@@@@@@@.@...........T...@@@@@@@@@@@@@@@@@@@@@@@@@@
@@@@@@@@@@@@@@@@@@@@@@@@.....T.@@@........T@@@@@@@@@@@@@@@@@@@@@@@@@
@@@@@@@@@@@@@@@@@@@@@@@.....TT@@@@...@@.....@@@@@@@@@@@@@@@@@@@@@@@@
@@@@@@@@@@@@@@@@@@@@@@.......@@@@@@@..@@.....@@@@@@@@@@@@@@@@@@@@@@@
@@@@@@@@@@@@@@@@@@@@@........@@@@@@@@..@@T....@@@@@@@@@@@@@@@@@@@@@@
@@@@@@@@@@@@@@@@@@@@...T......T@@@@@@@.T@..T...@@@@@@@@@@@@@@@@@@@@@
@@@@@@@@@@@@@@@@@@@@@..........@@@@@@@@....T.TT.@@@@@@@@@@@@@@@@@@@@
@@@@@@@@@@@@@@@@@.@@@@.......T..@@@@@@@.T........@@@@@@@@@@@@@@@@@@@
@@@@@@@@@@@@@@@@...@@@@......@@TT@@@@@...T........@@@@@@@@@@@@@@@@@@
@@@@@@@@@@@@@@@@@...@@@@..T...@@..@@@....T....T...@@@@@@@@@@@@@@@@@@
@@@@@@@@@@@@@@@@@@...@@@@......@@..@.......T.....@@@@@@@@@@@@@@@@@@@
@@@@@@@@@@@@@@@@@@@..@@@@@..T...@@..............@@@@@@@@@@@@@@@@@@@@
@@@@@@@@@@@@@@@@@@@@.@@@@@@.....T.T.T....T....T@@@@@@@@@@@@@@@@@@@@@
@@@@@@@@@@@@@T@@@@@.T.@@@@@@.....T............@@@@@@@@@@@@@@@@@@@@@@
@@@@@@@@@@@@...@@@.....@@@@@@...T..T.....T..T@@@@@@@@@@.@@@@@@@@@@@@
@@@@@@@@@@@.....@.........@@@@..............@@@@@@@@@@...@@@@@@@@@@@
@@@@@@@@@@@@................@@@@......T.T..@@@@@@@@T.....@@@@@@@@@@@
@@@@@@@@@@@@@.....T..........@@@@........T@@@@@@@@@T......@@@@@@@@@@
@@@@@@@@@@@@@@....T..T.......@@@@........@@@@@@@@.....@@..@@@@@@@@@@
@@@@@...@@@@@....T...........@@@@.......@@@@@@...T...@@@@..@@@@@@@@@
@@@@@@..T@@@.T............T.............T@@@@.......@@@@@....@@@@@@@
@@@@@@@..T@...T...T.......@....T..T...T....T....T..@@@@@@.....@@@@@@
@@@@@@@@.......T.....T...@@@...........T...........@@@@@...TT@@@@@@@
@@@@@@@@@...............@@@..T.T......T............@@@@.....@@@@@@@@
@@@@@@@@@@.TTT..T.....T@@@...T.T......TT..T....@..T@@@@...@@@@@@@@@@
@@@@@@@@@@@TT..T......@@@......T..T.......T...@@@....@@..@@@@@@@@@@@
@@@@@@@@@@@@........T@@@......................@@@@...T..@@@@@@@@@@@@
@@@@@@@@@@@@@.......@@@@......T.........T......@@@@....@@@@@@@@@@@@@
@@@@@@@@@@@@@...T..@@@@@........T...T.........T..@@@..@@@@@@@@@@@@@@
@@@@@@@@@@@@@@..T.@@@@@TT.......@@T.......T.......@@@@@@@@@@@@@@@@@@
@@@@@@@@@@@@@@@.T@@@TT.....T...@@@@@..T..T........T@@@@@@@@@@@@@@@@@
@@@@@@@@@@@@@@@@@@@..........@@@@@@@..........T.T..@@@@@@@@@@@@@@@@@
@@@@@@@@@@@@@@@@@@...........@@@@@@@.......T.....T@@@@@@@@@@@@@@@@@@
@@@@@@@@@@@@@@@@@@..T..T......@@@@@@.@@@.........@@@@@@@@@@@@@@@@@@@
@@@@@@@@@@@@@@@@@@@...T......@@@@@@@@@@@......T.@@@@@@@@@@@@@@@@@@@@
@@@@@@@@@@@@@@@@@@@@.....T..@@@@@@@@@@@@...T...@@@@@@@@@@@@@@@@@@@@@
@@@@@@@@@@@@@@@@@@@@@.......@@@@@@@@@@@.......@@@@@@@@@@@@@@@@@@@@@@
@@@@@@@@@@@@@@@@@@@@@@.....T.@@@@@@@@@T....T.@@@@@@@@@@@@@@@@@@@@@@@
@@@@@@@@@@@@@@@@@@@@@@@......T@@@@@@@.......@@@@@@@@@@@@@@@@@@@@@@@@
@@@@@@@@@@@@@@@@@@@@@@@@.......@@@@@.TT....@@@@@@@@@@@@@@@@@@@@@@@@@
@@@@@@@@@@@@@@@@@@@@@@@@@.T....T........T.@@@@@@@@@@@@@@@@@@@@@@@@@@
@@@@@@@@@@@@@@@@@@@@@@@@@@...............@@@@@@@@@@@@@@@@@@@@@@@@@@@
@@@@@@@@@@@@@@@@@@@@@@@@@@@.............@@@@@@@@@@@@@@@@@@@@@@@@@@@@
@@@@@@@@@@@@@@@@@@@@@@@@@@@@.T..T.TT..T@@@@@@@@@@@@@@@@@@@@@@@@@@@@@
@@@@@@@@@@@@@@@@@@@@@@@@@@@@@.........@@@@@@@@@@@@@@@@@@@@@@@@@@@@@@
@@@@@@@@@@@@@@@@@@@@@@@@@@@@@@T......@@@@@@@@@@@@@@@@@@@@@@@@@@@@@@@
@@@@@@@@@@@@@@@@@@@@@@@@@@@@@@@@....@@@@@@@@@@@@@@@@@@@@@@@@@@@@@@@@
@@@@@@@@@@@@@@@@@@@@@@@@@@@@@@@@@@@@@@@@@@@@@@@@@@@@@@@@@@@@@@@@@@@@
@@@@@@@@@@@@@@@@@@@@@@@@@@@@@@@@@@@@@@@@@@@@@@@@@@@@@@@@@@@@@@@@@@@@
@@@@@@@@@@@@@@@@@@@@@@@@@@@@@@@@@@@@@@@@@@@@@@@@@@@@@@@@@@@@@@@@@@@@
@@@@@@@@@@@@@@@@@@@@@@@@@@@@@@@@@@@@@@@@@@@@@@@@@@@@@@@@@@@@@@@@@@@@
@@@@@@@@@@@@@@@@@@@@@@@@@@@@@@@@@@@@@@@@@@@@@@@@@@@@@@@@@@@@@@@@@@@@
@@@@@@@@@@@@@@@@@@@@@@@@@@@@@@@@@@@@@@@@@@@@@@@@@@@@@@@@@@@@@@@@@@@@
