type octile
height 86
width 88
map
@@@@@@@@@@@@@@@@@@@@@@@@@@@@@@@@@@@@@@@@@@@@@@@@@@@@@@@@@@@@@@@@@@@@@@@@@@@@@@@@@@@@@@@@
@@@@@@@@@@@@@@@@@@@@@@@@@@@@@@@@@@@@@@@@@@@@@@@@@@@@@@@@@@@@@@@@@@@@@@@@@@@@@@@@@@@@@@@@
@@@@@@@@@@@@@@@@@@@@@@@@@@@@@@@@@@@@@@@@@@@@@@@@@@@@@@@@@@@@@@@@@@@@@@@@@@@@@@@@@@@@@@@@
@@@@@@@@@@@@@@@@@@@@@@@@@@@@@@@@@@@@@@@@@@@@@@@@@@@@@@@@@@@@@@@@@@@@@@@@@@@@@@@@@@@@@@@@
@@@@@@@@@@@@@@@@@@@@@@@@@@@@@@@@@@@@@@@@@@@@@@@@@@@@@@@@@@@@@@@@@@@@@@@@@@@@@@@@@@@@@@@@
@@@@@@@@@@@@@@@@@@@@@@@@@@@@@@@@@@@@@@@@@@@@@@@@@@@@@@@@@@@@@@@@@@@@@@@@@@@@@@@@@@@@@@@@
@@@@@@@@@@@@@@@@@@@@@@@@@@@@@@@@@@@@@@@@@@@@@@@@@@@@@@@@@@@@@@@@@@@@@@@@@@@@@@@@@@@@@@@@
@@@@@@@@@@@@@@@@@@@@@@@@@@@@@@@@@@@@@@@@@@@@@@@@@@@@@@@@@@@@@@@@@@@@@@@@@@@@@@@@@@@@@@@@
@@@@@@@@@@@@@@@@@@@@@@@@@@@@@@@@@@@@@@@@@@@@@@@@@@@@@@@@@@@@@@@@@@@@@@@@@@@@@@@@@@@@@@@@
@@@@@@@@@@@@@@@@@@@@@@@@@@@@@@@@@@@@@@@@@@@@@@@@@@@@@@@@@@@@@@@@@@@@@@@@@@@@@@@@@@@@@@@@
@@@@@@@@@@@@@@@@@@@@@@@@@@@@@.@@@@@@@@@@@@@@@@@@@@@@@@@@@@@@@@@@@@@@@@@@@@@@@@@@@@@@@@@@
@@@@@@@@@@@@@@@@@@@@@@@@@@@@..T@@@@@..@@@@@@@@@@@@@@@@@@@@@@@@@@@@@@@@@@@@@@@@@@@@@@@@@@
@@@@@@@@@@@@@@@@@@@@@@@@@@@TT...@@@...@@@@@@@@@@@@@@@@@@@@@@@@@@@@@@@@@@@@@@@@@@@@@@@@@@
@@@@@@@@@@@@@@@@@@@@@@@@@@.....@@@@T..@@@@@@@@@@@@@@@@@@@@@@@@@@@@@@@@@@@@@@@@@@@@@@@@@@
@@@@@@@@@@@@@@@@@@@@@@@@@....T@@@@@....@@@@@@@@@@@@@@@@@@@@@@@@@@@@@@@@@@@@@@@@@@@@@@@@@
@@@@@@@@@@@@@@@@@@@@@@@@.....@@@@@@T..T..@@@@@@@@@@@@@@@@@@@@@@@@@@@@@@@@@@@@@@@@@@@@@@@
@@@@@@@@@@@@@@@@@@@@@@@.T...@@@@@@@..T.@@@@@@@@@@@@@@@@@@@@@@@@@@@@@@@@@@@@@@@@@@@@@@@@@
@@@@@@@@@@@@@@@@@@@@@@@....@@@@@@@@T...@@@@@@@@@@@@@@@@@@@@@@@@@@@@@@@@@@@@@@@@@@@@@@@@@
@@@@@@@@@@@@@@@@@@@@@@....@@@@@@@@@.....@@@@@@@@@@@@@@@@@@@@@@@@@@@@@@@@@@@@@@@@@@@@@@@@
@@@@@@@@@@@@@@@@@@@@@.....@@@@@@@@@..T...@@@@@@@@@@@@@@@@@@@@@@@@@@@@@@@@@@@@@@@@@@@@@@@
@@@@@@@@@@@@@@@@@@@@.T..T@@@@@@@@@@....T..@@@@@@@@@@@@@@@@@@@@@@@@@@@@@@@@@@@@@@@@@@@@@@
@@@@@@@@@@@@@@@@@@@T....@@@@@@@@@.T....T.T.@T@@@@@@@@@@@@@@@@@@@@@@@@@@@@@@@@@@@@@@@@@@@
@@@@@@@@@@@@@@@@@@.....@@@@@@@@@.........T....@@@@@@@@@@@@@@@@@@@@@@@@@@@@@@@@@@@@@@@@@@
@@@@@@@@@@@@@@@@@......@@@@@@@@@@............@@@@@@@@@@@@@@@@@@@@@@@@@@@@@@@@@@@@@@@@@@@
@@@@@@@@@@@@@@@@@......@@@@@@@.@@.............@@@@@@@@@@@@@@@@@@@@@@@@@@@@@@@@@@@@@@@@@@
@@@@@@@@@@@@@@@@@.T.....@@@....@@....TT........@@@@@@@@@@@@@@@@@@@@@@@@@@@@@@@@@@@@@@@@@
@@@@@@@@@@@@@@@@@T.......@@....T.............T..@@@@@@@@@@@@@@@@@@@@@@@@@@@@@@@@@@@@@@@@
@@@@@@@@@@@@@@@@@@.....T..@.T.........T.....T.......@@@@@@@@@@@@@@@@@@@@@@@@@@@@@@@@@@@@
@@@@@@@@@@@@@@@@@@@.......@@....................T...@@@@@@@@@@@@@@@@@@@@@@@@@@@@@@@@@@@@
@@@@@@@@@@@@@@@@@@@@.......@.T..T.........T.....TT...@@@@@@@@@@@@@@@@@@@@@@@@@@@@@@@@@@@
@@@@@@@@@@@@@T.@@@@@@......@@..T..T...............T..@@@@@@@@@@@@@@@@@@@@@@@@@@@@@@@@@@@
@@@@@@@@@@@@.....@@@@@......@@..T..T.....T.......T....@@@@@@@@@@@@@@@@@@@@@@@@@@@@@@@@@@
@@@@@@@@@@@@@...T.@@@@@......@@.......TT..T........T....@@@@@@@@@@@@@@@@@@@@@@@@@@@@@@@@
@@@@@@@@@@@@.....T.@@@@@......@........TT...T.............@@@@@@@@@@@@@@@@@@@@@@@@@@@@@@
@@@@@@@@@@@@......@@@@@@@............T...T..........T......@@@@@@@@@@@@@@@@@@@@@@@@@@@@@
@@@@@@@@@@@@......@@@@@@@@T...................T...T....@@.T..@@@@@@@@@@@@@@@@@@@@@@@@@@@
@@@@@@@@@@@......T.@@@@@@@.......T.......T..T........TT@@.....@@@@@@@@@@@@@@@@@@@@@@@@@@
@@@@@@@.T...........@@@.@@@T.....T......T...T.T........@@....T@@@@@@@@@@@@@@@@@@@@@@@@@@
@@@@.@@..................@@@..T...T......TT......T.........@..@@@@@@@@@@@@@@@@@@@@@@@@@@
@@@.......T...T.........T@@@...T..T.......................@@TT.@@@@@@@@@@@@@@@@@@@@@@@@@
@@T..T...@@...@@.T....T..T..T.....T....T......T...........@@....@@@@@@@@@@@@@@@@@@@@@@@@
@@@.T....@@@@.@@T.............@@.T..T.................T........T@@@@@@@@@@@@@@@@@@@@@@@@
@@@@.....@@@@@@@@...T........@@@@@........T......................@@@@@@@@@@@@@@@@@@@@@@@
@@@@@....@@@@@@@@@.........@@@@@@@@.TT.....T..T................T..@@@@@@@@@@@@@@@@@@@@@@
@@@@@@....@@@@@@@@@.....T.@@@@@@@@@@....T.....T...................@@@@@@@@@@@@@@@@@@@@@@
@@@@@@@....@@@@@@@@@.....@@@@@@@@@@@@..TT..................T.......@@@@@@@@@@@@@@@@@@@@@
@@@@@@@@.....@@.......T..@@@@@@@@@@@@@TT.......TT...T...T...........@@@@@@@@@@@@@@@@@@@@
@@@@@@@@@..T.............T@@@@@@..@@@@@...........................T..@@@@@@@@@@@@@@@@@@@
@@@@@@@@@@..........T...T.@@@@@.....@@@@@.T.......T.................T.@@@@@@@@@@@@@@@@@@
@@@@@@@@@@@.....T....@@....@T...T....@@@@......................T..TTT..@.@@@@@@@@@@@@@@@
@@@@@@@@@@@@........@@@..............@@@..............T...................@@@@@@@@@@@@@@
@@@@@@@@@@@@@......@@@@@..............T....T.T.................T...........@@@@@@@@@@@@@
@@@@@@@@@@@@@@...@@@@@@@.....................T.......T...............T.....@@@@@@@@@@@@@
@@@@@@@@@@@@@@@@@@@@@@@...................@@T....T..........T.......TT.....T@@@@@@@@@@@@
@@@@@@@@@@@@@@@@@@@@@@@@.T..TT...@@.......@@@...............T....T.........@@@@@@@@@@@@@
@@@@@@@@@@@@@@@@@@....@@...T..T.@@@@T.....@@@@.......T....TT...........T..@@@@@@@@@@@@@@
@@@@@@@@@@@@@@@@@....T.........@@@@@@....T.@@@@@..T.............T...T...T@@@.@@@@@@@@@@@
@@@@@@@@@@@@@@@@@@.......T...@@@@@@@@TT...T.@@@@@...............T.......@@@...@@@@@@@@@@
@@@@@@@@@@@@@@@@@@@...T..T...@@@@@@@@..T.....@@@@@......................@@.....@@@@@@@@@
@@@@@@@@@@@@@@@@@@@@..........@@@@@@@........@@@@@.........T........T..@@..T....@@@@@@@@
@@@@@@@@@@@@@@@@@@@@@..T.........@@@..........@@@@@...........T.......@@.........@@@@@@@
@@@@@@@@@@@@@@@@@@@@@@..T.T..T...@@@...T.....@@@@@@@@...........T....@@..T.....T@@@@@@@@
@@@@@@@@@@@@@@@@@@@@@@.....T.....@@@........@@@@@@@@@@T.....@@......@@.T.......@@@@@@@@@
@@@@@@@@@@@@@@@@@@@@@........T....@........@@@@@@@.@@..T....@@@...T@@@..T.....@@@@@@@@@@
@@@@@@@@@@@@@@@@@@@@@@...........T........T@@@@@@@...........@@@...@@....T..T@@@@@@@@@@@
@@@@@@@@@@@@@@@@@@@@@@@...T..T............@@@@.@@@..T@@.@@.....@@@@@........@@@@@@@@@@@@
@@@@@@@@@@@@@@@@@@@@@@@...................@@@.T.......@@@@@@....@@@....T...@@@@@@@@@@@@@
@@@@@@@@@@@@@@@@@@@@@@@@T@@...............@@...........@@@@@@...T.........@@@@@@@@@@@@@@
@@@@@@@@@@@@@@@@@@@@@@@@@@@@.....T.....@...T.T...T......@@@@@@@........T.@@@@@@@@@@@@@@@
@@@@@@@@@@@@@@@@@@@@@@@@@@@@@.........@@@.......T........@@@@@@@..T.....@@@@@@@@@@@@@@@@
@@@@@@@@@@@@@@@@@@@@@@@@@@@@@@......@@@@@@...T...........@@@@@@@@......@@@@@@@@@@@@@@@@@
@@@@@@@@@@@@@@@@@@@@@@@@@@@@@@@.T.@@@@@@.@@....T......T.T.@@@@@@@@@...@@@@@@@@@@@@@@@@@@
@@@@@@@@@@@@@@@@@@@@@@@@@@@@@@@@.@@@@@@T..............T.....@@@@@@@@@@@@@@@@@@@@@@@@@@@@
@@@@@@@@@@@@@@@@@@@@@@@@@@@@@@@@@@@@@@..T..T................T@@@@@@@@@@@@@@@@@@@@@@@@@@@
@@@@@@@@@@@@@@@@@@@@@@@@@@@@@@@@@@@@T..........T.....@@@@@@@..@@@@@@@@@@@@@@@@@@@@@@@@@@
@@@@@@@@@@@@@@@@@@@@@@@@@@@@@@@@@@@.......T.........@@@@@@@@T..@@@@@@@@@@@@@@@@@@@@@@@@@
@@@@@@@@@@@@@@@@@@@@@@@@@@@@@@@@@@@@.....T......T@@.@@@@@@@@....@@@@@@@@@@@@@@@@@@@@@@@@
@@@@@@@@@@@@@@@@@@@@@@@@@@@@@@@@@@@@@.T.......T...@@@@@@@@@@.T..@@@@@@@@@@@@@@@@@@@@@@@@
@@@@@@@@@@@@@@@@@@@@@@@@@@@@@@@@@@@@@@......T.....@@@@@@@@@@...@@@@@@@@@@@@@@@@@@@@@@@@@
@@@@@@@@@@@@@@@@@@@@@@@@@@@@@@@@@@@@@@@......T....@@@@@@@@@@...@@@@@@@@@@@@@@@@@@@@@@@@@
@@@@@@@@@@@@@@@@@@@@@@@@@@@@@@@@@@@@@@@@.....TT..T@@@@@@@@@...@@@@@@@@@@@@@@@@@@@@@@@@@@
@@@@@@@@@@@@@@@@@@@@@@@@@@@@@@@@@@@@@@@@@..T.......@@@@@@.T..@@@@@@@@@@@@@@@@@@@@@@@@@@@
@@@@@@@@@@@@@@@@@@@@@@@@@@@@@@@@@@@@@@@@@@........T....T...@@@@@@@@@@@@@@@@@@@@@@@@@@@@@
@@@@@@@@@@@@@@@@@@@@@@@@@@@@@@@@@@@@@@@@@@@...............@@@@@@@@@@@@@@@@@@@@@@@@@@@@@@
@@@@@@@@@@@@@@@@@@@@@@@@@@@@@@@@@@@@@@@@@@@@.............@@@@@@@@@@@@@@@@@@@@@@@@@@@@@@@
@@@@@@@@@@@@@@@@@@@@@@@@@@@@@@@@@@@@@@@@@@@@@@@@@@@@@@@@@@@@@@@@@@@@@@@@@@@@@@@@@@@@@@@@
