type octile
height 75
width 76
map
@@@@@@@@@@@@@@@@@@@@@@@@@@@@@@@@@@@@@@@@@@@@@@@@@@@@@@@@@@@@@@@@@@@@@@@@@@@@
@@@@@@@@@@@@@@@@@@@@@@@@@@@@@@@@@@@@@@@@@@@@@@@@@@@@@@@@@@@@@@@@@@@@@@@@@@@@
@@@@@@@@@@@@@@@@@@@@@@@@@@@@@@@@@@@@@@@@@@@@@@@@@@@@@@@@@@@@@@@@@@@@@@@@@@@@
@@@@@@@@@@@@@@@@@@@@@@@@@@@@@@@@@@@@@@@@@@@@@@@@@@@@@@@@@@@@@@@@@@@@@@@@@@@@
@@@@@@@@@@@@@@@@@@@@@@@@@@@@@@@@@@@@@@@@@@@@@@@@@@@@@@@@@@@@@@@@@@@@@@@@@@@@
@@@@@@@@@@@@@@@@@@@@@@@@@@@@@@@@@@@@@@@@@@@@@@@@@@@@@@@@@@@@@@@@@@@@@@@@@@@@
@@@@@@@@@@@@@@@@@@@@@@@@@@@@@@@@@@@@@@@@@@@@@@@@@@@@@@@@@@@@@@@@@@@@@@@@@@@@
@@@@@@@@@@@@@@@..@@@@@@@@@@@@@@@@@@@@@@@@@@@@@@@@@@@@@@@@@@@@@@@@@@@@@@@@@@@
@@@@@@@@@@@@@.......@@@@@@@@@@@@@@@@@@@@@@@@@@@@@@@@@@@@@@@@@@@@@@@@@@@@@@@@
@@@@@@@@@@@.........T..@@@@@@@@@@@@@@@@@@@@@@@@@@@@@@@@@@@@@@@@@@@@@@@@@@@@@
@@@@@@@@@@...T.........T@@@@@@@@@@@@@@@@@@@@@@@@@@@@@@@@@@@@@@@@@@@@@@@@@@@@
@@@@@@@@@....T...........@@@@@@@@@@@@@@@@@@@@@@@@@@@@@@@@@@@@@@@@@@@@@@@@@@@
@@@@@@@@.........T.......@@@@@@@@@@@@@@@@@@@@@@@@@@@@@@@@@@@@@@@@@@@@@@@@@@@
@@@@@@@..................@@@@@@@@@@@@@@@@@@@@@@@@@@@@@@@@@@@@@@@@@@@@@@@@@@@
@@@@@@@T.................@@@@@@@@@@@@@@@@@@@@@@@@@@@@@@@@@@@@@@@@@@@@@@@@@@@
@@@@@@@.....T.T.T......T.@@@@@@@@@@@@@@@@@@@@@@@@@@@@@@@@@@@@@@@@@@@@@@@@@@@
@@@@@@@.......T@@.T.T.....@@@@@@@@@@@@@@@@@@@@@@@@@@@@@@@@@@@@@@@@@@@@@@@@@@
@@@@@@........@@@@........@@@@@@@@@@@@@@@@@@@@@@@@@@@@@@@@@@@@@@@@@@@@@@@@@@
@@@@@@.......T.@@.....T...@@@@@@@@@@@@@@@@@@@@@@@@@@@@@@@@@@@@@@@@@@@@@@@@@@
@@@@@@..........TT.......@@@@@@@@@@@@@@@@@@@@@@@@@@@@@@@@@@@@@@@@@@@@@@@@@@@
@@@@@@@...TT.........T...@@@@@@@@@@@@@@@@@@@@@@@@@@@@@@@@@@@@@@@@@@@@@@@@@@@
@@@@@@@@...T.....T...T...T@@@@@@@@@@@@@@@@@@@@@@@@@@@@@@@@@@@@@@@@@@@@@@@@@@
@@@@@@@@@@.....T..........@@@@@@@@@@@.T@@@@@@@@@@@@@@@@@@@@@@@@@@@@@@@@@@@@@
@@@@@@@@@@@........@@......@@@@@@@@@T...@@@@@@@@@@@@@@@@@@@@@@@@@@@@@@@@@@@@
@@@@@@@@@@@@@@@@@@@@@@.....@@@@@@@@......@@@@@@@@@@@@@@@@@@@@@@@@@@@@@@@@@@@
@@@@@@@@@@@@@@@@@@@@@@......@@@@@@@.T.....@@@@@@@@@@@@@@@@@@@@@@@@@@@@@@@@@@
@@@@@@@@@@@@@@@@@@@@@@......@@@@@...T.......@@@@@@@@@@@@@@@@@@@@@@@@@@@@@@@@
@@@@@@@@@@@@@@@@@@@@@@@..T...@@@@...........@@@@@@@@@@@@@@@@@@@@@@@@@@@@@@@@
@@@@@@@@@@@@@@@@@@@@@@@......@@@@...........@@@@@@@@@@@@@@@@@@@@@@@@@@@@@@@@
@@@@@@@@@@@@@@@@@@@@@@@@......@@@T.T.......T@@TT@@@@@@@@@@@@@@@@@@@@@@@@@@@@
@@@@@@@@@@@@@@@@@@@@@@@@......@@@@.........@@....@@@@@@@@@@@@@@@@@@@@@@@@@@@
@@@@@@@@@@@@@@@@@@@@@@@@@......@@@.....T.T.@..T...@@@@@@@@@@@@@@@@@@@@@@@@@@
@@@@@@@@@@@@@@@@@@@@@@@@@.....T@@................T@@@@@@@@@@@@@@@@@@@@@@@@@@
@@@@@@@@@@@@@@@@@@@@@@@@@@.....@@....T.............@@@@@@@@@@@@@@@@@@@@@@@@@
@@@@@@@@@@@@@@@@@@@@@@@@@@..T..T@...TT..............@@@@@@@@@@@@@@@@@@@@@@@@
@@@@@@@@@@@@@@@@@@@@@@@@@@@.....@T....TT...........T.@@@@@@@@@@@@@@@@@@@@@@@
@@@@@@@@@@@@@@@@@@@@@@@@..@...T..T.......T..T........@@@@@@@@@@@@@@@@@@@@@@@
@@@@@@@@@@@@@@@@@@@@@@@@..@@.T....T........T........@@@.@@@@@@@@@@@@@@@@@@@@
@@@@@@@@@@@@@@@@@@@@@@@@...@........................@@...@@@@@@@@@@@@@@@@@@@
@@@@@@@@@@@@@@@@@@@@@.@@..T@.........T.T............@.T...@@@@@@@@@@@@@@@@@@
@@@@@@@@@@@@@@@@@@@@..@@T......T...........................@@@@@@@@@@@@@@@@@
@@@@@@@@@@@@@@@@@@.............T...............T............@@@@@@@@@@@@@@@@
@@@@@@@@@@@@@@@@@........TT.......................T...........@@@@@@@@@@@@@@
@@@@@@@@@@@@@@@@@......T.........T...T...T................T...@@@@@@@@@@@@@@
@@@@@@@@@@@@@@@@@..........T...........T.................T.T.@@@@@@@@@@@@@@@
@@@@@@@@@@@@@@@@@........T......T..........T....T........T..@@@.@@@@@@@@@@@@
@@@@@@@@@@@@@@@@@................................T.....T.T..@@.....T.T@@..@@
@@@@@@@@@@@@@@@@@......TT..................T........T......T@@.T..........@@
@@@@@@@@@@@@@@@@@.T....T............T.T......T...T........TT..T..T........@@
@@@@@@@@@@@@@@@@@...............T..........T...T.......T..T..T...........T@@
@@@@@@@@@@@@@@@@@....T.......T.................T..........................@@
@@@@@@@@@@@@@@@@@......T.............................T................T..T@@
@@@@@@@@@@@@@@@@@T.T.........TT...............................T.....T.....@@
@@@@@@@@@@@@@@@@@.T........................T........T...T................@@@
@@@@@@@@@@@@@@@@@.......T...T......T..............T.....T....T........T.@@@@
@@@@@@@@@@@@@@@@@@..T..T........T.....T.....T.T...............T.....T..@@@@@
@@@@@@@@@@@@@@@@@@@T...T.T..........................T..........T......@@@@@@
@@@@@@@@@@@@@@@@@@@@................TT.T..................T..........@@@@@@@
@@@@@@@@@@@@@@@@@@@@@.....T....TT.T............T....................@@@@@@@@
@@@@@@@@@@@@@@@@@@@@@@..................T.....T.....T..T...........@@@@@@@@@
@@@@@@@@@@@@@@@@@@@@@@@............T.T.......T........T...T..T....@@@@@@@@@@
@@@@@@@@@@@@@@@@@@@@@@@@..................T....T.....T..T.......T@@@@@@@@@@@
@@@@@@@@@@@@@@@@@@@@@@@@@.T......................T........T...T.@@@@@@@@@@@@
@@@@@@@@@@@@@@@@@@@@@@@@@@.........................T..T........@@@@@@@@@@@@@
@@@@@@@@@@@@@@@@@@@@@@@@@@@..T...T.......T....................@@@@@@@@@@@@@@
@@@@@@@@@@@@@@@@@@@@@@@@@@@@..T.T.TT...T....T.T.T............@@@@@@@@@@@@@@@
@@@@@@@@@@@@@@@@@@@@@@@@@@@@@.T.....T..TT...................@@@@@@@@@@@@@@@@
@@@@@@@@@@@@@@@@@@@@@@@@@@@@@@T.T.........T..............T.@@@@@@@@@@@@@@@@@
@@@@@@@@@@@@@@@@@@@@@@@@@@@@@@@.......T...T.T........T....@@@@@@@@@@@@@@@@@@
@@@@@@@@@@@@@@@@@@@@@@@@@@@@@@@@.........T..T........T.T.@@@@@@@@@@@@@@@@@@@
@@@@@@@@@@@@@@@@@@@@@@@@@@@@@@@@@...........T.....T.....@@@@@@@@@@@@@@@@@@@@
@@@@@@@@@@@@@@@@@@@@@@@@@@@@@@@@@@...T..........T......@@@@@@@@@@@@@@@@@@@@@
@@@@@@@@@@@@@@@@@@@@@@@@@@@@@@@@@@@..T.............T..@@@@@@@@@@@@@@@@@@@@@@
@@@@@@@@@@@@@@@@@@@@@@@@@@@@@@@@@@@@@.T...T...T......@@@@@@@@@@@@@@@@@@@@@@@
@@@@@@@@@@@@@@@@@@@@@@@@@@@@@@@@@@@@@@@@@@@@@@@@@@@@@@@@@@@@@@@@@@@@@@@@@@@@
