type octile
height 80
width 52
map
@@@@@@@@@@@@@@@@@@@@@@@@@@@@@@@@@@@@@@@@@@@@@@@@@@@@
@@@@@@@@@@@@@@@@@@@@@@@@@@@@@@@@@@@@@@@@@@@@@@@@@@@@
@@@@@@@@@@@@@@@@@@@@@@@@@@@@@@@@@@@@@@@@@@@@@@@@@@@@
@@@@@@@@@@@@@@@@@@@@@@@@@@@@@@@@@@@@@@@@@@@@@@@@@@@@
@@@@@@@@@@@@@@@@@@@@@@@@@@@@@@@@@@@@@@@@@@@@@@@@@@@@
@@@@@@@@@@@@@@@@@@@@@@@@@@@@@@@@@@@@@@@@@@@@@@@@@@@@
@@@@@@@@@@@@@@@@@@@@@@@@@@@@@@@@@@@@@@@@@@@@@@@@@@@@
@@@@@@@@@@@@@@@@@@@@@@@@@@@@@@@@@@@@@@@@@@@@@@@@@@@@
@@@@@@@@@@@@@@@@@@@@@@@@@@@@@@@@@@@@@@@@@@@@@@@@@@@@
@@@@@@@@@@@@@@@@@@@@@@@@@@@@@@@@@@@@@@@@@@@@@@@@@@@@
@@@@@@@@@@@@@@@@@@@@@@@@@@@@@@@@@@@@@@@@@@@@@@@@@@@@
@@@@@@@@@@@@@@@@@@@@@@@@@@@@@@@@@@@@@@@@@@@@@@@@@@@@
@@@@@@@@@@@@@@@@@@@@@@@@@@@@@@@@@@@@@@@@@@@@@@@@@@@@
@@@@@@@@@@@@@@@@@@@@@@@@@@@@@@@@@@@@@@@@@@@@@@@@@@@@
@@@@@@@@@@@@@@@@@@@@@@@@@@@@@@@@@@@@@@@@@@@@@@@@@@@@
@@@@@@@@@@@@@@@@@@@@@@@@@@@@@@@@@@@@@@@@@@@@@@@@@@@@
@@@@@@@@@@@@@@@@@@@@@@@@@@@@@@@@@@@@@@@@@@@@@@@@@@@@
@@@@@@@@@@@@@@@@@@@@@@@@@@@@@@@@@@@@@@@@@@@@@@@@@@@@
@@@@@@@@@@@@@@@@@@@@@@@@@@@@@@@@@@@@@@@@@@@@@@@@@@@@
@@@@@@@@@@@@@@@@@@@@@@@@@@@@@@@@@@@@@@@@@@@@@@@@@@@@
@@@@@@@@@@@@@@@@@@@@@@@@@@@@@@@@@@@@@@@@@@@@@@@@@@@@
@@@@@@@@@@@@@@@@@@@@@@@@@@@@@@@@@@@@@@@@@@@@@@@@@@@@
@@@@@@@@@@@@@@@@@@@@@@@@@@@@@@@@@@@@@@@@@@@@@@@@@@@@
@@@@@@@@@@@@@@@@@@@@@@@@@@@@@@@@@@@@@@@@@@@@@@@@@@@@
@@@@@@@@@@@@@@@@@@@@@@@@@@@@@@@@@@@@@@@@@@@@@@@@@@@@
@@@@@@@@@@@@@@@@@@@@@@@@@@@@@@@@@@@@@@@@@@@@@@@@@@@@
@@@@@@@@@@@@@@@@@@@@@@@@@@@@@@@@@@@@@@@@@@@@@@@@@@@@
@@@@@@@@@@@@@@@@@@@@@@@@@@@@@@@@@@@@@@@@@@@@@@@@@@@@
@@@@@@@@@@@@@@@@@@@@@@@@@@@@@@@@@@@@@@@@@@@@@@@@@@@@
@@@@@@@@@@@@@@@@@@@@@@@.T...@@@@@@@@@@@@@@@@@@@@@@@@
@@@@@@@@@@@@@@@@@@@........T.....@@@@@@@@@@@@@@@@@@@
@@@@@@@@@@@@@@@@@........TT........@@@@@@@@@@@@@@@@@
@@@@@@@@@@@@@@@..T.TT..T.......T....@@@@@@@@@@@@@@@@
@@@@@@@@@@@@@@..........T......T.T.@@@@@@@@@@@@@@@@@
@@@@@@@@@@@@@@@............T.......@@@@@@@@@@@@@@@@@
@@@@@@@@@@@@@@@.......T............@@@@@.@@@@@@@@@@@
@@@@@@@@@@@@@@@.....................@@...@@@@@@@@@@@
@@@@@@@@@@@@@@@.......................T...@@@@@@@@@@
@@@@@@@@@@@@@@........T.................T..@@@@@@@@@
@@@@@@@@@@@@@.T..............TT....T.......@@@@@@@@@
@@@@@@@@.@@@.T....T.........................@@@@@@@@
@@@@@@@T....T...............................@@@@@@@@
@@@@@@@..........................T........T..@@@@@@@
@@@@@@@.................T.............T.....T@@@@@@@
@@@@@@....T................T.TT...T...........@@@@@@
@@@@@@..T.....................................@@@@@@
@@@@@@..............T....................T....@@@@@@
@@@@@@...............................T....@@@@@@@@@@
@@@@@@.T..................................@@@@@@@@@@
@@@@@@...........T...T....T.T..T..........@@@@@@@@@@
@@@@@@.....T........T........T....T.....T@@@@@@@@@@@
@@@@@@..................T.....T...T......@@@@@@@@@@@
@@@@@@...T..T.........T....................@@@@@@@@@
@@@@@@@.T....T........T...T.T......T.........@@@@@@@
@@@@@@@....T....T.....T...............T...T..@@@@@@@
@@@@@@@...T.....T..T..............T.........@@@@@@@@
@@@@@@@@........................T...........@@@@@@@@
@@@@@@@@..T@@@@............T...............@@@@@@@@@
@@@@@@@@@..@@@@.......T....T....T..........@@@@@@@@@
@@@@@@@@@@.@@@@@...T.T................T...@@@@@@@@@@
@@@@@@@@@@.@@@@@@.....T..............T...@@@@@@@@@@@
@@@@@@@@@@@@@@........T..T..............@@@@@@@@@@@@
@@@@@@@@@@@@@T......T.........@@@@.....@@@@@@@@@@@@@
@@@@@@@@@@@@@@.T.......T.....@@@@@@...@@@@@@@@@@@@@@
@@@@@@@@@@@@@@@..............@@@@@@..@@@@@@@@@@@@@@@
@@@@@@@@@@@@@@@@@T............@@@@@@@@@@@@@@@@@@@@@@
@@@@@@@@@@@@@@@@@@@@..........@@@@@@@@@@@@@@@@@@@@@@
@@@@@@@@@@@@@@@@@@@@@@@@.....@@@@@@@@@@@@@@@@@@@@@@@
@@@@@@@@@@@@@@@@@@@@@@@@@@@@@@@@@@@@@@@@@@@@@@@@@@@@
@@@@@@@@@@@@@@@@@@@@@@@@@@@@@@@@@@@@@@@@@@@@@@@@@@@@
@@@@@@@@@@@@@@@@@@@@@@@@@@@@@@@@@@@@@@@@@@@@@@@@@@@@
@@@@@@@@@@@@@@@@@@@@@@@@@@@@@@@@@@@@@@@@@@@@@@@@@@@@
@@@@@@@@@@@@@@@@@@@@@@@@@@@@@@@@@@@@@@@@@@@@@@@@@@@@
@@@@@@@@@@@@@@@@@@@@@@@@@@@@@@@@@@@@@@@@@@@@@@@@@@@@
@@@@@@@@@@@@@@@@@@@@@@@@@@@@@@@@@@@@@@@@@@@@@@@@@@@@
@@@@@@@@@@@@@@@@@@@@@@@@@@@@@@@@@@@@@@@@@@@@@@@@@@@@
@@@@@@@@@@@@@@@@@@@@@@@@@@@@@@@@@@@@@@@@@@@@@@@@@@@@
@@@@@@@@@@@@@@@@@@@@@@@@@@@@@@@@@@@@@@@@@@@@@@@@@@@@
@@@@@@@@@@@@@@@@@@@@@@@@@@@@@@@@@@@@@@@@@@@@@@@@@@@@
@@@@@@@@@@@@@@@@@@@@@@@@@@@@@@@@@@@@@@@@@@@@@@@@@@@@
