type octile
height 80
width 80
map
@@@@@@@@@@@@@@@@@@@@@@@@@@@@@@@@@@@@@@@@@@@@@@@@@@@@@@@@@@@@@@@@@@@@@@@@@@@@@@@@
@@@@@@@@@@@@@@@@@@@@@@@@@@@@@@@@@@@@@@@@@@@@@@@@@@@@@@@@@@@@@@@@@@@@@@@@@@@@@@@@
@@@@@@@@@@@@@@@@@@@@@@@@@@@@@@@@@@@@@@@@@@@@@@@@@@@@@@@@@@@@@@@@@@@@@@@@@@@@@@@@
@@@@@@@@@@@@@@@@@@@@@@@@@@@@@@@@@@@@@@@@@@@@@@@@@@@@@@@@@@@@@@@@@@@@@@@@@@@@@@@@
@@@@@@@@@@@@@@@@@@@@@@@@@@@@@@@@@@@@@@@@@@@@@@@@@@@@@@@@@@@@@@@@@@@@@@@@@@@@@@@@
@@@@@@@@@@@@@@@@@@@@@@@@@@@@@@@@@@@@@@@@@@@@@@@@@@@@@@@@@@@@@@@@@@@@@@@@@@@@@@@@
@@@@@@@@@@@@@@@@@@@@@@@@@@@@@@@@@@@@@@@@@@@@@@@@@@@@@@@@@@@@@@@@@@@@@@@@@@@@@@@@
@@@@@@@@@@@@@@@@@@@@@@@@@@@@@@@@@@@@@@@@@@@@@@@@@@@@@@@@@@@@@@@@@@@@@@@@@@@@@@@@
@@@@@@@@@@@@@@@@@@@@@@@@@@@@@@@@@@@@@@@@@@@@@@@@@@@@@@@@@@@@@@@@@@@@@@@@@@@@@@@@
@@@@@@@@@@@@@@@@@@@@@@@@@@@@@@@@@@@@@@@@@@@@@@@@@@@@@@@@@@@@@@@@@@@@@@@@@@@@@@@@
@@@@@@@@@@@@@@@@@@@@@@@@@@@@@@@@@@@@@@@@@@@@@@@@@@@@@@@@@@@@@@@@@@@@@@@@@@@@@@@@
@@@@@@@@@@@@@@@@@@@@@@@@@@@@@@@@@@@@@@@@@@@@@@@@@@@@@@@@@@@@@@@@@@@@@@@@@@@@@@@@
@@@@@@@@@@@@@@@@@@@@@@@@@@@@@@@@@@@@@@@@@@@@@@@@@@@@@@@@@@@@@@@@@@@@@@@@@@@@@@@@
@@@@@@@@@@@@@@@@@@@@@@@@@@@@@@@@@@@@@@@@@@@@@@@@@@@@@@@@@@@@@@@@@@@@@@@@@@@@@@@@
@@@@@@@@@@@@@@@@@@@@@@@@@@@@@@@@@@@@@@@@@@@@@@@@@@@@@@@@@@@@@@@@@@@@@@@@@@@@@@@@
@@@@@@@@@@@@@@@@@@@@@@@@@@@@@@@@@@@@@@@@@@@@@@@@@@@@@@@@@@@@@@@@@@@@@@@@@@@@@@@@
@@@@@@@@@@@@@@@@@@@@@@@@@@@@@@@@@@@@@@@@@@@@@@@@@@@@@@@@@@@@@@@@@@@@@@@@@@@@@@@@
@@@@@@@@@@@@@@@@@@@@@@@@@@@@@@@@@@@@@@@@@@@@@@@@@@@@@@@@@@@@@@@@@@@@@@@@@@@@@@@@
@@@@@@@@@@@@@@@@@@@@@@@@@@@@@@@@@@@@@@@@@@@@@@@@@@@@@@@@@@@@@@@@@@@@@@@@@@@@@@@@
@@@@@@@@@@@@@@@@@@@@@@@@@@@@@@@@@@@@@@@@@@@@@@@@@@@@@@@@@@@@@..@@@@@@@@@@@@@@@@@
@@@@@@@@@@@@@@@@@@@@@@@@@@@@@@@@@@@@@@@@@@@@@@@@@@@@@@@@@@@@..T.@@@@@@@@@@@@@@@@
@@@@@@@@@@@@@@@@@@@@@@@@@@@@@@@@@@@@@@@@@@@@@@@@@@@@@@@@@@@@.....@@@@@@@@@@@@@@@
@@@@@@@@@@@@@@@@@@@@@@@@@@@@@@@@@@@@@@@@@@@@@@@@@@@@@@@@@@@....TT.@@@@@@@@@@@@@@
@@@@@@@@@@@@@@@@@@@@@@@@@@@@@@@@@.@@@@@@@@@@@@@@@@@@@@@@@@......T.T@@@@@@@@@@@@@
@@@@@@@@@@@@@@@@@@@@@@@@@@@@@@@@T..@@@@@@@@@@@@@@@@@@@@@@..T.......T@@@@@@@@@@@@
@@@@@@@@@@@@@@@@@@@@@@@@@@@@@@....T.@@@@@@@@@@@@@@@@@@@@.............@@@@@@@@@@@
@@@@@@@@@@@@@@@@@@@@@@@@@@@@.....TT.@@@@@@@@@@@@@@@@@@@T.............@@@@@@@@@@@
@@@@@@@@@@@@@@@@@@@@@@@@@@..........@@@@@@@@@@@@@@@@@@.....T....T...@@@@@@@@@@@@
@@@@@@@@@@@@@@@@@@@@@@@@@@@.......T..@@@@@..@@@@@@@@@.....T....T...@@@@@@@@@@@@@
@@@@@@@@@@@@@@@@@@@@@@@@@@@...T.....T.@@@T..T@@@@@@@T...T.........@@@@@@@@@@@@@@
@@@@@@@@@@@@@@@@@@@@@@@@@@..T.............T...@@@@@.T............@@@@@@@@@@@@@@@
@@@@@@@@@@@@@@@@@@@@@@@@@.T.......T...T...@@@@@@@@.T.....T......@@@@@@@@@@@@@@@@
@@@@@@@@@@@@@@@@@@@@@@@@...T......T....T.@@@@@@@.....T....T..T..@@@@@@@@@@@@@@@@
@@@@@@@@@@@@@@@@@@@@@@@T...........@@..................T.TT.T..@@@@@@@@@@@@@@@@@
@@@@@@@@@@@@@@@@@@@@@@......@...@@T@@.............T.......T....@@@@@@@@@@@@@@@@@
@@@@@@@@@@@@@@@@@@@@@T.....@@..@@@@@.........T......T...T.....@@@@@@@@@@@@@@@@@@
@@@@@@@@@@@@@@@@@@@@..........@@@@@@T.T..T........T.........T.@@@@@@@@@@@@@@@@@@
@@@@@@@@@@@@@@T@@@@T.........@@@@@@@.T.............TT.T......@@@@@@@@@@@@@@@@@@@
@@@@@@@@@@@@@.T@@@.......T..@@@@@@@.............T...........@@@@@@@@@@@@@@@@@@@@
@@@@@@@@@@@@@..@@.....TT...@@@@@@@............T............@@@@@@@@@@@@@@@@@@@@@
@@@@@@@@@@@@@.T@.....T....@@@@@@@...............T..........@@@@@@@@@@@@@@@@@@@@@
@@@@@@@@@@@@@......T@....@@.@@@@..............T...........@@@@@@@@@@@@@@@@@@@@@@
@@@@@@@@@@@@@......@@@.T.....@@@..........................@..@@@@@@@@@@@@@@@@@@@
@@@@@@@@@@@@...T..T@@T......@@.....T.......T......T...T.T@@...@@@@@@@@@@@@@@@@@@
@@@@@@@@@@@@.......@@...T..T........T..........T.......T.@..T..@@@@@@@@@@@@@@@@@
@@@@@@@@@@@@..................................T............T...@@@@@@@@@@@@@@@@@
@@@@@@@@@@@.........T.....T.......T.................T..........@@@@@@@@@@@@@@@@@
@@@@@@@@@@.................TT....T........................T...@@@@@@@@@@@@@@@@@@
@@@@@@@@@@.T...........T.....T.T.....................TT......@@@@@@@@@@@@@@@@@@@
@@@@@@@@@.............................T.....T....T.T.......T@@@@@@@@@@@@@@@@@@@@
@@@@@@@@@..T..........................T....................@@@@@@@@@@@@@@@@@@@@@
@@@@@@@@@.................................................@@@@@@@@@@@@@@@@@@@@@@
@@@@@@@@@@.......@@@@@@@@@T.............T.............T..@@@@@@@@@@@@@@@@@@@@@@@
@@@@@@@@@@@....T@@@@@@@@@@@@............................@@@@@@@@@@@@@@@@@@@@@@@@
@@@@@@@@@@@@....@@@@@@@@@@@@@TT..T..T..T....T..........@@@@@@@@@@@@@@@@@@@@@@@@@
@@@@@@@@@@@@....@@@@@@@@@@@@...T.....T.........T.T....@@@@@@@@@@@@@@@@@@@@@@@@@@
@@@@@@@@@@......@@@@@@@@@@@@.......................@@@@@@@@@@@@@@@@@@@@@@@@@@@@@
@@@@@@@@@@@.T..T...@@@@@@@@......TT.T............@@@@@@@@@@@@@@@@@@@@@@@@@@@@@@@
@@@@@@@@@@@....T....@@@@@@@...........T..........@@@@@@@@@@@@@@@@@@@@@@@@@@@@@@@
@@@@@@@@@@@.............@@@......T..............@@@@@@@@@@@@@@@@@@@@@@@@@@@@@@@@
@@@@@@@@@@T.T...............T......T....TT.....@@@@@@@@@@@@@@@@@@@@@@@@@@@@@@@@@
@@@@@@@@TTT.T....T................T..T........@@@@@@@@@@@@@@@@@@@@@@@@@@@@@@@@@@
@@@@@@@@................T.............T.....@@@@@@@@@@@@@@@@@@@@@@@@@@@@@@@@@@@@
@@@@.T......T..............................@@@@@@@@@@@@@@@@@@@@@@@@@@@@@@@@@@@@@
@@@@....................T..........T......@@@@@@@@@@@@@@@@@@@@@@@@@@@@@@@@@@@@@@
@@@@@.T.@@T.......T.T....T.....T.........@@@@@@@@@@@@@@@@@@@@@@@@@@@@@@@@@@@@@@@
@@@@@...@@.....T......TT.........T.T....@@@@@@@@@@@@@@@@@@@@@@@@@@@@@@@@@@@@@@@@
@@@@....T................T..TT........@@@@@@@@@@@@@@@@@@@@@@@@@@@@@@@@@@@@@@@@@@
@@@..................................@@@@@@@@@@@@@@@@@@@@@@@@@@@@@@@@@@@@@@@@@@@
@@@@.T..............................@@@@@@@@@@@@@@@@@@@@@@@@@@@@@@@@@@@@@@@@@@@@
@@@@@.......T.T........T.......T...@@@@@@@@@@@@@@@@@@@@@@@@@@@@@@@@@@@@@@@@@@@@@
@@@@@@........T...T..T......TT.T..@@@@@@@@@@@@@@@@@@@@@@@@@@@@@@@@@@@@@@@@@@@@@@
@@@@@......T....T.T.T............@@@@@@@@@@@@@@@@@@@@@@@@@@@@@@@@@@@@@@@@@@@@@@@
@@@@..........T..........T....T.@@@@@@@@@@@@@@@@@@@@@@@@@@@@@@@@@@@@@@@@@@@@@@@@
@@@@@..........................@@@@@@@@@@@@@@@@@@@@@@@@@@@@@@@@@@@@@@@@@@@@@@@@@
@@@@@@....T.....T.....T.T.@....@@@@@@@@@@@@@@@@@@@@@@@@@@@@@@@@@@@@@@@@@@@@@@@@@
@@@@@.....T....T....T..TT.@@.@@@@@@@@@@@@@@@@@@@@@@@@@@@@@@@@@@@@@@@@@@@@@@@@@@@
@@@@.....T.....T.............@@@@@@@@@@@@@@@@@@@@@@@@@@@@@@@@@@@@@@@@@@@@@@@@@@@
@@@@@@@@@@@@@@@@@@@@@@@@@@@@@@@@@@@@@@@@@@@@@@@@@@@@@@@@@@@@@@@@@@@@@@@@@@@@@@@@
@@@@@@@@@@@@@@@@@@@@@@@@@@@@@@@@@@@@@@@@@@@@@@@@@@@@@@@@@@@@@@@@@@@@@@@@@@@@@@@@
