type octile
height 112
width 100
map
@@@@@@@@@@@@@@@@@@@@@@@@@@@@@@@@@@@@@@@@@@@@@@@@@@@@@@@@@@@@@@@@@@@@@@@@@@@@@@@@@@@@@@@@@@@@@@@@@@@@
@@@@@@@@@@@@@@@@@@@@@@@@@@@@@@@@@@@@@@@@@@@@@@@@@@@@@@@@@@@@@@@@@@@@@@@@@@@@@@@@@@@@@@@@@@@@@@@@@@@@
@@@@@@@@@@@@@@@@@@@@@@@@@@@@@@@@@@@@@@@@@@@@@@@@@@@@@@@@@@@@@@@@@@@@@@@@@@@@@@@@@@@@@@@@@@@@@@@@@@@@
@...T.@@@@@@@@@@@@@@@@@@@@@@@@@@@@@@@@@@@@@@@@@@@@@@@@@@@@@@@@@@@@@@@@@@@@@@@@@@@@@@@@@@@@@@@@@@@@@@
@.....@@@@@@@@@@@@@@@@@@@@@@@@@@@@@@@@@@@@@@@@@@@@@@@@@@@@@@@@@@@@@@@@@@@@@@@@@@@@@@@@@@@@@@@@@@@@@@
@.....@@@@@@@@@@@@@@@@@@@@@@@@@@@@@@@@@@@@@@@@@@@@@@@@@@@@@@@@@@@@@@@@@@@@@@@@@@@@@@@@@@@@@@@@@@@@@@
@.....@@@@@@@@@@@@@@@@@@@@@@@@@@@@@@@@@@@@@@@@@@@@@@@@@@@@@@@@@@@@@@@@@@@@@@@@@@@@@@@@@@@@@@@@@@@@@@
@.....@@@@@@@@@@@@@@@@@@@@@@@@@@@@@@@@@@@@@@@@@@@@@@@@@@@@@@@@@@@@@@@@@@@@@@@@@@@@@@@@@@@@@@@@@@@@@@
@@@@@@@@@@@@@@@@@@@@@@@@@@@@@@@@@@@@@@@@@@@@@@@@@@@@@@@@@@@@@@@@@@@@@@@@@@@@@@@@@@@@@@@@@@@@@@@@@@@@
@@@@@@@@@@@@@@@@@@@@@@@@@@@@@@@@@@@@@@@@@@@@@@@@@@@@@@@@@@@@@@@@@@@@@@@@@@@@@@@@@@@@@@@@@@@@@@@@@@@@
@@@@@@@@@@@@@@@@@@@@@@@@@@@@@@@@@@@@@@@@@@@@@@@@@@@@@@@@@@@@@@@@@@@@@@@@@@@@@@@@@@@@@@@@@@@@@@@@@@@@
@@@@@@@@@@@@@@@@@@@@@@@@@@@@@@@@@@@@@@@@@@@@@@@@@@@@@@@@@@@@@@@@@@@@@@@@@@@@@@@@@@@@@@@@@@@@@@@@@@@@
@@@@@@@@@@@@@@@@@@@@@@@@@@@@@@@@@@@@@@@@@@@@@@@@@@@@@@@@@@@@@@@@@@@@@@@@@@@@@@@@@@@@@@@@@@@@@@@@@@@@
@@@@@@@@@@@@@@@@@@@@@@@@@@@@@@@@@@@@@@@@@@@@@@@@@@@@@@@@@@@@@@@@@@@@@@@@@@@@@@@@@@@@@@@@@@@@@@@@@@@@
@@@@@@@@@@@@@@@@@@@@@@@@@@@@@@@@@@@@@@@@@@@@@@@@@@@@@@@@@@@@@@@@@@@@@@@@@@@@@@@@@@@@@@@@@@@@@@@@@@@@
@@@@@@@@@@@@@@@@@@@@@@@@@@@@@@@@@@@@@@@@@@@@@@@@@@@@@@@@@@@@@@@@@@@@@@@@@@@@@@@@@@@@@@@@@@@@@@@@@@@@
@@@@@@@@@@@@@@@@@@@@@@@@@@@@@@@@@@@@@@@@@@@@@@@@@@@@@@@@@@@@@@@@@@@@@@@@@@@@@@@@@@@@@@@@@@@@@@@@@@@@
@@@@@@@@@@@@@@@@@@@@@@@@@@@@@@@@@@@@@@@@@@@@@@@@@@@@@@@@@@@@@@@@@@@@@@@@@@@@@@@@@@@@@@@@@@@@@@@@@@@@
@@@@@@@@@@@@@@@@@@@@@@@@@@@@@@@@@@@@@@@@@@@@@@@@@@@@@@@@@@@@@@@@@@@@@@@@@@@@@@@@@@@@@@@@@@@@@@@@@@@@
@@@@@@@@@@@@@@@@@@@@@@@@@@@@@@@@@@@@@@@@@@@@@@@@@@@@@@@@@@@@@@@@@@@@@@@@@@@@@@@@@@@@@@@@@@@@@@@@@@@@
@@@@@@@@@@@@@@@@@@@@@@@@@@@@@@@@@@@@@@@@@@@@@@@@@@@@@@@@@@@@@@@@@@@@@@@@@@@@@@@@@@@@@@@@@@@@@@@@@@@@
@@@@@@@@@@@@@@@@@@@@@@@@@@@@@@@@@@@@@@@@@@@@@@@@@@@@@@@@@@@@@@@@@@@@@@@@@@@@@@@@@@@@@@@@@@@@@@@@@@@@
@@@@@@@@@@@@@@@@@@@@@@@@@@@@@@@@@@@@@@@@@@@@@@@@@@@@@@@@@@@@@@@@@@@@@@@@@@@@@@@@@@@@@@@@@@@@@@@@@@@@
@@@@@@@@@@@@@@@@@@@@@@@@@@@@@@@@@@@@@@@@@@@@@@@@@@@@@@@@@@@@@@@@@@@@@@@@@@@@@@@@@@@@@@@@@@@@@@@@@@@@
@@@@@@@@@@@@@@@@@@@@@@@@@@@@@@@@@@@@@@@@@@@@@@@@@@@@@@@@@@@@@@@@@@@@@@@@@@@@@@@@@@@@@@@@@@@@@@@@@@@@
@@@@@@@@@@@@@@@@@@@@@@@@@@@@@@@@@@@@@@@@@@@@@@@@@@@@@@@@@@@@@@@@@@@@@@@@@@@@@@@@@@@@@@@@@@@@@@@@@@@@
@@@@@@@@@@@@@@@@@@@@@@@@@@@@@@@@@@@@@@@@@@.@@@@@@@@@@@@@@@@@@@@@@@@@@@@@@@@@@@@@@@@@@@@@@@@@@@@@@@@@
@@@@@@@@@@@@@@@@@@@@@@@@@@@@@@@@@@@@.T@@@.TT@@@@@@@@@@@@@@@@@@@@@@@@@@@@@@@@@@@@@@@@@@@@@@@@@@@@@@@@
@@@@@@@@@@@@@@@@@@@@@@@@@@@@@@@@@@@.........T@@@@@@@@@@@@@@@@@@@@@@@@@@@@@@@@@@@@@@@@@@@@@@@@@@@@@@@
@@@@@@@@@@@@@@@@@@@@@@@@@@@@@@@@@@..TT........@@@@@@@@@@@@@@@@@@@@@@@@@@@@@@@@@@@@@@@@@@@@@@@@@@@@@@
@@@@@@@@@@@@@@@@@@@@@@@@@@@@@@@@@...............T...@@@@@@@@@@@@@@@@@@@@@@@@@@@@@@@@@@@@@@@@@@@@@@@@
@@@@@@@@@@@@@@@@@@@@@@@@@@@@@@@@............T........@@@@@@@@@@@@@@@@@@@@@@@@@@@@@@@@@@@@@@@@@@@@@@@
@@@@@@@@@@@@@@@@@@@@@@@@@@@@@@@@@...TT.....T...T.T...T@@@@@@@@@@@@@@@@......@@@@@@@@@@@@@@@@@@@@@@@@
@@@@@@@@@@@@@@@@@@@@@@@@@@@@@@@@@...................T..@@@@@@@@@@@@@@..T.....@@@@@@@@@@@@@@@@@@@@@@@
@@@@@@@@@@@@@@@@@@@@@@@@@@@@@@@@.T..T....@@@T..........@@@@@@@@@@@@T.T...@@@.T@@@@@@@@@@@@@@@@@@@@@@
@@@@@@@@@@@@@@@@@@@@@@@@@@@@@@@..T..@@...@@@..T........@@@@@@@@@@@......@@@@...@@@@@@@@@@@@@@@@@@@@@
@@@@@@@@@@@@@@@@@@@@@@@@@@..@@......@@@@@@@@..........@@@@@@@@@@@.......@@@@.T..@@@@@@@@@@@@@@@@@@@@
@@@@@@@@@@@@@@@@@@@@@@@@@@..........@@.@@@@..T.........@@@@@@@@@........@@@.....@@@@@@@@@@@@@@@@@@@@
@@@@@@@@@@@@@@@@@@@@@@@@@........T.....@@@@T...T........@@@@@@@@@...............@@@@@@@@@@@@@@@@@@@@
@@@@@@@@@@@@@@@@@@@@@@@@.....T@@@.T.....@@@..................@@@@T.......@@@.T..@@@@@@@@@@@@@@@@@@@@
@@@@@@@@@@@@@@@@@@@@@@@......@@@@@.......@@..................@@@........@@@@@...@@@@@@@@@@@@@@@@@@@@
@@@@@@@@@@@@@@@@@@@@@@@.....@@@@@@@.......@@@.............T............T@@@@@...@@@@@@@@@@@@@@@@@@@@
@@@@@@@@@@@@@@@@@@@@@@@..TT@@@@@@@@.......@@@...T..T....................@@@@@..@@@@@@@@@@@@@@@@@@@@@
@@@@@@@@@@@@@@@@@@@@@@@...@@@@@@@@@..T..........T.....T.......T.......TT.@@@..@@@@@@@@@@@@@@@@@@@@@@
@@@@@@@@@@@@@@@@@@@@@@...@@@@@@@@@@......T...T.T..................TTTT.......@@@@@@@@@@@@@@@@@@@@@@@
@@@@@@@@@@@@@@@@@@@@@.T.@@@@@@@@@@....T.T.....T....................T........@@@@@@@@@@@@@@@@@@@@@@@@
@@@@@@@@@@@@@@@@@@@@...@@@@@@@@@@@...............T....T..T.................@@@@@@@@@@@@@@@@@@@@@@@@@
@@@@@@@@@@@@@@@@.....T.@@@@@@@@@@@...T....T........@@@@...................@@@@@@@@@@@@@@@@@@@@@@@@@@
@@@@@@@@@@@@@@@..T......@@@@@@@@@@@......TT.......@@@@@@..T.........T....@@@@@@@@@@@@@@@@@@@@@@@@@@@
@@@@@@@@@@@@@.......T....@@@@@@@@@.....T.........@@@@@@@........T.T..T..@@@@@@@@@@@@@@@@@@@@@@@@@@@@
@@@@@@@@@@@@......@@@....T@@@..@@.....T.T@@.....@@@..@@..................@@@@@@@@@@@@@@@@@@@@@@@@@@@
@@@@@@@@@@@@@.....@@@..T...@..T..T......@@@...T@@@....T..T................@@@@@@@@@@@@@@@@@@@@@@@@@@
@@@@@@@@@@@@@......@@...........T..T.T.@@@.T..@@@.....T....................@@@@@@@@@@@@@@@@@@@@@@@@@
@@@@@@@@@@@@@...T.T@@.....T.........TT.@@....@@@.T......T............T....@@@@@@@@@@@@@@@@@@@@@@@@@@
@@@@@@@@@@@@.......@@.TTT..........T.@.@....@@@....T........TT.T..T..T...T@@@@@@@@@@@@@@@@@@@@@@@@@@
@@@@@@@.@@@.TT...T.@@@@.............@@.TT..@@@...T.....T.......T.........T@@@@@@@@@@@@@@@@@@@@@@@@@@
@@@@@@...@.........@@@@@...........@@@....@@T........T...........@.........@@@@@@@@@@@@@@@@@@@@@@@@@
@@@@@........T...T..@@@@.......T..@@@.T..@@.T...T.T...........T.@@.T..TT....@@@@@@@@@@@@@@@@@@@@@@@@
@@@@@@............@@@@@@@@@......@@@....@@.....T........TT.....@@@@.......T.......@@@@@@@@@@@@@@@@@@
@@@@@@@.T.T...T.T.@@@...@@@......@@...T@@......T....T..........@@@................T@@@@@@@@@@@@@@@@@
@@@@@@@@.T.T.......T.T................@@.......T................@@..................@@@@@@@@@@@@@@@@
@@@@@@@@@..T..........T.....T.T......@@.....T.T................@@.T............T....@@@@@@@@@@@@@@@@
@@@@@@@@@@......T...T.......T.....TT@@.............T.T........@@......TTT......T....@@@@@@@@@@@@@@@@
@@@@@@@@@@@..........T.............@@..........T.....T.......@@.......T....T..T...T.@@@@@@@@@@@@@@@@
@@@@@@@@@@@@.T........T...........@@........................@@...T.@.T..............@@@@@@@@@@@@@@@@
@@@@@@@@@@@@@....................@@.....................T.T@@.....@@@.T.....T.....T..@@@@@@@@@@@@@@@
@@@@@@@@@@@@@@T..........T......@@................T.......@@.....@@@@@T..T.......T....@@@.@@@@@@@@@@
@@@@@@@@@@@@@@@..T....T.......T.@.....................T..@@.....@@@@@............T.........@@@@@@@@@
@@@@@@@@@@@@@@@@..........T....@@@...............T......@@.....@@@@@...@...............T..@@@@@@@@@@
@@@@@@@@@@@@@@@@@..............................T..T....@@T...T@@@@@...@@@.....T......T...@@@@@@@@@@@
@@@@@@@@@@@@@@@@@...............................T.....@@.......@@@...@@@@@.T.......T...T@@@@@@@@@@@@
@@@@@@@@@@@@@@@@@@T........T.......T..T.............T@@....@@@..@...@@@@@@@T...........@@@@@@@@@@@@@
@@@@@@@@@@@@@@@@@@@.T................T......T.......@@....@@@@@....@@@@@@@@@......T...@@@@@@@@@@@@@@
@@@@@@@@@@@@@@@@@@@@..T....T.....................TT@@T.T.T@@@@......@@@@@@@.T...TT...@@@@@@@@@@@@@@@
@@@@@@@@@@@@@@@@@@@@@.........T.......T.......T...@@.T...@@@@........@@@@@.T.T......@@@@@@@@@@@@@@@@
@@@@@@@@@@@@@@@@@@@@.............................@@.....@@@@...T@.....@@@..T....T..@@@@@@@@@@@@@@@@@
@@@@@@@@@@@@@@@@@@@.T.TT............TT........T.@@.....@@@@.T..@@@.....T..........@@@@@@@@@@@@@@@@@@
@@@@@@@@@@@@@@@@@@....T......T..........T......@@.......@@....@@@@@.............T@@@@@@@@@@@@@@@@@@@
@@@@@@@@@@@@@@@@@.......T.T................@..@@.....@@......@@@@@@@T...T.......@@@@@@@@@@@@@@@@@@@@
@@@@@@@@@@@@@@@@@.......................T.@@@@@.....@@@@....@@@@@@@@@.........@@@@@@@@@@@@@@@@@@@@@@
@@@@@@@@@@@@@@@@@.................T.T..............@@@@.....@@@@@@@@.........@@@@@@@@@@@@@@@@@@@@@@@
@@@@@@@@@@@@@@@@@@......T....TT.....T..T..........@@@@...T...@@@@@@....T....@@@@@@@@@@@@@@@@@@@@@@@@
@@@@@@@@@@@@@@@@@@@T......T.......T..............@@@@...@@T...@@@@T........@@@@@@@@@@@@@@@@@@@@@@@@@
@@@@@@@@@@@@@@@@@@@@........T..............T....@@@@...@@@@.......T.......@@@@@@@@@@@@@@@@@@@@@@@@@@
@@@@@@@@@@@@@@@@@@@@@.....T....T......T.T.......T@@...@@@@@@.TT.........T@@@@@@@@@@@@@@@@@@@@@@@@@@@
@@@@@@@@@@@@@@@@@@@@@@...T....T................T....T@@@@@@@@...........@@@@@@@@@@@@@@@@@@@@@@@@@@@@
@@@@@@@@@@@@@@@@@@@@@@@T............T...............@@@@@@@@@.........T@@@@@@@@@@@@@@@@@@@@@@@@@@@@@
@@@@@@@@@@@@@@@@@@@@@@@@.T........................T..@@@@@@@......T...@@@@@@@@@@@@@@@@@@@@@@@@@@@@@@
@@@@@@@@@@@@@@@@@@@@@@@@@........@@@..................@@@@@T........T@@@@@@@@@@@@@@@@@@@@@@@@@@@@@@@
@@@@@@@@@@@@@@@@@@@@@@@@@@......@@@@@...T..T........T..@@@..........@@@@@@@@@@@@@@@@@@@@@@@@@@@@@@@@
@@@@@@@@@@@@@@@@@@@@@@@@@@@....@@@@@@@@..T..T.........T.....T.....T@@@@@@@@@@@@@@@@@@@@@@@@@@@@@@@@@
@@@@@@@@@@@@@@@@@@@@@@@@@@@@@@@@@@@@@@@@.........T....T......T..T.@@@@@@@@@@@@@@@@@@@@@@@@@@@@@@@@@@
@@@@@@@@@@@@@@@@@@@@@@@@@@@@@@@@@@@@@@@@@.....................T..@@@@@@@@@@@@@@@@@@@@@@@@@@@@@@@@@@@
@@@@@@@@@@@@@@@@@@@@@@@@@@@@@@@@@@@@@@@@@@T..........T....TT....@@@@@@@@@@@@@@@@@@@@@@@@@@@@@@@@@@@@
@@@@@@@@@@@@@@@@@@@@@@@@@@@@@@@@@@@@@@@@@@@.T..................@@@@@@@@@@@@@@@@@@@@@@@@@@@@@@@@@@@@@
@@@@@@@@@@@@@@@@@@@@@@@@@@@@@@@@@@@@@@@@@@@@................T.@@@@@@@@@@@@@@@@@@@@@@@@@@@@@@@@@@@@@@
@@@@@@@@@@@@@@@@@@@@@@@@@@@@@@@@@@@@@@@@@@@@@................@@@@@@@@@@@@@@@@@@@@@@@@@@@@@@@@@@@@@@@
@@@@@@@@@@@@@@@@@@@@@@@@@@@@@@@@@@@@@@@@@@@@@@@.T.....TT....@@@@@@@@@@@@@@@@@@@@@@@@@@@@@@@@@@@@@@@@
@@@@@@@@@@@@@@@@@@@@@@@@@@@@@@@@@@@@@@@@@@@@@@@@T..........@@@@@@@@@@@@@@@@@@@@@@@@@@@@@@@@@@@@@@@@@
@@@@@@@@@@@@@@@@@@@@@@@@@@@@@@@@@@@@@@@@@@@@@@@@@.T.......@@@@@@@@@@@@@@@@@@@@@@@@@@@@@@@@@@@@@@@@@@
@@@@@@@@@@@@@@@@@@@@@@@@@@@@@@@@@@@@@@@@@@@@@@@@@@....T..@@@@@@@@@@@@@@@@@@@@@@@@@@@@@@@@@@@@@@@@@@@
@@@@@@@@@@@@@@@@@@@@@@@@@@@@@@@@@@@@@@@@@@@@@@@@@@@.....@@@@@@@@@@@@@@@@@@@@@@@@@@@@@@@@@@@@@@@@@@@@
@@@@@@@@@@@@@@@@@@@@@@@@@@@@@@@@@@@@@@@@@@@@@@@@@@@@...@@@@@@@@@@@@@@@@@@@@@@@@@@@@@@@@@@@@@@@@@@@@@
@@@@@@@@@@@@@@@@@@@@@@@@@@@@@@@@@@@@@@@@@@@@@@@@@@@@@@@@@@@@@@@@@@@@@@@@@@@@@@@@@@@@@@@@@@@@@@@@@@@@
@@@@@@@@@@@@@@@@@@@@@@@@@@@@@@@@@@@@@@@@@@@@@@@@@@@@@@@@@@@@@@@@@@@@@@@@@@@@@@@@@@@@@@@@@@@@@@@@@@@@
@@@@@@@@@@@@@@@@@@@@@@@@@@@@@@@@@@@@@@@@@@@@@@@@@@@@@@@@@@@@@@@@@@@@@@@@@@@@@@@@@@@@@@@@@@@@@@@@@@@@
@@@@@@@@@@@@@@@@@@@@@@@@@@@@@@@@@@@@@@@@@@@@@@@@@@@@@@@@@@@@@@@@@@@@@@@@@@@@@@@@@@@@@@@@@@@@@@@@@@@@
@@@@@@@@@@@@@@@@@@@@@@@@@@@@@@@@@@@@@@@@@@@@@@@@@@@@@@@@@@@@@@@@@@@@@@@@@@@@@@@@@@@@@@@@@@@@@@@@@@@@
@@@@@@@@@@@@@@@@@@@@@@@@@@@@@@@@@@@@@@@@@@@@@@@@@@@@@@@@@@@@@@@@@@@@@@@@@@@@@@@@@@@@@@@@@@@@@@@@@@@@
@@@@@@@@@@@@@@@@@@@@@@@@@@@@@@@@@@@@@@@@@@@@@@@@@@@@@@@@@@@@@@@@@@@@@@@@@@@@@@@@@@@@@@@@@@@@@@@@@@@@
@@@@@@@@@@@@@@@@@@@@@@@@@@@@@@@@@@@@@@@@@@@@@@@@@@@@@@@@@@@@@@@@@@@@@@@@@@@@@@@@@@@@@@@@@@@@@@@@@@@@
@@@@@@@@@@@@@@@@@@@@@@@@@@@@@@@@@@@@@@@@@@@@@@@@@@@@@@@@@@@@@@@@@@@@@@@@@@@@@@@@@@@@@@@@@@@@@@@@@@@@
