type octile
height 54
width 52
map
@@@@@@@@@@@@@@@@@@@@@@@@@@@@@@@@@@@@@@@@@@@@@@@@@@@@
@@@@@@@@@@@@@@@@@@@@@@@@@@@@@@@@@@@@@@@@@@@@@@@@@@@@
@@@@@@@@@@@@@@@@@@@@@@@@@@@@@@@@@@@@@@@@@@@@@@@@@@@@
@@@@@@@@@@@@@@@@@@@@@@@@@@@@@@@@@@@@@@@@@@@@@@@@@@@@
@@@@@@@@@@@@@@@@@@@@@@@@@@@@@@@@@@@@@@@@@@@@@@@@@@@@
@@@@@@@@@@@@@@@@@@@@@@@@@@@@@@@@@@@@@@@@@@@@@@@@@@@@
@@@@@@@@@@@@@@@@@@@@@@@@@@@@@@@@@@@@@@@@@@@@@@@@@@@@
@@@@@@@@@@@@@@@@@@@@@@@@@@@@@@@@@@@@@@@@@@@@@@@@@@@@
@@@@@@@@@@@@@@@@@@@@@@@@@@@@@@@@@@@@@@@@@@@@@@@@@@@@
@@@@@@@@@@@@@@@@@@@@@@@@@@@@@@@@@@@@@@@@@@@@@@@@@@@@
@@@@@@@@@@@@@@@@@@@@@@@@@@@@@@@@@@@@@@@@@@@@@@@@@@@@
@@@@@@@@@@@@@@@@@@@@@@@@@@@@@@@@@@@@@@@@@@@@@@@@@@@@
@@@@@@@@@@@@@@@@@@@@@@@@@@@@@@@@@@@@@@@@@@@@@@@@@@@@
@@@@@@@@@@@@@@@@@@@@@@@@@@@@@.@@@@@@@@@@@@@@@@@@@@@@
@@@@@@@@@@@@@@@@@@@@@@@@@@@@..TTT@@@@@@@@@@@@@@@@@@@
@@@@@@@@@@@@@@@@@@@@@@@@@@@.T..T.T@@@@@@@@@@@@@@@@@@
@@@@@@@@@@@@@@@@@@@@@@@@@@TT.T..T.@@@@@@@@@@@@@@@@@@
@@@@@@@@@@@@@@@@@@@@@@@@@@.TTTTT.@@@@@@@@@@@@@@@@@@@
@@@@@@@@@@@@@@@@@@@@@@@@T......T@@@@@@@@@@@@@@@@@@@@
@@@@@@@@@@@@@@@@@@@@@@@@T..TTT.TT@@@@@@@@@@@@@@@@@@@
@@@@@@@@@@@@@@@@@@@@@@@TTTT.TT@@..@@@@@T@@@@@@@@@@@@
@@@@@@@@@@@@@@@@@@@@@@TTT.....@@T.T@@@.T.@@@@@@@@@@@
@@@@@@@@@@@@@@@@@@@@@@.TT..TT...TT@@@.T.TTT.@@@@@@@@
@@@@@@@@@@@@@@@@@@@@@@...T...T...@@@T..TTT.TT@@@@@@@
@@@@@@@@@@@@@@@@@@@@@.T....TT..TT.@@.TTT..T.T.@@@@@@
@@@@@@@@@@@@@@@@@@@@.TTT..TTT...TT.T.T.T.T..T.@@@@@@
@@@@@@@@@@@@@@@@@@@T..TT.T@@TTT..TTT...TT....@@@@@@@
@@@@@@@@@@@@@@@T@@..T...T@@@@.T.T.TTT..T.TTT@@@@@@@@
@@@@@@@@@@@@@@@TTTT.T.TT.TTTT....T.T...TT..@@@@@@@@@
@@@@@@@@@@@@.@T..TTTT@@@T@@@TT.TT..TT..T..@@@@@@@@@@
@@@@@@@@@@@@..T.T..T.@@@T@@@TT...T...TTTT@@@@@@@@@@@
@@@@@@@@@@@....TTTT.TT..TT@.T..T.TT.....@@@@@@@@@@@@
@@@@@@@@@T.T.TT.TTT.TT....T.@..T.T..TTT@@@@@@@@@@@@@
@@@@@@@@..TT..TT.TT..TT...@@@.T.T...T.@@@@@@@@@@@@@@
@@@@@@@....T...TT....TT.T.@@.T.TT.TTT@@@@@@@@@@@@@@@
@@@@@@.T....T@@....TTT..T...TTT.TTTT@@@@@@@@@@@@@@@@
@@@@@@@.....@@@..T.......T.T..T.TTT@@@@@@@@@@@@@@@@@
@@@@@@@@..T@@@@@...T..TT..T...TT.T@@@@@@@@@@@@@@@@@@
@@@@@@@@@T@@@@@@@TT.T..TT..TTTT.T@@@@@@@@@@@@@@@@@@@
@@@@@@@@@@@@@@@@@@T.T...TT...TTT@@@@@@@@@@@@@@@@@@@@
@@@@@@@@@@@@@@@@@@@.TTT.TT.T...@@@@@@@@@@@@@@@@@@@@@
@@@@@@@@@@@@@@@@@@@TTT.T...T.T@@@@@@@@@@@@@@@@@@@@@@
@@@@@@@@@@@@@@@@@@@TT.T...TTT@@@@@@@@@@@@@@@@@@@@@@@
@@@@@@@@@@@@@@@@@@T.T.TT..TT@@@@@@@@@@@@@@@@@@@@@@@@
@@@@@@@@@@@@@@@@@.TTTT..TT.@@@@@@@@@@@@@@@@@@@@@@@@@
@@@@@@@@@@@@@@@@T...T.T...@@@@@@@@@@@@@@@@@@@@@@@@@@
@@@@@@@@@@@@@@@@@.T...TT.@@@@@@@@@@@@@@@@@@@@@@@@@@@
@@@@@@@@@@@@@@@@@@T..TTT@@@@@@@@@@@@@@@@@@@@@@@@@@@@
@@@@@@@@@@@@@@@@@@@...T@@@@@@@@@@@@@@@@@@@@@@@@@@@@@
@@@@@@@@@@@@@@@@@@@@@@@@@@@@@@@@@@@@@@@@@@@@@@@@@@@@
@@@@@@@@@@@@@@@@@@@@@@@@@@@@@@@@@@@@@@@@@@@@@@@@@@@@
@@@@@@@@@@@@@@@@@@@@@@@@@@@@@@@@@@@@@@@@@@@@@@@@@@@@
@@@@@@@@@@@@@@@@@@@@@@@@@@@@@@@@@@@@@@@@@@@@@@@@@@@@
@@@@@@@@@@@@@@@@@@@@@@@@@@@@@@@@@@@@@@@@@@@@@@@@@@@@
