type octile
height 160
width 160
map
@@@@@@@@@@@@@@@@@@@@@@@@@@@@@@@@@@@@@@@@@@@@@@@@@@@@@@@@@@@@@@@@@@@@@@@@@@@@@@@@@@@@@@@@@@@@@@@@@@@@@@@@@@@@@@@@@@@@@@@@@@@@@@@@@@@@@@@@@@@@@@@@@@@@@@@@@@@@@@@@
@@@@@@@@@@@@@@@@@@@@@@@@@@@@@@@@@@@@@@@@@@@@@@@@@@@@@@@@@@@@@@@@@@@@@@@@@@@@@@@@@@@@@@@@@@@@@@@@@@@@@@@@@@@@@@@@@@@@@@@@@@@@@@@@@@@@@@@@@@@@@@@@@@@@@@@@@@@@@@@@
@@@@@@@@@@@@@@@@@@@@@@@@@@@@@@@@@@@@@@@@@@@@@@@@@@@@@@@@@@@@@@@@@@@@@@@@@@@@@@@@@@@@@@@@@@@@@@@@@@@@@@@@@@@@@@@@@@@@@@@@@@@@@@@@@@@@@@@@@@@@@@@@@@@@@@@@@@@@@@@@
@@@@@@@@@@@@@@@@@@@@@@@@@@@@@@@@@@@@@@@@@@@@@@@@@@@@@@@@@@@@@@@@@@@@@@@@@@@@@@@@@@@@@@@@@@@@@@@@@@@@@@@@@@@@@@@@@@@@@@@@@@@@@@@@@@@@@@@@@@@@@@@@@@@@@@@@@@@@@@@@
@@@@@@@@@@@@@@@@@@@@@@@@@@@@@@@@@@@@@@@@@@@@@@@@@@@@@@@@@@@@@@@@@@@@@@@@@@@@@@@@@@@@@@@@@@@@@@@@@@@@@@@@@@@@@@@@@@@@@@@@@@@@@@@@@@@@@@@@@@@@@@@@@@@@@@@@@@@@@@@@
@@@@@@@@@@@@@@@@@@@@@@@@@@@@@@@@@@@@@@@@@@@@@@@@@@@@@@@@@@@@@@@@@@@@@@@@@@@@@@@@@@@@@@@@@@@@@@@@@@@@@@@@@@@@@@@@@@@@@@@@@@@@@@@@@@@@@@@@@@@@@@@@@@@@@@@@@@@@@@@@
@@@@@@@@@@@@@@@@@@@@@@@@@@@@@@@@@@@@@@@@@@@@@@@@@@@@@@@@@@@@@@@@@@@@@@@@@@@@@@@@@@@@@@@@@@@@@@@@@@@@@@@@@@@@@@@@@@@@@@@@@@@@@@@@@@@@@@@@@@@@@@@@@@@@@@@@@@@@@@@@
@@@@@@@@@@@@@@@@@@@@@@@@@@@@@@@@@@@@@@@@@@@@@@@@@@@@@@@@@@@@@@@@@@@@@@@@@@@@@@@@@@@@@@@@@@@@@@@@@@@@@@@@@@@@@@@@@@@@@@@@@@@@@@@@@@@@@@@@@@@@@@@@@@@@@@@@@@@@@@@@
@@@@@@@@@@@@@@@@@@@@@@@@@@@@@@@@@@@@@@@@@@@@@@@@@@@@@@@@@@@@@@@@@@@@@@@@@@@@@@@@@@@@@@@@@@@@@@@@@@@@@@@@@@@@@@@@@@@@@@@@@@@@@@@@@@@@@@@@@@@@@@@@@@@@@@@@@@@@@@@@
@@@@@@@@@@@@@@@@@@@@@@@@@@@@@@@@@@@@@@@@@@@@@@@@@@@@@@@@@@@@@@@@@@@@@@@@@@@@@@@@@@@@@@@@@@@@@@@@@@@@@@@@@@@@@@@@@@@@@@@@@@@@@@@@@@@@@@@@@@@@@@@@@@@@@@@@@@@@@@@@
@@@@@@@@@@@@@@@@@@@@@@@@@@@@@@@@@@@@@@@@@@@@@@@@@@@@@@@@@@@@@@@@@@@@@@@@@@@@@@@@@@@@@@@@@@@@@@@@@@@@@@@@@@@@@@@@@@@@@@@@@@@@@@@@@@@@@@@@@@@@@@@@@@@@@@@@@@@@@@@@
@@@@@@@@@@@@@@@@@@@@@@@@@@@@@@@@@@@@@@@@@@@@@@@@@@@@@@@@@@@@@@@@@@@@@@@@@@@@@@@@@@@@@@@@@@@@@@@@@@@@@@@@@@@@@@@@@@@@@@@@@@@@@@@@@@@@@@@@@@@@@@@@@@@@@@@@@@@@@@@@
@@@@@@@@@@@@@@@@@@@@@@@@@@@@@@@@@@@@@@@@@@@@@@@@@@@@@@@@@@@@@@@@@@@@@@@@@@@@@@@@@@@@@@@@@@@@@@@@@@@@@@@@@@@@@@@@@@@@@@@@@@@@@@@@@@@@@@@@@@@@@@@@@@@@@@@@@@@@@@@@
@@@@@@@@@@@@@@@@@@@@@@@@@@@@@@@@@@@@@@@@@@@@@@@@@@@@@@@@@@@@@@@@@@@@@@@@@@@@@@@@@@@@@@@@@@@@@@@@@@@@@@@@@@@@@@@@@@@@@@@@@@@@@@@@@@@@@@@@@@@@@@@@@@@@@@@@@@@@@@@@
@@@@@@@@@@@@@@@@@@@@@@@@@@@@@@@@@@@@@@@@@@@@@@@@@@@@@@@@@@@@@@@@@@@@@@@@@@@@@@@@@@@@@@@@@@@@@@@@@@@@@@@@@@@@@@@@@@@@@@@@@@@@@@@@@@@@@@@@@@@@@@@@@@@@@@@@@@@@@@@@
@@@@@@@@@@@@@@@@@@@@@@@@@@@@@@@@@@@@@@@@@@@@@@@@@@@@@@@@@@@@@@@@@@@@@@@@@@@@@@@@@@@@@@@@@@@@@@@@@@@@@@@@@@@@@@@@@@@@@@@@@@@@@@@@@@@@@@@@@@@@@@@@@@@@@@@@@@@@@@@@
@@@@@@@@@@@@@@@@@@@@@@@@@@@@@@@@@@@@@@@@@@@@@@@@@@@@@@@@@@@@@@@@@@@@@@@@@@@@@@@@@@@@@@@@@@@@@@@@@@@@@@@@@@@@@@@@@@@@@@@@@@@@@@@@@@@@@@@@@@@@@@@@@@@@@@@@@@@@@@@@
@@@@@@@@@@@@@@@@@@@@@@@@@@@@@@@@@@@@@@@@@@@@@@@@@@@@@@@@@@@@@@@@@@@@@@@@@@@@@@@@@@@@@@@@@@@@@@@@@@@@@@@@@@@@@@@@@@@@@@@@@@@@@@@@@@@@@@@@@@@@@@@@@@@@@@@@@@@@@@@@
@@@@@@@@@@@@@@@@@@@@@@@@@@@@@@@@@@@@@@@@@@@@@@@@@@@@@@@@@@@@@@@@@@@@@@@@@@@@@@@@@@@@@@@@@@@@@@@@@@@@@@@@@@@@@@@@@@@@@@@@@@@@@@@@@@@@@@@@@@@@@@@@@@@@@@@@@@@@@@@@
@@@@@@@@@@@@@@@@@@@@@@@@@@@@@@@@@@@@@@@@@@@@@@@@@@@@@@@@@@@@@@@@@@@@@@@@@@@@@@@@@@@@@@@@@@@@@@@@@@@@@T@.@@@@@@@@@@@@@@@@@@@@@@@@@@@@@@@@@@@@@@@@@@@@@@@@@@@@@@@@
@@@@@@@@@@@@@@@@@@@@@@@@@@@@@@@@@@@@@@@@@@@@@@@@@@@@@@@@@@@@@@@@@@@@@@@@@@@@@@@@@@@@@@@@@@@@@@@@@@@@....@@@@@@@@@@@@@@@@@@@@@@@@@@@@@@@@@@@@@@@@@@@@@@@@@@@@@@@@
@@@@@@@@@@@@@@@@@@@@@@@@@@@@@@@@@@@@@@@@@@@@@@@@@@@@@@@@@@@@@@@@@@@@@@@@@@@@@@@@@@@@@@@@@@@@@@@TT@@T.TT.@@@@@@@@@@@@@@@@@@@@@@@@@@@@@@@@@@@@@@@@@@@@@@@@@@@@@@@@
@@@@@@@@@@@@@@@@@@@@@@@@@@@@@@@@@@@@@@@@@@@@@@@@@@@@@@@@@@@@@@@@@@@@@@@@@@@@@@@@@@@@@@@@@@...@@..T..TT.T@@@@@@@@@@@@@@@@@@@@@@@@@@@@@@@@@@@@@@@@@@@@@@@@@@@@@@@@
@@@@@@@@@@@@@@@@@@@@@@@@@@@@@@@@@@@@@@@@@@@@@@@@@@@@@@@@@@@@@@@@@@@@@@@@@@@@@@@@@.@@@@@@@TT..T..T.TTT....@@@@@@@@@@@@@@@@@@@@@@@@@@@@@@@@@@@@@@@@@@@@@@@@@@@@@@@
@@@@@@@@@@@@@@@@@@@@@@@@@@@@@@@@@@@@@@@@@@@@@@@@@@@@@@@@@@@@@@@@@@@@@@@@@@@@@@@@T.@@@@@@.T..TTT.T.T.T.....@@@@@@@@@@@@@@@@@@@@@@@@@@@@@@@@@@@@@@@@@@@@@@@@@@@@@@
@@@@@@@@@@@@@@@@@@@@@@@@@@@@@@@@@@@@@@@@@@@@@@@@@@@@@@@@@@@@@@@@@@@@@@@@@@@@@@@.T...@@@T..TTT...T.TTTT.TT.@@@@@@@@@@@@@@@@@@@@@@@@@@@@@@@@@@@@@@@@@@@@@@@@@@@@@@
@@@@@@@@@@@@@@@@@@@@@@@@@@@@@@@@@@@@@@@@@@@@@@@@@@@@@@@@@@@@@@@@@@@@@@@@@@@@@@...T.T...T..TTTT..TTT.T.TTT.T.@@@@@@@@@@@@@@@@@@@@@@@@@@@@@@@@@@@@@@@@@@@@@@@@@@@@
@@@@@@@@@@@@@@@@@@@@@@@@@@@@@@@@@@@@@@@@@@@@@@@@@@@@@@@@@@@@@@@@@@@@@@@@@@@@@@@.T@@@...TTT..TT..@@@TTTTT.T.T.@@@@@@@@@@@@@@@@@@@@@@@@@@@@@@@@@@@@@@@@@@@@@@@@@@@
@@@@@@@@@@@@@@@@@@@@@@@@@@@@@@@@@@@@@@@@@@@@@@@@@@@@@@@@@@@@@@@@@@@@@@@@@@@@@@@@T.@@@...T..TTTT@@@@..T.T...T@@@@@@@@@@@@@@@@@@@@@@@@@@@@@@@@@@@@@@@@@@@@@@@@@@@@
@@@@@@@@@@@@@@@@@@@@@@@@@@@@@@@@@@@@@@@@@@@@@@@@@@@@@@@@@@@@@@@@@@@@@@@@@@@@@@@@@T@@@T...TTTTT@@@@@@.....T..@@@@@@@@@@@@@@@@@@@@@@@@@@@@@@@@@@@@@@@@@@@@@@@@@@@@
@@@@@@@@@@@@@@@@@@@@@@@@@@@@@@@@@@@@@@@@@@@@@@@@@@@@@@@@@@@@@@@@@@@@@@@@@@@@@@@@@TTT..TTT..TT@@@@@@@TTTT.T.T@@@@@@@@@@@@@@@@@@@@@@@@@@@@@@@@@@@@@@@@@@@@@@@@@@@@
@@@@@@@@@@@@@@@@@@@@@@@@@@@@@@@@@@@@@@@@@@@@@@@@@@@@@@@@@@@@@@@@@@@@@@@@@@@@@@@@@TT@@..TTTTT@@@@@@@@TT.....@@@@@@@@@@@@@@@@T@@@@@@@@@@@@@@@@@@@@@@@@@@@@@@@@@@@@
@@@@@@@@@@@@@@@@@@@@@@@@@@@@@@@@@@@@@@@@@@@@@@@@@@@@@@@@@@@@@@@@@@@@@@@@@@@@@@@@@@@@@TTT..T.@@@@@@@@@TTT..@@@@@@@@@@@@@@@@@TT@@@@@@@@@@@@@@@@@@@@@@@@@@@@@@@@@@@
@@@@@@@@@@@@@@@@@@@@@@@@@@@@@@@@@@@@@@@@@@@@@@@@@@@@@@@@@@@@@@@@@@@@@@@@@@@@@@@@@@@@@TT.T.TT@@@@@@@@T.TT..@@@@@@@@@@@@@@@@@T.@@@@@@@@@@@@@@@@@@@@@@@@@@@@@@@@@@@
@@@@@@@@@@@@@@@@@@@@@@@@@@@@@@@@@@@@@@@@@@@@@@@@@@@@@@@@@@@@@@@@@@@@@@@@@@@@@@@@@@@.T.TT.TTT@@@@@@T...TTT@@@@@@@@@@@@@@@@@@T.@@@@@@@@@@@@@@@@@@@@@@@@@@@@@@@@@@@
@@@@@@@@@@@@@@@@@@@@@@@@@@@@@@@@@@@@@@@@@@@@@@@@@@@@@@@@@@@@@@@@@@@@@@@@@@@@@@@TT@TTT.TTTT..T@@@..TT.TTTT@@@@@@@@@@@@@@@@T..T@@@@@@@@@@@@@@@@@@@@@@@@@@@@@@@@@@@
@@@@@@@@@@@@@@@@@@@@@@@@@@@@@@@@@@@@@@@@@@@@@@@@@@@@@@@@@@@@@@@@@@@@@@@@@@@@@@@T.TT..TTT.TT...T....TT.T.TT@@@@@@@@@@@@@@.TTT@@@@@@@@@@@@@@@@@@@@@@@@@@@@@@@@@@@@
@@@@@@@@@@@@@@@@@@@@@@@@@@@@@@@@@@@@@@@@@@@@@@@@@@@@@@@@@@@@@@@@@@@@@@@@@@@@@@@TTTTTT.TT....TT..TTT...TTTTT@@@@@@@@@@@@TT...@@@@@@@@@@@@@@@@@@@@@@@@@@@@@@@@@@@@
@@@@@@@@@@@@@@@@@@@@@@@@@@@@@@@@@@@@@@@@@@@@@@@@@@@@@@@.TTTT.TT...@@@@@@@@@@@@@@T.T.T...T.....T.T..TTT.T..T.@@@@@@@@@@.TT..T@@@@@@@@@@@@@@@@@@@@@@@@@@@@@@@@@@@@
@@@@@@@@@@@@@@@@@@@@@@@@@@@@@@@@@@@@@@@@@@@@@@@@@@@@T.T..T.TT....T...@@@@@@@@@@@@.TTTT.T.T.TTT......TT.T.T.@@@@@@@@@@.T..TTT.@@@@@@@@@@@@@@@@@@@@@@@@@@@@@@@@@@@
@@@@@@@@@@@@@@@@@@@@@@@@@@@@@@@@@@@@@@@@@@@@@@@@@@@TTT.T..TTT.....T.....@@@@@@@@@@@TTT....T..TT.TT.TT..T..@@@@@@@@@@@TT..TTTT.T@@@@@@@@@@@@@@@@@@@@@@@@@@@@@@@@@
@@@@@@@@@@@@@@@@@@@@@@@@@@@@@@@@@@@@@@@@@@@@@@@@@@.T.....T@@..T...T.TT.@@@.@@@@@@@@TT.TTTTT.TT...T...TTTT@@@@@@@@@@@...T.T..T.T.@@@@@@@@@@@@@@@@@@@@@@@@@@@@@@@@
@@@@@@@@@@@@@@@@@@@@@@@@@@@@@@@@@@@@@@@@@@@@@@@@@TT.T.T.T@@@..T...T.TT..TT...@@@@@@T..T.T.TTTT...T.TT...@@@@@@@@@@@..TT...T....@@@@@@@@@@@@@@@@@@@@@@@@@@@@@@@@@
@@@@@@@@@@@@@@@@@@@@@@@@@@@@@@@@@@@@@@@@@@@@@@@@..TT.T.T@@@TTTT.T.T.T......TTT.@@@@.T..TTT.TT.T..T...T.@@@@@@@@@@@....TTT.TT..@@@@@@@@@@@@@@@@@@@@@@@@@@@@@@@@@@
@@@@@@@@@@@@@@@@@@@@@@@@@@@@@@@@@@@@@@@@@@@@@@@T......T@@@TT..T.TT.T..TTTT.TT...@@..@@....T.T..TTT.TT@@@@@@@TT.@@.TTTT..T..T@@@@@@@@@@@@@@@@@@@@@@@@@@@@@@@@@@@@
@@@@@@@@@@@@@@@@@@@@@@@@@@@@@@@@@@@@@@@@@@@@@@T.TTT.T.@@.T..TT...T.........TTTT.TT.T@@@..T..TT.....T@@@@@@@..T.T.TTTT.TTT..@@@@@@@@@@@@@@@@@@@@@@@@@@@@@@@@@@@@@
@@@@@@@@@@@@@@@@@@@@@@@@@@@@@@@@@@@@@@@@@@@@@..T.T.T.@@.T..T.T...TT..TT.T.TTTT.TTTT@@@@@T.T...TTTTT@@@@@@@....TT.TT...TTT.@@@@@@@@@.@@@@@@@@@@@@@@@@@@@@@@@@@@@@
@@@@@@@@@@@@@@@@@@@@@@@@@@@@@@@@@@@@@@@@@@@@@@TT.TT.@@T..TT....T...T..T..TTT...T.TT@@@@@.TTTT..T.T@@@@@@@@T.T.T...TT.TT..@@@@@@@@.T.T.@@@@@@@@@@@@@@@@@@@@@@@@@@
@@@@@@@@@@@@@@@@@@@@@@@@@@@@@@@@@@@@@@@@@@@@@@@.T..@@T.T.TT.TT@@@@..TTT....T.T..T.TT.@@@@......T.@@@@@@@@..T.T.T...T.TT.@@@@@@@@.T.TT..@@@@@@@@@@@@@@@@@@@@@@@@@
@@@@@@@@@@@@@@@@@@@@@@@@@@@@@@@@@@@@@@@@@@@@@@@@..@@TTTTT..TT.@@@@T..TTT..T...TTT.T..@@@@TT..TTT.@@@@@@@T.TT..TT.T..TT.@@@@@@@@@T.T...@@@@@@@@@@@@@@@@@@@@@@@@@@
@@@@@@@@@@@@@@@@@@@@@@@@@@@@@@@@@@@@@@@@@@@@@@@@@@@T..T....TTTT..TTTT.T..T..T.TTT.T.@@@@@@T.....T@@@@.T.T.TTTT.TTT..T.@@@@@@@@@TT.TT..@@@@@@@@@@@@@@@@@@@@@@@@@@
@@@@@@@@@@@@@@@@@@@@@@@@@@@@@@@@@@@@@@@@@@@@@@@@@@TT...TT.T.TTTTTT.T.TT.TT...TTTTTT.@@@@@@@...@.T@@@@....TTT...TTTTTT@@@@@@@@@.TTT.T@@@@@@@@@@@@@@@@@@@@@@@@@@@@
@@@@@@@@@@@@@@@@@@@@@@@@@@@@@@@@@@@@@@@@@@@@@@@@@TT.TTTT..TTTTTTTT.TTTTTTTT.TTTT.TT.T.T@@@@TT@@.T.@T..T...TT......T.@@@@@@@@.T.TTTTT@@@@@@@@@@@@@@@@@@@@@@@@@@@@
@@@@@@@@@@@@@@@@@@@@@@@@@@@@@@@@@@@@@@@@@@@@@@@@T.T....TT.T..TTT.TTT..T..TT..TTT...T...@@@@@@@@.T.@T.T.T..T...TT.TT@@@@@@@@T...TTT.@@@@@@@@@@@@@@@@@@@@@@@@@@@@@
@@@@@@@@@@@@@@@@@@@@@@@@@@@@@@@@@@@@@@@@@@@@@@@TT.TT..TTTTT.TT.T..TT....TTTT.TT.T..TTTTT@@@@@@@...T....TT..T.TT..T@@@@@@@@@.TTT...@@@@@@@@@@T@@@@@@@@@@@@@@@@@@@
@@@@@@@@@@@@@@@@@@@@@@@@@@@@@@@@@@@@.@@@@@@@@@..TTT.T.T...T....TTTT.T..T.TTT.TT...T.TTT.T@@@@@@@.TT.TTTTT...TTTTT@@@@@@@.TTTTT.TT@@@@@@@@@@...@@@@@@@@@@@@@@@@@@
@@@@@@@@@@@@@@@@@@@@@@@@@@@@@@@@@@@TTT@@@@@@@T.T.TTTT...T..T.TT.....T...T....T...T.T.TT..@@@@@@@.T....T.TTT.T..T@@@@@@.T...T.T.T.T@@@@@@@@.TTT@@@@@@@@@@@@@@@@@@
@@@@@@@@@@@@@@@@@@@@@@@@@@@@@@@@@@T.TTT@@@@@.TTTTTT..TT..TT..T.....TT..TTTT..T..T.TTT.TT..@@@@@@T..TT.TTT..T..T@@@@@@@T.@T.TT....T.@@@@@@.T..T@@@@@@@@@@@@@@@@@@
@@@@@@@@@@@@@@@@@@@@@@@@@@@@@@@@@TT.T.T@@@.TTTT...TT....T....TT.TT....T..TTT.....T.T.TTTTT@@@@@T.TT.TT.TTT.TTT@@@@@@@..@@T.T.TT..T..@@@@........@@@@@@@@@@@@@@@@
@@@@@@@@@@@@@@@@@@@@@@@@@@@@@@@@.T.T..@@@...T.TTT...TTTT.TTT.T..T.....T.T.TT..TTTTTT....TT.@@@@@TT...TTT.T.TT@@@@@@@T.TT@@...T.TT..T.@@.........@@@@@@@@@@@@@@@@
@@@@@@@@@@@@@@@@@@@@@@@@@@@@@@@@.T.TT@@@T.T....TTT....TTTT.TTT..TT.T.TTTTT...TTT.TT....T.T.@@@@@@T.TTTTT..T.@@@@@@@.T...@@..T.T....TTTT..T.T.TT.T@@@@@@@@@@@@@@@
@@@@@@@@@@@@@@@@@@@@@@@@@@@@@@@T..T.@@@.TT.T...TTTT..T..TTTT.T.TTT..TTTTT.TTT.@@@.TTTTT.TTTT@@@@@@..T.TTTT.@@@@@@@TTTTT.@@T.T..TTTT.T.T.TT..T.T.T.@@@@@@@@@@@@@@
@@@@@@@@@@@@@@@@@@@@@@@@@@@@@@@TT.@@@@.T...TTTTT.T.T..TT....TTT.....T.TT.TTTTT@@@T.T.TT..TTT@@@@@@@.TT.TT.@@@@@@@TT.T...@@@TTTTTTTTTT.T.T..T.T.T.T.@@@@@@@@@@@@@
@@@@@@@@@@@@@@@@@@@@@@@@@@@@@@@T.T.@@TTTT.T...TT.TT....TT..T.T.T.TTT.T.T..T.T....T...T.TTTT.@@@@@@@@...TT@@@@@@@.TT.TT..T@@T....TTTT.TT....T@.TT...T@@@@@@@@@@@@
@@@@@@@@@@@@@@@@@@@@@@@@@@@@@@@TTTT...TT...TT..TTTT.T..T..TT.TT.TTTTT.TT.TTT..TT..T.TT......@@@@@@@@@TT..@@@@@@TT.T.T.TT..T.TT.TTT..T.T.@@T@@@.T.....@@@@@@@@@@@
@@@@@@@@@@@@@@@@@@@@@@@@@@@@@@@.TTTTT.TTT....TT.T...T.TT..T..T...TT....T..TTTT...T....TT..TT.TT@@@@@@@T.T.@@.T..T.T..TT...TT.T.T..T.TTT@@@@@@@@T.T.TT.T@@@@@@@@@
@@@@@@@@@@@@@@@@@@@@@@@@@@@@@@@.TT..T..T...T....T.T.T..T...TTTTT.T...T..TTTT.TT....TT.T.T.TTTT.@@@@@@@@.T.T.TTT..TT..T..T.TT.TTTT.T.T..@@@@@@@@@TTTTTT.TTT@@@@@@
@@@@@@@@@@@@@@@@@@@@@@@@@@@@@@@...T.......TTT.TT...T...TTT..TT..T...TT.T....T.........TTTT..TT..@@@@@@@@TTTT.T.TTTTT...TTTT...TT.T.T...T@@@@@@@@T.T..T.TT..@@@@@
@@@@@@@@@@@@@@@@@@@@@@@@@@@@@@@..T.TTTTT.TT.T.T.TT.TTTT.TTTT.T........T..TT.T.TTT..T.....T..T..TT@@@@@@@@.T.TTT.TTT.T.T..TT..T..T.T..TTT.@@@@@@..TTT.T...T..@@@@
@@@@@@@@@@@@@@@@@@@@@@@@@@@@@@@..T..T.TTT@@@TT..TT.TTT...TTTT..TT..TTT..TTT..TT....TTT..TT....TT.T@@@@@@@@.TTTT.TT...@@........T...TTT.TT.@@@@T.T.T...TTT.TTT@@@
@@@@@@@@@@@@@@@@@@@@@@@@@@@@@@@.T.T....T.@@@T.T.T.T..T.T..TTT.T..TTT..TT.T.TT..T.T...TTTT..TT.....T@@@@@@@@..TTTTT@@@@@.T..TTTT.TT......TTT@@.TT..T.TTT.T....@@@
@@@@@@@@@@@@@@@@@@@@@@@@@@@@@@@T...T.T..TT@.TT..T....TT.TTTT.TT..T...TTT.T.TTTT.TTTTTTTT.T....T.T..T@@@@@@@@T.T.TT@@@@TTT..TT.TTT@T....T.T.....TTTT.T.TTT..T.@@@
@@@@@@@@@@@@@@@@@@@@@@@@@@@@@@@TT..T.TTT.TT.TTT..TTTT..TT..TT....TTTTTT..TTT.T..TT.TT.TTT.TT.T.T....T@@@@@@@..TT.@@@@@...TT..TTT@@@@...T..T.TTT..TTT.TTTTTTT@@@@
@@@@@@@@@@@@@@@@@@@@@@@@@@@@@@@.TTT..TT...TTTTTT.....TTTT.....T..T....T.T...T.....TT.TTTTT..T.T.TTT.T.@@@@@@@T....@@@...T.TTT..T@@@@@...T..T.TT.T.T..TTTT.T@@@@@
@@@@@@@@@@@@@@@@@@@@@@@@@@@@@@@@..T...T....T....T.T.T..T.TT.T.TT.TTTTTTTT.T..TTT.TT@@.T.T.T..T..TTT.T..@@@@@@@TT.T@@@...T..TTT.T@@@@@@TTT...T.T.T.TT.T..T.@@@@@@
@@@@@@@@@@@@@@@@@@@@@@@@@@@@@@@@.T..T.TT.TTTT.TTTTT..T...TTT.TT.....TTTT....TT....@@@@T..T....TT......T.@@@@@@@.T.....T...T.TTT@@@@@@@@....T..T..T.T.TTTT@@@@@@@
@@@@@@@@@@@@@@@@@@@@@@@@@@T@@@@@@TTT.T.TTT....TT..T.T.T.TTTT.T.....TT.T.TTTTT.TT@@@@@.T.T.....T..TT.T.T..@@@@@@@@TTT.......T.T@@@@@@@@@@T.T.TT....TT.T.T@@@@@@@@
@@@@@@@@@@@@@@@@@@@@@@@@@TTT@@@@@TTT...T..T.TTTTT..T.T.T..T...T.T...TT.T.TT.TT.@@@@.T.TTT..TT.TT.T.T....T.@@@@@@@@.TTTT....T@.@@@@@@@@@@@T...TT.......T@@@@@@@@@
@@@@@@@@@@@@@@@@@@@@@@@@TT@@@@@@@@TT.T....TT..T.T.TTTTTTT.....T....T..T....T.T@@@TT.T..TTT.TT...T....TT..TT@@@@@@@@..TTTTT.@@@@@@@@@@@@@@@TTTTTT..TTT.@@@@@@@@@@
@@@@@@@@@@@@@@@@@@@@@@@@..@@@@@@@@..TTT.....T.T..TTTT.TT..T...T.T.....T....T..@@T..T..T@@.T.T.T.TT..TTT.T.T.@@@@@@@@TTT..TT@@@@@@@@@@@@@@@..TTT..T..T@@@@@@@@@@@
@@@@@@@@@@@@@@@@@@@@@@@TT...T@@@@@@...T..T.TTTT...T....TT.TTT.T..TTTT.T..T.TT....T.T..@@@@T...TTTTTT......T...@@@@@@@TTTT..T@@@@@@@@@@T@@TT...TT...T@@@@@@@@@@@@
@@@@@@@@@@@@@@@@@@@@@@TT..T..T@@@@@@TT.T.TTT.TTTT.T.T..T...T.TTTT.TT.T...T@.T.T.TT.@@@@@@@.TTTTT.T..T....T.T.TT@@@@@@@.T..T.T@@@@@@@@TT...TT..T....@@@@@@@@@@@@@
@@@@@@@@@@@@@@@@@@@@@@@TT.T....@@@@@@T..T...TT..TT.TTT@@@T.TT.TT.TT......@@@...TTT@@@@@.@T...T....T.T..TTTT..TTT@@@@@@@..T.T.T@@@@@TT....T.T.T....@@@@@@@@@@@@@@
@@@@@@@@@@@@@@@@@@@@@@@@T...T.TT@@@@@..T.TTTTT.TT...TT@@@TT.TT...T.TT.T..@@@TT...T.@@@TTT.T.TT.TTT..T.....T..TT..@@@@@@@..T.TT.@@@..T.T.T...T.TTT@@@@@@@@@@@@@@@
@@@@@@@@@@@@@@@@@@@@@@@@@TT...TT.@@@@@T.TT..T.TTT..TT.T....T.TTT.TTTT@@.@@@TT.T..TT.@.TTTT..T.T.TT..T.T.TTTT..T..T@@@@@@@.TTT..T@..T.T......T.T.@@@@@@@@@@@@@@@@
@@@@@@@@@@@@@@@@@@@@@@@@@T...T..TT@@@@T..T.T.....T.TT.T...TTT.T.T.T.@@@@@@@TTTTTT.T..TTTT..TTT...TTT@TT...TT.T.TT.T@@@@@@@TTTT.T.TT.T.TT....T.T@@@@@@@@@@@@@@@@@
@@@@@@@@@@@@@@@@@@.@@@@@@TT....TTTT@@.TT.@.T.T.T.TT.....TT.TT.T.TTTT..@@@@...TT@@...TT.TTT..TTTTT@@@@@@@@TT....TT..T@@@@@@TT......TT.TTTTT..TT@@@@@@@@@@@@@@@@@@
@@@@@@@@@@@@@@@@@.TT@@@@@.T..TTTTTT@.TTT@@@...T..T....TT.TT.T.TT..T..TT@@@..T.@@@.T.T.T..T.....T.@@@@@@@@@.T.TT....TT@@@@@T.TTTT..T..T..TTT..@@@@@@@@@@@@@@@@@@@
@@@@@@@@@@@@@@@@...TT@@.T.TT.TTT.T.T.T.@@@@@..T.TTT..T.T.TTTTT....T..TTTTTT..@@@TTT.TTT..T.T.T.TT@@@@@@@@@.TTT.TTTTT..@@@T.@@..TT.T.TTT.TTT.@@@@@@@@@@@@@@@@@@@@
@@@@@@@@@@@@@@@.T.TTTTT.TTTT..TTT.TTTT@@@@@@@@.T..TTTT..T.TT..T..T..T.T.T..T@@@.T..TTT..TT..TT...@@@@@@@@@..TTTT.TTTT.T@..TT@@.T..T.TT...T.@@@@@@@@@@@@@@@@@@@@@
@@@@@@@@@@@@@@....TTT..TTTTTT.TTT.T...T@@@@@@@@T..TT.T......T...T.TT.TT...T@@@@...TT.T..TTTT..TT@@@@@@@@@T.TT..T.TT.TT.T.TT@@@@TTT.T.TT.TT@@@@@@@@@@@@@@@@@@@@@@
@@@@@@@@@@@@@@T.TTTT.T.TT.T@.T.TTTT...TT@@@@@@@@@@TTTTTT..T.TT.TT.T..T.T...@@@.TTTTTTT.....T..T.@@@@@@@TT......TTT.TT.T.T.@@@@@@.T..T.TT.@@@@@@@@@@@@@@@@@@@@@@@
@@@@@@@@@@@@@@@.....TT.T@@@@@T.T.TTT.T.T..@@@@@@@@@@T..TTT.TTT.TT....TT.T.T@@TTTT.....TTTTTTTT..T@@@@@T.T..TTTT.....T.TTT.@@@@@@@TT...TT@@@@@@@@@@@@@@@@@@@@@@@@
@@@@@@@T@@@@@@@.TTT.T...@@@@@@....T...T..T.@@@@@@@@@@@..T......T....T..TT.T.TTT.T...T....T.T..T..@@@@TT@@T..TT...T..TT.TTT.@@@@@@@TTTT.@@@@@@@@@@@@@@@@@@@@@@@@@
@@@@@@.T.@@@@@@@...TTT@@@@@@@@@..T.TT.T.T.TT@@@@@@@@@@@@TTTT.T.TTT..TT.TTTTT..TT..T....T..T.TT...@@@TT.T..TTTT.T.........TT.@@@@@@@@..@@@@@@@@@@@@@@@@@@@@@@@@@@
@@@@@.TT.T@@@@@@.T..TT@@@@@@@@@TT..T..TTTT.T..@@@@@@@@@@@@.T...TT.....TT..TTT...TTTTT..T.....TT.T.TTTT.T.TTT.TTTTTTTTT......T@@@@@@@@@@@@@@@@@@@@@@@@@@@@@@@@@@@
@@@@TT..T.T@@@@.T.TT.@@@@@@@@@@TT.T.@@.T....T.T.@@@@@@@@@@@..T..TTTTT....T...TTT.T.TT.TTTT...T...T..TTT...T.T...T..........T.T@@@@@@@@@@@@@@@@@@@@@@@@@@@@@@@@@@
@@@..TTTTTT.....TT..@@@@@@@@@@..T..@@@@..TTTT.T.T@@.@@@@@@@@@.TT....T..T.T.TTT.TT.T.....T..T......TTT.T......TTT..T...TTT.T....@@@@@@@@@@@@@@@@@@@@@@@@@@@@@@@@@
@@@T....T...TTTTT..T.T@@@@@@@.TTT.@@@@@@.T.T@@@..@@TTT@@@@@@@@......TT.TT.TTTTT..T..TTT.@@.TT..TTTTTTT....T.T.TT..T.T.T..TT...T.T@@@@@@@@@@@@@@@@@@@@@@@@@@@@@@@
@@@.T.T.T.T..TTTT.T.T@@@@@@@..TTT.@@@@@@@..@@@@T..@.T.T.@@@@@@@TT.T.....T.T.TT.T......T@@@.T.T..TT..TTTT.TT.T..TT.T.T.T.T.TTT...@@@@@@@@@@@@@@@@@@@@@@@@@@@@@@@@
@@@....TTT.TT...TT.T.@@@@@@..T..T.T@@@@@@@@@@@@@.TT.TTT...@@@@@@TTTTT.TT..TT.TT...TT..@@@@T.TT...TT.T.T.TT..T..TT.TTTT.T....TTT@@@@@@@@@@@@@@@@@@@@@@@@@@@@@@@@@
@@@....TT....T......T.T.@@.T....TTT.@@@@@@@@@@@@TTT..T.T.TT@@@@@@.T.TTT.TT.TTT.T..T..@@@@@@T..TTT..T.T......TTT.T.T.T.T.T.TTT.@@@@@@@@@@@@@@@@@@@@@@@@@@@@@@@@@@
@@@@T..T...TT..T.TTT...T.TT.TTT.T..TT@@@@@@@@@TT.T..T.T.TTTT@@@@@@@..T....TTT.TT.T...TT@@@@...TTT......TTT..T.TTT..T.TT..TT..@@@@@@@@@@@@@@@@@@@@@@@@@@@@@@@@@@@
@@@@@TT..TT..TT.T..T.T....TT@....T.TT.@@@@@@TTT..TTT...TTTT.T.@@@@@@...TTT..TT..T..TT...@@T..T.....TT.T.TTT......TT.T.TTT.T.@@@@@@@@@@@@@@@@@@@@@@@@@@@@@@@@@@@@
@@@@@@TT.TTT...TTTTTTT..TTT@@@...T..T@@@@@@....TTTTT..TT.....T@@@@@@@.T.T..TTTTT.TT.TTTTTTTT...T..TT.TTT.T.T...TTT.....T...@@@@@@@@@@@@@@@@@@@@@@@@@@@@@@@@@@@@@
@@@@@@@..TT...T.T.T.T.....@@@@@TTT.T@@@@@TT.TTTTTTTT...T.TT.TT@@@@@@@@T...TT..TT..T..TT.TTT....TTTT...TTT.TTTTT...TT.T.T.T@@@@@@@@@@@@@@@@@@@@@@@@@@@@@@@@@@@@@@
@@@@@@@@TT.T.T..TT..T...TT@@@@@@@TT@@@@@TT.TTT.TTT..TT..TTT@..T@@@@@@@@TTT...TTT.TT.TTT..TT..T..TTT.T....T.TTTTTT.TT.TT..@@@@@@@@@@@@@@@@@@@@@@@@@@@@@@@@@@@@@@@
@@@@@@@@@.T..TT...T.T.T..T@@@@@@@@@@@@@.....TTTT.TT...T..@@@@..T@@@@@@@@..T.T..TT....T..T.T.T.TTTT.......T.T..T.TT....TT@@@@@@@@@@@@@@@@@@@@@@@@@@@@@@@@@@@@@@@@
@@@@@@@@@@.........TTT.T.T.@@@@@@@@@@@TT.TTT.T.TTT..T..T@@@@@T.T@@@@@@@@@.T...T..T...TT.T.T....TT..TTT.TTT..TTT..T.TTTT@@@@@@@@@@@@@@@@@@@@@@@@@@@@@@@@@@@@@@@@@
@@@@@@@@@@@.TT..T....T....T.T@@@@@@@@@TT.TTT..T.T..T.TT@@@@@@@T.@@..@@@@@@....T........T.TT....T..TTTT...T....T..TTTT.@@@@@@@@@@@@@@@@@@@@@@@@@@@@@@@@@@@@@@@@@@
@@@@@@@@@@@@.T..TTT.TT.T...T..@@@@@@@@TT...TTTTT.T..TT@@@@@@T.TT...T@@@@@@@@TT.TT.TTTT.....TT.....T.TTT.T..T....T.T.T@@@@@@@@@@@@@@@@@@@@@@@@@@@@@@@@@@@@@@@@@@@
@@@@@@@@@@@@@TT.T...TT....TT.T@@@@@@@.TTT..TTT..T..T.@@@@TTTTT..TT.@@@@@@@@@TTTTTT.T..TTT.T..TTTT.TTT...T.T.TT......@@@@@@@@@@@@@@@@@@@@@@@@@@@@@@@@@@@@@@@@@@@@
@@@@@@@@@@@@@@.TT.T..TTT..T..@@@@@T.T.T....T.TT.T.T.@@@@T..T.TTT.@@@@@@@@@@@@....TTT...T.T..TT...TT..T..T..T..T..TT@@@@@@@@@@@@@@@@@@@@@@@@@@@@@@@@@@@@@@@@@@@@@
@@@@@@@@@@@@@@@.TT.T..T..T.T@@@@@...T..TT....T.T.T.@@@@T...T....@@@@@@@@@@@@@@..TT..TTTTTTT.TT...T...TT..TT..T.T.@@@@@@@@@@@@@@@@@@@@@@@@@@@@@@@@@@@@@@@@@@@@@@@
@@@@@@@@@@@@@@@@....T..T.@@@@@@@TT..T......TTTTTTT@@@@..TT.T.T.@@@@@@@@@@@@@@@@.TTTTT.TTT..TTTTT...T.TTT..T.T.TT@@@@@@@@@@@@@@@@@@@@@@@@@@@@@@@@@@@@@@@@@@@@@@@@
@@@@@@@@@@@@@@@@@T...T...@@@@@@TTTTTTTTT..TTTTT.T@@@@T..T..TT.T@@@@@@@@@@@@@@@@@.TT.T...TTT.TT..TT.T....T.T....@@@@@@@@@@@@@@@@@@@@@@@@@@@@@@@@@@@@@@@@@@@@@@@@@
@@@@@@@@@@@@@@@@@@T...T.T@@.@@T.T...TTTT.TTTTTTT@@@@....TT.TT..@@@@@@@@@T.T@@@@@@@TTTTT.....T.T.T..TTT.T..TTTT@@@@@@@@@@@@@@@@@@@@@@@@@@@@@@@@@@@@@@@@@@@@@@@@@@
@@@@@@@@@@@@@@@@@@@T.T...@@T.T.TTT.T...TT......@@@@T.TTTT....T.@@@@@@@@...T@@@@@@@@T..TTT.TTT...TT.T.T.T....T@@@@@@@@@@@@@@@@@@@@@@@@@@@@@@@@@@@@@@@@@@@@@@@@@@@
@@@@@@@@@@@@@@@@@@@@..T..@@TTT.....TT.T.TT..TT@@@@@T.TT..T.TTTT@@@@@@@..T.@@@@@@@@@@.TTT.TT.TT..TT..TT...TT.@@@@@@@@@@@@@@@@@@@@@@@@@@@@@@@@@@@@@@@@@@@@@@@@@@@@
@@@@@@@@@@@@@@@@@@@@@T..@@@T..T..TT.....T.T..@@@@@@T.@@T.TTT...T@@@@@T..T.TTTT@@@@@@@.T....TTTT....T..TTT..@@@@@@@@@@@@@@@@@@@@@@@@@@@@@@@@@@@@@@@@@@@@@@@@@@@@@
@@@@@@@@@@@@@@@@@@@@@@TT@@@T.T..TTTTT.T...TT@@@@..TT.@@..TT............T....TTT@@@@@@TTT..TTT.T...T.TTT.T@@@@@@@@@@@@@@@@@@@@@@@@@@@@@@@@@@@@@@@@@@@@@@@@@@@@@@@
@@@@@@@@@@@@@@@@@@@@@@@@@@@T....TT.T.T.TTTT@@@@TTT.T@@@T...T.TTTTTT....TTT.T..T@@@@@@.TT....T...T..TT.T.@@@@@@@@@@@@@@@@@@@@@@@@@@@@@@@@@@@@@@@@@@@@@@@@@@@@@@@@
@@@@@@@@@@@@@@@@@@@@@@@@@@@TT.T.T.TT.T.T..@@@@@@T.T@@@@@TT.TTT.T..T.TTT.TTT.TT.@@@@@@.TT....TTT..TT.TT.@@@@@@@@@@@@@@@@@@@@@@@@@@@@@@@@@@@@@@@@@@@@@@@@@@@@@@@@@
@@@@@@@@@@@@@@@@@@@@@@@@@@@@.T.T.TT....T@@@@@@@@@.T@@T@@.T.T...TTTT..T..TTTTT.TT@@.@.TT...T.TTT.TT.TTT@@@@@@@@@@@@@@@@@@@@@@@@@@@@@@@@@@@@@@@@@@@@@@@@@@@@@@@@@@
@@@@@@@@@@@@@@@@@@@@@@@@@@@@@.TT.T..TT.@@@@@@@@@@T@@@.@@TTTT.TT....T...T.T..T.TT.T.T.TT@@TTTTTT....TT@@@@@@@@@@@@@@@@@@@@@@@@@@@@@@@@@@@@@@@@@@@@@@@@@@@@@@@@@@@
@@@@@@@@@@@@@@@@@@@@@@@@@@@@@@TTTT..T..@@@@@@@TT..@@@TT@@TTT..T.TT.T..TT.T..TT.T...T.T@@@@..T.TTTTTT@@@@@@@@@@@@@@@@@@@@@@@@@@@@@@@@@@@@@@@@@@@@@@@@@@@@@@@@@@@@
@@@@@@@@@@@@@@@@@@@@@@@@@@@@@@@.TTTT...T@@@@@@.T..@@.TT..TTT...TT..T..TTT.T.TTT.T..T..@@@@@....TT.T@@@@@@@@@@@@@@@@@@@@@@@@@@@@@@@@@@@@@@@@@@@@@@@@@@@@@@@@@@@@@
@@@@@@@@@@@@@@@@@@@@@@@@@@@@@@@@TTT.T..TT@@@@@@..TT.TTTTT....T..TT...TT..T..T.TTTTT..T.@@@@@@@TT.T@@@@@@@@@@@@@@@@@@@@@@@@@@@@@@@@@@@@@@@@@@@@@@@@@@@@@@@@@@@@@@
@@@@@@@@@@@@@@@@@@@@@@@@@@@@@@@@@T...TT..TT@@@@@TT..TTT..T..T.TTT..T...TT..TTTT...T...TT@@@@@@@..@@@@@@@@@@@@@@@@@@@@@@@@@@@@@@@@@@@@@@@@@@@@@@@@@@@@@@@@@@@@@@@
@@@@@@@@@@@@@@@@@@@@@@@@@@@@@@@@@@TTT....TT.@@@@@T.T.TTT.TT.TTTTT...T@@.T.TTT..T.T.TT.T.T@@@@@@@@@@@@@@@@@@@@@@@@@@@@@@@@@@@@@@@@@@@@@@@@@@@@@@@@@@@@@@@@@@@@@@@
@@@@@@@@@@@@@@@@@@@@@@@@@@@@@@@@@@@T..TT...T.@@@@@.TTT..T.TT.T.TTT.T@@@T.TT.TTT.....TTT...@@@@@@@@@@@@@@@@@@@@@@@@@@@@@@@@@@@@@@@@@@@@@@@@@@@@@@@@@@@@@@@@@@@@@@
@@@@@@@@@@@@@@@@@@@@@@@@@@@@@@@@@@@@T..TTT.TTT@@@@@.T...TT.T..TTT.T@@@@.T.T...T.T.TTT..T.T.@@@@@@@@@@@@@@@@@@@@@@@@@@@@@@@@@@@@@@@@@@@@@@@@@@@@@@@@@@@@@@@@@@@@@
@@@@@@@@@@@@@@@@@@@@@@@@@@@@@@@@@@@@@T.T.T..TT.@@@@@T..TT.T..TTT..@@@@TT..@TT....TT.T..T..TT@@@@@@@@@@@@@@@@@@@@@@@@@@@@@@@@@@@@@@@@@@@@@@@@@@@@@@@@@@@@@@@@@@@@
@@@@@@@@@@@@@@@@@@@@@@@@@@@@@@@@@@@@@@....T.TT.T@@@@@.TT....T.T..@@@@.TTT@@@..TTT.TTTT.T..TT@@@@@@@@@@@@@@@@@@@@@@@@@@@@@@@@@@@@@@@@@@@@@@@@@@@@@@@@@@@@@@@@@@@@
@@@@@@@@@@@@@@@@@@@@@@@@@@@@@@@@@@@@@@@T...TTT..T@@@@@TT.TT.....@@@@T.TT@@@@@.TT..T...T.T.T@@@@@@@@@@@@@@@@@@@@@@@@@@@@@@@@@@@@@@@@@@@@@@@@@@@@@@@@@@@@@@@@@@@@@
@@@@@@@@@@@@@@@@@@@@@@@@@@@@@@@@@@@@@@@@..T..TTT..@@@@@T.TT...T@@@.TTTT..T@@@@.T.T.T..T...@@@@@@@@@@@@@@@@@@@@@@@@@@@@@@@@@@@@@@@@@@@@@@@@@@@@@@@@@@@@@@@@@@@@@@
@@@@@@@@@@@@@@@@@@@@@@@@@@@@@@@@@@@@@@@@@.TT.T....T@@@@@@..T...@@@@TT.TT.@@@@.T.TTT.TTT..@@@@@@@@@@@@@@@@@@@@@@@@@@@@@@@@@@@@@@@@@@@@@@@@@@@@@@@@@@@@@@@@@@@@@@@
@@@@@@@@@@@@@@@@@@@@@@@@@@@@@@@@@@@@@@@@@@TT.TTT..T@@@@@@@TTT...@@@@.TT..@@@@.T....TT..T@@@@@@@@@@@@@@@@@@@@@@@@@@@@@@@@@@@@@@@@@@@@@@@@@@@@@@@@@@@@@@@@@@@@@@@@
@@@@@@@@@@@@@@@@@@@@@@@@@@@@@@@@@@@@@@@@@@@.T....T..T.@@@@@..TTT@@@@@TTTT@@T.T..TTT..TT@@@@@@@@@@@@@@@@@@@@@@@@@@@@@@@@@@@@@@@@@@@@@@@@@@@@@@@@@@@@@@@@@@@@@@@@@
@@@@@@@@@@@@@@@@@@@@@@@@@@@@@@@@@@@@@@@@@@@@T.TTTT.TTT.@@@@@TT..T@@@@@.T.TTTT.TT..T...@@@@@@@@@@@@@@@@@@@@@@@@@@@@@@@@@@@@@@@@@@@@@@@@@@@@@@@@@@@@@@@@@@@@@@@@@@
@@@@@@@@@@@@@@@@@@@@@@@@@@@@@@@@@@@@@@@@@@@@@T.......T.T@@@@@T.T.T@@@@@.TTTT.TT.TT.T.@@@@@@@@@@@@@@@@@@@@@@@@@@@@@@@@@@@@@@@@@@@@@@@@@@@@@@@@@@@@@@@@@@@@@@@@@@@
@@@@@@@@@@@@@@@@@@@@@@@@@@@@@@@@@@@@@@@@@@@@@@..TT.T..TTT@@@@@T.T..@@@@.T.TTT.T.TTT.@@@@@@@@@@@@@@@@@@@@@@@@@@@@@@@@@@@@@@@@@@@@@@@@@@@@@@@@@@@@@@@@@@@@@@@@@@@@
@@@@@@@@@@@@@@@@@@@@@@@@@@@@@@@@@@@@@@@@@@@@@@@TTT...T.T.T@@@@@.T.TT@TT.T.T..TT...T@@@@@@@@@@@@@@@@@@@@@@@@@@@@@@@@@@@@@@@@@@@@@@@@@@@@@@@@@@@@@@@@@@@@@@@@@@@@@
@@@@@@@@@@@@@@@@@@@@@@@@@@@@@@@@@@@@@@@@@@@@@@@@T.TTT..T.T.@@@@@.TTT..TT...TTT.T.T@@@@@@@@@@@@@@@@@@@@@@@@@@@@@@@@@@@@@@@@@@@@@@@@@@@@@@@@@@@@@@@@@@@@@@@@@@@@@@
@@@@@@@@@@@@@@@@@@@@@@@@@@@@@@@@@@@@@@@@@@@@@@@@@TT..T.TT.T.@@@@@TTTT...T....T.TT@@@@@@@@@@@@@@@@@@@@@@@@@@@@@@@@@@@@@@@@@@@@@@@@@@@@@@@@@@@@@@@@@@@@@@@@@@@@@@@
@@@@@@@@@@@@@@@@@@@@@@@@@@@@@@@@@@@@@@@@@@@@@@@@@@TTT..T....T@@@@@T..TTTT..T....@@@@@@@@@@@@@@@@@@@@@@@@@@@@@@@@@@@@@@@@@@@@@@@@@@@@@@@@@@@@@@@@@@@@@@@@@@@@@@@@
@@@@@@@@@@@@@@@@@@@@@@@@@@@@@@@@@@@@@@@@@@@@@@@@@@@@.TTTTTT...@@@@@@@@TTT.T..TT@@@@@@@@@@@@@@@@@@@@@@@@@@@@@@@@@@@@@@@@@@@@@@@@@@@@@@@@@@@@@@@@@@@@@@@@@@@@@@@@@
@@@@@@@@@@@@@@@@@@@@@@@@@@@@@@@@@@@@@@@@@@@@@@@@@@@@@TTTTTT.T.@@@@@@@@@@T...TT@@@@@@@@@@@@@@@@@@@@@@@@@@@@@@@@@@@@@@@@@@@@@@@@@@@@@@@@@@@@@@@@@@@@@@@@@@@@@@@@@@
@@@@@@@@@@@@@@@@@@@@@@@@@@@@@@@@@@@@@@@@@@@@@@@@@@@@@@@T..T..T.@@@@@.T@@T.TTT@@@@@@@@@@@@@@@@@@@@@@@@@@@@@@@@@@@@@@@@@@@@@@@@@@@@@@@@@@@@@@@@@@@@@@@@@@@@@@@@@@@
@@@@@@@@@@@@@@@@@@@@@@@@@@@@@@@@@@@@@@@@@@@@@@@@@@@@@@@@T.T.T.TT.@@T.T@@....@@@@@@@@@@@@@@@@@@@@@@@@@@@@@@@@@@@@@@@@@@@@@@@@@@@@@@@@@@@@@@@@@@@@@@@@@@@@@@@@@@@@
@@@@@@@@@@@@@@@@@@@@@@@@@@@@@@@@@@@@@@@@@@@@@@@@@@@@@@@@@.T....TT.T...@@.T.@@@@@@@@@@@@@@@@@@@@@@@@@@@@@@@@@@@@@@@@@@@@@@@@@@@@@@@@@@@@@@@@@@@@@@@@@@@@@@@@@@@@@
@@@@@@@@@@@@@@@@@@@@@@@@@@@@@@@@@@@@@@@@@@@@@@@@@@@@@@@@@@TT..TT......@@@.@@@@@@@@@@@@@@@@@@@@@@@@@@@@@@@@@@@@@@@@@@@@@@@@@@@@@@@@@@@@@@@@@@@@@@@@@@@@@@@@@@@@@@
@@@@@@@@@@@@@@@@@@@@@@@@@@@@@@@@@@@@@@@@@@@@@@@@@@@@@@@@@@@TT...TT.TT.@@@@@@@@@@@@@@@@@@@@@@@@@@@@@@@@@@@@@@@@@@@@@@@@@@@@@@@@@@@@@@@@@@@@@@@@@@@@@@@@@@@@@@@@@@
@@@@@@@@@@@@@@@@@@@@@@@@@@@@@@@@@@@@@@@@@@@@@@@@@@@@@@@@@@@@@.....T.TT@@@@@@@@@@@@@@@@@@@@@@@@@@@@@@@@@@@@@@@@@@@@@@@@@@@@@@@@@@@@@@@@@@@@@@@@@@@@@@@@@@@@@@@@@@
@@@@@@@@@@@@@@@@@@@@@@@@@@@@@@@@@@@@@@@@@@@@@@@@@@@@@@@@@@@@@@.T.TT..T@@@@@@@@@@@@@@@@@@@@@@@@@@@@@@@@@@@@@@@@@@@@@@@@@@@@@@@@@@@@@@@@@@@@@@@@@@@@@@@@@@@@@@@@@@
@@@@@@@@@@@@@@@@@@@@@@@@@@@@@@@@@@@@@@@@@@@@@@@@@@@@@@@@@@@@@@@TTTTTT.@@@@@@@@@@@@@@@@@@@@@@@@@@@@@@@@@@@@@@@@@@@@@@@@@@@@@@@@@@@@@@@@@@@@@@@@@@@@@@@@@@@@@@@@@@
@@@@@@@@@@@@@@@@@@@@@@@@@@@@@@@@@@@@@@@@@@@@@@@@@@@@@@@@@@@@@@@@.T.T.@@@@@@@@@@@@@@@@@@@@@@@@@@@@@@@@@@@@@@@@@@@@@@@@@@@@@@@@@@@@@@@@@@@@@@@@@@@@@@@@@@@@@@@@@@@
@@@@@@@@@@@@@@@@@@@@@@@@@@@@@@@@@@@@@@@@@@@@@@@@@@@@@@@@@@@@@@@@@@@@@@@@@@@@@@@@@@@@@@@@@@@@@@@@@@@@@@@@@@@@@@@@@@@@@@@@@@@@@@@@@@@@@@@@@@@@@@@@@@@@@@@@@@@@@@@@
@@@@@@@@@@@@@@@@@@@@@@@@@@@@@@@@@@@@@@@@@@@@@@@@@@@@@@@@@@@@@@@@@@@@@@@@@@@@@@@@@@@@@@@@@@@@@@@@@@@@@@@@@@@@@@@@@@@@@@@@@@@@@@@@@@@@@@@@@@@@@@@@@@@@@@@@@@@@@@@@
@@@@@@@@@@@@@@@@@@@@@@@@@@@@@@@@@@@@@@@@@@@@@@@@@@@@@@@@@@@@@@@@@@@@@@@@@@@@@@@@@@@@@@@@@@@@@@@@@@@@@@@@@@@@@@@@@@@@@@@@@@@@@@@@@@@@@@@@@@@@@@@@@@@@@@@@@@@@@@@@
