type octile
height 91
width 104
map
@@@@@@@@@@@@@@@@@@@@@@@@@@@@@@@@@@@@@@@@@@@@@@@@@@@@@@@@@@@@@@@@@@@@@@@@@@@@@@@@@@@@@@@@@@@@@@@@@@@@@@@@
@@@@@@@@@@@@@@@@@@@@@@@@@@@@@@@@@@@@@@@@@@@@@@@@@@@@@@@@@@@@@@@@@@@@@@@@@@@@@@@@@@@@@@@@@@@@@@@@@@@@@@@@
@@@@@@@@@@@@@@@@@@@@@@@@@@@@@@@@@@@@@@@@@@@@@@@@@@@@@@@@@@@@@@@@@@@@@@@@@@@@@@@@@@@@@@@@@@@@@@@@@@@@@@@@
@@@@@@@@@@@@@@@@@@@@@@@@@@@@@@@@@@@@@@@@@@@@@@@@@@@@@@@@@@@@@@@@@@@@@@@@@@@@@@@@@@@@@@@@@@@@@@@@@@@@@@@@
@@@@@@@@@@@@@@@@@@@@@@@@@@@@@@@@@@@@@@@@@@@@@@@@@@@@@@@@@@@@@@@@@@@@@@@@@@@@@@@@@@@@@@@@@@@@@@@@@@@@@@@@
@@@@@@@@@@@@@@@@@@@@@@@@@@@@@@@@@@@@@@@@@@@@@@@@@@@@@@@@@@@@@@@@@@@@@@@@@@@@@@@@@@@@@@@@@@@@@@@@@@@@@@@@
@@@@@@@@@@@@@@@@@@@@@@@@@@@@@@@@@@@@@@@@@@@@@@@@@@@@@@@@@@@@@@@@@@@@@@@@@@@@@@@@@@@@@@@@@@@@@@@@@@@@@@@@
@@@@@@@@@@@@@@@@@@@@@@@@@@@@@@@@@@@@@@@@@@@@@@@@@@@@@@@@@@@@@@@@@@@@@@@@@@@@@@@@@@@@@@@@@@@@@@@@@@@@@@@@
@@@@@@@@@@@@@@@@@@@@@@@@@@@@@@@@@@@@@@@@@@@@@@@@@@@@@@@@@@@@@@@@@@@@@@@@@@@@@@@@@@@@@@@@@@@@@@@@@@@@@@@@
@@@@@@@@@@@@@@@@@@@@@@@@@@@@@@@@@@@@@@@@@@@@@@@@@@@@@@@@@@@@@@@@@@@@@@@@@@@@@@@@@@@@@@@@@@@@@@@@@@@@@@@@
@@@@@@@@@@@@@@@@@@@@@@@@@@@@@@@@@@@@@@@@@@@@@@@@@@@@@@@@@@@@@@@@@@@@@@@@@@@@@@@@@@@@@@@@@@@@@@@@@@@@@@@@
@@@@@@@@@@@@@@@@@@@@@@@@@@@@@@@@@@@@@@@@@@@@@@@@@@@@@@@@@@@@@@@@@@@@@@@@@@@@@@@@@@@@@@@@@@@@@@@@@@@@@@@@
@@@@@@@@@@@@@@@@@@@@@@@@@@@@@@@@@@@@@@@@@@@@@@@@@@@@@@@@@@@@@@@@@@@@@@@@@@@@@@@@@@@@@@@@@@@@@@@@@@@@@@@@
@@@@@@@@@@@@@@@@@@@@@@@@@@@@@@@@@@@@@@@@@@@@@@@@@@@@@@@@@@@@@@@@@@@@@@@@@@@@@@@@@@@@@@@@@@@@@@@@@@@@@@@@
@@@@@@@@@@@@@@@@@@@@@@@@@@@@@@@@@@@@@@@@@@@@@@@@@@@@@@@@@@@@@@@@@@@@@@@@@@@@@@@@@@@@@@@@@@@@@@@@@@@@@@@@
@@@@@@@@@@@@@@@@@@@@@@@@@@@@@@@@@@@@@@@@@@@@@@@@@@@@@@@@@@@@@@@@@@@@@@@@@@@@@@@@@@@@@@@@@@@@@@@@@@@@@@@@
@@@@@@@@@@@@@@@@@@@@@@@@@@@@@@@@@@@@@@@@@@@@@@@@@@@@@@@@@@@@@@@@@@@@@@@@@@@@@@@@@@@@@@@@@@@@@@@@@@@@@@@@
@@@@@@@@@@@@@@@@@@@@@@@@@@@@@@@@@@@@@@@@@@@@@@@@@@@@@@@@@@@@@@@@@@@@@@@@@@@@@@@@@@@@@@@@@@@@@@@@@@@@@@@@
@@@@@@@@@@@@@@@@@@@@@@@@@@@@@@@@@@@@@@@@@@@@@@@@@@@@@@@@@@@@@@@@@@@@@@@@@@@@@@@@@@@@@@@@@@@@@@@@@@@@@@@@
@@@@@@@@@@@@@@@@@@@@@@@@@@@@@@@@@@@@@@@@@@@@@@@@@@@@@@@@@@@@@@@@@@@@@@@@@@@@@@@@@@@@@@@@@@@@@@@@@@@@@@@@
@@@@@@@@@@@@@@@@@@@@@@@@@@@@@@@@@@@@@@@@@@@@@@@@@@@@@@@@@@@@@@@@@@@@@@@@@@@@@@@@@@@@@@@@@@@@@@@@@@@@@@@@
@@@@@@@@@@@@@@@@@@@@@@@@@@@@@@@@@@@@@@@@@@@@@@@@@@@@@@@@@@@@@@@@@@@@@@@@@@@@@@@@@@@@@@@@@@@@@@@@@@@@@@@@
@@@@@@@@@@@@@@@@@@@@@@@@@@@@@@@@@@@@@T@@@@@@@@@@@@@@@@@@@@@@@@@@@@@@@@@@@@@@@@@@@@@@@@@@@@@@@@@@@@@@@@@@
@@@@@@@@@@@@@@@@@@@@@@@@@@@@@@@@@T.@..T@@@@@@@@@@@@@@@@@@@@@@@@@@@@@@@@@@@@@@@@@@@@@@@@@@@@@@@@@@@@@@@@@
@@@@@@@@@@@@@@@@@@@@@@@@@@@@@@@@.T.T.TT.@@@@@@@@@@@@@@@@@@@@@@@@@@@@@@@@@@@@@@@@@@@@@@@@@@@@@@@@@@@@@@@@
@@@@@@@@@@@@@@@@@@@@@@@@@@@@@@@.TTTTTTT.T@@@@@@@@@@@@@@@@@@@@@@@@@@@@@@@@@@@@@@@@@@@@@@@@@@@@@@@@@@@@@@@
@@@@@@@@@@@@T@@@@@@@@@@@@@@@@@T.T.T.TTTTTT@@@@@@@@@@@@@@@@@@@@@@@@@@@@@@@@@@@@@@@@@@@.T.@@@@@@@@@@@@@@@@
@@@@@@@@@@@T.@@@@@@@@@@@@@@@@@@..TT.T....T.@.@@@@@@@@@@@@@@@@@@@@@@@@@@@@@@@@@@@@..@@.TT@@@@@@@@@@@@@@@@
@@@@@@@@@@...T@@@@@@@@@@@@@@.@@@....T..T.TTT.@@@@@@@@@@@@@@@@@@@@@@@@@@@@@@@@@@@.T.T@..@@@@@@@@@@@@@@@@@
@@@@@@@@@.TTTT.@@@@@@@@@@@@TT.T@@T.TT.T..T...@@@@@@@@@@@@@@@@@@@@@@@@@@@@@@@@@T.T.TTTT.@@@@@@@@@@@@@@@@@
@@@@@@@@@@...T.@@@@@@@@@@TTTT...@@T..TTTT...TT@@@@@@@@@@@@@@@@@@@@@@@@@@@@@@@.....T...T@@@@@@@@@@@@@@@@@
@@@@@@@@@@.TTT..@@@@@@@@.TTT.T...@@...TTTT.....@@@@@@@@@@@@@@@@@@@@@@@@@@@@@...T.T.TT.T@@@@@@@@@@@@@@@@@
@@@@@@@@@@@.TT..@@@@@@@@@....T...T@@T.....T....T@@@@@@@@@@@@@@@@@@@@@@@@@@@@@TTTTTT.T@@@@@@@@@@@@@@@@@@@
@@@@@@@@@@@@...T@@@@@@TT@@T.T...T.T@..T.TT..TT.@@.T@@@@@@@@@@@@@@@@@@@@@@@@@@@@TTT.T@@@@@@@@@@@@@@@@@@@@
@@@@@@@@@@@@TTT.T@@@@....@@T.T..TTTT.T.TT.T..T@@TTT@@@@@@@@@@@@@@@@@@@@@@.TT..@@T...@@@@@@@@@@@@@@@@@@@@
@@@@@@@@@@@@@T..T@@T.T.T.T@@TT.T...T.T...T.T.@@.T.T@@@@@@@@@@@@@@@@@@.@@.TTT...@@T.T@@@@@@@@@@@@@@@@@@@@
@@@@@@@@@@@@@@..T.@@..T..TT@@TTTTTT.TT...T..@@.TTTT@@@@@@@@@@@@@@@@@@T.TTT.T.TT..TT.@@@@@@@@@@@@@@@@@@@@
@@@@@@@@@@@@@@.T.T@@@T..T..T@@..TTT..T.TT..@@TTT..TT@@@@@@@@@@@@@@@@TTT.TT.T.TT...TT@@@@@@@@@@@@@@@@@@@@
@@@@@@@@@@@@@@@..T@@@@.T.....@@TT.....T..T@@TTT..T..@@.@@@@@@@@@@@@@.TT.T...TT.TTT@@@@@@@@@@@@@@@@@@@@@@
@@@@@@@@@@@@@@@.T.T@@@@T......@....TTTT..@@T..TT.TT.TT.@@@@@@@@@@@@@...TTTT...T....@@@@@@@@@@@@@@@@@@@@@
@@@@@@@@@@@@@@@@T.T@@@@@T.T.T..TT...TTT.@@TT.T.TTT.T.T.@@@@@@@@@@@@@@T..T.T...T...T.@@@@@@@@@@@@@@@@@@@@
@@@@@@@@@@@@@@@@TT.T@@@@@....TTTTT..TTTT@T.TT.T.T.T.TT.T@@@@@@@@@@@@@@.T.T..TTT.TT..T@@@@@@@@@@@@@@@@@@@
@@@@@@@@@@@@@.T.TTTTT@@@@@TTT..TTT....TT@..T@T.T..T.TT.@@@@@@@@@@@@@@@@@TTTT.TT.TT.TT.@@@@@@@@@@@@@@@@@@
@@@@@@@@@@@@.T..T.T..@@@@@..T..T.T..T.T@@..@@@...T.TT.@@@@@@@@@@@@@@@@@@@...T..T.TT....@@@@@@@@@@@@@@@@@
@@@@@@@@@@@TTT..T.T.T.@@@@@T.TTTT....T.@.T.@@@@.TT.T.@@@@@@@@@@@@@@@@@@@@@.TTTT.TTTTTTT.@@@@@@@@@@@@@@@@
@@@@@@@@@@TT.TT.TT..TTTTT@@..TT.TTTTTT@@..T@@@@@TT..@@@@@@@@@@@@@@@@@@@@@@@@T..T.TT...T.T@@@@@@@@@@@@@@@
@@@@@@@@@..T.T.TTTT.T...T....TTTT....T@T.T.@@@@@@T.@@@@@@@@@@@@@@@@@@@@@@@@@@T.TTTT.TT.TT.@@@@@@@@@@@@@@
@@@@@@@@....TT....TTTT.TT...T...TTT..@@T..@@@@@@@@@@@@@@@@.@@@@@@@@@@@@@@@@@@@@TT.TTT.T...T@@@@@@@@@@@@@
@@@@@@@@T..TTT.T.T.T.T.TT.TT.T....TT.@T..@@@@@@@@@@@@@@@@..@@@@@@@.@@@@@@@@@@@@@@TTT.T.T..TT@@@@@@@@@@@@
@@@@@@@@@T.T.T.T.TT.T.TT..TTT...TT..T@TT.@@@@@@@@@@@@@.@T...@@@@@..@@@@@@@@@@@@@.TTT.TT.....T@@@@@@@@@@@
@@@@@@@@@@T......T..T.T.T..T...T......TT@@@@@@@@@@@@.TTTT.T@@@@@@TTT@@@@@@@.@@@...TTT.T.T..TT..@@@@@@@@@
@@@@@@@@@@@...T.TTT..TTT..TT.T.TT.T.T...@@@@@@@@@@@T.TTT.TT@@@@@@T...T@@@@.T.@TT...T....T..T.T@@@@@@@@@@
@@@@@@@@@@@@T....TTTT.TT..T.T..T.T.T.T.@@@@@@@@@T@@T.T@@@T....T.T.TT..T@@@..TT.TTT..T.T...TT.@@@@@@@@@@@
@@@@@@@@@@@@@TTT..TTTT..T.T.T.TTT.T..T@@@@@@@@@T..TT.T@@@@T.T....T...TTT.TTT.T..T.@TT.TTTT.T@@@@@@@@@@@@
@@@@@@@@@@@@@@TT..T.T....TT.T.TTT..T.@@@@@@.@@..TTTT.@@@@@....T.T...T.T....TT..TT@@@T..T.T@@@@@@@@@@@@@@
@@@@@@@@@@@@@@@T.T.TTT..TTT........T.T.@@@TTTTTT.T.@@@@@@@TT..T...TT...TT.TTTT...@@@@TTTT@@@@@@@@@@@@@@@
@@@@@@@@@@@@@@@@.T.TT..T..TT....T...T.T.T.T.TTTTT.@@@@@@@.T.TT..T..@..T.TTTTT.....@@@@T.@@@@@@@@@@@@@@@@
@@@@@@@@@@@@@@@@@.T..TTTT..T.T.TTT@@@..T..T.T....@@@@@@@TTT...T.TT@@@..T.TT....T.TT@@@@@@@@@@@@@@@@@@@@@
@@@@@@@@@@@@@@@@@@.T.TT.T...TTTT.@@@@..T.T....TTT@@.@@.TT.@@T.T.@@@@@@TTT.T.TTTTT.TT@@@@@@@@@@@@@@@@@@@@
@@@@@@@@@@@@@@@@@@@.TTTT...T...T@@@@.TTT.T.TT..T@@@.T...T@@@@T.T@@@@@@@..TT...T.T..T.@@@@@@@@@@@@@@@@@@@
@@@@@@@@@@@@@@@@@@@@.TTTTT.TT.T@@@@@@.T...T..TT.@@...T.T@@@@@@..TT@@@@@..TTT.TT.T.TT@@@@@@@@@@@@@@@@@@@@
@@@@@@@@@@@@@@@@@@@@@TT.....TT@@@@@@@@T.TTTTT..TT.T....@@@@@@@T....@@@@T.TT.T....T.@@@@@@@@@@@@@@@@@@@@@
@@@@@@@@@@@@@@@@@@@@@@.TTT...@@@@@@@@@....T...T...T.TT@@@@@@@T.T.TTT.TT.T.T.TTT.TT@@@@@@@@@@@@@@@@@@@@@@
@@@@@@@@@@@@@@@@@@@@@@@TT...@@@@@@@@@@@TT..T...T..TTT@@@@@@@...T.T...TTT.T..TT..T@@@@@@@@@@@@@@@@@@@@@@@
@@@@@@@@@@@@@@@@@@@@@@@@...@@@T@@@@@@@@.TT.@TT.T..T.@@@@@@@..TT...TTTTT..TT....T@@@@@@@@@@@@@@@@@@@@@@@@
@@@@@@@@@@@@@@@@@@@@@@@@@T@@@...@@@.@@@.TT@@@T.TT..@@@@@@@.T.TT.T...T.T.T.TTTTT@@@@@@@@@@@@@@@@@@@@@@@@@
@@@@@@@@@@@@@@@@@@@@@@@@@@@@.TT.TT.T.T.TT@@...T..T@@@@@@@T...T..T.T..T..T.TTTT@@@@@@@@@@@@@@@@@@@@@@@@@@
@@@@@@@@@@@@@@@@@@@@@@@@@@@...TTT..T...T@@T..T.T..@@@@@@....TT..TT.T........T@@@@@@@@@@@@@@@@@@@@@@@@@@@
@@@@@@@@@@@@@@@@@@@@@@@@@@@@T..TTTTTTT.@@TT....T.TT@@@@T.TT.T.T.TTT.T.T..TT.@@@@@@@@@@@@@@@@@@@@@@@@@@@@
@@@@@@@@@@@@@@@@@@@@@@@@@@@@@...TTTT.T@@TT.T.@TT....@@T.TTTT.T..T..T.TTTT..@@@@@@@@@@@@@@@@@@@@@@@@@@@@@
@@@@@@@@@@@@@@@@@@@@@@@@@@@@@@@T.TTTT@@....T@@@TT.TT.TT..T.TTTTT.TT.T...TT@@@@@@@@@@@@@@@@@@@@@@@@@@@@@@
@@@@@@@@@@@@@@@@@@@@@@@@@@@@@@@@TT.T@@TTTTT@@....TT.T..TTTT.T...TT..TT.TT@@@@@@@@@@@@@@@@@@@@@@@@@@@@@@@
@@@@@@@@@@@@@@@@@@@@@@@@@@@@@@@@@.@@@..TTT@@TTTTTTTTTTT.....TT..T.T.....@@@@@@@@@@@@@@@@@@@@@@@@@@@@@@@@
@@@@@@@@@@@@@@@@@@@@@@@@@@@@@@@@@@@@...TT@@.....T.TTTTTTTT..T.TT....TT.@@@@@@@@@@@@@@@@@@@@@@@@@@@@@@@@@
@@@@@@@@@@@@@@@@@@@@@@@@@@@@@@@@@@@.TTT.@@T.TT.T@@..TT...T..T.........@@@@@@@@@@@@@@@@@@@@@@@@@@@@@@@@@@
@@@@@@@@@@@@@@@@@@@@@@@@@@@@@@@@@@@@...@@T.TTT@@@@@@TTT.T.T..TT.T..TT@@@@@@@@@@@@@@@@@@@@@@@@@@@@@@@@@@@
@@@@@@@@@@@@@@@@@@@@@@@@@@@@@@@@@@@@@.@@TTT..@@@@@@@@.T...T..T..T...@@@@@@@@@@@@@@@@@@@@@@@@@@@@@@@@@@@@
@@@@@@@@@@@@@@@@@@@@@@@@@@@@@@@@@@@@@@@.T.TTT.@@@@@@@TTT..TTT.T.TTT@@@@@@@@@@@@@@@@@@@@@@@@@@@@@@@@@@@@@
@@@@@@@@@@@@@@@@@@@@@@@@@@@@@@@@@@@@@@@TTT.TTT@@@@@@.T.TT.TT.....T@@@@@@@@@@@@@@@@@@@@@@@@@@@@@@@@@@@@@@
@@@@@@@@@@@@@@@@@@@@@@@@@@@@@@@@@@@@@@@@.......@@@@...T.TTTTT..TT@@@@@@@@@@@@@@@@@@@@@@@@@@@@@@@@@@@@@@@
@@@@@@@@@@@@@@@@@@@@@@@@@@@@@@@@@@@@@@@@@T.T.T..T@.T.T..T.TT.TTT@@@@@@@@@@@@@@@@@@@@@@@@@@@@@@@@@@@@@@@@
@@@@@@@@@@@@@@@@@@@@@@@@@@@@@@@@@@@@@@@@@@.TTT.TT.T.....TT.T...@@@@@@@@@@@@@@@@@@@@@@@@@@@@@@@@@@@@@@@@@
@@@@@@@@@@@@@@@@@@@@@@@@@@@@@@@@@@@@@@@@@@@..TT..TT.TT..T..TTT@@@@@@@@@@@@@@@@@@@@@@@@@@@@@@@@@@@@@@@@@@
@@@@@@@@@@@@@@@@@@@@@@@@@@@@@@@@@@@@@@@@@@@@....TTT..T..TT.TT@@@@@@@@@@@@@@@@@@@@@@@@@@@@@@@@@@@@@@@@@@@
@@@@@@@@@@@@@@@@@@@@@@@@@@@@@@@@@@@@@@@@@@@@@TTT.TT...TTTT..@@@@@@@@@@@@@@@@@@@@@@@@@@@@@@@@@@@@@@@@@@@@
@@@@@@@@@@@@@@@@@@@@@@@@@@@@@@@@@@@@@@@@@@@@@@.TT.T.T...TT@@@@@@@@@@@@@@@@@@@@@@@@@@@@@@@@@@@@@@@@@@@@@@
@@@@@@@@@@@@@@@@@@@@@@@@@@@@@@@@@@@@@@@@@@@@@@@T.TT...T.T@@@@@@@@@@@@@@@@@@@@@@@@@@@@@@@@@@@@@@@@@@@@@@@
@@@@@@@@@@@@@@@@@@@@@@@@@@@@@@@@@@@@@@@@@@@@@@@@T..T..TT@@@@@@@@@@@@@@@@@@@@@@@@@@@@@@@@@@@@@@@@@@@@@@@@
@@@@@@@@@@@@@@@@@@@@@@@@@@@@@@@@@@@@@@@@@@@@@@@@@...T.T@@@@@@@@@@@@@@@@@@@@@@@@@@@@@@@@@@@@@@@@@@@@@@@@@
@@@@@@@@@@@@@@@@@@@@@@@@@@@@@@@@@@@@@@@@@@@@@@@@@@@@@@@@@@@@@@@@@@@@@@@@@@@@@@@@@@@@@@@@@@@@@@@@@@@@@@@@
@@@@@@@@@@@@@@@@@@@@@@@@@@@@@@@@@@@@@@@@@@@@@@@@@@@@@@@@@@@@@@@@@@@@@@@@@@@@@@@@@@@@@@@@@@@@@@@@@@@@@@@@
