type octile
height 80
width 80
map
@@@@@@@@@@@@@@@@@@@@@@@@@@@@@@@@@@@@@@@@@@@@@@@@@@@@@@@@@@@@@@@@@@@@@@@@@@@@@@@@
@@@@@@@@@@@@@@@@@@@@@@@@@@@@@@@@@@@@@@@@@@@@@@@@@@@@@@@@@@@@@@@@@@@@@@@@@@@@@@@@
@@@@@@@@@@@@@@@@@@@@@@@@@@@@@@@@@@@@@@@@@@@@@@@@@@@@@@@@@@@@@@@@@@@@@@@@@@@@@@@@
@@@@@@@@@@@@@@@@@@@@@@@@@@@@@@@@@@@@@@@@@@@@@@@@@@@@@@@@@@@@@@@@@@@@@@@@@@@@@@@@
@@@@@@@@@@@@@@@@@@@@@@@@@@@@@@@@@@@@@@@@@@@@@@@@@@@@@@@@@@@@@@@@@@@@@@@@@@@@@@@@
@@@@@@@@@@@@@@@@@@@@@@@@@@@@@@@@@@@@@@@@@@@@@@@@@@@@@@@@@@@@@@@@@@@@@@@@@@@@@@@@
@@@@@@@@@@@@@@@@@@@@@@@@@@@@@@@@@@@@@@@@@@@@@@@@@@@@@@@@@@@@@@@@@@@@@@@@@@@@@@@@
@@@@@@@@@@@@@@@@@@@@@@@@@@@@@@@@@@@@@@@@@@@@@@@@@@@@@@@@@@@@@@@@@@@@@@@@@@@@@@@@
@@@@@@@@@@@@@@@@@@@@@@@@@@@@@@@@@@@@@@@@@@@@@@@@@@@@@@@@@@@@@@@@@@@@@@@@@@@@@@@@
@@@@@@@@@@@@@@@@@@@@@@@@@@@@@@@@@@@@@@@@@@@@@@@@@@@@@@@@@@@@@@@@@@@@@@@@@@@@@@@@
@@@@@@@@@@@@@@@@@@@@@@@@@@@@@@@@@@@@@@@@@@@@@@@@@@@@@@@@@@@@@@@@@@@@@@@@@@@@@@@@
@@@@@@@@@@@@@@@@@@@@@@@@@@@@@@@@@@@@@@@@@@@@@@@@@@@@@@@@@@@@@@@@@@@@@@@@@@@@@@@@
@@@@@@@@@@@@@@@@@@@@@@@@@@@@@@@@@@@@@@@@@@@@@@@@@@@@@@@@@@@@@@@@@@@@@@@@@@@@@@@@
@@@@@@@@@@@@@@@@@@@@@@@@@@@@@@@@@@@@@@@@@@@@@@@@@@@@@@@@@@@@@@@@@@@@@@@@@@@@@@@@
@@@@@@@@@@@@@@@@@@@@@@@@@@@@@@@@@@@@@@@@@@@@@@@@@@@@@@@@@@@@@@@@@@@@@@@@@@@@@@@@
@@@@@@@@@@@@@@@@@@@@@@@@@@@@@@@@@@@@@@@@@@@@@@@@@@@@@@@@@@@@@@@@@@@@@@@@@@@@@@@@
@@@@@@@@@@@@@@@@@@@@@@@@@@@@@@@@@@@@@@@@@@@@@@@@@@@@@@@@@@@@@@@@@@@@@@@@@@@@@@@@
@@@@@@@@@@@@@@@@@@@@@@@@@@@@@@@@@@@@@@@@@@@@@@@@@@@@@@@@@@@@@@@@@@@@@@@@@@@@@@@@
@@@@@@@@@@@@@@@@@@@@@@@@@@@@@@@@@@@@@@@@@@@@@@@@@@@@@@@@@@@@@@@@@@@@@@@@@@@@@@@@
@@@@@@@@@@@@@@@@@@@@@@@@@@@@@@@@@@@@@@@@@@@@@@@@@@@@@@@@@@@@@TT@@@@@@@@@@@@@@@@@
@@@@@@@@@@@@@@@@@@@@@@@@@@@@@@@@@@@@@@@@@@@@@@@@@@@@@@@@@@@@..TT@@@@@@@@@@@@@@@@
@@@@@@@@@@@@@@@@@@@@@@@@@@@@@@@@@@@@@@@@@@@@@@@@@@@@@@@@@@@@.....@@@@@@@@@@@@@@@
@@@@@@@@@@@@@@@@@@@@@@@@@@@@@@@@@@@@@@@@@@@@@@@@@@@@@@@@@@@T..T..T@@@@@@@@@@@@@@
@@@@@@@@@@@@@@@@@@@@@@@@@@@@@@@@@T@@@@@@@@@@@@@@@@@@@@@@@@TTTT....T@@@@@@@@@@@@@
@@@@@@@@@@@@@@@@@@@@@@@@@@@@@@@@..T@@@@@@@@@@@@@@@@@@@@@@T.TT.......@@@@@@@@@@@@
@@@@@@@@@@@@@@@@@@@@@@@@@@@@@@...TT.@@@@@@@@@@@@@@@@@@@@...T.TTTTTT.T@@@@@@@@@@@
@@@@@@@@@@@@@@@@@@@@@@@@@@@@..T.T.TT@@@@@@@@@@@@@@@@@@@T..TT.....TTTT@@@@@@@@@@@
@@@@@@@@@@@@@@@@@@@@@@@@@@TTT..TT.TT@@@@@@@@@@@@@@@@@@..TT.T.T..T.T.@@@@@@@@@@@@
@@@@@@@@@@@@@@@@@@@@@@@@@@@TT..TT.T.T@@@@@TT@@@@@@@@@TTT...TT...TT.@@@@@@@@@@@@@
@@@@@@@@@@@@@@@@@@@@@@@@@@@.......TTTT@@@T.T.@@@@@@@.TTTT.T...TT..@@@@@@@@@@@@@@
@@@@@@@@@@@@@@@@@@@@@@@@@@T...T.TT.TTTTTTTT.T.@@@@@T.T..TTTT.....@@@@@@@@@@@@@@@
@@@@@@@@@@@@@@@@@@@@@@@@@TTT..TT..TT...T.T@@@@@@@@T.....T..T..T.@@@@@@@@@@@@@@@@
@@@@@@@@@@@@@@@@@@@@@@@@TTTT.TTT..T.T.TTT@@@@@@@TTT.T.T..T...T..@@@@@@@@@@@@@@@@
@@@@@@@@@@@@@@@@@@@@@@@..TT.T.T.T..@@.T.T..TTT..TT.T.T.TTT...T.@@@@@@@@@@@@@@@@@
@@@@@@@@@@@@@@@@@@@@@@.TTTT.@T..@@.@@TTT..TT...TT..T.T....T.T..@@@@@@@@@@@@@@@@@
@@@@@@@@@@@@@@@@@@@@@TTT...@@TT@@@@@TT.TT...T.TTTTTT.T...T.T..@@@@@@@@@@@@@@@@@@
@@@@@@@@@@@@@@@@@@@@.T.TTTT..T@@@@@@.T..T...TT.TTT..TTTT..T.TT@@@@@@@@@@@@@@@@@@
@@@@@@@@@@@@@@.@@@@T.TT.T.TT.@@@@@@@.TT.T..TT..TT..TT..TT...T@@@@@@@@@@@@@@@@@@@
@@@@@@@@@@@@@..@@@TT.TT.....@@@@@@@....T.TT..TT.TT..TTT.TTTT@@@@@@@@@@@@@@@@@@@@
@@@@@@@@@@@@@TT@@T.T.T.T..T@@@@@@@TTT..TT.TTTT..T...T..T..T@@@@@@@@@@@@@@@@@@@@@
@@@@@@@@@@@@@.T@TT.TTTT.T.@@@@@@@..TTTT...TT.T.TTT..TT..T.T@@@@@@@@@@@@@@@@@@@@@
@@@@@@@@@@@@@...TTT.@.TTT@@T@@@@T.T.T...T.TTTT.TT.T.T.T..T@@@@@@@@@@@@@@@@@@@@@@
@@@@@@@@@@@@@..T...@@@T...TTT@@@.....TTTTT....T.T...T.T.T.@TT@@@@@@@@@@@@@@@@@@@
@@@@@@@@@@@@TT.TTTT@@.TT.T.T@@T.TTTTT....TT.TTT..TTT.TT..@@...@@@@@@@@@@@@@@@@@@
@@@@@@@@@@@@T.T....@@...T...TT.T..TTT.TTTTT.T.T.T.TTT.T..@T..T.@@@@@@@@@@@@@@@@@
@@@@@@@@@@@@T.T..TT.T.T.T..TTT..TTTT.T...TTTTTT..T.T.TT.TTT.TTT@@@@@@@@@@@@@@@@@
@@@@@@@@@@@TT...TTTTT..T.TTT.TT.TT..TT....T....T...TT.T..TTTTT.@@@@@@@@@@@@@@@@@
@@@@@@@@@@....T.T.TTTT.T.TT..TTT.T.T.TT......T...T..T..TTT..T.@@@@@@@@@@@@@@@@@@
@@@@@@@@@@TT.T.TTTT.T.T.......TT......T.TTT..TTTTT....T.TTT..@@@@@@@@@@@@@@@@@@@
@@@@@@@@@..TTTTTTTT.TTT.T.T.TT...T......T....TT....T....T...@@@@@@@@@@@@@@@@@@@@
@@@@@@@@@TTTTT.TTT..T.T.TTT...T.TTTTTTT...TTTTT...TTTT.TTT.@@@@@@@@@@@@@@@@@@@@@
@@@@@@@@@.TT.T.TTT.TTTTT.TT.T..TTTTT.T.T.....TTT.....TT...@@@@@@@@@@@@@@@@@@@@@@
@@@@@@@@@@.TT.T.T@@@@@@@@@.T.T..TTTTT.TT...T...T...T.T.T.@@@@@@@@@@@@@@@@@@@@@@@
@@@@@@@@@@@TT.T.@@@@@@@@@@@@.......TTTT.TT.TTTTT..TTT..T@@@@@@@@@@@@@@@@@@@@@@@@
@@@@@@@@@@@@T.T.@@@@@@@@@@@@@..T.TTTT.TTT..T.T...T.TT..@@@@@@@@@@@@@@@@@@@@@@@@@
@@@@@@@@@@@@.T.T@@@@@@@@@@@@TT.T.TT..T.TTT.TT..T.T...T@@@@@@@@@@@@@@@@@@@@@@@@@@
@@@@@@@@@@..TTTT@@@@@@@@@@@@..TTTT...TT..T.TTTTTT..@@@@@@@@@@@@@@@@@@@@@@@@@@@@@
@@@@@@@@@@@T.....TT@@@@@@@@TTTTTT.T..T.T.TT..TT..@@@@@@@@@@@@@@@@@@@@@@@@@@@@@@@
@@@@@@@@@@@TT..T...T@@@@@@@..TT..TT.TTT...TTTT.T.@@@@@@@@@@@@@@@@@@@@@@@@@@@@@@@
@@@@@@@@@@@..T.TT....TTT@@@.TT..TTTT..T..T.TT.T.@@@@@@@@@@@@@@@@@@@@@@@@@@@@@@@@
@@@@@@@@@@TTT...TTT.TTTT.TT....TT....T.T.TT....@@@@@@@@@@@@@@@@@@@@@@@@@@@@@@@@@
@@@@@@@@TT..T.T..TTTT..TT..TTT....TTTTTT..T..T@@@@@@@@@@@@@@@@@@@@@@@@@@@@@@@@@@
@@@@@@@@TTTTTTTTT.TT.T..T.T.....TTTTTTT.TTTT@@@@@@@@@@@@@@@@@@@@@@@@@@@@@@@@@@@@
@@@@T...TTT.T.TTT.TTT.T.....T.T...T..T..T.T@@@@@@@@@@@@@@@@@@@@@@@@@@@@@@@@@@@@@
@@@@....TT..TT.TTT..T.TT.TT.....T.TT.TT.TT@@@@@@@@@@@@@@@@@@@@@@@@@@@@@@@@@@@@@@
@@@@@TTT@@....TT...TTTT.TTTTT.T.T.T.TTT..@@@@@@@@@@@@@@@@@@@@@@@@@@@@@@@@@@@@@@@
@@@@@T..@@...T.T.TTT..T.TT...TT.TTT.TT.T@@@@@@@@@@@@@@@@@@@@@@@@@@@@@@@@@@@@@@@@
@@@@T...T...T...T..T...T.TTT.TTTT..TT.@@@@@@@@@@@@@@@@@@@@@@@@@@@@@@@@@@@@@@@@@@
@@@T.T..T.TT.T.TTT...TTTT...TT.TTT..T@@@@@@@@@@@@@@@@@@@@@@@@@@@@@@@@@@@@@@@@@@@
@@@@T...T..T.TT.TTTTTTTT..T.T....T.T@@@@@@@@@@@@@@@@@@@@@@@@@@@@@@@@@@@@@@@@@@@@
@@@@@T..TTT...TT..TTT...T.T..TTT..T@@@@@@@@@@@@@@@@@@@@@@@@@@@@@@@@@@@@@@@@@@@@@
@@@@@@TT..TT.T.T.TT.TTT.T..T.TT..T@@@@@@@@@@@@@@@@@@@@@@@@@@@@@@@@@@@@@@@@@@@@@@
@@@@@.T.TTTTT...TTTT..TT.TT..T.TT@@@@@@@@@@@@@@@@@@@@@@@@@@@@@@@@@@@@@@@@@@@@@@@
@@@@.TTTT.TTTTT.TT...TTT.TT..TTT@@@@@@@@@@@@@@@@@@@@@@@@@@@@@@@@@@@@@@@@@@@@@@@@
@@@@@.T..T.....T.TT.TTT....T.T.@@@@@@@@@@@@@@@@@@@@@@@@@@@@@@@@@@@@@@@@@@@@@@@@@
@@@@@@TT..T.TTT..T..TT.TT.@..T.@@@@@@@@@@@@@@@@@@@@@@@@@@@@@@@@@@@@@@@@@@@@@@@@@
@@@@@.TT..T...TT..TTTTT.T.@@.@@@@@@@@@@@@@@@@@@@@@@@@@@@@@@@@@@@@@@@@@@@@@@@@@@@
@@@@.TTTTTT.TTTTTTTT.T.TTTTTT@@@@@@@@@@@@@@@@@@@@@@@@@@@@@@@@@@@@@@@@@@@@@@@@@@@
@@@@@@@@@@@@@@@@@@@@@@@@@@@@@@@@@@@@@@@@@@@@@@@@@@@@@@@@@@@@@@@@@@@@@@@@@@@@@@@@
@@@@@@@@@@@@@@@@@@@@@@@@@@@@@@@@@@@@@@@@@@@@@@@@@@@@@@@@@@@@@@@@@@@@@@@@@@@@@@@@
