type octile
height 54
width 52
map
@@@@@@@@@@@@@@@@@@@@@@@@@@@@@@@@@@@@@@@@@@@@@@@@@@@@
@@@@@@@@@@@@@@@@@@@@@@@@@@@@@@@@@@@@@@@@@@@@@@@@@@@@
@@@@@@@@@@@@@@@@@@@@@@@@@@@@@@@@@@@@@@@@@@@@@@@@@@@@
@@@@@@@@@@@@@@@@@@@@@@@@@@@@@@@@@@@@@@@@@@@@@@@@@@@@
@@@@@@@@@@@@@@@@@@@@@@@@@@@@@@@@@@@@@@@@@@@@@@@@@@@@
@@@@@@@@@@@@@@@@@@@@@@@@@@@@@@@@@@@@@@@@@@@@@@@@@@@@
@@@@@@@@@@@@@@@@@@@@@@@@@@@@@@@@@@@@@@@@@@@@@@@@@@@@
@@@@@@@@@@@@@@@@@@@@@@@@@@@@@@@@@@@@@@@@@@@@@@@@@@@@
@@@@@@@@@@@@@@@@@@@@@@@@@@@@@@@@@@@@@@@@@@@@@@@@@@@@
@@@@@@@@@@@@@@@@@@@@@@@@@@@@@@@@@@@@@@@@@@@@@@@@@@@@
@@@@@@@@@@@@@@@@@@@@@@@@@@@@@@@@@@@@@@@@@@@@@@@@@@@@
@@@@@@@@@@@@@@@@@@@@@@@@@@@@@@@@@@@@@@@@@@@@@@@@@@@@
@@@@@@@@@@@@@@@@@@@@@@@@@@@@@@@@@@@@@@@@@@@@@@@@@@@@
@@@@@@@@@@@@@@@@@@@@@@@@@@@@@@@@@@@@@@@@@@@@@@@@@@@@
@@@@@@@@@@@@@@@@@@@@@@@@@@@@@@@T@@@@@@@@@@@@@@@@@@@@
@@@@@@@@@@@@@@@@@@@@@@@@@@@..@TT.@@@@@@@@@@@@@@@@@@@
@@@@@@@@@@@@@@@@@@@@@@@@@@@..TTT@@@@@@@@@@@@@@@@@@@@
@@@@@@@@@@@@@@@@@@@@@@@@@@@@.TT.@@@T@@@@@@@@@@@@@@@@
@@@@@@@@@@@@@@@@@@@@@@@@@@@@.TTT@@TTTTT@@@@@@@@@@@@@
@@@@@@@@@@@@@@@@@@@@@@@@@@.TT...TTT..TT@@@@@@@@@@@@@
@@@@@@@@@@@@@@@@@@@@@@@@@.TT.TTTTT..T.T@@@@@@@@@@@@@
@@@@@@@@@@@@@@@@@@@@@@@@T..TT..TT.T.TT.@@T@@@@@@@@@@
@@@@@@@@@@@@@@@@@@@@@@@..T.TT.T.TTTT...T...@@@@@@@@@
@@@@@@@@@@@@@@@@@@@@@@TT..TTT.TT...TTT....T.@@@@@@@@
@@@@@@@@@@@@@@@@@@@@TT..T@@@.TT..TT.....TT...@@@@@@@
@@@@@@@@@@T.@@@@@@@TTTTT@@@@@....TTTTTTT.T..TT@@@@@@
@@@@@@@@@....@@.TTT...T@@@@@@@.TTT.TT..TT..TT.T@@@@@
@@@@@@@@..T.T@T.TT.TT.@@@@@@@..T..T.T.....T..T@@@@@@
@@@@@@@T....T@@....TT@@@@@@@..TTTT..T.TTTTTTT@@@@@@@
@@@@@@T..T..T.@.TTTT@@@@@@@T..T.TT.T..T..TTT@@@@@@@@
@@@@@@@TT.TT.T@@...@@@@@@@....TTTTT.T.TTT..@@@@@@@@@
@@@@@@@T.T...T.@.T@@@@@@@TTT....T...T.....@@@@@@@@@@
@@@@@@@@T...T.T@.T.@@@@TTTTT.TTTT.TT.TTTT@@@@@@@@@@@
@@@@@@@@.T....T@@TT.@@.T...TT.TTTT..TT..@@@@@@@@@@@@
@@@@@@@@@.T..TT.@T..@T...TTTTT..T..TTTT@@@@@@@@@@@@@
@@@@@@@@@..TTT.T@T..TT........TT.....T@@@@@@@@@@@@@@
@@@@@@@@@@..T.T......T.TTTT.TTT..TTTT@@@@@@@@@@@@@@@
@@@@@@@@@@TT.T.TTTT..TTT.T..T..T.TTT@@@@@@@@@@@@@@@@
@@@@@@@@@@@TTT.TTTT....T..T.TTT..TT@@@@@@@@@@@@@@@@@
@@@@@@@@@@@.TTT..TTTTTT.T....TTTTT@@@@@@@@@@@@@@@@@@
@@@@@@@@@@TT.TTTT.T..T..T..T.TTTT@@@@@@@@@@@@@@@@@@@
@@@@@@@@@..TT.T...T..T.T.T.T..TT@@@@@@@@@@@@@@@@@@@@
@@@@@@@@TTT..TTT.TTTT.T..TTT.TT@@@@@@@@@@@@@@@@@@@@@
@@@@@@@@.T.T.TT..TT...T.TTTTT.@@@@@@@@@@@@@@@@@@@@@@
@@@@@@@@@....TTT.....T.TTTTTT@@@@@@@@@@@@@@@@@@@@@@@
@@@@@@@@@@.T.T..TT..T..TTTT.@@@@@@@@@@@@@@@@@@@@@@@@
@@@@@@@@@@@TT..TTTTTT.T..TT@@@@@@@@@@@@@@@@@@@@@@@@@
@@@@@@@@@@@@..T.T.TTT.T.T.@@@@@@@@@@@@@@@@@@@@@@@@@@
@@@@@@@@@@@@@.T...T.T...T@@@@@@@@@@@@@@@@@@@@@@@@@@@
@@@@@@@@@@@@@@..TT.T....@@@@@@@@@@@@@@@@@@@@@@@@@@@@
@@@@@@@@@@@@@@@TTTTT.TT@@@@@@@@@@@@@@@@@@@@@@@@@@@@@
@@@@@@@@@@@@@@@@T...T.@@@@@@@@@@@@@@@@@@@@@@@@@@@@@@
@@@@@@@@@@@@@@@@@T.T.@@@@@@@@@@@@@@@@@@@@@@@@@@@@@@@
@@@@@@@@@@@@@@@@@@@@@@@@@@@@@@@@@@@@@@@@@@@@@@@@@@@@
