type octile
height 64
width 60
map
@@@@@@@@@@@@@@@@@@@@@@@@@@@@@@@@@@@@@@@@@@@@@@@@@@@@@@@@@@@@
@@@@@@@@@@@@@@@@@@@@@@@@@@@@@@@@@@@@@@@@@@@@@@@@@@@@@@@@@@@@
@@@@@@@@@@@@@@@@@@@@@@@@@@@@@@@@@@@@@@@@@@@@@@@@@@@@@@@@@@@@
@@@@@@@@@@@@@@@@@@@@@@@@@@@@@@@@@@@@@@@@@@@@@@@@@@@@@@@@@@@@
@@@@@@@@@@@@@@@@@@@@@@@@@@@@@@@@@@@@@@@@@@@@@@@@@@@@@@@@@@@@
@@@@@@@@@@@@@@@@@@@@@@@@@@@@@@@@@@@@@@@@@@@@@@@@@@@@@@@@@@@@
@@@@@@@@@@@@@@@@@@@@@@@@@@@@@@@@@@@@@@@@@@@@@@@@@@@@@@@@@@@@
@@@@@@@@@@@@@@@@@@@@@@@@@@@@@@@@@@@@@@@@@@@@@@@@@@@@@@@@@@@@
@@@@@@@@@@@@@@@@@@@@@@@@@@@@@@@@@@@@@@@@@@@@@@@@@@@@@@@@@@@@
@@@@@@@@@@@@@@@@@@@@@@@@@@@@@@@@@@@@@@@@@@@@@@@@@@@@@@@@@@@@
@@@@@@@@@@@@@@@@@@@@@@@@@@@@@@@@@@@@@@@@@@@@@@@@@@@@@@@@@@@@
@@@@@@@@@@@@@@@@@@@@@@@@@@@@@@@@@@@@@@@@@@@@@@@@@@@@@@@@@@@@
@@@@@@@@@@@@@@@@@@@@@@@@@@@@@@@@@@@@@@@@@@@@@@@@@@@@@@@@@@@@
@@@@@@@@@@@@@@@@@@@@@@@@@@@..T.@@@@@@@@@@@@@@@@@@@@@@@@@@@@@
@@@@@@@@@@@@@@@@@@@@@@@@@@TT.T...T@@@@@@@@@@@@@@@@@@@@@@@@@@
@@@@@@@@@@@@@@@@@@@@@@@@@@T.T.TTTT.@@@@@@@@@@@@@@@@@@@@@@@@@
@@@@@@@@@@@@@@@@@@@@@@@@@@...T....T..@@@@@@@@@@@@@@@@@@@@@@@
@@@@@@@@@@@@@@@@@@@@@@@@@@..TTT.T.TTTT.@@@@@@@@@@@@@@@@@@@@@
@@@@@@@@@@@@@@@@@@@@@@@@@@T..T.T.TTTTTTT@@@@@@@@@@@@@@@@@@@@
@@@@@@@@@@@@@@@@@@@@@@@@@@TTTTT...TTTTT.T@@@@@@@@@@@@@@@@@@@
@@@@@@@@@@@@@@@@@@@@@@@@@@TTT.TTTTTTTTTT.@@@.@@@@@@@@@@@@@@@
@@@@@@@@@@@@@@@@@@@@@@@@@TT..TT.T.T.TTTT.T..TT@@@@@@@@@@@@@@
@@@@@@@@@@@@@@@@@@@@@@@@@..TT..TTT..TT........@@@@@@@@@@@@@@
@@@@@@@@@@@@@@@.T...@@@@@.T...TTT...TT...T@..T.@@@@@@@@@@@@@
@@@@@@@@@@@@@@TTTTTT.@@@.TT.TT.TTT..@@@.TT@@T..@@@@@@@@@@@@@
@@@@@@@@@@@@@@@..TT.TT.TT..@@@@T..T@@@@.TT@@.T.@@@@@@@@@@@@@
@@@@@@@@@@@@@@@.T.T.T.TTTT.@@@@TT@@@@@@.T@@@T..@@@@@@@@@@@@@
@@@@@@@@@@@@@@@T.T.TTTTTT..@@@@@@@@@@@T..@@@TT.@@@@@@@@@@@@@
@@@@@@@@@@@@@@@TTT..T.@@@@@@@@@@@@@@@@@@@@@.T.T@@@@@@@@@@@@@
@@@@@@@@@@@@@@@TT..TTT@@@@@@@@@@@@@@@@@@@@.T.TT@@@@@@@@@@@@@
@@@@@@@@@@@@@.TT..TTTT@@@@@@@@@@@@@@@@@@@@T.T@@@@...T@@@@@@@
@@@@@@@@@@@@@..T...TT@@@@@@@@@@@@@@@@@@@@@...@@@TTT.TT@@@@@@
@@@@@@@@@@@@@.T....TTT@@@@@@@@@@@@@@@@@@@@@T.T@@TT..T.@@@@@@
@@@@@@@@@@@@@..T.TT.TT.@@@@@@@@@@@@@@@@TTT@@TT@@.T..TT@@@@@@
@@@@@@@@@@@@@T.....TT.@@@@@@@@@@@@@@@@@.T.@@.T...T.T.T@@@@@@
@@@@@@@@@@@@@@TT..TT.@@@@@@@T@@@@@@@@@@..T@@@T.....T..@@@@@@
@@@@@@@@@@@@@@@..T..@@@@@@@.TT@@@@@@@@@...T..T..TT.TTT@@@@@@
@@@@@@@@@@@@@@@@.TTT@@@@@@@.T..@@@@@@@@T.T...TT.....TT@@@@@@
@@@@@@@@@@@@@@@@@..@@@@@@@.T.T..@@@@@@TT.TTTT.TTTTTT..@@@@@@
@@@@@@@@@@@@@@@@@@@@@@@@@@T.@@@..@@.TT.TTTTT.T.T.T...T@@@@@@
@@@@@@@@@@@@@@@@@@@@@@@@@.T@@@@@.@@.T...TT.....T....T.@@@@@@
@@@@@@@@@@@@@@@@@@@@@@@@@TT@@@@@T.....TTT..TTTTTT.T..T@@@@@@
@@@@@@@@@@@@@@@@@@@@@@@@TT.@@@@...TT..TTTT..T.T.T..T.@@@@@@@
@@@@@@@@@@@@@@@@@@@@@@@@T.T@@@@T.T..T..T..T.TTT.T...@@@@@@@@
@@@@@@@@..TT@.TT@@@@@@@@T..T..T.TTTTT.TT.T.TTT.T...T@@@@@@@@
@@@@@@@@.TTTTT..T@@@@@@@@....T.T....TTT.T.TTTTT.TT.@@@@@@@@@
@@@@@@@@TT......T.T.@@@@..TTT.TTTT..T.TT..T.TT.TTT@@@@@@@@@@
@@@@@@@@TTT.T.TTT.TT@@.T...TTTT..TTTT...TTTT.T.T..@@@@@@@@@@
@@@@@@@@@TTTT....T..T.T..TT..TT.T.TTTTT.TTTT..TTT@@@@@@@@@@@
@@@@@@@@@@T..TT..TTTT..T..TT.T...TT.T.T.TT.TT...T@@@@@@@@@@@
@@@@@@@@@@@.T.T....T.T..T.TT.T....TTT.T.TTT.T.T.@@@@@@@@@@@@
@@@@@@@@@@@@.TT.TT.T..T.TTTTT..TT.TT.T.T..T...T@@@@@@@@@@@@@
@@@@@@@@@@@@@...TT.TT..T.T..T.T.T..TT....TT....@@@@@@@@@@@@@
@@@@@@@@@@@@@@T.T....TTTT.TT..TT.T.T.T..TT.T.T@@@@@@@@@@@@@@
@@@@@@@@@@@@@@@T.TT.TTT.T....TT.T.T..TT.T.T.T@@@@@@@@@@@@@@@
@@@@@@@@@@@@@@@@@T..TTTT...TT.TTT.TTTTT.T....@@@@@@@@@@@@@@@
@@@@@@@@@@@@@@@@@@@..T..T...T.T...T.T.....T.@@@@@@@@@@@@@@@@
@@@@@@@@@@@@@@@@@@@@@T.T.TTTT.T.T.TT...TT...@@@@@@@@@@@@@@@@
@@@@@@@@@@@@@@@@@@@@@@@@TTTTT.TT.TT.T......@@@@@@@@@@@@@@@@@
@@@@@@@@@@@@@@@@@@@@@@@@@@T....TTT.T.TTTT.@@@@@@@@@@@@@@@@@@
@@@@@@@@@@@@@@@@@@@@@@@@@@@@@@.T...TT.T.T@@@@@@@@@@@@@@@@@@@
@@@@@@@@@@@@@@@@@@@@@@@@@@@@@@@@@.T.TTTTT@@@@@@@@@@@@@@@@@@@
@@@@@@@@@@@@@@@@@@@@@@@@@@@@@@@@@@@@@@@@@@@@@@@@@@@@@@@@@@@@
@@@@@@@@@@@@@@@@@@@@@@@@@@@@@@@@@@@@@@@@@@@@@@@@@@@@@@@@@@@@
