type octile
height 86
width 88
map
@@@@@@@@@@@@@@@@@@@@@@@@@@@@@@@@@@@@@@@@@@@@@@@@@@@@@@@@@@@@@@@@@@@@@@@@@@@@@@@@@@@@@@@@
@@@@@@@@@@@@@@@@@@@@@@@@@@@@@@@@@@@@@@@@@@@@@@@@@@@@@@@@@@@@@@@@@@@@@@@@@@@@@@@@@@@@@@@@
@@@@@@@@@@@@@@@@@@@@@@@@@@@@@@@@@@@@@@@@@@@@@@@@@@@@@@@@@@@@@@@@@@@@@@@@@@@@@@@@@@@@@@@@
@@@@@@@@@@@@@@@@@@@@@@@@@@@@@@@@@@@@@@@@@@@@@@@@@@@@@@@@@@@@@@@@@@@@@@@@@@@@@@@@@@@@@@@@
@@@@@@@@@@@@@@@@@@@@@@@@@@@@@@@@@@@@@@@@@@@@@@@@@@@@@@@@@@@@@@@@@@@@@@@@@@@@@@@@@@@@@@@@
@@@@@@@@@@@@@@@@@@@@@@@@@@@@@@@@@@@@@@@@@@@@@@@@@@@@@@@@@@@@@@@@@@@@@@@@@@@@@@@@@@@@@@@@
@@@@@@@@@@@@@@@@@@@@@@@@@@@@@@@@@@@@@@@@@@@@@@@@@@@@@@@@@@@@@@@@@@@@@@@@@@@@@@@@@@@@@@@@
@@@@@@@@@@@@@@@@@@@@@@@@@@@@@@@@@@@@@@@@@@@@@@@@@@@@@@@@@@@@@@@@@@@@@@@@@@@@@@@@@@@@@@@@
@@@@@@@@@@@@@@@@@@@@@@@@@@@@@@@@@@@@@@@@@@@@@@@@@@@@@@@@@@@@@@@@@@@@@@@@@@@@@@@@@@@@@@@@
@@@@@@@@@@@@@@@@@@@@@@@@@@@@@@@@@@@@@@@@@@@@@@@@@@@@@@@@@@@@@@@@@@@@@@@@@@@@@@@@@@@@@@@@
@@@@@@@@@@@@@@@@@@@@@@@@@@@@@@@@@@@@@@@@@@@@@@@@@@@@@@@@@@@@@@@@@@@@@@@@@@@@@@@@@@@@@@@@
@@@@@@@@@@@@@@@@@@@@@@@@@@@@@@@@@@@@@@@@@@@@@@@@@@@@@@@@@@@@@@@@@@@@@@@@@@@@@@@@@@@@@@@@
@@@@@@@@@@@@@@@@@@@@@@@@@@@@@@@TT@@@@@@@@@@@@@@@@@@@@@@@@@@@@@@@@@@@@@@@@@@@@@@@@@@@@@@@
@@@@@@@@@@@@@@@@@@@@@@@@@@@@@@@T..@@@@@@@@@@@@@@@@@@@@@@@@@@@@@@@@@@@@@@@@@@@@@@@@@@@@@@
@@@@@@@@@@@@@@@@@@@@@@@@@@@@@@TTTTT@@@@@@@@@@@@@@@@@@@@@@@@@@@@@@@@@@@@@@@@@@@@@@@@@@@@@
@@@@@@@@@@@@@@@@@@@@@@@@@@@@@.TTTT.T@@@@@@@@@@@@@@@@@@@@@@@@@@@@@@@@@@@@@@@@@@@@@@@@@@@@
@@@@@@@@@@@@@@@@@@@@@@@@@@@@....T..T.@@@..@@@@@@@@@@@@@@@@@@@@@@@@@@@@@@@@@@@@@@@@@@@@@@
@@@@@@@@@@@@@@@@@@@@@@@@@@@TT.T.@@.....TT.@@@@@@@@@@@@@@@@@@@@@@@@@@@@@@@@@@@@@@@@@@@@@@
@@@@@@@@@@@@@@@@@@@@@@@@@@.TT.T@@@T.T...T.T@@@@@@@@@@@@@@@@@@@@@@@@@@@@@@@@@@@@@@@@@@@@@
@@@@@@@@@@@@@@@@@@@@@@@@@.TT..@@@..T.....TTTT@@@@@@@@@@@@@@@@@@@@@@@@@@@@@@@@@@@@@@@@@@@
@@@@@@@@@@@@@@@@@@@@@@@@..TTT@@@.TTT...TTTTT..@@@@@@@@@@@@@@@@@@@@@@@@@@@@@@@@@@@@@@@@@@
@@@@@@@@@@@@@@@@@@@@@@@@@...@@@.T.T..@@TTT..T.@@@@@@@@@@@@@@@@@@@@@@@@@@@@@@@@@@@@@@@@@@
@@@@@@@@@@@@@@@@@@@@@@.@@TT@@@...T.T.@@@.T..T..@@@@@@@@@@@@@@@@@@@@@@@@@@@@@@@@@@@@@@@@@
@@@@@@@@@@@@@@@@@@@@@T.T@@@@@TT.T.TT@@@@@....T@@@@@@@@@@@@@@@@@@@@@@@@@@@@@@@@@@@@@@@@@@
@@@@@@@@@@@@@@@@@@@@..T.@@@@TTT.T..@@@@@@TT..@@@@@@@@@@@@@@@@@@@@@@@@@@@@@@@@@@@@@@@@@@@
@@@@@@@@@@@@@@@@@@@.TTTT.TT.TT..T..@@@@@..T.@@@@@@@@@@@@@@@@@@@@@@@@@@@@@@@@@@@@@@@@@@@@
@@@@@@@@@@@@@@@@@@.TTT.TTTT..TTT.TTT.@@@....@@@@@@@@@@@@@@@@@@@@@@@@@@@@@@@@@@@@@@@@@@@@
@@@@@@@@@@@@@@@@@.T..TT..TT.TTT..TT..T@@@T.@@@@@@.@@T@@@@@@@@@@@@@@@@@@@@@@@@@@@@@@@@@@@
@@@@@@@@@@@@@@@@T.T..T.T.T.T.TT.TTT...T@..@@@@@@@..@..@@@@@@@@@@@@@@@@@@@@@@@@@@@@@@@@@@
@@@@@@@@@@@@@@@....TT.TT..T.T.TT.TTT.TTT..@@@@@@@@T.TT@@@@@@@@@@@@@@@@@@@@@@@@@@@@@@@@@@
@@@@@@@@@@@@@@@...TT.TT..T.T...TT..T.T..T@@@@@@@@..T..T@@@@@@@@@@@@@@@@@@@@@@@@@@@@@@@@@
@@@@@@@@@@@@@@@@T.T..TTT.T.T...TT...TT..@@@@@@@@TT.TT..TT@@@@@@@@@@@@@@@@@@@@@@@@@@@@@@@
@@@@@@@@@@@@@@@@@@T..T.TT.T..T...TT..T@@@@@@@@@T.T.T..T....@@@@@@@@@@@@@@@@@@@@@@@@@@@@@
@@@@@@@@@@@@@@@@@@@@@T.TTTT..TTTT.TTT.@@@@@@@@@T.TT..TT....@@@@@@@@@@@@@@@@@@@@@@@@@@@@@
@@@@@@@@@@T@@@@@@@@@@TT.T.TT.TT..TT..T@@@@@@@@@T.T.T......@@@@@@@@@@@@@@@@@@@@@@@@@@@@@@
@@@@@@@@..T.@@@@@@@@@.T.TT...TT.....T@@@@@@@@TT.TTT.TT...T@@@.@@@@@@@@@@@@@@@@@@@@@@@@@@
@@@@@@@TT.T..@@@@@@@@@@@....T.T..T..@@@@@@.T.TT..T.TTT...TT.T.T@@@@@@@@@@@@@@@@@@@@@@@@@
@@@@@@.T.TTTT.@@@@@@T@@@T..TT.T.TT.T@@@.@@.T.TT.T....TT......TT@@@@@@@@@@@@@@@@@@@@@@@@@
@@@@@...T.TTTTT@@@@TT@@TTT...T.....@@@TT..TTT....@@@@.TT.T.T.TT.@@@@@@@@@@@@@@@@@@@@@@@@
@@@@TTT.T.TTTTTT.@.T@@.TT....TTT.TT@@@..T...T...T@@@@@.TTTT.T.TTT.@@@@@@@@@@@@@@@@@@@@@@
@@@..T....T.T..T....@.T.T.T.TT.@TT.T.@..TT.......TT.@@@.T.T.T.TTT..@@@@@@@@@@@@@@@@@@@@@
@@@T...TT.TT.TTTT.TTT...T.T...@@T...T@TT.T..TT.T.TT.@@@..TTTTT.T..T@@@@@@@@@@@@@@@@@@@@@
@@@TT....TT....T.TT.T.T...TT.@@@@@TTT.TTTTTTTT.TT....@@@T...T.TT..T@@@@@@@@@@@@@@@@@@@@@
@@@@TTT.TT...T..TT.TT..TT..T@@@@@@@TT.T.T.T.T.T.TTT..T@T...T...T.T@@@@@@@@@@@@@@@@@@@@@@
@@@@@T....T...T.....T.TTT..@@@@T.@@....T..T..TTT.TT..TT.TT.T..T.T.@@@@@@@@@@@@@@@@@@@@@@
@@@@@@.....T.T..TT..T.TT..@@@@TTT...T...TTTTTTTT.T.T.......TTTTT@@@@@@@@@@@@@@@@@@@@@@@@
@@@@@@@TT..T.T.TT.TTTTTTT@@@@@.T.TTT.T.....TT..TT..T.TT.TTTT.TT@@@@@T.@@@@@@@@@@@@@@@@@@
@@@@@@@@T......T.T.T...T@@@@@@@.TT..TTT..TT.TTT.....T.......T.@@@@@.T.T@@@@@@@@@@@@@@@@@
@@@@@@@@@..T.TTT.TT.T..@@@@@@@@.T..T.T.TT.@@@.T.T.TT.TT...TT.@@@@@@.TTTT@@@@@@@@@@@@@@@@
@@@@@@@@@@TT.....T.TT.@@@@@@@@...TTT.TTT..@@@TTT.TT..TTT.TT.@@@@@@@.T..TT@@@@@@@@@@@@@@@
@@@@@@@@@@@.T.TT.....@@@@@@@@@TT...T..TTTT@@@.T..TT.T.TT.TT@@@@@@T.T..T..T@@@@@@@@@@@@@@
@@@@@@@@@@@@T..TTT@@@@@@@@@@.T.TTT.T...TT.T.TTTT..T.T..T.@@@@@@@@.@@@@.....T.T@@@@@@@@@@
@@@@@@@@@@@@@....T@@@@@@@@@@TT.T.TT...TTT.T....TTT..T.TTT@@@@@@@@.@@@@@..T.T.T@@@@@@@@@@
@@@@@@@@@@@@@@.T.@@@@@@@@@@...TT.T.T..TTT..T....TT...T..@@@@@@@@T.@@@@@@.T..TT@@@@@@@@@@
@@@@@@@@@@@@@@@@@@@@@@@@@.TT....T..T.T..TTTT.TTT.TT...@@@@@@@@@.TT@@@@@@@TT...@@@@@@@@@@
@@@@@@@@@@@@@@@@@@@@....T.T.T....T.T..TT.TTT....T...T@@@@@@@@@TTT.@@@@@@@..TT...@@@@@@@@
@@@@@@@@@@@@@@@@@@@T.....TTTTT.TTTTTTTT.T.T.TTT...T.T@@@@@@@@@.T.T@@@@@@@.TTT...@@@@@@@@
@@@@@@@@@@@@@@@@@@TTT....T.TTT.T...TT.....TT..TTT..T..@@.TT..T.T..T@@@@@..TTT..TT@T.@@@@
@@@@@@@@@@@@@@@@@@@TTTT.T.TTT.T.TTTT.T.TTT..T..TTTTTTT.TTTTT..TTTT...T.T.TTT@@TT..TTT@@@
@@@@@@@@@@@@@@@@@@@@...TTTT..TTTT...TTTT.TTTTT..T@@.T.TTT...T.TTT.....T.T..@@@TT.T.@@@@@
@@@@@@@@@@@@@@@@@@@@@..T....T.T...TT.TT....TTTT.@@@@TTT.....TTT.TT...TT.T.@@@.T...@@@@@@
@@@@@@@@@@@@@@@@@@@@@@T.TT.TT..T..T.TTT.TT..T..@@@@@.TTTT.T...T.T.T.TTT..@@@..T..@@@@@@@
@@@@@@@@@@@@@@@@@@@@@@@TTTT.TT..TT.TT...T.TTTT@@@@@@TTT.T........T.T..T.@@@...TT@@@@@@@@
@@@@@@@@@@@@@@@@@@@@@@@@T....T.TT..T...T..TTT@@@@@@@TT.T.T..T..T...T.TT@@@T.T..@@@@@@@@@
@@@@@@@@@@@@@@@@@@@@@@@@@TTT.TTTTTTT....T.TT@@@@@@@.....TTTTTTTT.T.T.T@@@TT..T.@@@@@@@@@
@@@@@@@@@@@@@@@@@@@@@@@@@@TTTT.T....TTTTT..@@@@@@@TT.TTT...TT.T.TTT..@@@T...T.@@@@@@@@@@
@@@@@@@@@@@@@@@@@@@@@@@@@@@T.T..TTT..T.T.@@@@@@@T.T...TTTT..TTTT...T@@@.TTTT.@@@@@@@@@@@
@@@@@@@@@@@@@@@@@@@@@@@@@@@@....TT..TTTTT@@@@@@@TT..TT.T.T..TTTT..TT@@@T.TT.@@@@@@@@@@@@
@@@@@@@@@@@@@@@@@@@@@@@@@@@@@TTTT.T...TT@@@@@@@.TTT.TT..TTTT.T...TTTTT@@.T.@@@@@@@@@@@@@
@@@@@@@@@@@@@@@@@@@@@@@@@@@@@@T.TT....T@@@@@@@.TT.TTT.T.TT...T.T...TT.@@@T@@@@@@@@@@@@@@
@@@@@@@@@@@@@@@@@@@@@@@@@@@@@@@T....T@@@@@@@T.T.T....T@....TTT.....T..T@@@@@@@@@@@@@@@@@
@@@@@@@@@@@@@@@@@@@@@@@@@@@@@@@@.TT.T@@@@@@@.TTTT.T..@@.T..TTT....TTT..@@@@@@@@@@@@@@@@@
@@@@@@@@@@@@@@@@@@@@@@@@@@@@@@@@@TT.@@@@@@@TT.T..TTTT.TT@.T.T..T.TT...@@@@@@@@@@@@@@@@@@
@@@@@@@@@@@@@@@@@@@@@@@@@@@@@@@@@@.@@@@@.T.T...T...TT@@@@@@..T.TTTT.T@@@@@@@@@@@@@@@@@@@
@@@@@@@@@@@@@@@@@@@@@@@@@@@@@@@@@@@@@@@....T..T....T@@@@@@@@TTT...T.@@@@@@@@@@@@@@@@@@@@
@@@@@@@@@@@@@@@@@@@@@@@@@@@@@@@@@@@@@@.T.T.TTTTTTTT@@@@@@@@@@T.T.T.@@@@@@@@@@@@@@@@@@@@@
@@@@@@@@@@@@@@@@@@@@@@@@@@@@@@@@@@@@@TTT...TTT.T.TT@@@@@@@@@@@....@@@@@@@@@@@@@@@@@@@@@@
@@@@@@@@@@@@@@@@@@@@@@@@@@@@@@@@@@@@@@..TTT...T..TT.T@@@@@@@@@@T.@@@@@@@@@@@@@@@@@@@@@@@
@@@@@@@@@@@@@@@@@@@@@@@@@@@@@@@@@@@@@@@T...T.TTT....T.TT..@@@@@@@@@@@@@@@@@@@@@@@@@@@@@@
@@@@@@@@@@@@@@@@@@@@@@@@@@@@@@@@@@@@@@@@TTT..T..T...TTT.TT.@@@@@@@@@@@@@@@@@@@@@@@@@@@@@
@@@@@@@@@@@@@@@@@@@@@@@@@@@@@@@@@@@@@@@@@..T..T..TTTT..TTTT.@@@@@@@@@@@@@@@@@@@@@@@@@@@@
@@@@@@@@@@@@@@@@@@@@@@@@@@@@@@@@@@@@@@@@@@TT...T..TTTT.TTTTTT@@@@@@@@@@@@@@@@@@@@@@@@@@@
@@@@@@@@@@@@@@@@@@@@@@@@@@@@@@@@@@@@@@@@@@@.TT...TT....TTT..@@@@@@@@@@@@@@@@@@@@@@@@@@@@
@@@@@@@@@@@@@@@@@@@@@@@@@@@@@@@@@@@@@@@@@@@@.TTT....TT.TT.T@@@@@@@@@@@@@@@@@@@@@@@@@@@@@
@@@@@@@@@@@@@@@@@@@@@@@@@@@@@@@@@@@@@@@@@@@@@T..TTTT.T.TT.@@@@@@@@@@@@@@@@@@@@@@@@@@@@@@
@@@@@@@@@@@@@@@@@@@@@@@@@@@@@@@@@@@@@@@@@@@@@@@@@@@@@@@@@@@@@@@@@@@@@@@@@@@@@@@@@@@@@@@@
