type octile
height 54
width 52
map
@@@@@@@@@@@@@@@@@@@@@@@@@@@@@@@@@@@@@@@@@@@@@@@@@@@@
@@@@@@@@@@@@@@@@@@@@@@@@@@@@@@@@@@@@@@@@@@@@@@@@@@@@
@@@@@@@@@@@@@@@@@@@@@@@@@@@@@@@@@@@@@@@@@@@@@@@@@@@@
@@@@@@@@@@@@@@@@@@@@@@@@@@@@@@@@@@@@@@@@@@@@@@@@@@@@
@@@@@@@@@@@@@@@@@@@@@@@@@@@@@@@@@@@@@@@@@@@@@@@@@@@@
@@@@@@@@@@@@@@@@@@@@@@@@@@@@@@@@@@@@@@@@@@@@@@@@@@@@
@@@@@@@@@@@@@@@@@@@@@@@@@@@@@@@@@@@@@@@@@@@@@@@@@@@@
@@@@@@@@@@@@@@@@@@@@@@@@@@@@@@@@@@@@@@@@@@@@@@@@@@@@
@@@@@@@@@@@@@@@@@@@@@@@@@@@@@@@@@@@@@@@@@@@@@@@@@@@@
@@@@@@@@@@@@@@@@@@@@@@@@@@@@@@@@@@@@@@@@@@@@@@@@@@@@
@@@@@@@@@@@@@@@@@@@@@@@@@@@@@@@@@@@@@@@@@@@@@@@@@@@@
@@@@@@@@@@@@@@@@@@@@@@@@@@@@@@@.@@@@@@@@@@@@@@@@@@@@
@@@@@@@@@@@@@@@@@@@@@@@@@@@@@@..T@@@@@@@@@@@@@@@@@@@
@@@@@@@@@@@@@@@@@@@@@@@@@@@@@...T.@@@@@@@@@@@@@@@@@@
@@@@@@@@@@@@@@@@@@@@@@@@@@@@@..TT..@@@@@@@@@@@@@@@@@
@@@@@@@@@@@@@@@@@@@@@@@@@@@@T.T...@@@@@@@@@@@@@@@@@@
@@@@@@@@@@@@@@@@@@@@@@@@@@@T...TTTT@@@@@@@@@@@@@@@@@
@@@@@@@@@@@@@@@@@@@@@@@@@TT.TT..T.T.@@@@@@@@@@@@@@@@
@@@@@@@@@@@@@@@@@@@@@@@@T..TT....TT.T@@.@@@@@@@@@@@@
@@@@@@@@@@@@@@@@@@@@@@@TT....TT.TT.T.T..T@@@@@@@@@@@
@@@@@@@@@@@@@@@@@@@@@@...TT.T.TT@@T..T..T@@@@@@@@@@@
@@@@@@@@@@@@@@@@@@@@@.TTTTTT.T@@@@.T...T@@@@@@@@@@@@
@@@@@@@@@@@@@@@@@@@@@@T..TTT@@@@@@...TT@@@@@@@@@@@@@
@@@@@@@@@@@@@@@@@@@@@@...TT.@@@@@@.....@@@@@@@@@@@@@
@@@@@@@@@@@@@@@@@@@@@....T...@@@@@@TTT..@@@@@@@@@@@@
@@@@@@@@@@@@@@@@@@@@TT.TT.TTTT@@@@@TT.T..@@@@@@@@@@@
@@@@@@@@@@@@@@@@@@@...TT.TTTT.T..@@.......@@@@@@@@@@
@@@@@@@@@@@@@@@@@@T.T..TT.T..TT.T.TTT.T.TTT@@@@@@@@@
@@@@@@@@@@@@@T@@T.TTTT...T..T.T...TT.T.T....@@@@@@@@
@@@@@@@@@TT.TTT.TT.TT..T.T..TT.T.TTTTTT.TTT@@@@@@@@@
@@@@@@@@@@..T.TTT.@....TTT.TT....T.TTTTT..@@@@@@@@@@
@@@@@@@@@@@@..TT.@@@TT.TT.T.....TTT..TT.T@@@@@@@@@@@
@@@@@@@@@@@@@@.T@@@@@TT.TTTT...TT....T..@@@@@@@@@@@@
@@@@@@@@@@@@@@@@@@@@@@T...TTT.T.TTT....@@@@@@@@@@@@@
@@@@@@@@@@@@@@@@@@@@@@@TT.TTTTT.T....T@@@@@@@@@@@@@@
@@@@@@@@@@@@@@@@@@@@@@@@T..T..TTTTTTT@@@@@@@@@@@@@@@
@@@@@@@@@@@@@@@@@@@@@@@@@TTTT.T...TT@@@@@@@@@@@@@@@@
@@@@@@@@@@.@@@@@@@@@@@@@@@TTT.T.T..@@@@@@@@@@@@@@@@@
@@@@@@@@@TT.@@@@@@@@@@@@@@T..T.T.T@@@@@@@@@@@@@@@@@@
@@@@@@@@@T.T.@@@@@@@@@@@@..TT..T.@@@@@@@@@@@@@@@@@@@
@@@@@@@@@@TTT.@@@@@@@@@@TT....T.@@@@@@@@@@@@@@@@@@@@
@@@@@@@@@@@TTTT@@@@@@@@...TTTT.@@@@@@@@@@@@@@@@@@@@@
@@@@@@@@@@@@..T.@@@@@@TTTTT.T.@@@@@@@@@@@@@@@@@@@@@@
@@@@@@@@@@@@@..TT@@@@.T...TTT@@@@@@@@@@@@@@@@@@@@@@@
@@@@@@@@@@@@@@.T..@@..T...TT@@@@@@@@@@@@@@@@@@@@@@@@
@@@@@@@@@@@@@@@TTT..TTTT.T.@@@@@@@@@@@@@@@@@@@@@@@@@
@@@@@@@@@@@@@@@@.T...T.T..@@@@@@@@@@@@@@@@@@@@@@@@@@
@@@@@@@@@@@@@@@@@TT.TTTTT@@@@@@@@@@@@@@@@@@@@@@@@@@@
@@@@@@@@@@@@@@@@@@.TTTTT@@@@@@@@@@@@@@@@@@@@@@@@@@@@
@@@@@@@@@@@@@@@@@@@TTTT@@@@@@@@@@@@@@@@@@@@@@@@@@@@@
@@@@@@@@@@@@@@@@@@@@@@@@@@@@@@@@@@@@@@@@@@@@@@@@@@@@
@@@@@@@@@@@@@@@@@@@@@@@@@@@@@@@@@@@@@@@@@@@@@@@@@@@@
@@@@@@@@@@@@@@@@@@@@@@@@@@@@@@@@@@@@@@@@@@@@@@@@@@@@
@@@@@@@@@@@@@@@@@@@@@@@@@@@@@@@@@@@@@@@@@@@@@@@@@@@@
