type octile
height 80
width 80
map
@@@@@@@@@@@@@@@@@@@@@@@@@@@@@@@@@@@@@@@@@@@@@@@@@@@@@@@@@@@@@@@@@@@@@@@@@@@@@@@@
@@@@@@@@@@@@@@@@@@@@@@@@@@@@@@@@@@@@@@@@@@@@@@@@@@@@@@@@@@@@@@@@@@@@@@@@@@@@@@@@
@@@@@@@@@@@@@@@@@@@@@@@@@@@@@@@@@@@@@@@@@@@@@@@@@@@@@@@@@@@@@@@@@@@@@@@@@@@@@@@@
@@@@@@@@@@@@@@@@@@@@@@@@@@@@@@@@@@@@@@@@@@@@@@@@@@@@@@@@@@@@@@@@@@@@@@@@@@@@@@@@
@@@@@@@@@@@@@@@@@@@@@@@@@@@@@@@@@@@@@@@@@@@@@@@@@@@@@@@@@@@@@@@@@@@@@@@@@@@@@@@@
@@@@@@@@@@@@@@@@@@@@@@@@@@@@@@@@@@@@@@@@@@@@@@@@@@@@@@@@@@@@@@@@@@@@@@@@@@@@@@@@
@@@@@@@@@@@@@@@@@@@@@@@@@@@@@@@@@@@@@@@@@@@@@@@@@@@@@@@@@@@@@@@@@@@@@@@@@@@@@@@@
@@@@@@@@@@@@@@@@@@@@@@@@@@@@@@@@@@@@@@@@@@@@@@@@@@@@@@@@@@@@@@@@@@@@@@@@@@@@@@@@
@@@@@@@@@@@@@@@@@@@@@@@@@@@@@@@@@@@@@@@@@@@@@@@@@@@@@@@@@@@@@@@@@@@@@@@@@@@@@@@@
@@@@@@@@@@@@@@@@@@@@@@@@@@@@@@@@@@@@@@@@@@@@@@@@@@@@@@@@@@@@@@@@@@@@@@@@@@@@@@@@
@@@@@@@@@@@@@@@@@@@@@@@@@@@@@@@@@@@@@@@@@@@@@@@@@@@@@@@@@@@@@@@@@@@@@@@@@@@@@@@@
@@@@@@@@@@@@@@@@@@@@@@@@@@@@@@@@@@@@@@@@@@@@@@@@@@@@@@@@@@@@@@@@@@@@@@@@@@@@@@@@
@@@@@@@@@@@@@@@@@@@@@@@@@@@@@@@@@@@@@@@@@@@@@@@@@@@@@@@@@@@@@@@@@@@@@@@@@@@@@@@@
@@@@@@@@@@@@@@@@@@@@@@@@@@@@@@@@@@@@@@@@@@@@@@@@@@@@@@@@@@@@@@@@@@@@@@@@@@@@@@@@
@@@@@@@@@@@@@@@@@@@@@@@@@@@@@@@@@@@@@@@@@@@@@@@@@@@.TT@@@@@@@@@@@@@@@@@@@@@@@@@@
@@@@@@@@@@@@@@@@@@@@@@@@@@@@@@@@@@@@@@@@@@@@@@@@@@TTT.T@@@@@@@@@@@@@@@@@@@@@@@@@
@@@@@@@@@@@@@@@@@@@@@@@@@@@@@@@@@@@@@@@@@@@@@@@@@T.TT...@@@@@@@@@@@@@@@@@@@@@@@@
@@@@@@@@@@@@@@@@@@@@@@@@@@@@@@@@@@@@@@@@@@@@@@@@T.TT..TTT@@@@@@@@@@@@@@@@@@@@@@@
@@@@@@@@@@@@@@@@@@@@@@@@@@@@@@@@@@@@@@@@@@@@@@@TT.T.TT..T.@@@@@@@@@@@@@@@@@@@@@@
@@@@@@@@@@@@@@@@@@@@@@@@@@@@@@@@@@@@@@@@@@@@T@TT...T...T.T.@@@@@@@@@@@@@@@@@@@@@
@@@@@@@@@@@@@@@@@@@@@@@@@@@@@@@@@@@@@@@@@@@@.TTTT.T.....T..TT.@@@@@@@@@@@@@@@@@@
@@@@@@@@@@@@@@@@@@@@@@@@@@@@@@@@@@@@@@@@@@@.T..TT.T..TT.T.TT...@@@@@@@@@@@@@@@@@
@@@@@@@@@@@@@@@@@@@@@@@@@@@@@@@@@@@@@@@@@@..T.T.T.TT.TTTTT.T..@@@@@@@@@@@@@@@@@@
@@@@@@@@@@@@@@@@@@@@@@@@@@@@@@@@@@@@@@@@..TT...T.T.......T.TT@@@@.T@@@@@@@@@@@@@
@@@@@@@@@@@@@@@@@@@@@@@@@@@@@@@@@@@@@@@T..T.TT..TT.T.TT..T.T@@@@.T..@@@@@@@@@@@@
@@@@@@@@@@@@@@@@@@@@@@@@@@@@@@@@@@@@@@@.T.T..T.TTTTTT.TT..T@@@@..T..T@@@@@@@@@@@
@@@@@@@@@@@@@@@@@@@@@@@@@@@@@@@@@@@@@@@@T..T..TTTT.TT.T.T.@@@@TT..TT.T@@@@@@@@@@
@@@@@@@@@@@@@@@@@@@@@@@@@@@@@@@@@@@@@@@@@TTT.T.....TT...T@@@@..TT..T.T.@@@@@@@@@
@@@@@@@@@@@@@@@@@@@@@@@@@@@@@@@@@@@@T@@@@.TT.T...TT.T..T@@@T.TT.@@T.T..T@@@@@@@@
@@@@@@@@@@@@@@@@@@@@@@@@@@@@@@@@@@TT.T.@@@TTT.T.T..TTT.@@@..T..T@@@@TTT..@@@@@@@
@@@@@@@@@@@@@@@@@@@@@@@@@@@@@@@@@.T....TT.TTT.TT....TT@@@T..TTT@@@@@....TT@@@@@@
@@@@@@@@@@@@@@@@@@@@@@@@@@@@@.T@@.TT.T....TTTTT.TT.T.@@@TT.TTT.@@@@@TT...TT@@@@@
@@@@@@@@@@@@@@@@@@@@@@@@@@@@TT....TT.TT...T..TT..T.T@@@T..T.T..@@@@@@...T...@@@@
@@@@@@@@@@@@@@@@@@@@@@@@@@@..T.@@@.TT.TT...@@@..T.T@@@TTT.TTTT.@@@@@@.T.T....@@@
@@@@@@@@@@@@@@@@@@@@@@@@@@T..@@@@@@@.TTTTTT.@@@.TT@@@..TT.....T@@..@.TTT.T.TTT@@
@@@@@@@@@@@@@@@@@@@@@@@@@..TT@@@@@@@@...TT.T.@@@T@@@T...TT..T.T.TT.T...T...TT@@@
@@@@@@@@@@@@@@@@@@@@@@@@.TT.T.@@@@@@@@.TT.....@@@@@T.TT@@@@..T.T.T.TT.T.T...@@@@
@@@@@@@@@@@@@@@@@@@@@@@.TTTTTT..@@@@@@@.TTTTTT.@@@T.T..@@@@.TTTT..TTTT..T.T@@@@@
@@@@@@@@@@@@@@@@@@@@@@T.@@@@...TT@@@@@@@T.T.T..T@T..T..@@@@@TTTTTT.T.TT...@@@@@@
@@@@@@@@@@@@@@@@@@@@@T.@@@@@@TT...@@@@@@@T..T.TTTT....T@@@@@@....T.T..TTT@@@@@@@
@@@@@@@@@@@@@@@@@@@@TTT@@@@@@T.TT..@@@@@@@T.TT.T...T...@@@@@@TT..T.T.T..@@@@@@@@
@@@@@@@@@@@@@@@@@@@.T...@@@@@TTTTTT.@@@@@@..TT.TT.TTTT.@@@@@@.T......T.@@@@@@@@@
@@@@@@@@@@@@@@@@@@..TTT@@@@@@@T..T...@@@@@@.TTTT.TTT.T.T...TTTTT..TTT.@@@@@@@@@@
@@@@@@@@@@@@@@@@@.T@@TT@@@@@@@.T...TTT@@@@@.TT.TTT..T.T.....TTT..T.TT@@@@@@@@@@@
@@@@@@@@@@@@@@@@.T.@@.TTTTT.TTTT...T.TT@@@.....TTTT.TTTT.T..T..TTTTT@@@@@@@@@@@@
@@@@@@@@@@@@@@@..TT@@TT.TTT.T..TT.TTT..TT@T.TTT...T.TTTT.TT.TTT...T@@@@@@@@@@@@@
@@@@@@@@@@@@@@.TTT....TT.T.....TT.T.TT.T.T....T.TT.T..TTTT.TT..T..@@@@@@@@@@@@@@
@@@@@@@@@@@@@T...TTT.TT.....T.T@@@@@.TTT.TTTTT...TT...TTTTTT.T..T@@@@@@@@@@@@@@@
@@@@@@@@@@@T@@TTT.....T.T.....T@@@@@@....T...T.TT.TTT....T...TTT@@@@@@@@@@@@@@@@
@@@@@@@@@@T..@T...TT.T.TTT.T..T.@@@@@T.T..T...T..T...TT.T....TT@@@@@@@@@@@@@@@@@
@@@@@@@@@.T..@@..@@@@..T.T.TT.T.@@@@@@..T..T.TT...T.TT..TTTTT.@@@@@@@@@@@@@@@@@@
@@@@@@@@....T.@T@@@@@@TT.T....TTT@@@@@.T...TT...T....TTTTTTTT@@@@@@@@@@@@@@@@@@@
@@@@@@@T..TT..@T@@@@@@..T...T.T.TT.@@T..T.TTT..TTTTTT.T.TT.T@@@@@@@@@@@@@@@@@@@@
@@@@@@T....TTT@@@@@@@@T.T.T.T.T.T...T...T...TTT.T.TT...T..T@@@@@@@@@@@@@@@@@@@@@
@@@@@T.TT..T..T@@@@@@@T.TTT..TT..T....TT.T.T.T..T.T@..TTT.@@@@@@@@@@@@@@@@@@@@@@
@@@@@@T...T.T.T@@@.@@.TT...@.TTTT..TT.T.T..TT..TT.T@..T.T@@@@@@@@@@@@@@@@@@@@@@@
@@@@@@.TTT.TT..T.TT.TT.T...@..........T..T.T.TTTT...T..T@@@@@@@@@@@@@@@@@@@@@@@@
@@@@@@@T.T...T..TT.TTTTTT....T......T.TT.TT.TTT..T.T.TT@@@@@@@@@@@@@@@@@@@@@@@@@
@@@@@@@....TT.TT.TT.T...T....T.T..@@@@.TT...TT..TTTT.T@@@@@@@@@@@@@@@@@@@@@@@@@@
@@@@@@@@TT.T.T..TT.T.TT.T.T...TT.T@@@@@@@..T.T......T@@@@@@@@@@@@@@@@@@@@@@@@@@@
@@@@@@@@T.T..T....T..T.TT.TT.@TT.....@@@@.T...TT.TT.@@@@@@@@@@@@@@@@@@@@@@@@@@@@
@@@@@@@@@T.T.TTTTTTT..T.TT.@@@@@....T.T.....TTTT..T@@@@@@@@@@@@@@@@@@@@@@@@@@@@@
@@@@@@@@@T.TT.T..TT..TT.T..@@@@@...TTT.TT...T.T...@@@@@@@@@@@@@@@@@@@@@@@@@@@@@@
@@@@@@@@@@TT.TTTTTTTTT.T.T.@@@@@TT.T.TT.TTT..TT..@@@@@@@@@@@@@@@@@@@@@@@@@@@@@@@
@@@@@@@@@@T.......T..TTTT..@@@@@TT.T..TTT.T..TT.@@@@@@@@@@@@@@@@@@@@@@@@@@@@@@@@
@@@@@@@@@@.....T..TT........T@@@T.TTTT.TT.T.T..@@@@@@@@@@@@@@@@@@@@@@@@@@@@@@@@@
@@@@@@@@@@.TTT...T.....TTTT..T.TTT.TTT......T.@@@@@@@@@@@@@@@@@@@@@@@@@@@@@@@@@@
@@@@@@@@@@T.T.TTTT..TT.T.TTTTTTT..T.TTT.TTT.T@@@@@@@@@@@@@@@@@@@@@@@@@@@@@@@@@@@
@@@@@@@@@@@T.TT.T.T.TT.T........T.......T.TT@@@@@@@@@@@@@@@@@@@@@@@@@@@@@@@@@@@@
@@@@@@@@@@@@.....TT.TT.T.T.T..TTT.T.TTTTT..@@@@@@@@@@@@@@@@@@@@@@@@@@@@@@@@@@@@@
@@@@@@@@@@@@@TTTT.TTT.T.T.TTT.T.T..T.T...T@@@@@@@@@@@@@@@@@@@@@@@@@@@@@@@@@@@@@@
@@@@@@@@@@@@@@T.TT..T....TT..TTT...TTTTT.@@@@@@@@@@@@@@@@@@@@@@@@@@@@@@@@@@@@@@@
@@@@@@@@@@@@@@@T...TT.T.TT@@@T..T.....TT@@@@@@@@@@@@@@@@@@@@@@@@@@@@@@@@@@@@@@@@
@@@@@@@@@@@@@@@@T.....T..T@@@T.T....T.T@@@@@@@@@@@@@@@@@@@@@@@@@@@@@@@@@@@@@@@@@
@@@@@@@@@@@@@@@@@.TTTTTTTT....T.T..TT.@@@@@@@@@@@@@@@@@@@@@@@@@@@@@@@@@@@@@@@@@@
@@@@@@@@@@@@@@@@@@.T...T..T..T..TTTT.@@@@@@@@@@@@@@@@@@@@@@@@@@@@@@@@@@@@@@@@@@@
@@@@@@@@@@@@@@@@@@@T...TT..TTT.T..TT@@@@@@@@@@@@@@@@@@@@@@@@@@@@@@@@@@@@@@@@@@@@
@@@@@@@@@@@@@@@@@@@@TTTT...T.T.....@@@@@@@@@@@@@@@@@@@@@@@@@@@@@@@@@@@@@@@@@@@@@
@@@@@@@@@@@@@@@@@@@@@TT.T...TTT.T.@@@@@@@@@@@@@@@@@@@@@@@@@@@@@@@@@@@@@@@@@@@@@@
@@@@@@@@@@@@@@@@@@@@@@@@@@@@@@@@@@@@@@@@@@@@@@@@@@@@@@@@@@@@@@@@@@@@@@@@@@@@@@@@
