type octile
height 80
width 80
map
@@@@@@@@@@@@@@@@@@@@@@@@@@@@@@@@@@@@@@@@@@@@@@@@@@@@@@@@@@@@@@@@@@@@@@@@@@@@@@@@
@@@@@@@@@@@@@@@@@@@@@@@@@@@@@@@@@@@@@@@@@@@@@@@@@@@@@@@@@@@@@@@@@@@@@@@@@@@@@@@@
@@@@@@@@@@@@@@@@@@@@@@@@@@@@@@@@@@@@@@@@@@@@@@@@@@....TTTT.....T.TT.TTTT...T.T@@
@@@@@@@@@@@@@@@@@@@@@@@@@@@@@@@@@@@@@@@@@@@@@@@@@.T.TT.T.....TT..TT...T..TTTTT@@
@@@@@@@@@@@@@@@@@@@@@@@@@@@@@@@@@@@@@@@@@@@@@@@@T...TTT...TTTT.TTTT.TT.T...T..@@
@@@@@@@@@@@@@@@@@@@@@@@@@@@@@@@@@@@@@@@@@@@@@@@T.T..T.TTT.TT.....TT....T.TTTTT@@
@@@@@@@@@@@@@@@@@@@@@@@@@@@@@@@@@@@@@@@@@@@@@@...TTTT.T...T....TT...T.T..TT...@@
@@@@@@@@@@@@@@@@@@@@@@@@@@@@@@@@@@@@@@@@@@@@@T..T...TTT.TT...TT.TTTTT..TT.TTT.@@
@@@@@@@@@@@@@@@@@@@@@@@@@@@@@@@@@@@@@@@@@@@@TT....TTTT....T.....TT....T.T..T..@@
@@@@@@@@@@@@@@@@@@@@@@@@@@@@@@@@@@@@@@@@@@@T.T.TTTT.TT...T...TTTT.TT.T..T.TT.T@@
@@@@@@@@@@@@@@@@@@@@@@@@@@@@@@@@@@@@@@@@@@TT.TT.T.T.T..T.T.T.T......TTT..TT...@@
@@@@@@@@@@@@@@@@@@@@@@@@@@@@@@@@@@@@@@@@@@TTT.TT..TTTT..TTTT...T.TTT..T....T.T@@
@@@@@@@@@@@@@@@@@@@@@@@@@@@@@@@@@@@@@@@@@@@.T..T.T..T.T.TTTTT.T.TT.TT....TTT..@@
@@@@@@@@@@@@@@@@@@@@@@@@@@@@@@@@@@@@@@@@@@@@.T....T.T..T.....TTT..TT..T...T...@@
@@@@@@@@@@@@@@@@@@@@@@@@@@@@@@@@@@@@@@@@@@@@T.TT....TTT..T..T.TTTT.TTT.....T..@@
@@@@@@@@@@@@@@@@@@@@@@@@@@@@@@@@@@@@@@@@@@@@@....TTT.T...T....T......T.T.TT...@@
@@@@@@@@@@@@@@@@@@@@@@@@@@@@@@@@@@@@@@@@@@@@@@TT.....T..TTTT..T.TTTT.....TTTTT@@
@@@@@@@@@@@@@@@@@@@@@@@@@@@@@@@@@@@@@@@@@@@@@@T.T...TTTT.T.TTT....T....TT.TTTT@@
@@@@@@@@@@@@@@@@@@@@@@@@@@@@@@@@T@@@@@@@@@@@@@@TT...TTT..TTTTTT.TTT.....T...T.@@
@@@@@@@@@@@@@@@@@@@@@@@@@@@@@@@.TT@@@@@@@@@@@@@@.T......TT.TTTT..TT.TT.TTTT..T@@
@@@@@@@@@@@@@@@@@@@@@@@@@@@@@@TTT.@@@@@@@@@T@@@@@..T.T.....T.T.T.T....TT.T.T.@@@
@@@@@@@@@@@@@@@@@@@@@@@@@@@@@TTT..@@@@@@@@...@@@TT.......T.....T..TTT.TTTT.T@@@@
@@@@@@@@@@@@@@@@@@@@@@@@@@@@.TT.TT.T.@@@@.TTT@@T...T.T.T.....TT..T....TT.T.@@@@@
@@@@@@@@@@@@@@@@@@@@@@@@@@@T.TT..TTTT@@@@@....TT.TTT.TT..TT....T.@@@@@@@@.@@@@@@
@@@@@@@@@@@@@@@@@@@@@@@@T@T.....T.TTTTT@@@TTTTTT.TT.TTT..T..TTT.T@@@@@@@@@@@@@@@
@@@@@@@@@@@@@@@@@@@@@@@TT.TT.T.T.TTTT.TT@T...T..TT.TT...T.T.T.TTT@@@@@@@@@@@@@@@
@@@@@@@@@@@@@@@@@@@@@@..TT....TT.TT...T.T...TT..T.TT..T.TT.T.TT.T.TT.T.@@@@@@@@@
@@@@@@@@@@@@@@@@@@@@@TT.T.TTT..T..TTTT.T..T..T.TTTTT...TTTTTT@@@TTTTTT@@@@@@@@@@
@@@@@@@@@@@@@@@@@@@@T.T.T...T.T.TT.T...TT..TTTT..TT....TT.@@@@@@T.T..@@@@@@@@@@@
@@@@@@@@@@@@@@@@@@@T.TT.TT.T.TT..T....TTTT....T.....TTT.@@@@@@@@@..T@@@@@@@@@@@@
@@@@@@@@@@@@@@@@@@@@@T..T..TT.T......TT..T....TT..TT.T@@@@@@@@@@@.T@@@@@@@@@@@@@
@@@@@@@@@@@@@@@@@@@@@@@@@..TTT.T.T.T..T....T..T..TTT.T@@@@@@@@@@@.@@@@@@@@@@@@@@
@@@@@@@@@@@@@@@@@@@@@@@@@@TTTT...TT.TT....TT...T.T.TTT@@@@@@@@@@@@@@@@@@@@@@@@@@
@@@@@@@@@@@@@@@@@.@@@@@@@@@@...T....T.TT.T.T.TT..T..T.@@..@@@TT@@@@@@@@@@@@@@@@@
@@@@@@@@@@@@@@@@..@@@@@@@@@@.TTT....TTTTTT.......T.TTT.T......@@@@@@@@@@@@@@@@@@
@@@@@@@@@@@@@@@@TT@@@@@@@@@@.T..T.T..TT.......TT.TTT.TT..T...@@@@@@@@@@@@@@@@@@@
@@@@@@@@@@@@@@@@@TTT@@@T@@@..T.T.T....TT....TT....T.T..T.T.T@@@@@@@@@@@@@@@@@@@@
@@@@@@@@@@@@@@@@@T.TT..TT@T.T..TTT.T.TT...T.TTT..TT.TT.TTTT@@@@@@@@@@@@@@@@@@@@@
@@@@@@@@@@@@@@@@.TT...T.TT...TTTTTTTT..T..T.TT...........@@@@@@@@@@@@@@@@@@@@@@@
@@@@@@@@@@@@@@@TT..T.T.TTTT.T..T..T.....TTT..TT.T...@@@@@@@@@@@@@@@@@@@@@@@@@@@@
@@@@@@@@@@@@@@..T..TT...TT..TTT..TTTTTTTT..TTT.T.T.T@@@@@@@@@@@@@@@@@@@@@@@@@@@@
@@@@@@@@T@@TT..T.T....T.TT.TTTT.TTTT.TTTTTTT..TT.T.T@@@@@@@@@@@@@@@@@@@@@@@@@@@@
@@@@@@@.T..TT....TT..T.TT.TTT.TTTT.T.....T.T.TT.TT@@@@@@@@@@@@@@@@@@@@@@@@@@@@@@
@@@@TT.T...TT.TT.T.T.......T.TTTTT.T..T...TTT..T.T@@@@@@@@@@@@@@@@@@@@@@@@@@@@@@
@@@T..T.TTT....T.T.....TT.T.TT...TTTT.TT.T.....T.T@@@@@@@@@@@@@@@@@@@@@@@@@@@@@@
@@.....TTTT.TTTT.T..T..TT..TTT...TT..TTT...T..T...@@..@@@@@@@@@@@@@@@@@@@@@@@@@@
@@TTTT..TT..TTTTTT.TT..T.TT..T.T.TTT..T........TTT..T@@@@@@@@@@@@@@@@@@@@@@@@@@@
@@....T...T.TTTTTT...TTT..T.T.T..TT...TTTT...TT..T..T.@@@@@@@@@@@@@@@@@@@@@@@@@@
@@...T...T.....T.T..TTTTT.T..T.TT.T..TT..T.T.T..TTT.T.T@@@@@@@@@@@@@@@@@@@@@@@@@
@@....T..T...T..T.T...TT..TTTTTT...T.T...TT.TTTT.T...T.T@@@@@@@@@@@@@@@@@@@@@@@@
@@TTTT....TT....TT.T...TT.T.TTT..TT...TT..T.TTT.@@T.TT...@@@@@@@@@@@@@@@@@@@@@@@
@@......T.....T.TT.T.TTT.T.T......TT..TT.TTT@@..@@@..TTT@@@@@@@@@@@@@@@@@@@@@@@@
@@.TTT.TTT.T.TTT.T.TTT....TTTT...TT..TTT.T.@@@T@@@@@@@@@@@@@@@@@@@@@@@@@@@@@@@@@
@@TTTTT.......TTTT.TT.TTT..T.TT.TTT.TT.T.TT@@@@@@@@@@@@@@@@@@@@@@@@@@@@@@@@@@@@@
@@TTTT.T.T.T.T.....TTTT..T..T.....T..TT...TT@@@@@T@@@@@@@@@@@@@@@@@@@@@@@@@@@@@@
@@T....T...T.T.TTTTTTTT..TTT.TT.T.TT....TT....@@@.T@@@@@@@@@@@@@@@@@@@@@@@@@@@@@
@@T.T...T.......TTTT...T.TT.TTT....T....TT....T@@TT@@@@@@@@@@@@@@@@@@@@@@@@@@@@@
@@T.TTT.T.T.T.TTT...T..T.T..TT..TT...TTTT..T....T...@@@@@@@@@@@@@@@@@@@@@@@@@@@@
@@..TTTT.TT.TT.T.TT...TTTTTTTT.T...T...T.T..T....T.@@@@@@@@@@@@@@@@@@@@@@@@@@@@@
@@TT.TTT.T...T....T.TT.T..TT.T.TTTTT.TT.T..T.T.TT.@@@@@@@@@@@@@@@@@@@@@@@@@@@@@@
@@.T.TT.T....T..TTTTT.TTT.T..TTT...T..T..TTTT.T.T@@@@@@@@@@@@@@@@@@@@@@@@@@@@@@@
@@...TTT.T..T....TTTT..TT.TT...TT.TTTT.T.T.TT..T@@@@@@@@@@@@@@@@@@@@@@@@@@@@@@@@
@@.TTTT.TT.TT..T...TT...T..TT...TT.TTT.TT.T.TTT@@@@@@@@@@@@@@@@@@@@@@@@@@@@@@@@@
@@T.TTT..TTT..T.TT.TTTTT..T.TT.TTTT.TTT.TT.T..@@@@@@@@@@@@@@@@@@@@@@@@@@@@@@@@@@
@@..T.TTTTT....T.......TT.TT.TT..TT@@TTT...TT@@@@@@@@@@@@@@@@@@@@@@@@@@@@@@@@@@@
@@.T.T.T.TTTT...T.T.TT.TTT.T..T..T@@@@...TTT@@@@@@@@@@@@@@@@@@@@@@@@@@@@@@@@@@@@
@@..T....T.T.TTTTT.T.T....@@TTTT@@@@@@@.T..@@@@@@@@@@@@@@@@@@@@@@@@@@@@@@@@@@@@@
@@.T.T.T.....T.TT.TT.TT.T@@@...@@@@@@@@@T.@@@@@@@@@@@@@@@@@@@@@@@@@@@@@@@@@@@@@@
@@........TTT.T...T.T.T@@@@@@.@@@@@@@@@@@@@@@@@@@@@@@@@@@@@@@@@@@@@@@@@@@@@@@@@@
@@T.TT.TTTTTTTTTT.T..T@@@@@@@@@@@@@@@@@@@@@@@@@@@@@@@@@@@@@@@@@@@@@@@@@@@@@@@@@@
@@T.T..TTT.T..T..T.TT@@@@@@@@@@@@@@@@@@@@@@@@@@@@@@@@@@@@@@@@@@@@@@@@@@@@@@@@@@@
@@.T...TT..T.TT..TTT.@@@@@@@@@@@@@@@@@@@@@@@@@@@@@@@@@@@@@@@@@@@@@@@@@@@@@@@@@@@
@@..TTT....TT..TTT.....@@@@@@@@@@@@@@@@@@@@@@@@@@@@@@@@@@@@@@@@@@@@@@@@@@@@@@@@@
@@....TT.TT..T..TT...T@@@@@@@@@@@@@@@@@@@@@@@@@@@@@@@@@@@@@@@@@@@@@@@@@@@@@@@@@@
@@...T..@@@@T.T..TTT.@@@@@@@@@@@@@@@@@@@@@@@@@@@@@@@@@@@@@@@@@@@@@@@@@@@@@@@@@@@
@@T..@@@@@@@@.TT.T.@@@@@@@@@@@@@@@@@@@@@@@@@@@@@@@@@@@@@@@@@@@@@@@@@@@@@@@@@@@@@
@@..@@@@@@@@@@TTTT@@@@@@@@@@@@@@@@@@@@@@@@@@@@@@@@@@@@@@@@@@@@@@@@@@@@@@@@@@@@@@
@@TTT@@@@@@@@@@@..@@@@@@@@@@@@@@@@@@@@@@@@@@@@@@@@@@@@@@@@@@@@@@@@@@@@@@@@@@@@@@
@@@@@@@@@@@@@@@@@@@@@@@@@@@@@@@@@@@@@@@@@@@@@@@@@@@@@@@@@@@@@@@@@@@@@@@@@@@@@@@@
@@@@@@@@@@@@@@@@@@@@@@@@@@@@@@@@@@@@@@@@@@@@@@@@@@@@@@@@@@@@@@@@@@@@@@@@@@@@@@@@
