type octile
height 86
width 80
map
@@@@@@@@@@@@@@@@@@@@@@@@@@@@@@@@@@@@@@@@@@@@@@@@@@@@@@@@@@@@@@@@@@@@@@@@@@@@@@@@
@@@@@@@@@@@@@@@@@@@@@@@@@@@@@@@@@@@@@@@@@@@@@@@@@@@@@@@@@@@@@@@@@@@@@@@@@@@@@@@@
@@@@@@@@@@@@@@@@@@@@@@@@@@@@@@@@@@@@@@@@@@@@@@@@@@@@@@@@@@@@@@@@@@@@@@@@@@@@@@@@
@@@@@@@@@@@@@@@@@@@@@@@@@@@@@@@@@@@@@@@@@@@@@@@@@@@@@@@@@@@@@@@@@@@@@@@@@@@@@@@@
@@@@@@@@@@@@@@@@@@@@@@@@@@@@@@@@@@@@@@@@@@@@@@@@@@@@@@@@@@@@@@@@@@@@@@@@@@@@@@@@
@@@@@@@@@@@@@@@@@@@@@@@@@@@@@@@@@@@@@@@@@@@@@@@@@@@@@@@@@@@@@@@@@@@@@@@@@@@@@@@@
@@@@@@@@@@@@@@@@@@@@@@@@@@@@@@@@@@@@@@@@@@@@@@@@@@@@@@@@@@@@@@@@@@@@@@@@@@@@@@@@
@@@@@@@@@@@@@@@@@@@@@@@@@@@@@@@@@@@@@@@@@@@@@@@@@@@@@@@@@@@@@@@@@@@@@@@@@@@@@@@@
@@@@@@@@@@@@@@@@@@@@@@@@@@@@@@@@@@@@@@@@@@@@@@@@@@@@@@@@@@@@@@@@@@@@@@@@@@@@@@@@
@@@@@@@@@@@@@@@@@@@@@@@@@@@@@@@@@@@@@@@@@@@@@@@@@@@@@@@@@@@@@@@@@@@@@@@@@@@@@@@@
@@@@@@@@@@@@@@@@@@@@@@@@@@@@@@@@@@@@@@@@@@@@@@@@@@@@@@@@@@@@@@@@@@@@@@@@@@@@@@@@
@@@@@@@@@@@@@@@@@@@@@@@@@@@@@@@@@@@@@@@@@@@@@@@@@@@@@@@@@@@@@@@@@@@@@@@@@@@@@@@@
@@@@@@@@@@@@@@@@@@@@@@@@@@@@@@@@@@@@@@@@@@@@@@@@@@@@@@@@@@@@@@@@@@@@@@@@@@@@@@@@
@@@@@@@@@@@@@@@@@@@@@@@@@@@@@@@@@@@@@@@@@@@@@@@@@@@@@@@@@@@@@@@@@@@@@@@@@@@@@@@@
@@@@@@@@@@@@@@@@@@@@@@@@@@@@@@@@@@@@@@@@@.@@@@@@@@@TTT@@@@@@@@@@@@@@@@@@@@@@@@@@
@@@@@@@@@@@@@@@@@@@@@@@@@@@@@@@@@@@@@@@@.T.T@@@@@@TTT..@@@@@@@@@@@@@@@@@@@@@@@@@
@@@@@@@@@@@@@@@@@@@@@@@@@@@@@@@@@@@@@@@TT....@@@@.T.T.T@@@@@@@@@@@@@@@@@@@@@@@@@
@@@@@@@@@@@@@@@@@@@@@@@@@@@@@@@@@@@@@@@.TT.TTT@@@TT.TT@@@@@@@@@@@@@@@@@@@@@@@@@@
@@@@@@@@@@@@@@@@@@@@@@@@@@@@@@@@@@@@@@@@...T.@@@@T.TT@@@@@@@@@@@@@@@@@@@@@@@@@@@
@@@@@@@@@@@@@@@@@@@@@@@@@@@@@@@@@@@@@@@TT..T.@@@@TTT@@@@@@@@@@@@@@@@@@@@@@@@@@@@
@@@@@@@@@@@@@@@@@@@@@@@@@@@@@@@@@@@@@@T.T.T.TTTT.TTT@@@@@@@.@@@@@@@@@@@@@@@@@@@@
@@@@@@@@@@@@@@@@@@@@@@@@@@@@@@@@@@@@@....T.T...TT..@@@@@@@...@@@@@@@@@@@@@@@@@@@
@@@@@@@@@@@@@@@@@@@@@@@@@@@@@@@@@@@@TT....T.TTTT.@@@@@@@@TT..T@@@@@@@@@@@@@@@@@@
@@@@@@@@@@@@@@@@@@@@@@@@@@@@@@@@@@@@@T.T.T.TT.TT.T@@@@@TT..T.@@@@@@@@@@@@@@@@@@@
@@@@@@@@@@@@@@@@@@@@@@@@@@@@@@@@@@@@@@TT...T....TTT@@....T..@@@@@@@@@@@@@@@@@@@@
@@@@@@@@@@@@@@@@@@@@@@@@@@@@@@@@@@@@@@@T..T...T..T....T.TTT@@@@@@@@@@@@@@@@@@@@@
@@@@@@@@@@@@@@@@@@@@@@@@@@@@@...@@@@@@@@.TT.T.TTTT.TTT.TTT@@@@@@@@@@@@@@@@@@@@@@
@@@@@@@@@@@@@@@@@@@@@@@@@@@@@TT..@@@@@@@@T..TT.TT.T..T.T.@@@@@@@@@@@@@@@@@@@@@@@
@@@@@@@@@@@@@@@@@@@@@@@@@@@@@..TT@@@@@@@@@T....TT..TT.TTT@@@@@@...TT.@@@@@@@@@@@
@@@@@@@@@@@@@@@@@@@@@@@@@@@@@@@.T.@@@@@@@@@.TTT.TT....TTTT@@@@@....TTT@@@@@@@@@@
@@@@@@@@@@@@@@@@@@@@@@@@@@@@@@@@T.T@@..@@@@@T.TTT...T......@@.TT...T.T@@@@@@@@@@
@@@@@@@@@@@@@@@@@@@@@@@@T@@@@@@@@T...T.T@@@@@T.T..T..TTTTT.@@.TT.T...@@@@@@@@@@@
@@@@@@@@@@@@@@@@@@@@@@@..T@@@@@@@.TT..T...@@@@TT..TT.TT..T...TT.TTTT@@@@@@@@@@@@
@@@@@@@@@@@@@@@@@@@@@@.T..T@@@@@T.T...TTT@@@@@.....TTT..TT.T.T...T.@@@@@@@@@@@@@
@@@@@@@@@@@@@@@@@@@@@T...TT.@@@.TT.TT...@@@@@..T.TT.TTT.....T..TT.@@@@@@TTT@@@@@
@@@@@@@@@@@@@@@@@@@@.T.T...T.T.TT.TTTT.@@@@@..T..T..TT......T.TTT@@@@@@T.T..T@@@
@@@@@@@@@@@@@@@@@@@TT.T...T.T..T.T..T.@@@@@...TTT..T...T..T.T..TT@@@@@...T...@@@
@@@@@@@@@@@@@@@@@@@@T..T.TTTT.T.TTTT.@@@@@.TTTTTTT.@.TTT..T...TT..@@@T.T.TT..@@@
@@@@@@@@@@@@@@@@@@@@@TT...TTTT..T....@@@@T...TT...@@@TTTT..TTT...T.TT...T.TTT@@@
@@@@@@@@@@@@@@@@@@@@@@..TTTTT.....T..@@@TT..T.TTT@@@@@.TT....T.TTTT....TTTT.@@@@
@@@@@@@@@@@@@@@@@@@@@@@...T..T.TT@.T..@..T.TTTTT@@@@@@@TTTT...T.@@T....T.T.@@@@@
@@@@@@@@@@@@@@@@@@@@@@@@....T.T.@@@T..T..T.T.T.@@@@@@@@@..TT..T@@TTT.T.T..@@@@@@
@@@@@@@@@@@@@@@@@@@@@@@@@T.T..T@@@@@.T.T.TT.T.@@@@@@@@@@@...TT@@T...TTTT.@@@@@@@
@@@@@@@@@@@@@@@@@@.@@@@@@@TT..@@@@@@..T.TT..T@@@@@@T@@@@@@T.T@@....T.TT.@@@@@@@@
@@@@@@@@@@T@@@@@@@TT@@@@@@@.T@@@@@@..T..T...@@@@@@@.T@@@@@@.@@T.TT..T.T@@@@@@@@@
@@@@@@@@@TT.@@@@T..T.@@@@@@@@@@@@@TTT..T.T..@@@.T..T.T@@@@@@@T..T..T.T@@@@@@@@@@
@@@@@@@@T.TTT.@TT.T.T.@@@@@@@@@@@T.T.TTTTTTTT@TTTTT.@..@@@@@@TTT..T.T@@@@@@@@@@@
@@@@@@@..TT....TT...T..@@@@@@@@@TTTTT.T.@@TTTTTT@@@@@...@@@@@@TTT..T@@@@@@@@@@@@
@@@@@@...TT.T.T.....TT.T@@@@@@@TTT..T.T@@@@T.T.@@@@@@TT.T@@@@@@....@@@@@@@@@@@@@
@@@@@.TT.T.@....TTTTT...T@@@@@T.TTTT.T@@@@@TT..@@@@@@T..TT@@@@@@T.@@@@@@@@@@@@@@
@@@@T..TT.@@@T.TTTT.....@@@@@TTT.TTT.@@@@@@TTTT@@@@@@T.T...@@@@@@@@@@@@@@@@@@@@@
@@@.T.T.T@@@@@.TT......@@@@@T..TT.TT@@@@@@@@TT.@@@@@@TTT..TT@@@@@@@@@@@@@@@@@@@@
@@.T..@@@@@@@@T.TT....@@@@@.....TTT@@@@@@@@..T@@@@@@@..TT.TT.@@@@@@@@@@@@@@@@@@@
@@.TT@@@.@@@@@T.T..TTT@@@@@T..TT..@@@@@@@@..TT@@@@@@T..T..T.T.@@@@@@@@@@@@@@@@@@
@@@.@@@.T.@@@TTT.TT.T.T@.T..T.T..@@@@@@@@TTT.T@@@@@..TTT.TTT.@@@@@@@@@@@@@@@@@@@
@@@@@@TT.T..TTT.TT@@TTT........T@@@@@@@@T.TTT.T@TT.TTTT.T.T.@@@@@@@@@@@@@@@@@@@@
@@@@@T.T.TT..TT.T@@@@..TT.T..TT@@@@@@@@@@..T...TT..T.T...T.@@@@@@@@@@@@@@@@@@@@@
@@@@@@TTT..T...T@@@@@TT..TTT..@@@@@@@@@@@@..T......TT..TT.@@@@@@@@@@@@@@@@@@@@@@
@@@@@@@........@@@@@T..TT..T.@@@@@@@@@@@@@@..T....TT.TTTT@@@@@@@@@@@@@@@@@@@@@@@
@@@@@@@@.TT..T@@@@@TTTT..TTT.@@@TT@@TT.@@@@@T..T..TTT.T.@@@@@@@@@@@@@@@@@@@@@@@@
@@@@@@@@@TT.T@@@@@TTTT.TTT...@@TTT...TTT@@@@@TT.TT..TT.@@@@@@@@@@@@@@@@@@@@@@@@@
@@@@@@@@@@.T@@@@@..TTT.T.T.T.TTT.T.TT..T@@@@@@.T.TTTT.@@@@@@@@@@@@@@@@@@@@@@@@@@
@@@@@@@@@@@@@@@@T..T.T..@@.TT.T..@T.T..T@@@@@@@...TT.@@@@@@@@@@@@@@@@@@@@@@@@@@@
@@@@@@@@@@@@@@@..T.T.T.@@@@.T..@@@@..T..T@@@@@@@TTT.@@@@@@@@@@@@@@@@@@@@@@@@@@@@
@@@@@@@@@@@@@@.T..TTTT@@@@@TT.@@@@@@...TTT@.@@@@@..@@@@@@@@@@@@@@@@@@@@@@@@@@@@@
@@@@@@@@@@@@@@@TTT..T@@@@@TTT@@@@@@@@.T.T.T.T@@@@@@@@@@@@@@@@@@@@@@@@@@@@@@@@@@@
@@@@@@@@@@@@@@@@T.T.@@@@@TT..@@@@@@@@TT.TT.TTT@@@@@@@@@@@@@@@@@@@@@@@@@@@@@@@@@@
@@@@@@@@@@@@@@@@@TT@@@@@.TTTT@@@@@@@T...T...TT.@@@@@@@@@@@@@@@@@@@@@@@@@@@@@@@@@
@@@@@@@@@@@@@@@@@@@@@@@.TT..@@@@@@@@.....TT..TT@@@@@@@@@@@@@@@@@@@@@@@@@@@@@@@@@
@@@@@@@@@@@@@@@@@@@@@@.T..TT@@@@@@@....TT..TTT@@@@@@@@@@@@@@@@@@@@@@@@@@@@@@@@@@
@@@@@@@@@@@@@@@@@@@@@T.TT...@@@@@@.T.TT.TT...@@@@@@@@@@@@@@@@@@@@@@@@@@@@@@@@@@@
@@@@@@@@@@@@@@@@@@@@@T.T.TT.@@@@.T.TTT.TT..T@@@@@@@@@@@@@@@@@@@@@@@@@@@@@@@@@@@@
@@@@@@@@@@@@@@@@@@@@@@T..T.T..TT..T.T.TT...@@@@@@@@@@@@@@@@@@@@@@@@@@@@@@@@@@@@@
@@@@@@@@@@@@@@@@@@@@@@@.T...TTTT.T.TT.TT.T@@@@@@@@@@@@@@@@@@@@@@@@@@@@@@@@@@@@@@
@@@@@@@@@@@@@@@@@@@@@@@@T.TTTTT.TTTTT.TTT@@@@@@@@@@@@@@@@@@@@@@@@@@@@@@@@@@@@@@@
@@@@@@@@@@@@@@@@@@@@@@@@@.T.TTTTT.TTTTT.@@@@@@@@@@@@@@@@@@@@@@@@@@@@@@@@@@@@@@@@
@@@@@@@@@@@@@@@@@@@@@@@@@@.T.T.TT.T...T@@@@@@@@@@@@@@@@@@@@@@@@@@@@@@@@@@@@@@@@@
@@@@@@@@@@@@@@@@@@@@@@@@@@@.TTT.TTT...@@@@@@@@@@@@@@@@@@@@@@@@@@@@@@@@@@@@@@@@@@
@@@@@@@@@@@@@@@@@@@@@@@@@@@@.T...TT..@@@@@@@@@@@@@@@@@@@@@@@@@@@@@@@@@@@@@@@@@@@
@@@@@@@@@@@@@@@@@@@@@@@@@@@@@.T.T.T@@@@@@@@@@@@@@@@@@@@@@@@@@@@@@@@@@@@@@@@@@@@@
@@@@@@@@@@@@@@@@@@@@@@@@@@@@@@TTT@@@@@@@@@@@@@@@@@@@@@@@@@@@@@@@@@@@@@@@@@@@@@@@
@@@@@@@@@@@@@@@@@@@@@@@@@@@@@@@@@@@@@@@@@@@@@@@@@@@@@@@@@@@@@@@@@@@@@@@@@@@@@@@@
@@@@@@@@@@@@@@@@@@@@@@@@@@@@@@@@@@@@@@@@@@@@@@@@@@@@@@@@@@@@@@@@@@@@@@@@@@@@@@@@
@@@@@@@@@@@@@@@@@@@@@@@@@@@@@@@@@@@@@@@@@@@@@@@@@@@@@@@@@@@@@@@@@@@@@@@@@@@@@@@@
@@@@@@@@@@@@@@@@@@@@@@@@@@@@@@@@@@@@@@@@@@@@@@@@@@@@@@@@@@@@@@@@@@@@@@@@@@@@@@@@
@@@@@@@@@@@@@@@@@@@@@@@@@@@@@@@@@@@@@@@@@@@@@@@@@@@@@@@@@@@@@@@@@@@@@@@@@@@@@@@@
