type octile
height 75
width 76
map
@@@@@@@@@@@@@@@@@@@@@@@@@@@@@@@@@@@@@@@@@@@@@@@@@@@@@@@@@@@@@@@@@@@@@@@@@@@@
@@@@@@@@@@@@@@@@@@@@@@@@@@@@@@@@@@@@@@@@@@@@@@@@@@@@@@@@@@@@@@@@@@@@@@@@@@@@
@@@@@@@@@@@@@@@@@@@@@@@@@@@@@@@@@@@@@@@@@@@@@@@@@@@@@@@@@@@@@@@@@@@@@@@@@@@@
@@@@@@@@@@@@@@@@@@@@@@@@@@@@@@@@@@@@@@@@@@@@@@@@@@@@@@@@@@@@@@@@@@@@@@@@@@@@
@@@@@@@@@@@@@@@@@@@@@@@@@@@@@@@@@@@@@@@@@@@@@@@@@@@@@@@@@@@@@@@@@@@@@@@@@@@@
@@@@@@@@@@@@@@@@@@@@@@@@@@@@@@@@@@@@@@@@@@@@@@@@@@@@@@@@@@@@@@@@@@@@@@@@@@@@
@@@@@@@@@@@@@@@@@@@@@@@@@@@@@@@@@@@@@@@@@@@@@@@@@@@@@@@@@@@@@@@@@@@@@@@@@@@@
@@@@@@@@@@@@@@@T.@@@@@@@@@@@@@@@@@@@@@@@@@@@@@@@@@@@@@@@@@@@@@@@@@@@@@@@@@@@
@@@@@@@@@@@@@.....TT@@@@@@@@@@@@@@@@@@@@@@@@@@@@@@@@@@@@@@@@@@@@@@@@@@@@@@@@
@@@@@@@@@@@..TTT.T.T.TT@@@@@@@@@@@@@@@@@@@@@@@@@@@@@@@@@@@@@@@@@@@@@@@@@@@@@
@@@@@@@@@@TTTTT.T.TTTTT.@@@@@@@@@@@@@@@@@@@@@@@@@@@@@@@@@@@@@@@@@@@@@@@@@@@@
@@@@@@@@@TTT..T.T.....T..@@@@@@@@@@@@@@@@@@@@@@@@@@@@@@@@@@@@@@@@@@@@@@@@@@@
@@@@@@@@TTTT...T.TT.T.TTT@@@@@@@@@@@@@@@@@@@@@@@@@@@@@@@@@@@@@@@@@@@@@@@@@@@
@@@@@@@T...TT.....T..TTT.@@@@@@@@@@@@@@@@@@@@@@@@@@@@@@@@@@@@@@@@@@@@@@@@@@@
@@@@@@@TT.TTT..TT..T.T..T@@@@@@@@@@@@@@@@@@@@@@@@@@@@@@@@@@@@@@@@@@@@@@@@@@@
@@@@@@@T...TTTTTT.TTT....@@@@@@@@@@@@@@@@@@@@@@@@@@@@@@@@@@@@@@@@@@@@@@@@@@@
@@@@@@@.T.TT.TT@@T.T..TTTT@@@@@@@@@@@@@@@@@@@@@@@@@@@@@@@@@@@@@@@@@@@@@@@@@@
@@@@@@..TTTT.T@@@@.TT..TTT@@@@@@@@@@@@@@@@@@@@@@@@@@@@@@@@@@@@@@@@@@@@@@@@@@
@@@@@@.TTT.TT..@@.T.TTT...@@@@@@@@@@@@@@@@@@@@@@@@@@@@@@@@@@@@@@@@@@@@@@@@@@
@@@@@@T....T.T..TT...TT.T@@@@@@@@@@@@@@@@@@@@@@@@@@@@@@@@@@@@@@@@@@@@@@@@@@@
@@@@@@@.T.T.TTT.TTTT.....@@@@@@@@@@@@@@@@@@@@@@@@@@@@@@@@@@@@@@@@@@@@@@@@@@@
@@@@@@@@.TTTT..TT.TT.TTT..@@@@@@@@@@@@@@@@@@@@@@@@@@@@@@@@@@@@@@@@@@@@@@@@@@
@@@@@@@@@@T.T...T.TTT.TT..@@@@@@@@@@@T.@@@@@@@@@@@@@@@@@@@@@@@@@@@@@@@@@@@@@
@@@@@@@@@@@T...TT.T@@.TT...@@@@@@@@@T..T@@@@@@@@@@@@@@@@@@@@@@@@@@@@@@@@@@@@
@@@@@@@@@@@@@@@@@@@@@@.TTT.@@@@@@@@T.TT..@@@@@@@@@@@@@@@@@@@@@@@@@@@@@@@@@@@
@@@@@@@@@@@@@@@@@@@@@@.TT..T@@@@@@@..TT.TT@@@@@@@@@@@@@@@@@@@@@@@@@@@@@@@@@@
@@@@@@@@@@@@@@@@@@@@@@....T.@@@@@.TTT.TTTTT.@@@@@@@@@@@@@@@@@@@@@@@@@@@@@@@@
@@@@@@@@@@@@@@@@@@@@@@@.T.TT.@@@@T.T.TT....T@@@@@@@@@@@@@@@@@@@@@@@@@@@@@@@@
@@@@@@@@@@@@@@@@@@@@@@@T...T.@@@@.TT.T.TT..T@@@@@@@@@@@@@@@@@@@@@@@@@@@@@@@@
@@@@@@@@@@@@@@@@@@@@@@@@T..TT.@@@T.TTTTT.T..@@TT@@@@@@@@@@@@@@@@@@@@@@@@@@@@
@@@@@@@@@@@@@@@@@@@@@@@@T.....@@@@......TT.@@....@@@@@@@@@@@@@@@@@@@@@@@@@@@
@@@@@@@@@@@@@@@@@@@@@@@@@.TTT.T@@@..TTTT.TT@T.TTTT@@@@@@@@@@@@@@@@@@@@@@@@@@
@@@@@@@@@@@@@@@@@@@@@@@@@TTT.TT@@.TTT...TT..T.....@@@@@@@@@@@@@@@@@@@@@@@@@@
@@@@@@@@@@@@@@@@@@@@@@@@@@T.T.T@@T.T...T.TTT.T..TTT@@@@@@@@@@@@@@@@@@@@@@@@@
@@@@@@@@@@@@@@@@@@@@@@@@@@T.....@..T...T..T.TT..TT..@@@@@@@@@@@@@@@@@@@@@@@@
@@@@@@@@@@@@@@@@@@@@@@@@@@@T..T.@T.T..T..TT.TT.TTT.T.@@@@@@@@@@@@@@@@@@@@@@@
@@@@@@@@@@@@@@@@@@@@@@@@.T@TT.T.TT...TT.TT.TT.TTTT...@@@@@@@@@@@@@@@@@@@@@@@
@@@@@@@@@@@@@@@@@@@@@@@@T.@@..TT...T.TTTTT...TT..T..@@@.@@@@@@@@@@@@@@@@@@@@
@@@@@@@@@@@@@@@@@@@@@@@@T..@.TT.TTT.TT..TT...T....T.@@.TT@@@@@@@@@@@@@@@@@@@
@@@@@@@@@@@@@@@@@@@@@.@@T.T@....TTTT....T..T.T..TT.T@TTTT.@@@@@@@@@@@@@@@@@@
@@@@@@@@@@@@@@@@@@@@..@@.T.......T..TTT.....TT.TT....TT...T@@@@@@@@@@@@@@@@@
@@@@@@@@@@@@@@@@@@T.T.TT.TTT.TT.T.T...T.T..T.TTTT.TTTTTTTT.T@@@@@@@@@@@@@@@@
@@@@@@@@@@@@@@@@@.T.T..T......TT.T.TTT..T..TTT.TTTTT..T.TTTTT.@@@@@@@@@@@@@@
@@@@@@@@@@@@@@@@@T.T...T..TT.T.T.TT..TTTT.TT.T....T..T.T......@@@@@@@@@@@@@@
@@@@@@@@@@@@@@@@@TT..TTT....T..TT..TT....T..TT.TTTTTTT..TT.T.@@@@@@@@@@@@@@@
@@@@@@@@@@@@@@@@@..T....T.T..TTTTT...TTTTT...TTT....T....T.T@@@T@@@@@@@@@@@@
@@@@@@@@@@@@@@@@@..T..TT.......T..T.T..TT.T.TTTT.TTTTT..T.T.@@TT..T..T@@.T@@
@@@@@@@@@@@@@@@@@..TT..TTTT..T....TT...TT.TT..T.T.T.T..TT.T.@@T..T.TT.TTT.@@
@@@@@@@@@@@@@@@@@..TTTT...TTT......TTT.T.T...T..T..TTTTTTT.T...TTT..T.TTTT@@
@@@@@@@@@@@@@@@@@TTTTT...TTTTT....T..T..T.TT...TT.TT.T..TTTT....T....TT.T.@@
@@@@@@@@@@@@@@@@@TTTTT.T.T..T.TTT.T..T.T.T..TTTT.T...TT..TTTT.T.TTT...T.T.@@
@@@@@@@@@@@@@@@@@.TT.T...T.TT.TT.T.TTT.T.T.TTTTT.T..TTTT..T.T.TT...T.T.T..@@
@@@@@@@@@@@@@@@@@..TT....TT.T..T.T.T.TT....TT.......T.T.TT..TTTT.TTT.T.TT.@@
@@@@@@@@@@@@@@@@@TT..T..T.TTTT..T.T..TTTT...T.......T..TTT.TT..T..TT...TT@@@
@@@@@@@@@@@@@@@@@TTTT.TTTT....TT.TT.T..TT.T.TT....TT.T....TTTTT.TTT.TT.T@@@@
@@@@@@@@@@@@@@@@@@T...T.T.TTTTTTT.T.T.TTTT.T..TT.T....TT.TT.TT.....TT.T@@@@@
@@@@@@@@@@@@@@@@@@@T..TT.T..TT.....T..TTTTTT..T.TT..TTTTTTT...TTT.TTT.@@@@@@
@@@@@@@@@@@@@@@@@@@@TT..TTTTT.T.TT.....TT..T..TTT...T..T.T.TT.TT...TT@@@@@@@
@@@@@@@@@@@@@@@@@@@@@.TT..T.TTT.TTTTT.T..TTT.TT....TTT....T.TT.....T@@@@@@@@
@@@@@@@@@@@@@@@@@@@@@@T..T....TTT.T...TT.T..TT.TTT.TT.T...T..T.T...@@@@@@@@@
@@@@@@@@@@@@@@@@@@@@@@@.TTTTT..T.....TTTT.TT.TTTT..TT..T.TT..T..TT@@@@@@@@@@
@@@@@@@@@@@@@@@@@@@@@@@@.TTTTT...T.....TT.TT.....T......TT..TT..T@@@@@@@@@@@
@@@@@@@@@@@@@@@@@@@@@@@@@T.TT.TTT....TTT..T..T....TT..T..T.T..T.@@@@@@@@@@@@
@@@@@@@@@@@@@@@@@@@@@@@@@@.T.T....T..T..T...TT...T.T.T..T.TT...@@@@@@@@@@@@@
@@@@@@@@@@@@@@@@@@@@@@@@@@@.T...T..T.TTT.TT.....T...T..TTT...T@@@@@@@@@@@@@@
@@@@@@@@@@@@@@@@@@@@@@@@@@@@T...TT.TT.....TT.T.TTT...TTT....T@@@@@@@@@@@@@@@
@@@@@@@@@@@@@@@@@@@@@@@@@@@@@T.TT.......T...TTTT..TT.T.T.TTT@@@@@@@@@@@@@@@@
@@@@@@@@@@@@@@@@@@@@@@@@@@@@@@.TT.....TT...TTTTTTTTTT....T.@@@@@@@@@@@@@@@@@
@@@@@@@@@@@@@@@@@@@@@@@@@@@@@@@T..T..T.T.TTTT.TT....T.TTT.@@@@@@@@@@@@@@@@@@
@@@@@@@@@@@@@@@@@@@@@@@@@@@@@@@@T.T.T.T.T.TT.T....T.T..T.@@@@@@@@@@@@@@@@@@@
@@@@@@@@@@@@@@@@@@@@@@@@@@@@@@@@@.T.TTTTTT.T.T....T..TTT@@@@@@@@@@@@@@@@@@@@
@@@@@@@@@@@@@@@@@@@@@@@@@@@@@@@@@@....TTT.TTTTT..TT...T@@@@@@@@@@@@@@@@@@@@@
@@@@@@@@@@@@@@@@@@@@@@@@@@@@@@@@@@@T..T.TTTTT....T..T.@@@@@@@@@@@@@@@@@@@@@@
@@@@@@@@@@@@@@@@@@@@@@@@@@@@@@@@@@@@@T..T.TT..TT....T@@@@@@@@@@@@@@@@@@@@@@@
@@@@@@@@@@@@@@@@@@@@@@@@@@@@@@@@@@@@@@@@@@@@@@@@@@@@@@@@@@@@@@@@@@@@@@@@@@@@
