type octile
height 54
width 56
map
@@@@@@@@@@@@@@@@@@@@@@@@@@@@@@@@@@@@@@@@@@@@@@@@@@@@@@@@
@@@@@@@@@@@@@@@@@@@@@@@@@@@@@@@@@@@@@@@@@@@@@@@@@@@@@@@@
@@@@@@@@@@@@@@@@@@@@@@@@@@@@@@@@@@@@@@@@@@@@@@@@@@@@@@@@
@@@@@@@@@@@@@@@@@@@@@@@@@@@@@@@@@@@@@@@@@@@@@@@@@@@@@@@@
@@@@@@@@@@@@@@@@@@@@@@@@@@@@@@@@@@@@@@@@@@@@@@@@@@@@@@@@
@@@@@@@@@@@@@@@@@@@@@@@@@@@@@@@@@@@@@@@@@@@@@@@@@@@@@@@@
@@@@@@@@@@@@@@@@@@@@@@@@@@@@@@@@@@@@@@@@@@@@@@@@@@@@@@@@
@@@@@@@@@@@@@@@@@@@@@@@@@@@@@@@@@@@@@@@@@@@@@@@@@@@@@@@@
@@@@@@@@@@@@@@@@@@@@@@@@@@@@@@@@@@@@@@@@@@@@@@@@@@@@@@@@
@@@@@@@@@@@@@@@@@@@@@@@@@@@@@@@@@@@@@@@@@@@@@@@@@@@@@@@@
@@@@@@@@@@@@@@@@@@@@@@@@@@@@@@@@@@@@@@@@@@@@@@@@@@@@@@@@
@@@@@@@@@@@@@@@@@@@@@@@@@@@@@@@@@@@@@@@@@@@@@@@@@@@@@@@@
@@@@@@@@@@@@@@@@@@@@@@@@@@@@@@@@@@@@@@@@@@@@@@@@@@@@@@@@
@@@@@@@@@@@@@@@@@@@@@@@@@@@@@@@@@@@@@@@@@@@@@@@@@@@@@@@@
@@@@@@@@@@@@@@@@@@@@@@@@@@.@@@@@@@@@@@@@@@@@@@@@@@@@@@@@
@@@@@@@@@@@@@@@@@@@@@@@@@..@@@@@@@@@@@@@@@@@@@@@@@@@@@@@
@@@@@@@@@@@@@@@@@@@@@@@@@T.T@T@@@@@@@@@@@@@@@@@@@@@@@@@@
@@@@@@@@@@@@@@@@@@@@@@@@T.TT.T..@@@@@@@@@@@@@@@@@@@@@@@@
@@@@@@@@@@@@@@@@@@@@@@@.T..TTT..T@@@@@@@@@@@@@@@@@@@@@@@
@@@@@@@@@@@@@@@@@@@@@@..TTT..TTT@@@@@@@@@@@@@@@@@@@@@@@@
@@@@@@@@@@@@@@@@@@@@@@.TTTT...T.@@@@@@@@@@@@@@@@@@@@@@@@
@@@@@@@@@@@@@@@@@@@@@.T..T.T.T.TT@@@@@@@@@@@@@@@@@@@@@@@
@@@@@@@@@@@@@@@@@@@@..@@T.T......@@@@@@@@@@@@@@@@@@@@@@@
@@@@@@@@@@@@@@@@@@@@.@@@...T..TT@@@@@@@@@@@@@@@@@@@@@@@@
@@@@@@@@@@@@@@@@@@@T.T...TT.TT..T@TT@@@@@@@@@@@@@@@@@@@@
@@@@@@@@@@@@@@@@@@T.TT.TT.T..TT.TT.T.T@@@@@@@@@@@@@@@@@@
@@@@@@@@@@@@@@@@@TTT.TT.TTT..T.T..TT...@@.@@@@@@@@@@@@@@
@@@@@@@@@@@@@@@@@TT.......T.TT.TTTTT...@@..@@@T@@@@@@@@@
@@@@@@@@@@@@@@@@T.T...TTTTTT.T...T.TTTT@@..T@...@@@@@@@@
@@@@@@@@@@@@@@@@@@TT.TTT..T...T.TTTT.T.@@.....T...@@@@@@
@@@@@@@@@@@@@@@T@@TTTT..T....T.@T..TTT.TTTTT.T...T@@@@@@
@@@@@@@@@@@@@@TT@@.T.T...T...T@@@.T...T.T....TT.T.@@@@@@
@@@@@@@@@@@@@.TTT.....T.T.....T.@@@.T.T..TTTTTTT.T@@@@@@
@@@@@@@@@@@@..TT..T.TT...TTT.T.T.@@T.T.TT.T.T..T.@@@@@@@
@@@@@@@@@@@@T.TTTT....TTTT.TT.T...TT.TT..T.T....@@@@@@@@
@@@@@@@@@@@T.T.TTTTTT.TT.TT.T.T.TT..T....T..@@TT@@@@@@@@
@@@@@@@@@@..T.T.TTTTTTTT..TT..TT....TT.TT..T@@@@@@@@@@@@
@@@@@@@@@TT@@..TTTT..TTT......TTT.T.T..T.T.T.@@@@@@@@@@@
@@@@@@@@@T@@@TTTTT.T.TT..T.TTTTTTTT..T.T....T@@@@@@@@@@@
@@@@@@@@T.@@.TT.T.T.T...T.TT..TT.T.TT.....TT.@@@@@@@@@@@
@@@@@@@T...T........TTT.TTTTTT.TTTT......TTTT@@@@@@@@@@@
@@@@@@TT.TT..T.T..T......T.T.TTT...TT.TT.T..@@@@@@@@@@@@
@@@@@@@@..TT...TTTTTTTT.TT.T..T.T..T..T.T.T@@@@@@@@@@@@@
@@@@@@@@@.TT..TTTTT....T..T..TTT..TTT..@@.T@@@@@@@@@@@@@
@@@@@@@@@@@TT.T.TTTTTTT..T.TT.T.......T@@@@@@@@@@@@@@@@@
@@@@@@@@@@@@.....T............TT.TT.....@@@@@@@@@@@@@@@@
@@@@@@@@@@@@@@TT.....TT..T.TTTTT.TTT.T..@@@@@@@@@@@@@@@@
@@@@@@@@@@@@@@@T.T.TTT.T...TT.T.TT.TT..T@@@@@@@@@@@@@@@@
@@@@@@@@@@@@@@@@T..T....TTTTT.T...T...T@@@@@@@@@@@@@@@@@
@@@@@@@@@@@@@@@@@@T...TT.T..T...T.....T@@@@@@@@@@@@@@@@@
@@@@@@@@@@@@@@@@@@@..TTTT.T.T.TT..T.T.@@@@@@@@@@@@@@@@@@
@@@@@@@@@@@@@@@@@@@@@..TT..TTTT..@@T.@@@@@@@@@@@@@@@@@@@
@@@@@@@@@@@@@@@@@@@@@@@TT.TTTT..T@@@@@@@@@@@@@@@@@@@@@@@
@@@@@@@@@@@@@@@@@@@@@@@@@@@@@@@@@@@@@@@@@@@@@@@@@@@@@@@@
