type octile
height 54
width 52
map
@@@@@@@@@@@@@@@@@@@@@@@@@@@@@@@@@@@@@@@@@@@@@@@@@@@@
@@@@@@@@@@@@@@@@@@@@@@@@@@@@@@@@@@@@@@@@@@@@@@@@@@@@
@@@@@@@@@@@@@@@@@@@@@@@@@@@@@@@@@@@@@@@@@@@@@@@@@@@@
@@@@@@@@@@@@@@@@@@@@@@@@@@@@@@@@@@@@@@@@@@@@@@@@@@@@
@@@@@@@@@@@@@@@@@@@@@@@@@@@@@@@@@@@@@@@@@@@@@@@@@@@@
@@@@@@@@@@@@@@@@@@@@@@@@@@@@@@@@@@@@@@@@@@@@@@@@@@@@
@@@@@@@@@@@@@@@@@@@@@@@@@@@@@@@@@@@@@@@@@@@@@@@@@@@@
@@@@@@@@@@@@@@@@@@@@@@@@@@@@@@@@@@@@@@@@@@@@@@@@@@@@
@@@@@@@@@@@@@@@@@@@@@@@@@@@@@@@@@@@@@@@@@@@@@@@@@@@@
@@@@@@@@@@@@@@@@@@@@@@@@@@@@@@@@@@@@@@@@@@@@@@@@@@@@
@@@@@@@@@@@@@@@@@@@@@@@@@@@@@@@@@@@@@@@@@@@@@@@@@@@@
@@@@@@@@@@@@@@@@@@@@@@@@@@@@@@@@@@@@@@@@@@@@@@@@@@@@
@@@@@@@@@@@@@@@@@@@@@@@@@@@@@@@@@@@@@@@@@@@@@@@@@@@@
@@@@@@@@@@@@@@@@@@@@@@@@@@@@@.@@@@@@@@@@@@@@@@@@@@@@
@@@@@@@@@@@@@@@@@@@@@@@@@@@@TT..T@@@@@@@@@@@@@@@@@@@
@@@@@@@@@@@@@@@@@@@@@@@@@@@.T.T.T.@@@@@@@@@@@@@@@@@@
@@@@@@@@@@@@@@@@@@@@@@@@@@T.TT...T@@@@@@@@@@@@@@@@@@
@@@@@@@@@@@@@@@@@@@@@@@@@@...T..T@@@@@@@@@@@@@@@@@@@
@@@@@@@@@@@@@@@@@@@@@@@@T.TTT..T.@@@@@@@@@@@@@@@@@@@
@@@@@@@@@@@@@@@@@@@@@@@@..T.TTTT.@@@@@@@@@@@@@@@@@@@
@@@@@@@@@@@@@@@@@@@@@@@TTTTTT.@@T.@@@@@.@@@@@@@@@@@@
@@@@@@@@@@@@@@@@@@@@@@T.TT.TTT@@.T.@@TT.T@@@@@@@@@@@
@@@@@@@@@@@@@@@@@@@@@@TT...TT.TTT.@@T...T.TT@@@@@@@@
@@@@@@@@@@@@@@@@@@@@@@.TT..T..TT.@@@.T.TT.T..@@@@@@@
@@@@@@@@@@@@@@@@@@@@@.TT.TT..TTTT.@@T..T...T.T@@@@@@
@@@@@@@@@@@@@@@@@@@@...TT.T.TT...TTT....T.T...@@@@@@
@@@@@@@@@@@@@@@@@@@.......@@...TT.T.T..TT.TT.@@@@@@@
@@@@@@@@@@@@@@@T@.TT.TT..@@@@.TTTTTT..TTT..T@@@@@@@@
@@@@@@@TT@@@@@@...TT.TT..T..T......TTTTTT..@@@@@@@@@
@@@@@@@.TT.TTT.TTT...@@@T@@@..T.TT...T.TTT@@@@@@@@@@
@@@@@@@.TTT.TTT..TTT.@@@T@@@T....T.....TT@@@@@@@@@@@
@@@@@@@@..@@@.TT.....T.TT.@T.T..T.T..T.T@@@@@@@@@@@@
@@@@@@@@@@@@@@@.T.T...T..TT.@..TT..TT.T@@@@@@@@@@@@@
@@@@@@@@@@@@@@@.TT..T.T.T.@@@..T.TTTTT@@@@@@@@@@@@@@
@@@@@@@@@@@@@@@TTTT..TT...T.T..TTTT.T@@@@@@@@@@@@@@@
@@@@@@@@@@@@@@@.TT.T..TT...T.T.T...T@@@@@@@@@@@@@@@@
@@@@@@@@@@@@@@@.TTTTT.TT.TT...TTTT.@@@@@@@@@@@@@@@@@
@@@@@@@@@@@@@@@@TT..T.T......T.T.T@@@@@@@@@@@@@@@@@@
@@@@@@@@@@@@@@@@@..T.T.TT....TTTT@@@@@@@@@@@@@@@@@@@
@@@@@@@@@@@@@@@@@@.TTTT.T.TT..T.@@@@@@@@@@@@@@@@@@@@
@@@@@@@@@@@@@@@@@@@TTTT.T.TTT..@@@@@@@@@@@@@@@@@@@@@
@@@@@@@@@@@@@@@@@@@.TT.T.T.TTT@@@@@@@@@@@@@@@@@@@@@@
@@@@@@@@@@@@@@@@@@@TTT..T....@@@@@@@@@@@@@@@@@@@@@@@
@@@@@@@@@@@@@@@@@@T..T..T..T@@@@@@@@@@@@@@@@@@@@@@@@
@@@@@@@@@@@@@@@@@.TTTT..T..@@@@@@@@@@@@@@@@@@@@@@@@@
@@@@@@@@@@@@@@@@.TTTT...T.@@@@@@@@@@@@@@@@@@@@@@@@@@
@@@@@@@@@@@@@@@@@.....TT.@@@@@@@@@@@@@@@@@@@@@@@@@@@
@@@@@@@@@@@@@@@@@@T.T...@@@@@@@@@@@@@@@@@@@@@@@@@@@@
@@@@@@@@@@@@@@@@@@@....@@@@@@@@@@@@@@@@@@@@@@@@@@@@@
@@@@@@@@@@@@@@@@@@@@@@@@@@@@@@@@@@@@@@@@@@@@@@@@@@@@
@@@@@@@@@@@@@@@@@@@@@@@@@@@@@@@@@@@@@@@@@@@@@@@@@@@@
@@@@@@@@@@@@@@@@@@@@@@@@@@@@@@@@@@@@@@@@@@@@@@@@@@@@
@@@@@@@@@@@@@@@@@@@@@@@@@@@@@@@@@@@@@@@@@@@@@@@@@@@@
@@@@@@@@@@@@@@@@@@@@@@@@@@@@@@@@@@@@@@@@@@@@@@@@@@@@
