type octile
height 54
width 52
map
@@@@@@@@@@@@@@@@@@@@@@@@@@@@@@@@@@@@@@@@@@@@@@@@@@@@
@@@@@@@@@@@@@@@@@@@@@@@@@@@@@@@@@@@@@@@@@@@@@@@@@@@@
@@@@@@@@@@@@@@@@@@@@@@@@@@@@@@@@@@@@@@@@@@@@@@@@@@@@
@@@@@@@@@@@@@@@@@@@@@@@@@@@@@@@@@@@@@@@@@@@@@@@@@@@@
@@@@@@@@@@@@@@@@@@@@@@@@@@@@@@@@@@@@@@@@@@@@@@@@@@@@
@@@@@@@@@@@@@@@@@@@@@@@@@@@@@@@@@@@@@@@@@@@@@@@@@@@@
@@@@@@@@@@@@@@@@@@@@@@@@@@@@@@@@@@@@@@@@@@@@@@@@@@@@
@@@@@@@@@@@@@@@@@@@@@@@@@@@@@@@@@@@@@@@@@@@@@@@@@@@@
@@@@@@@@@@@@@@@@@@@@@@@@@@@@@@@@@@@@@@@@@@@@@@@@@@@@
@@@@@@@@@@@@@@@@@@@@@@@@@@@@@@@@@@@@@@@@@@@@@@@@@@@@
@@@@@@@@@@@@@@@@@@@@@@@@@@@@@@@@@@@@@@@@@@@@@@@@@@@@
@@@@@@@@@@@@@@@@@@@@@@@@@@@@@@@@@@@@@@@@@@@@@@@@@@@@
@@@@@@@@@@@@@@@@@@@@@@@@@@@@@@@@@@@@@@@@@@@@@@@@@@@@
@@@@@@@@@@@@@@@@@@@@@@@@@@@@@.@@@@@@@@@@@@@@@@@@@@@@
@@@@@@@@@@@@@@@@@@@@@@@@@@@@T.T.T@@@@@@@@@@@@@@@@@@@
@@@@@@@@@@@@@@@@@@@@@@@@@@@..TTT..@@@@@@@@@@@@@@@@@@
@@@@@@@@@@@@@@@@@@@@@@@@@@T..TTTT.@@@@@@@@@@@@@@@@@@
@@@@@@@@@@@@@@@@@@@@@@@@@@..T.TT.@@@@@@@@@@@@@@@@@@@
@@@@@@@@@@@@@@@@@@@@@@@@T....T..@@@@@@@@@@@@@@@@@@@@
@@@@@@@@@@@@@@@@@@@@@@@@TTT.TTTTT@@@@@@@@@@@@@@@@@@@
@@@@@@@@@@@@@@@@@@@@@@@....TTT@@T.@@@@@T@@@@@@@@@@@@
@@@@@@@@@@@@@@@@@@@@@@...TTTTT@@T.T@@@T.T@@@@@@@@@@@
@@@@@@@@@@@@@@@@@@@@@@T.T...T....T@@@.TT.TTT@@@@@@@@
@@@@@@@@@@@@@@@@@@@@@@.T.TT.TTT.T@@@T....T.T.@@@@@@@
@@@@@@@@@@@@@@@@@@@@@.....T..T.TTT@@..T.T.TTT.@@@@@@
@@@@@@@@@@@@@@@@@@@@TT.TTTT......TTT.TTTT...T.@@@@@@
@@@@@@@@@@@@@@@@@@@..T.T.T@@T...T.....T....T.@@@@@@@
@@@@@@@@@@@@@@@T@@T.TT.T.@@@@.T...TTTT.TTTTT@@@@@@@@
@@@@@@@@@@@@@@@T....TT....TT.TT.T.T..TTTT.T@@@@@@@@@
@@@@@@@@@@@@T@T.T.T..@@@T@@@T.TTT..T..T.T.@@@@@@@@@@
@@@@@@@@@@@@TTTTT....@@@.@@@TT..T.T.T.TTT@@@@@@@@@@@
@@@@@@@@@@@.T....TT..TTT.T@.TT...TTT..T.@@@@@@@@@@@@
@@@@@@@@@.TTT......TTT....TT@TT.T.TTTT.@@@@@@@@@@@@@
@@@@@@@@TTTTTTTTT.T....TT.@@@..TTTTTT.@@@@@@@@@@@@@@
@@@@@@@.T...TTTT...T..T.T.@@TTTTT..T.@@@@@@@@@@@@@@@
@@@@@@T..TTTT@@T.T.TTTT.T.TTT.T.TT.T@@@@@@@@@@@@@@@@
@@@@@@@.TTT.@@@....T...TT.T..TT..TT@@@@@@@@@@@@@@@@@
@@@@@@@@..T@@@@@.TTT.TT..TTTTTTTT.@@@@@@@@@@@@@@@@@@
@@@@@@@@@.@@@@@@@.TT.TT.T..T...TT@@@@@@@@@@@@@@@@@@@
@@@@@@@@@@@@@@@@@@..T..T.TTT..T.@@@@@@@@@@@@@@@@@@@@
@@@@@@@@@@@@@@@@@@@..T.TT.T...T@@@@@@@@@@@@@@@@@@@@@
@@@@@@@@@@@@@@@@@@@T...TT.T..T@@@@@@@@@@@@@@@@@@@@@@
@@@@@@@@@@@@@@@@@@@...T.TT.TT@@@@@@@@@@@@@@@@@@@@@@@
@@@@@@@@@@@@@@@@@@TTT.T.TTT.@@@@@@@@@@@@@@@@@@@@@@@@
@@@@@@@@@@@@@@@@@..TTT...T.@@@@@@@@@@@@@@@@@@@@@@@@@
@@@@@@@@@@@@@@@@T......T.T@@@@@@@@@@@@@@@@@@@@@@@@@@
@@@@@@@@@@@@@@@@@..TT.TTT@@@@@@@@@@@@@@@@@@@@@@@@@@@
@@@@@@@@@@@@@@@@@@TT....@@@@@@@@@@@@@@@@@@@@@@@@@@@@
@@@@@@@@@@@@@@@@@@@TTTT@@@@@@@@@@@@@@@@@@@@@@@@@@@@@
@@@@@@@@@@@@@@@@@@@@@@@@@@@@@@@@@@@@@@@@@@@@@@@@@@@@
@@@@@@@@@@@@@@@@@@@@@@@@@@@@@@@@@@@@@@@@@@@@@@@@@@@@
@@@@@@@@@@@@@@@@@@@@@@@@@@@@@@@@@@@@@@@@@@@@@@@@@@@@
@@@@@@@@@@@@@@@@@@@@@@@@@@@@@@@@@@@@@@@@@@@@@@@@@@@@
@@@@@@@@@@@@@@@@@@@@@@@@@@@@@@@@@@@@@@@@@@@@@@@@@@@@
