type octile
height 80
width 80
map
@@@@@@@@@@@@@@@@@@@@@@@@@@@@@@@@@@@@@@@@@@@@@@@@@@@@@@@@@@@@@@@@@@@@@@@@@@@@@@@@
@@@@@@@@@@@@@@@@@@@@@@@@@@@@@@@@@@@@@@@@@@@@@@@@@@@@@@@@@@@@@@@@@@@@@@@@@@@@@@@@
@@TT.....T.TTTT.TTT.T.T.T.TT.T......T.TT.TTT.TTT.T.T..T.T..TT.....TT.....TTT..@@
@@..TTTTTT...T.T..T..TT...TT.T.T..TTTT.T...TT...TT..T..T.......TTT..T.TT.T.T.T@@
@@TT.TTTT...T.TTTTT.T..T..T.TTT.T...TTTTTTT.TTTT.TT.T....TTT.T.T..T.....TT.T.T@@
@@TTTTT.TT.TTT...T..T..T......T.T....T..TTTTT...T.T.....TT.T.....T.T.T...TT..T@@
@@T.T.T..TT..TTTT.......T..TT..TT...T.TTT...TT...T.TTTTTT.TTT..T...TTT.TT.TTTT@@
@@TT.TTT..TTTTTT.TTT..TTTT.T..TT.T...T........T.TTT.TTTTT.T.....T.T.T..T.....T@@
@@...T.TTT.T....TTTT.T..TTT.TT.TT.TTT.T....T.T..T.T.T..T.T.TT..TT.TTTTTT..TT.T@@
@@..T..TTTTT...TT.TT.T..T..T.T.T.T..T..T.TTTTT.T...T.T.TTT.T.T.TTT...TT.TTT.T.@@
@@TTT.T.T..T...T........T..TT.T.T.TTTT..T....TTT......T..T.T.TT...T...T...T.T.@@
@@.TT.....TTT...TTT..T.T......TT..TTTT...@@@TTT..TTT..T.TTT.TTT.TTTT.TTT.T.T..@@
@@T...T.TTT.TT.T...T.T.T.T..T...TT..T..T@@@@@T..T.T.TTTT...T.TT.T.TT......T.TT@@
@@.TTTTT.TT.T..T.TT..T.TT.T..TT.TTTTTT.T@@@@@...T....T.T..T..TT..TTTT....T.TT.@@
@@.TTTTT.T..TTT.......TT...TTT...T..T...T@@@..T.T.T.T@@@@.T.T...T..T.T.T..T.TT@@
@@.TT....TTTTT..T.T..T.T...T..T.TT.TTTTT.T.T.TT..TTT.@@@@TTTT.T.T..T.TTT.TTTT.@@
@@T...T..TTT.T.TT..TTT..T.T.TT....T....T...TTT..T.T.TT@@T.TT..TTTTTTT.T...T...@@
@@.T.....T.T....TTTT.......T.T.T.T@@@@@T...TT..T.T....T..TT.T..T.T..T.....TT.T@@
@@..TTT..T..T.TTTT...TTTTT....T.TT@@@@@TTTTT.T...T..TTT.....TT..T.@@@@@.T.....@@
@@TTTTT.TT..T.TT.T..TTT....TTTTTTTT@@@TTTT...TTTT.T..T...TTTT..T.T@@@@@T......@@
@@T.TT..TT.TTTT...TTTT...T.T...T..TTTTT.T..T..TTT....T.TT..TT..T.TT@@@TT....TT@@
@@...TT...TTTT.TT.T.T...T...TT..T..T..TTT..TTT.TT.T.T..T.T.TTT.T.TTT.T......T.@@
@@....TT.TT..T.TTT..TT....T...T....TTT.T.TTT.TT.TTT.TT..TTT....TT..T...TT...TT@@
@@..TT.TTTTT..TT....TT.T.T.TTT.T.T..TTTTTTT.T.TTTT.TT.T..T...T...T.TT..T..T.TT@@
@@TTT...TT.T....TTT..T.T..T.....TT..TTT..T......T....TTT.T.TTTTT.TT...TTT..TT.@@
@@.T.T.T...T.TT...T...TTTT.T.TT.TTTTT..TTTTTT..TT...TTT.T.T.T....TT.TTTTT...TT@@
@@.TT..T.T....TTTT.T.TTT.T.TTT...TT.TT.T.T.....T.T.T..T.T..T..T.T..T.T.TT..TT.@@
@@.T...T....T.TT..T..T.T.T..TT.TTT...TTTTT...TT.T......T.TT.TTTTTTT.T.T.T.TT.T@@
@@TTT..TT.T.TTTTTTT.T.TTTT..T..TTT.T.TTTT.T..T.TTT.....TT....T.T.TT...TTTTT...@@
@@T...TTT.T..T...TTTT.T..TT..T...T..T..T..TTT..T...T...T.T..T.TT...TTTTTT.T.TT@@
@@TTT.T.T....T.TTT.T.TT..TT.T.....T..T..T.TT.....T.TT..TT..T..T.TT.TT....TT.@@@@
@@TT..TTTT...T..TT....T...TT.T.T.TT..TTTT.TTTTTT.TT.TTTT.T...T.TTT...T..T...@@@@
@@..T.....TTT..TT.T..TTTT.T.TTT.TTTT.T..T.T..T.T.T....T.TT.TTT.T.T.....T.T.T@@@@
@@..T.TTTT.T.TTTT..T.TTT.T.T.....TTT.T.TT..T..TTTT.TT.TTTT..T.TT.TT..T.T....TT@@
@@.T.T..T.T.T.TTTT......TT.T..T..TT.T.T....TT.TTTTT..T..TT.T...TTTTTT...T.TTTT@@
@@TT...T.T.TTTT........T..T.T...T.T..T.T..T...TTT.T...T..T.T..T.TT......TTT.TT@@
@@TT..TT.T.T.TTTTTTTT...T.TTTT.TTT.TTTT.T.....TTT.T.T.TTT.TT.T.TTT..T.T.TT....@@
@@..TT.T........T.T.T..T.T...TT.T.TTTTTT.TTTTTTTT.TTT.T...T....TTTT.T..T.T.TTT@@
@@TT.T..TT..TT...T..T..TT.TTTT.T.TT.T.TT...TT.TT..TTTTTTTTT..TTTT.TT....TT...T@@
@@T..T...T.T..TT..TT..TT...T..TTTTT.TTT.TTTT.T.T.T....TT..TTT.T..T..T.TT...T.T@@
@@....TTTT.TT.TT.TT.T..T..T.TT...T..T....TT...T...T....T.T..T.TTT.T.TTT.T.TT..@@
@@.T....T...TT....T..T..TT..T...TT....T..T...TTT..T.TT..TTT......T.TT.T.T..T..@@
@@.T..TTT.T.TTT.TT.T.T.T.TT.TT..T.T.....TT......TT.TT..T..T..TTT.TT....T..TTTT@@
@@.T..TTT.T.T...TTTTT.T.TT...T..TTT.....TTT.T.T....TTT.T......T.TT.TT...T.T...@@
@@TTT..TT.TTTT...T.TTTTTTT...TT...TT.T.T..TT.T..T.T..T@@@@..TTT..TTTTT..T..TTT@@
@@.....T..T.T.TTTTT.TTT.T.....TT.....T..TT..T.TT..T.@@@@@@@.T.T.TTTT.TTT.T..T.@@
@@....T.T.T.TT.T..T.T..T...TT...T..TT..TTTTT.T.....@@@@@@@@@TT.TTT..T.TT.T.T..@@
@@TT..TTT...TT..TT..TTTT..TT......TTT.TT..TTTT.TTT.@@@@@@@@@..TT..TTT.TTT.T.TT@@
@@..TTT.TT.T@@T.TTTTTT.....TT.T..TTTT.TT.T...T....TTT@@@@@@TTT.TTTTT.TT....T.T@@
@@TTTT...T.@@@@..T.T.....T..T..T.T.T.TTTTTTT.T...T.TT.T...T..TT.TTTT.T.T.TT...@@
@@.T.TTT...@@@@T.T.T.T.TT..TTTTTT.TT.TT..TTT..T..T..T.T....TT.TT.T.TT.TT.T....@@
@@TT...T..T.@@.TT.TT.T.T.TTT..T.TTT.T.T...T.T..T.TT..T..TTT....TTT..TT.T....T.@@
@@.TTTT..TT....T..T..TT.TT..T........T..T...T.T.T...TT.T....T..TTT..T.T...T.T.@@
@@.TTTT.TTT..TT.T..TT.TTT.TT...TT.TTT.T..TTTTT.T.T.TTT.TT....T...T...T.T....T.@@
@@TTT..T...T..TTT...TT..T.TT.TTT...T.T..TT.T...T.TT....TTT.T...T....TT....TTTT@@
@@T@@@.T..TTT.TTTTTTTT.T.....TTTT.T..T.T..T...T..TT..TT.T..T.TT..T.TT..TTTT.T.@@
@@T@@@TTTT.T...T..T.TT..TT.TTT...T..TT..TT..T.TTT.....TT..TTTTTTTTT.T.TTTTT.TT@@
@@.@@@.T.TT.TT.T.T..TT..TT..T...TT.TT...TT...T...TTT.TTTTT.T..TT..T.T.TTT.TT.T@@
@@.@@@..TT...T.T..TTT.TT..TT..TTT....TTTT.T.T.T...T..TT...T..TTTT.TTTTT...T.TT@@
@@T...TTT.TTT.T..TT.TTTT..T..T..TTT....T....T....TTTT.TT.TTT....TT..TTTT..T.TT@@
@@T..TT.TT.TTT.T.....T...T..TT.T.T.TTTT.T.TT..T.TTT..TTTT.T..T.TTT.T.T.TTT...T@@
@@T...TT.TT...T.TTT.T..TTTT...T..TT.....T..T.T.T...T..TTTT.....TTT...TTTTTTT..@@
@@T.T...TT.TTTT.TT.TTTT.T..TTTTTT..T.T..TTTTTTTT.T...T.....TT.....TT.T.T.T.T..@@
@@.TT.TTT...TT.T.T..TT.T..TT....TTT.TT..TT..TTT.T.T.TTT..T......T..T..T.T...T.@@
@@.T.T...T..TT....TTTTT...T.T..TT..T..T...T..TTTTTTT..T.TT..TTT..T.TTTTT..TTT.@@
@@TT........TTTTTTTT...T..T.TTT...TTT...T.TTT..T.T.....TTT.TTT.T.TT...T..TT...@@
@@............T.....TTT.T.TTT.TT..TT..T...TT..T..T.T.T...TTT...TTTTT....TT....@@
@@.T.TTTTTTT...T.TT..TT.T..T.T.TT..TT.T...T..TT.T...T..T...T...T..T.TTT...T.T.@@
@@.....TTT.T..TTTTT....TT.T...TTT.TT.TT...T..TT..TT.TTT.T.T..TT..T.T.TT.TT.TTT@@
@@TT..T.TTTT..TTT.TT.T..TT.T......T.T.T.TTTT.T..T.TTTTT.T...TTT...T..T..T....T@@
@@.TTTTT....T.TTTT...T...TT...TTT.TT.TTTTT...TTTTTTT..TTTT....T.TTT.T......TT.@@
@@..TTT...TT.TT.T..TTTTTT.T.T....T.T...TTTT..T...T.TTT.T....TTTT.T.TT.TTTT.T.T@@
@@..TT.T.TTTTT..TTT.TT...T.T...T.......TTT...T.TTTT..TT..T.....TT.T..T...TT.TT@@
@@TT.T...T.TTT.T...T...T.TT.TT..TT....T.TT.TT......T.TT...TTTTT.TT.TTT......TT@@
@@.....TTTT..T.TT......TT.T.TTTTT....TT.TTT..T.TTTTTT..TT..TTT.TTTT.T.TTTT..T.@@
@@..T.....T.T.TTT..TTTT.T...TTT..T.T....TT....T.......TT.TTTTTTTTT..TT.TT.....@@
@@.TT.T.T...T.T..T.T@@@TT.T..TTTT..T..TTTT..TT..T.T...T.TTTT...TTTT.TT.TT.T..T@@
@@TT.T.TT..T@@@@@@@@@@@@@@@@@@TT......T.TTT..TTTTTTTTT..T.T..TT.T.T.T.....T.TT@@
@@@@@@@@@@@@@@@@@@@@@@@@@@@@@@@@@@@@@@@@@@@@@@@@@@@@@@@@@@@@@@@@@@@@@@@@@@@@@@@@
@@@@@@@@@@@@@@@@@@@@@@@@@@@@@@@@@@@@@@@@@@@@@@@@@@@@@@@@@@@@@@@@@@@@@@@@@@@@@@@@
