type octile
height 139
width 148
map
@@@@@@@@@@@@@@@@@@@@@@@@@@@@@@@@@@@@@@@@@@@@@@@@@@@@@@@@@@@@@@@@@@@@@@@@@@@@@@@@@@@@@@@@@@@@@@@@@@@@@@@@@@@@@@@@@@@@@@@@@@@@@@@@@@@@@@@@@@@@@@@@@@@@
@@@@@@@@@@@@@@@@@@@@@@@@@@@@@@@@@@@@@@@@@@@@@@@@@@@@@@@@@@@@@@@@@@@@@@@@@@@@@@@@@@@@@@@@@@@@@@@@@@@@@@@@@@@@@@@@@@@@@@@@@@@@@@@@@@@@@@@@@@@@@@@@@@@@
@@@@@@@@@@@@@@@@@@@@@@@@@@@@@@@@@@@@@@@@@@@@@@@@@@@@@@@@@@@@@@@@@@@@@@@@@@@@@@@@@@@@@@@@@@@@@@@@@@@@@@@@@@@@@@@@@@@@@@@@@@@@@@@@@@@@@@@@@@@@@@@@@@@@
@@@@@@@@@@@@@@@@@@@@@@@@@@@@@@@@@@@@@@@@@@@@@@@@@@@@@@@@@@@@@@@@@@@@@@@@@@@@@@@@@@@@@@@@@@@@@@@@@@@@@@@@@@@@@@@@@@@@@@@@@@@@@@@@@@@@@@@@@@@@@@@@@@@@
@@@@@@@@@@@@@@@@@@@@@@@@@@@@@@@@@@@@@@@@@@@@@@@@@@@@@@@@@@@@@@@@@@@@@@@@@@@@@@@@@@@@@@@@@@@@@@@@@@@@@@@@@@@@@@@@@@@@@@@@@@@@@@@@@@@@@@@@@@@@@@@@@@@@
@@@@@@@@@@@@@@@@@@@@@@@@@@@@@@@@@@@@@@@@@@@@@@@@@@@@@@@@@@@@@@@@@@@@@@@@@@@@@@@@@@@@@@@@@@@@@@@@@@@@@@@@@@@@@@@@@@@@@@@@@@@@@@@@@@@@@@@@@@@@@@@@@@@@
@@@@@@@@@@@@@@@@@@@@@@@@@@@@@@@@@@@@@@@@@@@@@@@@@@@@@@@@@@@@@@@@@@@@@@@@@@@@@@@@@@@@@@@@@@@@@@@@@@@@@@@@@@@@@@@@@@@@@@@@@@@@@@@@@@@@@@@@@@@@@@@@@@@@
@@@@@@@@@@@@@@@@@@@@@@@@@@@@@@@@@@@@@@@@@@@@@@@@@@@@@@@@@@@@@@@@@@@@@@@@@@@@@@@@@@@@@@@@@@@@@@@@@@@@@@@@@@@@@@@@@@@@@@@@@@@@@@@@@@@@@@@@@@@@@@@@@@@@
@@@@@@@@@@@@@@@@@@@@@@@@@@@@@@@@@@@@@@@@@@@@@@@@@@@@@@@@@@@@@@@@@@@@@@@@@@@@@@@@@@@@@@@@@@@@@@@@@@@@@@@@@@@@@@@@@@@@@@@@@@@@@@@@@@@@@@@@@@@@@@@@@@@@
@@@@@@@@@@@@@@@@@@@@@@@@@@@@@@@@@@@@@@@@@@@@@@@@@@@@@@@@@@@@@@@@@@@@@@@@@@@@@@@@@@@@@@@@@@@@@@@@@@@@@@@@@@@@@@@@@@@@@@@@@@@@@@@@@@@@@@@@@@@@@@@@@@@@
@@@@@@@@@@@@@@@@@@@@@@@@@@@@@@@@@@@@@@@@@@@@@@@@@@@@@@@@@@@@@@@@@@@@@@@@@@@@@@@@@@@@@@@@@@@@@@@@@@@@@@@@@@@@@@@@@@@@@@@@@@@@@@@@@@@@@@@@@@@@@@@@@@@@
@@@@@@@@@@@@@@@@@@@@@@@@@@@@@@@@@@@@@@@@@@@@@@@@@@@@@@@@@@@@@@@@@@@@@@@@@@@@@@@@@@@@@@@@@@@@@@@@@@@@@@@@@@@@@@@@@@@@@@@@@@@@@@@@@@@@@@@@@@@@@@@@@@@@
@@@@@@@@@@@@@@@@@@@@@@@@@@@@@@@@@@@@@@@@@@@@@@@@@@@@@@@@@@@@@@@@@@@@@@@@@@@@@@@@@@@@@@@@@@@@@@@@@@@@@@@@@@@@@@@@@@@@@@@@@@@@@@@@@@@@@@@@@@@@@@@@@@@@
@@@@@@@@@@@@@@@@@@@@@@@@@@@@@@@@@@@@@@@@@@@@@@@@@@@@@@@@@@@@@@@@@@@@@@@@@@@@@@@@@@@@@@@@@@@@@@@@@@@@@@@@@@@@@@@@@@@@@@@@@@@@@@@@@@@@@@@@@@@@@@@@@@@@
@@@@@@@@@@@@@@@@@@@@@@@@@@@@@@@@@@@@@@@@@@@@@@@@@@@@@@@@@@@@@@@@@@@@@@@@@@@@@@@@@@@@@@@@@@@@@@@@@@@@@@@@@@@@@@@@@@@@@@@@@@@@@@@@@@@@@@@@@@@@@@@@@@@@
@@@@@@@@@@@@@@@@@@@@@@@@@@@@@@@@@@@@@@@@@@@@@@@@@@@@@@@@@@@@@@@@@@@@@@@@@@@@@@@@@@@@@@@@@@@@@@@@@@@@@@@@@@@@@@@@@@@@@@@@@@@@@@@@@@@@@@@@@@@@@@@@@@@@
@@@@@@@@@@@@@@@@@@@@@@@@@@@@@@@@@@@@@@@@@@@@@@@@@@@@@@@@@@@@@@@.T@@@@@@@@@@@@@@@@@@@@@@@@@@@@@@@@@@@@@@@@@@@@@@@@@@@@@@@@@@@@@@@@@@@@@@@@@@@@@@@@@@@
@@@@@@@@@@@@@@@@@@@@@@@@@@@@@@@@@@@@@@@@@@@@@@@@@@@@@@@@@@@@@.TT.T@@@@@@@@@@@@@@@@@@@@@@@@@@@@@@@@@@@@@@@@@@@@@@@@@@@@@@@@@@@@@@@@@@@@@@@@@@@@@@@@@@
@@@@@@@@@@@@@@@@@@@@@@@@@@@@@@@@@@@@@@@@@@@@@@@@@@@@@@@@@@@@TTTTT.T@@@@@@@@@@@@@@@@@@@@@@@@@@@@@@@@@@@@@@@@@@@@@@@@@@@@@@@@@@@@@@@@@@@@@@@@@@@@@@@@@
@@@@@@@@@@@@@@@@@@@@@@@@@@@@@@@@@@@@@@@@@@@@@@@@@@@@@@@@@@T..TTTT..T@@@@@@@@@@@@@@@@@@@@@@@@@@@@@@@@@@@@@@@@@@@@@@@@@@@@@@@@@@@@@@@@@@@@@@@@@@@@@@@@
@@@@@@@@@@@@@@@@@@@@@@@@@@@@@@@@@@@@@@@@@@@@@@@@@@@@@@@@@.TTT..T.T.TT@@@@@@@@@@@@@@@@@@@@@@@@@@@@@@@@@@@@@@@@@@@@@@@@@@@@@@@@@@@@@@@@@@@@@@@@@@@@@@@
@@@@@@@@@@@@@@@@@@@@@@@@@@@@@@@@@@@@@@@@@@@@@@@@@@@@@@@@.TT.T.TT......@@@@@@@@@@@@@@@@@@@@@@@@@@@@@@@@@@@@@@@@@@@@@@@@@@@@@@@@@@@@@@@@@@@@@@@@@@@@@@
@@@@@@@@@@@@@@@@@@@@@@@@@@@@@@@@@@@@@@@@@@@@@@@@@@@@@@@TTT.@@...T....TT@@@@@@@@@@@@@@@@@@@@@@@@@@@@@@@@@@@@@@@@@@@@@@@@@@@@@@@@@@@@@@@@@@@@@@@@@@@@@
@@@@@@@@@@@@@@@@@@@@@@@@@@@@@@@@@@@@@@@@@@@@@@@@@@@@@@T..@@@@.TT.T.TT.T@@@@@@@@@@@@@@@@@@@@@@@@@@@@@@@@@@@@@@@@@@@@@@@@@@@@@@@@@@@@@@@@@@@@@@@@@@@@@
@@@@@@@@@@@@@@@@@@@@@@@@@@@@@@@@@@@@@@@@@@@@@@@@@@@@@.T.@@@@.TT..TTT.T..@@@@@@@@@@@@@@@@@@@@@@@@@@@@@@@@@@@@@@@@@@@@@@@@@@@@@@@@@@@@@@@@@@@@@@@@@@@@
@@@@@@@@@@@@@@@@@@@@@@@@@@@@@@@@@@@@@@@@@@@@@@@@@@@@.T.@@@@.T..@@@T..T..T@@@@@@@@@@@@@@@@@@@@@@@@@@@@@@@@@@@@@@@@@@@@@@@@@@@@@@@@@@@@@@@@@@@@@@@@@@@
@@@@@@@@@@@@@@@@@@@@@@@@@@@@@@@@@@@@@@@@@@@@@@@@@@@T..@@@@@@...T@@.T.T...TT@@@@@@@@@@@@@@@@@@@@@@@@@@@@@@@@@@@@@@@@@@@@@@@@@@@@@@@@@@@@@@@@@@@@@@@@@
@@@@@@@@@@@@@@@@@@@@@@@@@@@@@@@@@@@@@@@@@@@@@@@@@.T.T@@@@@@@@TT.TTTTTT..TTTT.@@@@@@@@@@@@@@@@@@@@@@@@@@@@@@@@@@@@@@@@@@@@@@@@@@@@@@@@@@@@@@@@@@@@@@@
@@@@@@@@@@@@@@@@@@@@@@@@@@@@@@@@@@@@@@@@@@@@@@@@.TTT.@@@@@@@@.@T........TT...@@@@@@@@@@@@@@@@@@@@@@@@@@@@@@@@@@@@@@@@@@@@@@@@@@@@@@@@@@@@@@@@@@@@@@@
@@@@@@@@@@@@@@@@@@@@@@@@@@@@@@@@@@@@@@@@@@@@@@@T..TTTT@.@@@@TT@@.T.TTT..T.TTTTT@@@@@@@@@@@@@@@@@@@@@@@@@@@@@@@@@@@@@@@@@@@@@@@@@@@@@@@@@@@@@@@@@@@@@
@@@@@@@@@@@@@@@@@@@@@@@@@@@@@@@@@@@@@@@@@@@@@@T.T.@@@T..@@@.T@@@.T.T..TT.T.TT..T@@@@@@@@@@@@@@@@@@@@@@@@@@@@@@@@@@@@@@@@@@@@@@@@@@@@@@@@@@@@@@@@@@@@
@@@@@@@@@@@@@@@@@@@@@@@@@@@@@@@@@@@@@@@@@@@@@@.T..@@@...T@.T@@@TTT..TTT..TT..T..@@@@@@@@@@@@@@@@@@@@@@@@@@@@@@@@@@@@@@@@@@@@@@@@@@@@@@@@@@@@@@@@@@@@
@@@@@@@@@@@@@@@@@@@@@@@@@@@@@@@@@@@@@@@@@@@@..TT.TTTTT...TT@@@T...T.T..TT.T....TT.@@@@@@@@@@@@@@@@@@@@@@@@@@@@@@@@@@@@@@@@@@@@@@@@@@@@@@@@@@@@@@@@@@
@@@@@@@@@@@@@@@@@@@@@@@@@@@@@@@@@@@@@@@@@@@@TT.T.TTT..TT..@@@...TT..T.T..TTTT..T.T@@@@@@@@@@@@@@@@@@@@@@@@@@@@@@@@@@@@@@@@@@@@@@@@@@@@@@@@@@@@@@@@@@
@@@@@@@@@@@@@@@@@@@@@@@@@@@@@@@@@@@@@@@@@@@.T....T..TT@@@T.@T.TTTTT....T.T..TTTTTT.@@@@@@@@@@@@@@@@@@@@@@@@@@@@@@@@@@@@@@@@@@@@@@@@@@@@@@@@@@@@@@@@@
@@@@@@@@@@@@@@@@@@@@@@@@@@@@@@@@@@@@@@@@@@@.T.T...TT..@@@@.T.TT..T.T.T.TTTT.T...TTTT.@@@@@@@@@@@@@@@@@@@@@@@@@@@@@@@@@@@@@@@@@@@@@@@@@@@@@@@@@@@@@@@
@@@@@@@@@@@@@@@@@@@@@@@@@@@@@@@@@@@@@@@@@@@@TTT.TTTTT..@@@.T..T...@@...TTT.TT.TT.T.TT@@@@@@@@@@@@@@@@@@@@@@@@@@@@@@@@@@@@@@@@@@@@@@@@@@@@@@@@@@@@@@@
@@@@@@@@@@@@@@@@@@@@@@@@@@@@@@@@@@@@@@@@@@@@@.T..TTTTT.T.TT.TT...@@@@T.T.T.T.TT.T.T.@@@@@@@@@@@@@@@@@@@@@@@@@@@@@@@@@@@@@@@@@@@@@@@@@@@@@@@@@@@@@@@@
@@@@@@@@@@@@@@@@@@@@@@@@@@@@@@@@@@@@@@@@@@@@@TT.TTTT.TTT.T.TT..T@@@@@..TTTTTT.TTT.@@@@@@@@@@@@@@@@@@@@@@@@@@@@@@@@@@@@@@@@@@@@@@@@@@@@@@@@@@@@@@@@@@
@@@@@@@@@@@@@@@@@@@@@@@@@@@@@@@@@@@@@@@@@@@@@@....T....TTT.T.T.@@@@@@..T.T.TTT...@@@@@@@@@@@@@@@@@@@@@@@@@@@@@@@@@@@@@@@@@@@@@@@@@@@@@@@@@@@@@@@@@@@
@@@@@@@@@@@@@@@@@@@@@@@@@@@@@@@TT@@@@@@T@@@@@@@TT.T..T..TT..T.@@@@@@@@..TT.T..T.@@@@@.T@@T@@@@@@@@@@@@@@@@@@@@@@@@@@@@@@@@@@@@@@@@@@@@@@@@@@@@@@@@@@
@@@@@@@@@@@@@@@@@@@@@@@@@@@@@@@..@@@TTTT.TT@@@@@TT..T..TTT.T.@@@@@@@@TT.T....T.@@@@@...@@T@@@@@@@@@@@@@@@@@@@@@@@@@@@@@@@@@@@@@@@@@@@@@@@@@@@@@@@@@@
@@@@@@@@@@@@@@@@@@@@@@@@@@@@@@@.T@@.....T.T.@@@@@.TT....TT..@@@@@@@@T...TT..@@@@@@@TTTTT..T@@@@@@@@@@@@@@@@@@@@@@@@@@@@@@@@@@@@@@@@@@@@@@@@@@@@@@@@@
@@@@@@@@@@@@@@@@@@@@@@@@@@@@@@@TTTTTTTT...T.T@@@@.TTT..TTT.@@@@@@@@....TTT..@@@@@@@T.TTTT.T.@@@@@@@@@@@@@@@@@@@@@@@@@@@@@@@@@@@@@@@@@@@@@@@@@@@@@@@@
@@@@@@@@@@@@@@@@@@@@@@@@@@@@@@@TTTTTTT..TT.T..@@@T...T..T..@@@@@@@..TTTTT.T@@@@@@TT.T.TTT...@@@@@@@@@@@@@@@@@@@@@@@@@@@@@@@@@@@@@@@@@@@@@@@@@@@@@@@@
@@@@@@@@@@@@@@@@@@@@@@@@@@@@@@.TTT.T.TT....T.@@@@TT.T..TTT@@@@@@@TTT...TT.@@@@@@T.T.....T..T.@@@@@@@@@@@@@@@@@@@@@@@@@@@@@@@@@@@@@@@@@@@@@@@@@@@@@@@
@@@@@@@@@@@@@@@@@@@@@@@@@@@@@.T..T..T...TTT.@@@@..TTTT....@@@@@@TT.T...TT@@@@@@TTTTT@@.T...TTT.@@@@@@@@@@@@@@@@@@@@@@@@@@@@@@@@@@@@@@@@@@@@@@@@@@@@@
@@@@@@@@@@@@@@@@@@@@@@@@@@@@@...TTTTT...TTT@@@T.T...T.....T@TT@TT.TTTT..@@@@@@.T.TT@@@@TT.T.....@@@@@@@@@@@@@@@@@@@@@@@@@@@@@@@@@@@@@@@@@@@@@@@@@@@@
@@@@@@@@@@@@@@@@@@@@@@@@@@@@T..T.T..TT....@@@TT......T..TT.TTT.TTTT.T.T@@@@@@TT.TT@@@@@TT.T.T.TT.@@@@@@@@@@@@@@@@@@@@@@@@@@@@@@@@@@@@@@@@@@@@@@@@@@@
@@@@@@@@@@@@@@@@@@@@@@@@@@TTT..TT...TTTTT@@@.T.T.....TT..T.T.T..TT.T.@@@@@@...TTT@@@@T..T.TT..TTT.@@@@@@@@@@@@@@@@@@@@@@@@@@@@@@@@@@@@@@@@@@@@@@@@@@
@@@@@@@@@@@@@@@@@@@@@@@@@@T..TTT.T.TTT.T@@@...T.....TTT..T..TTT..TT.T@@@@@@...T.@@@@TT...T..TT..T..@@@@@@@@@@@@@@@@@@@@@@@@@@@@@@@@@@@@@@@@@@@@@@@@@
@@@@@@@@@@@@@@@@@@@@@@@@T..TT.....T.T.T@@@TTT.TT..T.TT.TT...T..TTTT.@@@@@@TTTT.@@@@TT.TT..T.TT.TT...@@@@@@@@@@@@@@@@@@@@@@@@@@@@@@@@@@@@@@@@@@@@@@@@
@@@@@@@@@@@@@@@@@@@@@@@@.TTT.T....TT...@@T...TT..T..TTTTTT..TTTT.T.@@@@@@....T@@@@TT......T...TT..T.T@@@@@@@@@@@@@@@@@@@@@@@@@@@@@@@@@@@@@@@@@@@@@@@
@@@@@@@@@@@@@@@@@@@@@@@.TTTT...T.T.T...TT..T..T@@.....T...T.T.....@@@@@@.T.TT@@@@TT.@@@T.TTTTT...TT.TT@@@@@@@@@@@@@@@@@@@@@@@@@@@@@@@@@@@@@@@@@@@@@@
@@@@@@@@@@@@@@@@@@@@@TT..TTTTTTTTT@@@TTT.T..T.@@@@....T.T..T...T.@@@@@@@TT.T@@@@...@@@@@TTT..T@..TTTTTT@@@@@@@@@@@@@@@@@@@@@@@@@@@@@@@@@@@@@@@@@@@@@
@@@@@@@@@@@@@@@@@@@@@.TTTTT.TTTT.@@@@@..TT.T.@@@@@@TT..TTTTT...T@@@@@....T.@@@@T..@@@@@@.@.T.@@@T.TTT.T.@@@@@@@@@@@@@@@@@@@@@@@@@@@@@@@@@@@@@@@@@@@@
@@@@@@@@@@@@@@@@@@@@.T..TT.TT.T.@@@@@T.T..TT@@@@@@@T.T.TT.T.T.T@@@@@...T.T@@@@T..@@@@@@@@@T.@@@@TTT...TTT@@@@@@@@@@@@@@@@@@@@@@@@@@@@@@@@@@@@@@@@@@@
@@@@@@@@@@@@@@@@@@@@@TTT..T.T.T@@@@@T.T.T..@@@@@@@@TTT.....TT..@@@@TT.T..@@@@TT.T@@@@@@@@TT@@@@TT.TT..TTTT@@@@@@@@@@@@@@@@@@@@@@@@@@@@@@@@@@@@@@@@@@
@@@@@@@@@@@@@@@@@@@@@.T.T...TT@@@@@.TT.T..@@@@@@@@@...T.T...T..T@@@....T..@@T.T..@@@@@@@..@@@@...T..TTT.T.TT@@@@@@@@@@@@@@@@@@@@@@@@@@@@@@@@@@@@@@@@
@@@@@@@@@@@@@@@@@@@@@@.T..TT.@@@@@TT..T.T@@@@@@@@T.TTT..TTTTT.TT.@@.TT.T......T..T.@@T@T.@@@@.T.TT...TTT.T..@@@@@@@@@@@@@@@@@@@@@@@@@@@@@@@@@@@@@@@@
@@@@@@@@@@@@@@@@@@@@@@@T.T..@@@@@.T....T@@@@@@@@.TTT.TT...@.T..TT...TTT.T....T.T.......T@@@@.T..TT.T.TTTT.T..T@@@@@@@@@@@@@@@@@@@@@@@@@@@@@@@@@@@@@@
@@@@@@@@@@@@@@@@@@@@@@@@.T.@@@@@.T...T.T@@@@@@@TT.TT....T@@@..TTTTT.......TT....T..TTT.@@@@TT@@....TTTT..T.TTT@@@@@@@@@@@@@@@@@@@@@@@@@@@@@@@@@@@@@@
@@@@@@@@@@@@@@@.T.@@@@@@@..@@@@.TT.T...T@@@@@@T..TTTTTTT@@@@@T..TTT.TT...T.TTTTTT.TT.T@@@@TT@@@@.TT..T@....T...@@@@@@@@@@@@@@@@@@@@@@@@@@@@@@@@@@@@@
@@@@@@@@@@@@@@@T..T@@@@@@@@@@@.....TTT..@@@@@...TTTTTTT@@@@@@T.TTTTT..T.TT.TTTT..T...@@@@.T@@@@@@.T..@@@TT...T..@@@@@@@@@@@@@@@@@@@@@@@@@@@@@@@@@@@@
@@@@@@@@@@@@@@@T..TTT@@@@@@@@..T....T.TT.@@@T...T.T.T.@@@@@@@T..TTT.T.TT.TTTTTTT.T..@@@@TT@@@@@@@...@@@@...TTT.T.@@@@@@@@@@@@@@@@@@@@@@@@@@@@@@@@@@@
@@@@@@@@@@@@@@@@..T...@@@@@@T..TT..T..T.TT.T.TT..TTT.@@@@@@TT.TT.TTT..TTTTT..TT..TT@@@@..@@@@@@@...@@@@..TTTT..T..@@@@@@@@@@@@@@@@@@@@@@@@@@@@@@@@@@
@@@@@@@@@@@@@@@@TTTT..T@@@@@@@T....T.T.T.T..T...TT..@@@@@@..T....T.T.T...T.TT.@@...@@@...T@@@@@.TT@@@@...TT.TTTT...@@@@@@@@@@@@@@@@@@@@@@@@@@@@@@@@@
@@@@@@@@@@@@@@@...TTT..T@@@@@@...T.......T...T...TT@@@@@@TT.T..T.TTTT.TTTT..T@@@@.T.@TTTTTT@@@T..@@@@.TTTTT..T.T.T.TT@@@@@@@@@@@@@@@@@@@@@@@@@@@@@@@
@@@@@@@@..@@@@..T.T@..TT.@@@@@@T..T.T.TTTT..TTT.TT@@@@@@T...TTT.TT.T...TT...@@@@@@.TTTTT....T..T@@@@.TTT.TTTTTT.TTT...@@@@@@@@@@@@@@@@@@@@@@@@@@@@@@
@@@@@@@..TT@@T..TT@@@TTT..@@@@@T..TTT.T.TTT..T..T@@@@@@@TTT..T.T@T@@TT.TTTT@@@.T@@@T.TTT...TT..@@@@..@@@.T.T.TT.TT.TT..T@@@@@@@@@@@@@@@@@@@@@@@@@@@@
@@@@@@@@..T.TT.TT@@@@@TTT.T@@@@...TT.TTT..TTTT.T@@@@@TTT.TTTTT.@@@@@@.....@@@.T..@@@......T.T.@@@@@@@@@@@.....TTT...T.TT.@@@@@@@@@@@@@@@@@@@@@@@@@@@
@@@@@@@@@..T.TT.T@@@@@@T...T@.T..T.TTTTTT......@@@@@..TT.T.TT..@@@@@@TTT.@@@T...T.@@@T..T.T.T@@@@@@@@@@@@T...TTT@TT..T.T..@@@@@@@@@@@@@@@@@@@@@@@@@@
@@@@@@@@@@.TT.T...@@@@@@TTTT..T.@@@TTT...TTTT.@@@@@.TTT...T.TT@@@@@@...T@@@.TTT....@@@......@@@@T@@@@@@@@@.TT.T@@@TT.TTT.TT@@@@@@@@@@@@@@@@@@@@@@@@@
@@@@@@@@@@@T.TTT.TT@@@@@T.T.TTTT@@@@..T.TTTTT@@@@@@.TTTTT.TTT.T@@@@TT..@@@T..T......@@@TT.T@@@@TT@T@@@@@@@....@@@@..TT...TT.@@@@@@@@@@@@@@@@@@@@@@@@
@@@@@@@@@@@@.....T..@@@..@T.T..T@@@@@...TTT.@@@@@@@TTTTTTT.TTT.T@@.T..@@@.TT.TT.TTTT.@@@T..@@@T.T.T@@@@@@T.TT@@@@TT.T...TTT..@@@@@@@@@@@@@@@@@@@@@@@
@@@@@@@@@@@@@.T.T.TTT@TT@@@.T.TTTT@@@@...TT@@@@@@@@@.TTTTTTT.T...TT..@@@TTT.T.TT..T...@@T.T.@.TT.TT.@@@@..TT@@@@TTT...T.TTT..@@@@@@@@@@@@@@@@@@@@@@@
@@@@@@@@@@@@@@.TT...T..@@@@@T......@@@@.T.@@@@@@@@...TT....T.TT.TTTT.@@T..TTTTTT.T.TTT@@@..T..T...T.T@@.T..@@@@..T.T.T..T..T@@@@@@@@@@@@@@@@@@@@@@@@
@@@@@@@@@@@@@@@TTT.TTTT@@@@@@T....T.@@@@T@@@@@@@@...TTTTT....T..TTT.@@TT...TT..@@..T...@@@.T...T.TT.TT..T.@@@@.T.TT...TT..T@@@@@@@@@@@@@@@@@@@@@@@@@
@@@@@@@@@@@@@@@@TT.T.TTT.@@@@TT...T.@@@@@@@@@@@@T...TT...TT..T...TT@@@TTTTTT..T@@@TT.T.@@@TT...TTTTTTTT..@@@@.TTT.TT..TT..@@@@@@@T@@@@@@@@@@@@@@@@@@
@@@@@@@@@@@@@@@@@...TTTTT.@@.TTTT.T@@@@@@@@@@@@TTT.T.@@........T..@@@@...T.TTT.T@@.T....@.TTTTTT.TTT..T.@@@@.T.TTTT....TT@@@@@@TTTT@@@@@@@@@@@@@@@@@
@@@@@@@@@@@@@@@@@@TTTTT.TT..TT.T.T@@@@@@@@@@@@......@@@@T..TTT...@@@@@@..TTTT..T@@T...T..TTT..TTTTTTT..@@@@T.T..TT..TTTT@@@@@@@TTT@@@@@@@@@@@@@@@@@@
@@@@@@@@@@@@@@@@@@@.T..T..T.TTTT.@@@@@@@@@@@@.T.TTT@@@@@@TTTTTT.T@@@@@@@TT.T....@@@TT...@@TT.T.T..T...@@@@TT.TT..T.TTT.@@@@@@@@T..@@@@@@@@@@@@@@@@@@
@@@@@@@@@@@@@@@@@@@@.T..T.T..T.T@@@@@@@@@@@@@T..TT@@@@@@@@@T.TT..@@@@@@@@@@....@@@@..TT.@@...TTT..TTT@@@@TT....TTT..TT@@@@@@@@@.T.T@@@@@@@@@@@@@@@@@
@@@@@@@@@@@@@@@@@@@@@T.TT.T....@@@@@@@@@@@@@@TT.T@@@@@@@@@@@T.T...@@@@@@@@@@@@@@.T@@TT.T.T...T.T..T..@@@....TTTTTTTT.@@@@@@@@TT.TT.T@@@@@@@@@@@@@@@@
@@@@@@@@@@@@@@@@@@@@@@TTTTTT..@@@@@@@@@@@@....@@@@@@@@@@@@@@@TTTTTT@@@@@@@@@@T...T@@..TT...TT.T.T.T...@.T.TT..T..T.T@@@@@@@@..T...T.T@@@@@@@@@@@@@@@
@@@@@@@@@@@@@@@@@@@@@@@.TT..T@@@@@@@@@@@@T..TT@@@@@@@@@@@@@@@T.TTT.T@@@@@@@@..T.TTT@T.T.T...T..T..TTTTT.TTT...T..TT@@@@@@@@@T..T.T..T.@@@@@@@@@@@@@@
@@@@@@@@@@@@@@@@@@@@@@@@TTTT@@@@@@@@@@@@T..TTT@@@@@@@@@@@@@@TTT.T.TT..@@@@@T.TT.TTTT...TT..T.TT..T.TTT....TT.TTT..@@@@@@@@TT...TT.T..TT@@@@@@@@@@@@@
@@@@@@@@@@@@@@@@@@@@@@@@@TT@@@@@@@@@T@@TTT.T...@@@@@@@@@@@@T..TTT..T.TT@@@TT.TTTT.TT...TT..T.T.T.TTT......T.T.T.T@@@@@@@@TT.T..TT...TT.T@@@@@@@@@@@@
@@@@@@@@@@@@@@@@@@@@@@@@@@@@@@@@@@@@TTT..TTTTTT.@@@@@@@@@@..TTT@@.TT.TTT@T..T.T.TTT.T.TTTTT..T.TTTT.T.....TTT..T@@@@@@@@.T.TTTTT.TT..TT..@@@@@@@@@@@
@@@@@@@@@@@@@@@@@@@@@@@@@@@@@@@@@@@@.T.TTT.T..T.@@@@@@@@@.T...@@@@@...T.TTT..TTTTTTT...T...TT....TTT..TTT..T.TT@@@@@@@@T.TT.T.T.TTT.T.TT..@@@@@@@@@@
@@@@@@@@@@@@@@@@@@@@@@@@@@@@@@@@@@.TT..TT..TTT..T@@@@@@.TT.TT@@@@@@@T.T.TT.T.TTTTT...T.TTT..T..T.T.T..TT..T...@@@@@@@@..TTTT....T.T..T....T@@@@@@@@@
@@@@@@@@@@@@@@@@@@@@@@@@@@@@@@@@@TT.T..T.......T@@@@@@@TT.T.@@@@@@@@@T.T.TTT...T..TTTT..TTTTTT..T.....T......@@@@@@@@....T.TTTT@.TT.TT....T.@@@@@@@@
@@@@@@@@@@@@@@@@@@@@@@@@@@@@@@@@.T.TT..TT.TTTTT@@@@@@@@TTTT@@@@@@@@@@@TTT.T.TT.T..TT.T.TTT.T.T..T..TTT...TT.@@@@@@@@...T....TT@@@..TTTT.TTTT.@@@@@@@
@@@@@@@@@@@@@@@@@@@@@@@@@@@@@@@..T...TT....T..@@@@@@@@@TT.T@@@@@@@@@@@@TT.TTT...TTT...TT...T.TT.TT.TTTTT..T@@@@@@@@TT..TT...T@@@@@TT.......T.T@@@@@@
@@@@@@@@@@@@@@@@@@@@@@@@@@@@@@@@T..T.T..T....@@@@@@@T....@@@@@@@@@@@@@@@......T.T.T...T..TTT.T.T..T..TT..T@@@@@@@@TT.......T.T@@@@.T..T.T....@@@@@@@
@@@@@@@@@@@@@@@@@@@@@@@@@@@@@@@@@...TTT...TT@@@@@@@....T@@@@@@@@@@@@@@@T.....T.TTT.T..TTT..TTT.T....TTT..@@@@@@@@T..TTTTT.TT.TT@@T.T....TTT.@@@@@@@@
@@@@@@@@@@@@@@@@@@@@@@@@@@@@@@@@@@.TT.T.TT.@@@@@@@@...T..@@@@@@@@@@@@T.T.T.T...TT....T.T.T..TT.T..T.TTT.T@@@@@@@TT.TTTT.TT...TTTTT...T...TT@@@@@@@@@
@@@@@@@@@@@@@@@@@@@@@@@@@@@@@@@@@@@...TT.@@@@@@...TTTTT.TT@@@@@@@@@@T.TT.@@TTTTT..TT......T....T......TT.T@@T@@@...TT@TTTT..TT.TTT...T.T.T@@@@@@@@@@
@@@@@@@@@@@@@@@@@@@@@@@@@@@@@@@@@@@@TT.T@@@@@@@..TTTT.T..T@@@@@@@@@.T.T.@@@@.T..TTTT.TTT.T.T.T...TTT.TT...T@....T...@@@TTTTTT...TT.T.TTT.@@@@@@@@@@@
@@@@@@@@@@@@@@@@@@@@@@@@@@@@@@@@@@@@@T.@@@@@@@..TT..TTT..T.@@@@@@@.T..T@@@@@@T.TT..TTT.T.TT...TTTT..TTTTTTTT.TT..TT@@@@@TTTT....T..TTTTT@@@@@@@@@@@@
@@@@@@@@@@@@@@@@@@@@@@@@@@@@@@@@@@@@@@@@@@@@@TT...TTTTT....@@@@@@TTTT.@@@@@@@@.TTTTTTT.T...TTTTT.TT.T....T..TTT.T..T@@@@@TTT..TT.T.....@@@@@@@@@@@@@
@@@@@@@@@@@@@@@@@@@@@@@@@@@@@@@@@@@@@@@@@@@T.T.T..T..T.TT.@@@@@@@..T.@@@@@@@@@@....T.T..TT....T....TTTT..TT...TTT..T.@@@@@T.T...TT..T.@@@@@@@@@@@@@@
@@@@@@@@@@@@@@@@@@@@@@@@@@@@@@@@@@@@@@@@@@TT.T.TTT....TT.@@@@@@@@T.T@@@@@@@@@@@@T..T....TT.T.T..TT..TT.T..T.T..TT..TTT@@@@@T.....T...@@@@@@@@@@@@@@@
@@@@@@@@@@@@@@@@@@@@@@@@@@@@@@@@@@@@@@@@@.T.T.T..TT.T.T.@@@@@@@TT..@@@@@@@@@@@@@@T.T..TT.TTT.TT.TTTT.T.T......T....T..T@@@@@.T.TT.T.@@@@@@@@@@@@@@@@
@@@@@@@@@@@@@@@@@@@@@@@@@@@@@@@@@@@@@@@@@@T.TT..T..T.T@@@@@@@..TT..@@@@@@@@@@@@@@.TTTTTT..T..TT.TT..T.....T..TTTT@..T...@@@@@...T.T@@@@@@@@@@@@@@@@@
@@@@@@@@@@@@@@@@@@@@@@@@@@@@@@@@@@@@@@@@@@@TT...TTTT.@@@@@@@@.T.T.@@@@@@@@@@@@@@.T..T..T.T.TT@...TT...T......T.TT@@.TT...@@@@@TTT.@@@@@@@@@@@@@@@@@@
@@@@@@@@@@@@@@@@@@@@@@@@@@@@@@@@@@@@@@@@@@@@...T.T.@@@@@@.@@@.T.TTT@@@@@@@@@@@@...TT.TTTT...@@@TTT...T..T..TT.....@@.TT.TT@@@@@T.@@@@@@@@@@@@@@@@@@@
@@@@@@@@@@@@@@@@@@@@@@@@@@@@@@@@@@@@@@@@@@@@@...T.@@@@@@@..TTTT.TT.T@@@@@@@@@@.TT..T..TT..T@@@@@..TTTT...T.TTT..T..@@TT..TT@@@@@@@@@@@@@@@@@@@@@@@@@
@@@@@@@@@@@@@@@@@@@@@@@@@@@@@@@@@@@@@@@@@@@@@@...@@@@@@@@T.T...TT.T.@@@@@@@@@.TTT.T......T@@@@@@T..TT.T.TT.@@.TTT.TT@T.TT.T.@@@@@@@@@@@@@@@@@@@@@@@@
@@@@@@@@@@@@@@@@@@@@@@@@@@@@@@@@@@@@@@@@@@@@@@@.@@@@@@@.TTT..T.T.T.T@@@@@@@@...TT.TT.TTT.@@@@@@@TT..TTTT.T@@@@.T...TT.T...T.@@@@@@@@@@@@@@@@@@@@@@@@
@@@@@@@@@@@@@@@@@@@@@@@@@@@@@@@@@@@@@@@@@@@@@@@@@@@@@@TT....TT.TTT.@@@@@@@@.TTTTTT..T..T@@@@@@..T..TT...T.@@@@TTT......T...@@@@@@@@@@@@@@@@@@@@@@@@@
@@@@@@@@@@@@@@@@@@@@@@@@@@@@@@@@@@@@@@@@@@@@@@@@@@@@@...TTT.T.TT..@@@@@@@@@T..T.TTTT...@@@@@@..T.TTT.TT..TT@@T..T.T.TTT...@@@@@@@@@@@@@@@@@@@@@@@@@@
@@@@@@@@@@@@@@@@@@@@@@@@@@@@@@@@@@@@@@@@@@@@@@@@@@@.TTT......TT..@@@@@@@@@@.TT.T.T..TT@@@@@@@T..TTTT..TTT.....TT..TT.TTT.@@@@@@@@@@@@@@@@@@@@@@@@@@@
@@@@@@@@@@@@@@@@@@@@@@@@@@@@@@@@@@@@@@@@@@@@@@@@@@@TT..T...TT.T.@@@@@@@@TTT.T@T.T.T.T@@@@@@@@.TT..T.TT....T.....T..T....@@@@@@@@@@@@@@@@@@@@@@@@@@@@
@@@@@@@@@@@@@@@@@@@@@@@@@@@@@@@@@@@@@@@@@@@@@@@@@@@@T......TT.T@@@@@@@@.TTTTT@@.TT..@@@@@@@@TTTT....T..@@TTTTTTT...T.TT@@@@@@@@@@@@@@@@@@@@@@@@@@@@@
@@@@@@@@@@@@@@@@@@@@@@@@@@@@@@@@@@@@@@@@@@@@@@@@@@@@@TT.....T.@@@@@@@@.TTT..T@@@.T.@@@@@@@@TT.TT.T..TTTT@@.T.TTTT.T.T..T@@@@@@@@@@@@@@@@@@@@@@@@@@@@
@@@@@@@@@@@@@@@@@@@@@@@@@@@@@@@@@@@@@@@@@@@@@@@@@@@@@@..T.TTT@@@@@@T...T..T.T.@@@@@@@@@@@@.TTT.TTTT.T..TT@@T.TT.T.TT..T.T@@@@@@@@@@@@@@@@@@@@@@@@@@@
@@@@@@@@@@@@@@@@@@@@@@@@@@@@@@@@@@@@@@@@@@@@@@@@@@@@@@@.TTT@@@@@@@@T.TTTTTTT.T@@@@@@@@@@@TT.T.TT@@TT.T...T@@...TT.....TTT@@@@@@@@@@@@@@@@@@@@@@@@@@@
@@@@@@@@@@@@@@@@@@@@@@@@@@@@@@@@@@@@@@@@@@@@@@@@@@@@@@@@..@@@@@@@@..T......TT.@@@@@@@@@@.TTTTTT@@@@..TT....@TT.TTT..TTT.@@@@@@@@@@@@@@@@@@@@@@@@@@@@
@@@@@@@@@@@@@@@@@@@@@@@@@@@@@@@@@@@@@@@@@@@@@@@@@@@@@@@@@@@@@@@@@@..TT.T.TT.T@@@@@@@@@@@.T..T..T@@@@..T....TTTTT.T.T..T@@@@@@@@@@@@@@@@@@@@@@@@@@@@@
@@@@@@@@@@@@@@@@@@@@@@@@@@@@@@@@@@@@@@@@@@@@@@@@@@@@@@@@@@@@@@@@@T..TT..T.TT@@@@@@@@@TTTT..T.T..T@@@@T..TTT.T..T.TTT..@@@@@@@@@@@@@@@@@@@@@@@@@@@@@@
@@@@@@@@@@@@@@@@@@@@@@@@@@@@@@@@@@@@@@@@@@@@@@@@@@@@@@@@@@@@@@@@T.T.T..T...@@@@@@@@@TT.T.TTT....T.@@@@TT.TT.T..TT....@@@@@@@@@@@@@@@@@@@@@@@@@@@@@@@
@@@@@@@@@@@@@@@@@@@@@@@@@@@@@@@@@@@@@@@@@@@@@@@@@@@@@@@@@@@@@@@TTTTTTTTT.T@@@@@@@@@TTTTTTT.TT.TTT..@@@@TT..TT..TT.T.@@@@@@@@@@@@@@@@@@@@@@@@@@@@@@@@
@@@@@@@@@@@@@@@@@@@@@@@@@@@@@@@@@@@@@@@@@@@@@@@@@@@@@@@@@@@@@T.TTTTTT.TTT@@@@@@@@T.T.T...TT..T..TT.T@@@@TT...T@@@@.@@@@@@@@@@@@@@@@@@@@@@@@@@@@@@@@@
@@@@@@@@@@@@@@@@@@@@@@@@@@@@@@@@@@@@@@@@@@@@@@@@@@@@@@@@@@@@@@T.......TT@@@@@@@@TTTTTT...TT.TTTTTT.T.@@@@TT.T.@@@@@@@@@@@@@@@@@@@@@@@@@@@@@@@@@@@@@@
@@@@@@@@@@@@@@@@@@@@@@@@@@@@@@@@@@@@@@@@@@@@@@@@@@@@@@@@@@@@@@@...T...T@@@@@@@@.TTTT.TT..T.TTT..T..T.T@@@@.TT@@@@@@@@@@@@@@@@@@@@@@@@@@@@@@@@@@@@@@@
@@@@@@@@@@@@@@@@@@@@@@@@@@@@@@@@@@@@@@@@@@@@@@@@@@@@@@@@@@@@@@@@....TT@@@@@@@@.T.T..T......T..TTT......@@@@T@@@@@@@@@@@@@@@@@@@@@@@@@@@@@@@@@@@@@@@@
@@@@@@@@@@@@@@@@@@@@@@@@@@@@@@@@@@@@@@@@@@@@@@@@@@@@@@@@@@@@@@@@@TT.T@@@@@@@@@T..T.T.T.TT.T.TT...TT..TT.@@@@@@@@@@@@@@@@@@@@@@@@@@@@@@@@@@@@@@@@@@@@
@@@@@@@@@@@@@@@@@@@@@@@@@@@@@@@@@@@@@@@@@@@@@@@@@@@@@@@@@@@@@@@@@@T.T@@@@@T@@...TT......@@@T.TTT.T.TT..T.@@@@@@@@@@@@@@@@@@@@@@@@@@@@@@@@@@@@@@@@@@@
@@@@@@@@@@@@@@@@@@@@@@@@@@@@@@@@@@@@@@@@@@@@@@@@@@@@@@@@@@@@@@@@@@@.@@@@@...T..TT...T.T@@@@@T..T...T...T.@@@@@@@@@@@@@@@@@@@@@@@@@@@@@@@@@@@@@@@@@@@
@@@@@@@@@@@@@@@@@@@@@@@@@@@@@@@@@@@@@@@@@@@@@@@@@@@@@@@@@@@@@@@@@@@@@@@@.T.TT.TT....T..@@@@TTTTT.TTTT.T@@@@@@@@@@@@@@@@@@@@@@@@@@@@@@@@@@@@@@@@@@@@@
@@@@@@@@@@@@@@@@@@@@@@@@@@@@@@@@@@@@@@@@@@@@@@@@@@@@@@@@@@@@@@@@@@@@@@@T.T..TTTT..TTTTT.@@.TT.T.TT.T.TT@@@@@@@@@@@@@@@@@@@@@@@@@@@@@@@@@@@@@@@@@@@@@
@@@@@@@@@@@@@@@@@@@@@@@@@@@@@@@@@@@@@@@@@@@@@@@@@@@@@@@@@@@@@@@@@@@@@@..T..T.TT..T....TT..T..T..TTT..T@@@@@@@@@@@@@@@@@@@@@@@@@@@@@@@@@@@@@@@@@@@@@@
@@@@@@@@@@@@@@@@@@@@@@@@@@@@@@@@@@@@@@@@@@@@@@@@@@@@@@@@@@@@@@@@@@@@@@@TT..TTTT.T.T..TTT.T.......TT.T@@@@@@@@@@@@@@@@@@@@@@@@@@@@@@@@@@@@@@@@@@@@@@@
@@@@@@@@@@@@@@@@@@@@@@@@@@@@@@@@@@@@@@@@@@@@@@@@@@@@@@@@@@@@@@@@@@@@@@@@..TTTTT..TT..T.TT....TTT.TT.@@@@@@@@@@@@@@@@@@@@@@@@@@@@@@@@@@@@@@@@@@@@@@@@
@@@@@@@@@@@@@@@@@@@@@@@@@@@@@@@@@@@@@@@@@@@@@@@@@@@@@@@@@@@@@@@@@@@@@@@@@TT..T.TTT.TTT.T.TTTT..T..T@@@@@@@@@@@@@@@@@@@@@@@@@@@@@@@@@@@@@@@@@@@@@@@@@
@@@@@@@@@@@@@@@@@@@@@@@@@@@@@@@@@@@@@@@@@@@@@@@@@@@@@@@@@@@@@@@@@@@@@@@@@@..T.T...TTT..T..T..T.TT.@@@@@@@@@@@@@@@@@@@@@@@@@@@@@@@@@@@@@@@@@@@@@@@@@@
@@@@@@@@@@@@@@@@@@@@@@@@@@@@@@@@@@@@@@@@@@@@@@@@@@@@@@@@@@@@@@@@@@@@@@@@@@@T...TT.TTTT.TTT..TTTT.@@@@@@@@@@@@@@@@@@@@@@@@@@@@@@@@@@@@@@@@@@@@@@@@@@@
@@@@@@@@@@@@@@@@@@@@@@@@@@@@@@@@@@@@@@@@@@@@@@@@@@@@@@@@@@@@@@@@@@@@@@@@@@@@..T.TT.T..T..TTT.T.T@@@@@@@@@@@@@@@@@@@@@@@@@@@@@@@@@@@@@@@@@@@@@@@@@@@@
