type octile
height 54
width 52
map
@@@@@@@@@@@@@@@@@@@@@@@@@@@@@@@@@@@@@@@@@@@@@@@@@@@@
@@@@@@@@@@@@@@@@@@@@@@@@@@@@@@@@@@@@@@@@@@@@@@@@@@@@
@@@@@@@@@@@@@@@@@@@@@@@@@@@@@@@@@@@@@@@@@@@@@@@@@@@@
@@@@@@@@@@@@@@@@@@@@@@@@@@@@@@@@@@@@@@@@@@@@@@@@@@@@
@@@@@@@@@@@@@@@@@@@@@@@@@@@@@@@@@@@@@@@@@@@@@@@@@@@@
@@@@@@@@@@@@@@@@@@@@@@@@@@@@@@@@@@@@@@@@@@@@@@@@@@@@
@@@@@@@@@@@@@@@@@@@@@@@@@@@@@@@@@@@@@@@@@@@@@@@@@@@@
@@@@@@@@@@@@@@@@@@@@@@@@@@@@@@@@@@@@@@@@@@@@@@@@@@@@
@@@@@@@@@@@@@@@@@@@@@@@@@@@@@@@@@@@@@@@@@@@@@@@@@@@@
@@@@@@@@@@@@@@@@@@@@@@@@@@@@@@@@@@@@@@@@@@@@@@@@@@@@
@@@@@@@@@@@@@@@@@@@@@@@@@@@@@@@@@@@@@@@@@@@@@@@@@@@@
@@@@@@@@@@@@@@@@@@@@@@@@@@@@@@@@@@@@@@@@@@@@@@@@@@@@
@@@@@@@@@@@@@@@@@@@@@@@@@@@@@@@@@@@@@@@@@@@@@@@@@@@@
@@@@@@@@@@@@@@@@@@@@@@@@@@@@@.@@@@@@@@@@@@@@@@@@@@@@
@@@@@@@@@@@@@@@@@@@@@@@@@@@@..T..@@@@@@@@@@@@@@@@@@@
@@@@@@@@@@@@@@@@@@@@@@@@@@@..TT..T@@@@@@@@@@@@@@@@@@
@@@@@@@@@@@@@@@@@@@@@@@@@@T..T.TTT@@@@@@@@@@@@@@@@@@
@@@@@@@@@@@@@@@@@@@@@@@@@@.TT.T.T@@@@@@@@@@@@@@@@@@@
@@@@@@@@@@@@@@@@@@@@@@@@TTTTTT...@@@@@@@@@@@@@@@@@@@
@@@@@@@@@@@@@@@@@@@@@@@@T.TT...T.@@@@@@@@@@@@@@@@@@@
@@@@@@@@@@@@@@@@@@@@@@@T.T.TTT@@..@@@@@T@@@@@@@@@@@@
@@@@@@@@@@@@@@@@@@@@@@T.TT..T.@@.TT@@.T..@@@@@@@@@@@
@@@@@@@@@@@@@@@@@@@@@@..TT.TTT.TTT@@TT....T.@@@@@@@@
@@@@@@@@@@@@@@@@@@@@@@..T...T.T..@@@T....T.T.@@@@@@@
@@@@@@@@@@@@@@@@@@@@@TT.TT.TTTT.TT@@T.T..T.TTT@@@@@@
@@@@@@@@@@@@@@@@@@@@..T.T.T..T.......TT.TTT..T@@@@@@
@@@@@@@@@@@@@@@@@@@T.TTT.T@@..T.TT.TTTT..T.TT@@@@@@@
@@@@@@@@@@@@@@@.@T...T.T.@@@@TTTTTT.....TTTT@@@@@@@@
@@@@@@@TT@@@@@@.TT..T.T.T.T..TTTT.T...TT..T@@@@@@@@@
@@@@@@@.T.TT..TTTT...@@@T@@@T.T..TT.......@@@@@@@@@@
@@@@@@@...T..T.T.T.TT@@@T@@@..TTTT.T.T.TT@@@@@@@@@@@
@@@@@@@@TT@@@TTT..T...T.T.@.TT.TT.T..T..@@@@@@@@@@@@
@@@@@@@@@@@@@@@T..TT..TT...T@.TTT.TT.T.@@@@@@@@@@@@@
@@@@@@@@@@@@@@@T.TTTT.TT..@@@......TTT@@@@@@@@@@@@@@
@@@@@@@@@@@@@@@..T...TTTTTT.......TTT@@@@@@@@@@@@@@@
@@@@@@@@@@@@@@@T....T....T...T.T.T.T@@@@@@@@@@@@@@@@
@@@@@@@@@@@@@@@T.T.T.TTTT.T.TTTTT.T@@@@@@@@@@@@@@@@@
@@@@@@@@@@@@@@@@......TT......T..T@@@@@@@@@@@@@@@@@@
@@@@@@@@@@@@@@@@@T.TT.TT..TT.T.TT@@@@@@@@@@@@@@@@@@@
@@@@@@@@@@@@@@@@@@T...T...T...TT@@@@@@@@@@@@@@@@@@@@
@@@@@@@@@@@@@@@@@@@...TT.TT.TT.@@@@@@@@@@@@@@@@@@@@@
@@@@@@@@@@@@@@@@@@@...TTT.T...@@@@@@@@@@@@@@@@@@@@@@
@@@@@@@@@@@@@@@@@@@.TT..T....@@@@@@@@@@@@@@@@@@@@@@@
@@@@@@@@@@@@@@@@@@TTTTTT..TT@@@@@@@@@@@@@@@@@@@@@@@@
@@@@@@@@@@@@@@@@@TT.T..TTTT@@@@@@@@@@@@@@@@@@@@@@@@@
@@@@@@@@@@@@@@@@T...TT.TT.@@@@@@@@@@@@@@@@@@@@@@@@@@
@@@@@@@@@@@@@@@@@.T.TTT.T@@@@@@@@@@@@@@@@@@@@@@@@@@@
@@@@@@@@@@@@@@@@@@.TTTTT@@@@@@@@@@@@@@@@@@@@@@@@@@@@
@@@@@@@@@@@@@@@@@@@TT..@@@@@@@@@@@@@@@@@@@@@@@@@@@@@
@@@@@@@@@@@@@@@@@@@@@@@@@@@@@@@@@@@@@@@@@@@@@@@@@@@@
@@@@@@@@@@@@@@@@@@@@@@@@@@@@@@@@@@@@@@@@@@@@@@@@@@@@
@@@@@@@@@@@@@@@@@@@@@@@@@@@@@@@@@@@@@@@@@@@@@@@@@@@@
@@@@@@@@@@@@@@@@@@@@@@@@@@@@@@@@@@@@@@@@@@@@@@@@@@@@
@@@@@@@@@@@@@@@@@@@@@@@@@@@@@@@@@@@@@@@@@@@@@@@@@@@@
