type octile
height 80
width 80
map
@@@@@@@@@@@@@@@@@@@@@@@@@@@@@@@@@@@@@@@@@@@@@@@@@@@@@@@@@@@@@@@@@@@@@@@@@@@@@@@@
@@@@@@@@@@@@@@@@@@@@@@@@@@@@@@@@@@@@@@@@@@@@@@@@@@@@@@@@@@@@@@@@@@@@@@@@@@@@@@@@
@@@@@@@@@@@@@@@@@@@@@@@@@@@@@@@@@@@@@@@@@@@@@@@@@@@@@@....TTT..TTTT..TTT..TT..@@
@@@@@@@@@@@@@@@@@@@@@@@@@@@@@@@@@@@@@@@@@@@@@@@@@@@@@@TTTT......TTTTT..T.T.TT.@@
@@@@@@@@@@@@@@@@@@@@@@@@@@@@@@@@@@@@@@@@@@@@@@@@@@@@@...TT....TT.TT..TT.TTT...@@
@@@@@@@@@@@@@@@@@@@@@@@@@@@@@@@@@@@@@@@@@@@@@@@@@@@@..TT..TT.TT..T.TT...TT.T..@@
@@@@@@@@@@@@@@@@@@@@@@@@@@@@@@@@@@@@@@@@@@@@@@@@@@@..T..T..T............TT....@@
@@@@@@@@@@@@@@@@@@@@@@@@@@@@@@@@@@@@@@@@@@@@@@@@@@@@...T.TT..T.T....TT..TTTTT.@@
@@@@@@@@@@@@@@@@@@@@@@@@@@@@@@@@@@@@@@@@@@@@@@@@@@@@@...T..T.TTTT..T.T.T..TT..@@
@@@@@@@@@@@@@@@@@@@@@@@@@@@@@@@@@@@@@@@@@@@@@@@@@@@@@.TT...TTT....TT..TTTT...T@@
@@@@@@@@@@@@@@@@@@@@@@@@@@@@@@@@@@@@@@@@@@@@@@@@@@@@@.TTT..T.TT.T.T..TTT.TT.TT@@
@@@@@@@@@@@@@@@@@@@@@@@@@@@@@@@@@@@@@@@@@@@@@@@@@@@@TT.TT....T.TT...TT.T......@@
@@@@@@@@@@@@@@@@@@@@@@@@@@@@@@@@@@@@@@@@@@@@@@@@@@TTTTT..T........T.T.T.T...TT@@
@@@@@@@@@@@@@@@@@@@@@@@@@@@@@@@@@@@@@@@@@@@@@@@@@@@TT.T..T.TTTT..T..T.TTTTTT.T@@
@@@@@@@@@@@@@@@@@@@@@@@@@@@@@@@@@@@@@..@@@@@@@@@@@@......T.TT......T.TT.T.T.TT@@
@@@@@@@@@@@@@@@@@@@@@@@@@@@@@@@@@@@@TTT@@@@@@@@@TT...TTTT...T.T..TT@@TTT.T.T.T@@
@@@@@@@@@@@@@@@@@@@@@@@@@@@@@@@@@@@@....@@@@@@@TTT......T.T.TT...@@@@....T.TTT@@
@@@@@@@@@@@@@@@@@@@@@@@@@@@@@@@@@@@T..T.@@TT...TT...TT.TTT...T.@@@@@@@...T.TTT@@
@@@@@@@@@@@@@@@@@@@@@@@@@@@@@@@@@@TT.TT.T..TTTTT.TTTT...TTT...@@@@@@@@T...TTTT@@
@@@@@@@@@@@@@@@@@@@@@@@@@@@@@@@@@@.@@T..T.T.......T.TT.TT.T.T.@@@@@@@@@.TT.T..@@
@@@@@@@@@@@@@@@@@@@@@@@@@@@@@@@@@@@@@TT...TT.TT....TTTTT....TTT@@@@@@@@..TT.T.@@
@@@@@@@@@@@@@@@@@@@@@@@@@@@@@@@@@@@@@@.TT..TT.TTT....TTTTT..TTT@@@@@@@@....T.T@@
@@@@@@@@@@@@@@@@@@@@@@@@@@@@@@@@@@@@...T.T.T.T...T......TT.T...@@@@@@@TTTT..TT@@
@@@@@@@@@@@@@@@@@@@@@@@@@@@@@@@@@@@@.....T.T....T.T..T.T..T.TT.T@@@@@....T..TT@@
@@@@@@@@@@@@@@@@@@@@@@@@@@@@@@@@@@@@T.T.T.T.....T..T..TTTTTTTTT.T@...TT..T.T..@@
@@@@@@@@@@@@@@@@@@@@@@@@@@@@@@@@@@..T.T.T.TT...T..TT..........TT.T...T.TTT.T..@@
@@@@@@@@@@@@@@@@@@@@@@@@@@@@@@@@@@..TTT.T.......TTTTTTT..TT.T...T..T...TT.T..@@@
@@@@@@@@@@@@@@@@@@@@@@@@@@@@@@@@@@...T.T.T..TTT.TTT..TT.T...T.TTTTT.T.T.T.T.@@@@
@@@@@@@@@@@@@@@@@@@@@@@@@@@@@@@@@@TTTT..TTT.TTT..T.T.TT..TT.....T.T..TT....@@@@@
@@@@@@@@@@@@@@@@@@@@@@TT..T@@@@@@TTT.T...T.TT..T..TT.TTT..T.T.T.TTTT.T..T@@@@@@@
@@@@@@@@@@@@@@@@@@@@@..T.TT@@@@@@....TTT.T.......TTTT.T.TTT.T...TT..TTT.@@@@@@@@
@@@@@@@@@@@@@@@@.@@@T.TT.T......T....T...T.T...TT....TTT.TT....TTTTT.T.@@@@@@@@@
@@@@@@@@@@@@@@@T...TT....TTTT...TTTT...TT.T.T.T..TT..T...T.TTTTT.T.TTTT@@@@@@@@@
@@@@@@@@@@@@@.TT.TT..T.TTTTTT.TTT.T..T..TTT.T.TT.TT...TTTTTTT...T.T...@@@@@@@@@@
@@@@@@@@@@@@..T.T.T..TTTTTT..TT.T..TT...T...T.T.T..T.TTT..T.TTT.T.T..@@@@@@@@@@@
@@@@@@@@@@@T....T....T.TT.......T.TTT..TT.T.TTTTT..TTTT..TT.TT..TT.T@@@@@@@@@@@@
@@@@@@@@@@T.TT..TTT....TTT.TT..TT.T..T....T.T.T..T.T....TT.TT.TT.TT@@@@@@@@@@@@@
@@@@@@@@@TTT....TTTT...TTT....TT..T......T...T..TTTTTT.TTT......T.@@@@@@@@@@@@@@
@@@@@@@@TT.TTTT.T..TT..TTTTT...TT...T.T....TTT.TTT.T.T.T...TT.TTT@@@@@@@@@@@@@@@
@@@@@@T.TTTT.T.T..@@@@@@@.T.TT..T..T.TTTTTT..T.TT.T.TTT.T.T.TTTTT@@@@@@@@@@@@@@@
@@@@@TT......T...@@@@@@@@TTTTTTT.T.T..TT..T...TTT..TTT...T.T.TTT@@@@@@@@@@@@@@@@
@@@@.T..TTT...T.T@@@@@@@@.....T.TT.TT...T....T.T..T...T...T..TT@@@@@@@@@@@@@@@@@
@@@TTTT..TT..TTTT.@@@@@@@.T..T.TTTT.T...TTT...T...T..T.T.T.TTT@@@@@@@@@@@@@@@@@@
@@.TT.TT...T..TT.T@@@@@.T....T..TT..TT....T..T.T.TT.T.T...T..@@@@@@@@@@@@@@@@@@@
@@.TTTT...T.T.TT..T.@@.TT.T...T.T.T...TTT.T....T..T.TTT...T.@@@@@@@@@@@@@@@@@@@@
@@..T...T.T.T.T..TTTT.T.TTTT..T.T.T.T.TTTT.T.T..TTT....TTTT@@@@@@@@@@@@@@@@@@@@@
@@..T..@T.TTT..TT.T.T....TT.T....T.T.TT.T.TT.T.T..T....TT.@@@@@@@@@@@@@@@@@@@@@@
@@.T.T@@@@TT.TT....TTT.T...TT....TTT.T.T.T..T.T.T...T.T.@@@@@@@@@@@@@@@@@@@@@@@@
@@T.@@@@@@@@TTTTT.TT..TTTT.T.TT.......TT.......T...T...@@@@@@@@@@@@@@@@@@@@@@@@@
@@.@@@@@@@@@@..TTT.TTTT....T..TTT...TTT...TT....T.T...@@@@@@@@@@@@@@@@@@@@@@@@@@
@@@@@@@@@@@@@@T.T.TTTT...T..TT.TT..T.T......T.TTT...@@@@@@@@@@@@@@@@@@@@@@@@@@@@
@@@@@@@@@@@@@@@T...TT.T.T....TT....T..T.TTT..TT....@@@@@@@@@@@@@@@@@@@@@@@@@@@@@
@@@@@@@@@@@@@@@@..TT.TTTTTTTTTT....TT.T.....TTTT.T@@@@@@@@@@@@@@@@@@@@@@@@@@@@@@
@@@@@@@@@@@@@@@@@.TTT..TT.T..TT...T.T.TT.TTTTTTT.@@@@@@@@@@@@@@@@@@@@@@@@@@@@@@@
@@@@@@@@@@@@@@@@@@..TTT..T...T.T.T..T..TT.TT.T.T@@@@@@@@@@@@@@@@@@@@@@@@@@@@@@@@
@@@@@@@@@@@@@@@@@@@TT.TTT...TT.T..T....T...TTTT@@@@@@@@@@@@@@@@@@@@@@@@@@@@@@@@@
@@@@@@@@@@@@@@@@@@@@TTT.TT...T.T.TTTTT.TTT..T.@@@@@@@@@@@@@@@@@@@@@@@@@@@@@@@@@@
@@@@@@@@@@@@@@@@@@@@@T.T..T....T..T....TTT.TTT@@@@@@@@@@@@@@@@@@@@@@@@@@@@@@@@@@
@@@@@@@@@@@@@@@@@@@@@@..TT..TTTT....T.....TT.@@@@@@@@@@@@@@@@@@@@@@@@@@@@@@@@@@@
@@@@@@@@@@@@@@@@@@@@@@@.T...T....T.TTTTTT.TT@@@@@@@@@@@@@@@@@@@@@@@@@@@@@@@@@@@@
@@@@@@@@@@@@@@@@@@@@@@@@T...TT.TT.TTTT..T..@@@@@@@@@@@@@@@@@@@@@@@@@@@@@@@@@@@@@
@@@@@@@@@@@@@@@@@@@@@@@@@TT.TT.T.TTTTT.TTT@@@@@@@@@@@@@@@@@@@@@@@@@@@@@@@@@@@@@@
@@@@@@@@@@@@@@@@@@@@@@@@@T.T..TTT..TT...T@@@@@@@@@@@@@@@@@@@@@@@@@@@@@@@@@@@@@@@
@@@@@@@@@@@@@@@@@@@@@@@@@.T.......T..TTT@@@@@@@@@@@@@@@@@@@@@@@@@@@@@@@@@@@@@@@@
@@@@@@@@@@@@@@@@@@@@@@@@@T..T....T..T..@@@@@@@@@@@@@@@@@@@@@@@@@@@@@@@@@@@@@@@@@
@@@@@@@@@@@@@@@@@@@@@@@@@@.....T..T...@@@@@@@@@@@@@@@@@@@@@@@@@@@@@@@@@@@@@@@@@@
@@@@@@@@@@@@@@@@@@@@@@@@@@@..T..T..T.T@@@@@@@@@@@@@@@@@@@@@@@@@@@@@@@@@@@@@@@@@@
@@@@@@@@@@@@@@@@@@@@@@@@@@@@.TTTT.TTTT@@@@@@@@@@@@@@@@@@@@@@@@@@@@@@@@@@@@@@@@@@
@@@@@@@@@@@@@@@@@@@@@@@@@@@@@T.T.TTT.T@@@@@@@@@@@@@@@@@@@@@@@@@@@@@@@@@@@@@@@@@@
@@@@@@@@@@@@@@@@@@@@@@@@@@@@@@..T.T.T..@@@@@@@@@@@@@@@@@@@@@@@@@@@@@@@@@@@@@@@@@
@@@@@@@@@@@@@@@@@@@@@@@@@@@@@@@@.TT.TTT.@@@@@@@@@@@@@@@@@@@@@@@@@@@@@@@@@@@@@@@@
@@@@@@@@@@@@@@@@@@@@@@@@@@@@@@@@@T.TT.TT.@@@@@@@@TT@@@@@@@@@@@@@@@@@@@@@@@@@@@@@
@@@@@@@@@@@@@@@@@@@@@@@@@@@@@@@@@@.TTT.T..@@@@@@T..T@@@@@@@@@@@@@@@@@@@@@@@@@@@@
@@@@@@@@@@@@@@@@@@@@@@@@@@@@@@@@@@@.T..T.T.@@@@T..TTT@@@@@@@@@@@@@@@@@@@@@@@@@@@
@@@@@@@@@@@@@@@@@@@@@@@@@@@@@@@@@@@@...TT..T@@...T...@@@@@@@@@@@@@@@@@@@@@@@@@@@
@@@@@@@@@@@@@@@@@@@@@@@@@@@@@@@@@@@@@TTT...T.T..T....@@@@@@@@@@@@@@@@@@@@@@@@@@@
@@@@@@@@@@@@@@@@@@@@@@@@@@@@@@@@@@@@@@....TT..T.T.TTT.@@@@@@@@@@@@@@@@@@@@@@@@@@
@@@@@@@@@@@@@@@@@@@@@@@@@@@@@@@@@@@@@@@@T.TT..TT..T....@@@@@@@@@@@@@@@@@@@@@@@@@
@@@@@@@@@@@@@@@@@@@@@@@@@@@@@@@@@@@@@@@@@@@@@@@@@@@@@@@@@@@@@@@@@@@@@@@@@@@@@@@@
@@@@@@@@@@@@@@@@@@@@@@@@@@@@@@@@@@@@@@@@@@@@@@@@@@@@@@@@@@@@@@@@@@@@@@@@@@@@@@@@
