type octile
height 64
width 64
map
@@@@@@@@@@@@@@@@@@@@@@@@@@@@@@@@@@@@@@@@@@@@@@@@@@@@@@@@@@@@@@@@
@@@@@@@@@@@@@@@@@@@@@@@@@@@@@@@@@@@@@@@@@@@@@@@@@@@@@@@@@@@@@@@@
@@@@@@@@@@@@@@@@@@@@@@@@@@@@@@@@@@@@@@@@@@@@@@@@@@@@@@@@@@@@@@@@
@@@@@@@@@@@@@@@@@@@@@@@@@@@@@@@@@@@@@@@@@@@@@@@@@@@@@@@@@@@@@@@@
@@@@@@@@@@@@@@@@@@@@@@@@@@@@@@@@@@@@@@@@@@@@@@@@@@@@@@@@@@@@@@@@
@@@@@@@@@@@@@@@@@@@@@@@@@@@@@@@@@@@@@@@@@@@@@@@@@@@@@@@@@@@@@@@@
@@@@@@@@@@@@@@@@@@@@@@@@@@@@@@@@@@@@@@@@@@@@@@@@@@@@@@@@@@@@@@@@
@@@@@@@@@@@@@@@@@@@@@@@@@@@@@@@@@@@@@@@@@@@@@@@@@@@@@@@@@@@@@@@@
@@@@@@@@@@@@@@@@@@@@@@@@@@@@@@@@@@@@@@@@@@@@@@@@@@@@@@@@@@@@@@@@
@@@@@@@@@@@@@@@@@@@@@@@@@@@@@@@@@@@@.@@@@@@@@@@@@@@@@@@@@@@@@@@@
@@@@@@@@@@@@@@@@@@@@@@@@@@@@@@@@@@@TT.@@@@@@@@@@@@@@@@@@@@@@@@@@
@@@@@@@@@@@@@@@@@@@@@@@@@@@@@@@@@@TT...@@@@@@@@@@@@@@@@@@@@@@@@@
@@@@@@@@@@@@@@@@@@@@@@@@@@@@@@@@@.T.T..T@@@@@@@@@@@@@@@@@@@@@@@@
@@@@@@@@@@@@@@@@@@@@@@@@@@@@@@@@.TT.T...T@@@@@@@@@@@@@@@@@@@@@@@
@@@@@@@@@@@@@@@@@@@@@@@@@@@@@@@...T.TT...T@@@@@@@@@@@@@@@@@@@@@@
@@@@@@@@@@@@@@@@@@@@@@@@@@@@@@...TTTT..T...@@@@@@@@@@@@@@@@@@@@@
@@@@@@@@@@@@@@@@@@@@@@@@@@@@@T...TTTT.T....@@@@@@@@@@@@@@@@@@@@@
@@@@@@@@@@@@@@@@@@@@@@@@@@@@.T.T@@..T.TT..@@.@@@@@@@@@@@@@@@@@@@
@@@@@@@@@@@@@@@@@@@@@@@@@@@TT.T..@@T....T@@.TT@@@@@@@@@@@@@@@@@@
@@@@@@@@@@@@@@@@@@@@@@@@@.TT.T.TT.@@....@@.T.T.@@@@@@@@@@@@@@@@@
@@@@@@@@@@@@@@@@@@@@@@@@@TTTTT..T..@@.T@@T.....T@@@@@@@@@@@@@@@@
@@@@@@@@@@@@@@@@@@@@@@@@@T...T...T.T@@@@T..T..T..@@@@@@@@@@@@@@@
@@@@@@@@@@@@@@@@@@@@@@@@@@....TTT.TT.@@T..TTTTTTTTT@@@@@@@@@@@@@
@@@@@@@@@@@@@@@@@@@@@@@@@@@T..T.......T....TT....T.T@@@@@@@@@@@@
@@@@@@@@@@@@@@@@@@@@@@@@@@@@...T.TT.TT.TTT..TT.TT.T.T@@@@@@@@@@@
@@@@@@@@@@@@@@@@@@@@@@@@@@@@@T.T.TT....T......T....T.T@@@@@@@@@@
@@@@@@@@@@@@@@@@@@@@@@@@@@@@@@..T..T.T.T.T....TTTT..TTT@@@@@@@@@
@@@@@@@@@@@@@@@@@@@@@@@@@@.@@@@.TTTT.TTTTT.TT..T....TTTT@@@@@@@@
@@@@@@@@@@@@@@@@@@@.@@@@@TTT@@@@..TTTTT..T.T..T...T.TT.TT@@@@@@@
@@@@@@@@@@@@@@@@@@TTT@@@.T..T@@@@TTT.T..TTTT.T........T.T.@@@@@@
@@@@@@@@@@@@@@@@@@.TTTT..TTT..@@@@T..T..TTT.TTTTTTT.TT...T.@@@@@
@@@@@@@@@@@@@@@@@@@.TT..T.T....@@...TTTTTTTT.T...T.T..T.T..T@@@@
@@@@@@@@@@@@@@@@@@@@TTT...TT.TT.T..T.TT..TTT.TT..T.TTTTT.....@@@
@@@@@@@@@@@@@@@@@@@@.T.T.......T.T.T@....TT..T.T..T.T.T.....@@@@
@@@@@@@@@@@@TT@@@@TTT..T..TTT.TTT.T@@@TT.T.T..T....T.TT.TTT@@@@@
@@@@@@@@@@@T...@@TTTT..TTTTT.@TT.T.@@@@T..T..T...TTT...TTT@@@@@@
@@@@@@@@@@@TT..T..TTTTTTT.TT@@TTT..T@@@@TTT.TTT.T..T.TT..@@@@@@@
@@@@@@@@@@@@.T..T.T.TT..TT.@@@@...T..@@@@T..TT.TT......T@@@@@@@@
@@@@@.@@@@@@@..T.T.TT.T...@@@@@@T..T..@@@@T..T..T.T.T..@@@@@@@@@
@@@@T..@@@@@@..TT..TT.TT.@@@@@@@T.TT..T@@@@.TTTT..T.TT@@@@@@@@@@
@@@TTT.T@@@@TT........TT@@@@@@@@.T......T@@@.T.T.TT.T@@@@@@@@@@@
@@@.T.TT.@@.TT.T..T..TT.@@@@@@@......T.T@@@@@@.T....@@@@@@@@@@@@
@@@@.....TTTTTT.TT.TT..@@@@@@@T.TT.TT.T@@@@@@@@....@@@@@@@@@@@@@
@@@@@T.TT...T.T....T@.T@@@@@@T.TT..T.T@@@@@@@@@@T.@@@@@@@@@@@@@@
@@@@@@.T..TTT....TT@@@..@@T.T.T..T..T.@@@@@@@@@@@@@@@@@@@@@@@@@@
@@@@@@@.T.TT.TTTT.@@@@@TTTTT.T....TTTT@@@@@@@@@@@@@@@@@@@@@@@@@@
@@@@@@@@.TTT.T.T.@@@@@@@.T..T.T......TT@@@@@@@@@@@@@@@@@@@@@@@@@
@@@@@@@@@.TTT...@@@@@@@@...TT.....@@TT..@@@@@@@@@@@@@@@@@@@@@@@@
@@@@@@@@@@..T.T..@@@@@@TT......TT@@@@T.TT@@@@@@@@@@@@@@@@@@@@@@@
@@@@@@@@@@@TTTTT.T@@@@T..TTT..T.@@@@@@T...@@@@@@@@@@@@@@@@@@@@@@
@@@@@@@@@@@@.TT.T..@@..........@@@@@@@@TT.T@@@@@@@@@@@@@@@@@@@@@
@@@@@@@@@@@@@...T..TTT.TTTTTT...@@@@@@@@TT@@@@@@@@@@@@@@@@@@@@@@
@@@@@@@@@@@@@@TT.T..T..T..T..TT..@@@@@@@@@@@@@@@@@@@@@@@@@@@@@@@
@@@@@@@@@@@@@@@.T..T.T..TTT@@.T...@@@@@@@@@@@@@@@@@@@@@@@@@@@@@@
@@@@@@@@@@@@@@@@.T.....TTT@@@@T...T@@@@@@@@@@@@@@@@@@@@@@@@@@@@@
@@@@@@@@@@@@@@@@@T.T.TT..@@@@@@T..T.@@@@@@@@@@@@@@@@@@@@@@@@@@@@
@@@@@@@@@@@@@@@@@@T..TT.@@@@@@@@...TT@@@@@@@@@@@@@@@@@@@@@@@@@@@
@@@@@@@@@@@@@@@@@@@T.TT..@@@@@@@@.T.@@@@@@@@@@@@@@@@@@@@@@@@@@@@
@@@@@@@@@@@@@@@@@@@@T....T@@@@@@@@T@@@@@@@@@@@@@@@@@@@@@@@@@@@@@
@@@@@@@@@@@@@@@@@@@@@...T.T@@@@@@@@@@@@@@@@@@@@@@@@@@@@@@@@@@@@@
@@@@@@@@@@@@@@@@@@@@@@TTTTTT@@@@@@@@@@@@@@@@@@@@@@@@@@@@@@@@@@@@
@@@@@@@@@@@@@@@@@@@@@@@TT.T..@@@@@@@@@@@@@@@@@@@@@@@@@@@@@@@@@@@
@@@@@@@@@@@@@@@@@@@@@@@@...T..@@@@@@@@@@@@@@@@@@@@@@@@@@@@@@@@@@
@@@@@@@@@@@@@@@@@@@@@@@@@@@@@@@@@@@@@@@@@@@@@@@@@@@@@@@@@@@@@@@@
