type octile
height 102
width 92
map
@@@@@@@@@@@@@@@@@@@@@@@@@@@@@@@@@@@@@@@@@@@@@@@@@@@@@@@@@@@@@@@@@@@@@@@@@@@@@@@@@@@@@@@@@@@@
@@@@@@@@@@@@@@@@@@@@@@@@@@@@@@@@@@@@@@@@@@@@@@@@@@@@@@@@@@@@@@@@@@@@@@@@@@@@@@@@@@@@@@@@@@@@
@@@@@@@@@@@@@@@@@@@@@@@@@@@@@@@@@@@@@@@@@@@@@@@@@@@@@@@@@@@@@@@@@@@@@@@@@@@@@@@@@@@@@@@@@@@@
@@@@@@@@@@@@@@@@@@@@@@@@@@@@@@@@@@@@@@@@@@@@@@@@@@@@@@@@@@@@@@@@@@@@@@@@@@@@@@@@@@@@@@@@@@@@
@@@@@@@@@@@@@@@@@@@@@@@@@@@@@@@@@@@@@@@@@@@@@@@@@@@@@@@@@@@@@@@@@@@@@@@@@@@@@@@@@@@@@@@@@@@@
@@@@@@@@@@@@@@@@@@@@@@@@@@@@@@@@@@@@@@@@@@@@@@@@@@@@@@@@@@@@@@@@@@@@@@@@@@@@@@@@@@@@@@@@@@@@
@@@@@@@@@@@@@@@@@@@@@@@@@@@@@@@@@@@@@@@@@@@@@@@@@@@@@@@@@@@@@@@@@@@@@@@@@@@@@@@@@@@@@@@@@@@@
@@@@@@@@@@@@@@@@@@@@@@@@@@@@@@@@@@@@@@@@@@@@@@@@@@@@@@@@@@@@@@@@@@@@@@@@@@@@@@@@@@@@@@@@@@@@
@@@@@@@@@@@@@@@@@@@@@@@@@@@@@@@@@@@@@@@@@@@@@@@@@@@@@@@@@@@@@@@@@@@@@@@@@@@@@@@@@@@@@@@@@@@@
@@@@@@@@@@@@@@@@@@@@@@@@@@@@@@@@@@@@@@@@@@@@@@@@@@@@@@@@@@@@@@@@@@@@@@@@@@@@@@@@@@@@@@@@@@@@
@@@@@@@@@@@@@@@@@@@@@@@@@@@@@@@@@@@@@@@@@@@@@@@@@@@@@@@@@@@@@@@@@@@@@@@@@@@@@@@@@@@@@@@@@@@@
@@@@@@@@@@@@@@@@@@@@@@@@@@@@@@@@@@@@@@@@@@@@@@@@@@@@@@@@@@@@@@@@@@@@@@@@@@@@@@@@@@@@@@@@@@@@
@@@@@@@@@@@@@@@@@@@@@@@@@@@@@@@@@@@@@@@@@@@@@@@@@@@@@@@@@@@@@@@@@@@@@@@@@@@@@@@@@@@@@@@@@@@@
@@@@@@@@@@@@@@@@@@@@@@@@@@@@@@@@@@@@@@@@@@@@@@@@@@@@@@@@@@@@@@@@@@@@@@@@@@@@@@@@@@@@@@@@@@@@
@@@@@@@@@@@@@@@@@@@@@@@@@@@@@@@@@@@@@@@@@@@@@@@@@@@@@@@@@@@@@@@@@@@@@@@@@@@@@@@@@@@@@@@@@@@@
@@@@@@@@@@@@@@@@@@@@@@@@@@@@@@@@@@@@@@@@@@@@@@@@@@@@@@@@@@@@@@@@@@@@@@@@@@@@@@@@@@@@@@@@@@@@
@@@@@@@@@@@@@@@@@@@@@@@@@@@@@@@@@@@@@@@@@@@@@@@@@@@@@@@@@@@@@@@@@@@@@@@@@@@@@@@@@@@@@@@@@@@@
@@@@@@@@@@@@@@@@@@@@@@@@@@@@@@@@@@@@@@@@@@@@@@@@@@@@@@@@@@@@@@@@@@@@@@@@@@@@@@@@@@@@@@@@@@@@
@@@@@@@@@@@@@@@@@@@@@@@@@@@@@@@@@@@@@@@@@@@@@@@@@@@@@@@@@@@@@@@@@@@@@@@@@@@@@@@@@@@@@@@@@@@@
@@@@@@@@@@@@@@@@@@@@@@@@@@@@@@@@@@@@@@..T..TT.TTTTT.T...T@@@@@@@@@@@@@@@@@@@@@@@@@@@@@@@@@@@
@@@@@@@@@@@@@@@@@@@@@@@@@@@@@@@@@..TT...T.TT...T..T.TT.TT..@@@@@@@@@@@@@@@@@@@@@@@@@@@@@@@@@
@@@@@@@@@@@@@@@@@@@@@@@@@@@@@.T.T.T.T.TT...T..T..T......TTT@@@@@@@@@@@@@@@@@@@@@@@@@@@@@@@@@
@@@@@@@@@@@@@@@@@@@@@@@@@@@TTT.T..T.T.TTT...T....TTT.T..TTT@@@@@@@@@@@@@@@@@@@@@@@@@@@@@@@@@
@@@@@@@@@@@@@@@@@@@@@@@@@.T..T.TTTT.TT..TTTTT.T.TTTTT....TT@@@@@@@@@@@@@@@@@@@@@@@@@@@@@@@@@
@@@@@@@@@@@@@@@@@@@@@@@....T.TT.TTT...T..TTT.TTTTTT...TTT..@@@@@@@@@@@@@@@@@@@@@@@@@@@@@@@@@
@@@@@@@@@@@@@@@@@@@@@.TT.TTTTT.......T...TTT....T....T.TTTT@@@@@@@@@@@@@@@@@@@@@@@@@@@@@@@@@
@@@@@@@@@@@@@@@@@@@@...TT.TTTT..TTT.TT....TTT....TT.TT..TTT@@@@@@@@@@@@@@@@@@@@@@@@@@@@@@@@@
@@@@@@@@@@@@@@@@@@@.TT..T......TTTTTT.TTTTTTTTT.TT.TT.TTTTT@@@@@@@@@@@@@@@@@@@@@@@@@@@@@@@@@
@@@@@@@@..@@@@@@@T...TT.TTT.TT..TT.T.TTTT@@..TT..T@@TT.TT.T@@@@@@@@@@@@@@@@@@@@@@@@@@@@@@@@@
@@@@@@@@T..@@@@@..TT.T..........TT..TTTT@@@@T.T..@@@@T..TTT@@@@@@@@@@@@@@@@@@@@@@@@@@@@@@@@@
@@@@@@@TT..@@@@..TT.T..T.T..TT..@@T..TTTT.....T...TTT..TTT.@@@@@T.@@@@@@@@@@@@@@@@@...@@@@@@
@@@@@@@..T..@@T.T.T.TT..TT.T.TT@@@@.TTT@@@@@@@@@@@@@@TT.TT.@@@@@.TT@@@@@@@@@@@@@@@TTT..@@@@@
@@@@@@T..T...T.TTT...T.TT.TT...T@@@@@@@@@@@@@@@@@@@@@@@@@..@@@@@TT.@@@@@@@@@@@@@@.T.T.T@@@@@
@@@@@@TT.T.TT.T..T..T.TT@@.TT.TT@@@@@@@@@@@@@@@@@@@@@@@@@@@@@@@@T...@@@@@@@@@@@@T.T..T.@@@@@
@@@@@@TTTT.T..T..TT.TTT.@@@T.@@@@@@@@@@@@@@@@@@@@@@@@@@@@@@@@@@@TTT.@@@@@@@@@@@TT.T.T..@@@@@
@@@@@.....TTTTTT.TTT.TT@@@@@@@@@@@@@@@@@@@@@@@@@@@@@@@@@@@@@@@@@..TT@@@@@@@@@@T.T.T..TT@@@@@
@@@@@...T.........TT.TT..@@@@@@@@@@@@@@@@@@@@@@@@@@@@@@@@@@@@@@TTTT.@@@@@@@@@TTT....TTTT@@@@
@@@@T.T.T.T.....TT....T@@@@@@@@@@@@@@@@@@@@@@@@@@@@@@@@@@@@@@@.TTTT.@@@@@@@@..T.......T.@@@@
@@@@TTT....TT..T...T..@@@@@@@@@@@@@@@@@@@@@@@@@@@@@@@@@@@@@@@..TT.TT@@@@@@@@..T.T.TTT...@@@@
@@@@..T.TTTT.T...@@@@@@@@@@@@@@@@@@@@@@@@@@@@@@@@@@@@@@@@@@@....TTTT@@@@@@@@..TT..TTT.TTT@@@
@@@@TT...T.TT.T.T@@@@@@@@@@@@@@@@@@@@@@@@@@@@@@@@@@@@@@@@@@TT.T...T@@@@@@@@@TT....T.....T@@@
@@@TT.TT....T..T.@@@@@@@@@@@@@@@@@@@@@@@@@@@@@@@@@@@@@@@@@.TTTTTT..@@@@@@@@@.T.TT.TT....T@@@
@@@T..T.TT..T...T.T.@@@@@@@@@@@@@@@@@@@@@@@@@@@@@@@@@@@@@@.T.T...T@@@@@@@@@@..T.TT..T..TT@@@
@@@T..T..TTT....TT...@@@@@@@@@@@@@@@@@@@@@@@@@@@@@@@@@@@@...TT..T@@@@@@@@@TT..TTTT...T..T@@@
@@@TT..T..TTTT...TT.TTT@@@@@@@@@@@@@@@@@@@@@@@@@@@@@@@@@.T..TT..@@@@@@@@@@@T..TT.TTTTT.TT@@@
@@@.TTT..T.....T...TT.TT.@@@@@@@@@@@@@@@@@@@@@@@@@@@@@@..TTT...T@@@@@@@@@@@@.....T.TTTT.T@@@
@@@.TTT.TTT.T..TTT...T..T..@@@@@@@@@@@@@@@@@@@@@@@@@@@.T..TT...@@@@@@@@@@@@@@.@@.T.T.TTTT@@@
@@@T........@@@@T..TT..T....@@@@@@@@@@@@@@@@@@@@@@@@@T.T.T...T@@@@@@@@@@@@@@@@@@.TT.T.TT.@@@
@@@T..T.T.T@@@@@@....T.TTTT.T.@@@@@@@@@@@@@@@@@@@@@@@TTT.T.TT@@@@@@@@@@@@@@@@@@@@TTT.T.TT@@@
@@@.TT.T.T..T@@@@@@..T...TT.....@@@@@@@@@@@@@@@@@@@@TT..T.TT.@@@@@@@@@@@@@@@@@@@@.....T.T@@@
@@@TTTT....TT@@@@@@@.TTTTT..TT.TT@@@@@@@@@@@@@@@@@@...TTTT..@@@@@@@@@@@@@@@@@@@T.TT.T..TT@@@
@@@T.T.......@@@@@@@@@.TT.TTT...T.@@@@@@@@@@@@@@@@TT..TTT.T@@@@@@@@@@@@@@@@@@@@T.TT.TT.T.@@@
@@@T...TTT.T@@@@@@@@@@@..TTTTTTT.TTT@@@@@@TT.TTT..T.T.TTTT@@@@@@@@@@@@@@@@@@@@@@T.T.T.TT.@@@
@@@TTT.TTT..@@@@@@@@@@@@@.TT.TT.....T@@...TTTTT.T..T.T...T@@@@@@@@@@@@@@@@@@@@@@TTT..TT.T@@@
@@@TT.TTT.T.@@@@@@@@@@@@@@TT..TT.T.T.TTTT.....TT....T....@@@@@@@@@@@@@@@@@@@@@@@@TTTT.T..@@@
@@@T.TT..TT@@@@@@@@@@@@@@@@@T...T....T.....T.TTT...T..TT.@@@@@@@@@@@@@@@@@@@@@@@@T......T@@@
@@@.TT..TTT@@@@@@@@@@@@@@@@@@...T.TT.....TT.T.T.T.T..T.T.@@@@@@@@@@@@@@@@@@@@@@@@@TTTTT.T@@@
@@@.....T.T@@@@@@@@@@@@@@@@@@@@.T..T.T..T.....T...TTT.TT..@@@@@@@@@@@@@@@@@@@@@@@@..T...T@@@
@@@..T..T.T@@@@@@@@@@@@@@@@@@@@@.TT.T......TTTTT...T.TT..T@@@@@@@@@@@@@@@@@@@@@@@@TT....T@@@
@@@TTT.T.TT@@@@@@@@@@@@@@@@@@@@@@TTTTT...T..@@@@TTT..TTTTTT@@@@@@@@@@@@@@@@@@@@@@@.TT....@@@
@@@T.T....TT@@@@@@@@@@@@@@@@@@@@@T.T.TTTT.@@@@@@@@.T.T..T..@@@@@@@@@@@@@@@@@@@@@@@.TTT...@@@
@@@T...T.T.T@@@@@@@@@@@@@@@@@@@@@T.TTT.T.@@@@@@@@@@.T.T.TTT@@@@@@@@@@@@@@@@@@@@@@@.T..T..@@@
@@@....TTTT.@@@@@@@@@@@@@@@@@@@@@T.T.T.T@@@@@@@@@@@..T.TTTT@@@@@@@@@@@@@@@@@@@@@@@..T.T..@@@
@@@TT.T..TT.@@@@@@@@@@@@@@@@@@@@@TTTTTTT@@@@@@@@@@@TTTTT.T.@@@@@@@@@@@@@@@@@@@@@@@T.TT.T.@@@
@@@.T..TT.TT@@@@@@@@@@@@@@@@@@@@@T..TTT.@@@@@@@@@@@T..T.T..@@@@@@@@@@@@@@@@@@@@@@@T.T....@@@
@@@..T.T.TT.T@@@@@@@@@@@@@@@@@@@@....T..@@@@@@@@@@@.TT....T@@@@@@@@@@@@@@@@@@@@@@@.TTTT.T@@@
@@@.TTT.TT.T.@@@@@@@@@@@@@@@@@@@@TTTTTTT.@@@@@@@@@@TT.TT.T.@@@@@@@@@@@@@@@@@@@@@@@...TT.T@@@
@@@TTTT.TT...@@@@@@@@@@@@@@@@@@@@.T.TTTTT@@@@@@@@@..TT.T.T.@@@@@@@@@@@@@@@@@@@@@@TTTTTT.T@@@
@@@T.T.TTTTTTT@@@@@@@@@@@@@@@@@@@@.TTT.T.T@@@@@@@TTTTT..TT.@@@@@@@@@@@@@@@@@@@@@@T.TTT.TT@@@
@@@TT.T.TTTTT.T@@@@@@@@@@@@@@@@@@@.TT.TTTT.@@@@@.....TTTT.T..@@@@@@@@@@@@@@@@@@@@T.T..T..@@@
@@@TT...T.T.T.T@@@@@@@@@@@@@@@@@@@@TT.TTT...TTT.T.T.T.T..T..T.@@@@@@@@@@@@@@@@@@@TTTTTT..@@@
@@@T.....T.....T@@@@@@@@@@@@@@@@@@@.T.T..TT.T..T..T.TT....T.TTT.@@@@@@@@@@@@@@@@TTT.TT.T.@@@
@@@.T...TTTT.T.T@@@@@@@@@@@@@@@@@@.T.TT..T...TT.TTTTTTTTTT..TTTT..@@@@@@@@@@@@@T...T.T.T.@@@
@@@....TTTTT.T.TT@@@@@@@@@@@@@@@@@T.T.TT.T..TTTTTT.T.@@TTTTTT.TT..T.@@@@@@@@@@..T........@@@
@@@.TTTTT..TTTT.T.@@@@@@@@@@@@@@@@TT...T....T.TT.TT@@@@@T...T.TTTT.TT@@@@@@@@@T..T..TT..T@@@
@@@TTT...T.TTT.T..@@@@@@@@@@@@@@@.T.TTTT.T@@....@@@@@@@@@@TTTT.TTT.T...@@@@@@T.T.T.T.TT.T@@@
@@@TTTTTT...T.T..TT@@@@@@@@@@@@@.TT.TTT.T@@@@@@@@@@@@@@@@@@TTT....T..T.T.@@@T.T..T..T.TTT@@@
@@@T.T.T..TTTTT.TTT.@@@@@@@@@@@@.......T@@@@@@@@@@@@@@@@@@@@@.T.TTT.....TTT....T..T..TT..@@@
@@@...TTT....TT.TTTT@@@@@@@@@@@.T...TTT@@@@@@@@@@@@@@@@@@@@@@@.TT.T.T.T...T.TTTTT.....TTT@@@
@@@T....TT..TT.T..TTT@@@@@@@@@.T...TT..@@@@@@@@@@@@@@@@@@@@@@@@..T....T..T.T.TT..TT..T..T@@@
@@@T....TT.T.......T.T@@@@@@@@TT....T.@@@@@@@@@@@@@@@@@@@@@@@@@@..T..TTT...T.T.T.TTT..TT.@@@
@@@@T..TT.T.T.T..TT..T@@@@@@T...T.T..@@@@@@@@@@@@@@@@@@@@@@@@@@@@.TTT.TTTT..TTTTT.TTT...T@@@
@@@@@@..TT..T.TT.......T@@.T..TT.TT.@@@@@@@@@@@@@@@@@@@@@@@@@@@@@@..T.T.T.TT.....TTTTTT.@@@@
@@@@@@TT..TTT.T.TT..T...TTTT..TT.TT@@@@@@@@@@@@@@@@@@@@@@@@@@@@@@@.TT.T..TT.T.TT...T.T.@@@@@
@@@@@@@TT..T.TT..T...TT.TT.T..TT.T@@@@@@@@@@@@@@@@@@@@@@@@@@@@@@@.......TTT...TTT.....@@@@@@
@@@@@@@@@..T.T.T.TT..TTTT.T..T...@@@@@@@@@@@@@@@@@@@@@@@@@@@@@@@@....T.TTTT..TT..TTTT@@@@@@@
@@@@@@@@@@T.T.......T...T....T..@@@@@@@@@@@@@@@@@@@@@@@@@@@@@@@@T..TTTTT...T.TTT..TT@@@@@@@@
@@@@@@@@@@@@....TT..T.TTTT.TT..TTT@@@@@@@@@@@@@@@@@@@@@@@@@@@@@T.TTTTTTT.T.....TTT@@@@@@@@@@
@@@@@@@@@@@@@@.TTTTT......TTTT.T.T.@@@@@@@@@@@@@@@@@@@@@@@@TTTTT..TT.T..T.TTT.TT.@@@@@@@@@@@
@@@@@@@@@@@@@@@.TT..TTTTT....T.TT..TTT.T.T@@@@@@@@@@@@@@@TT.T.TTTTT...TTT..TT..@@@@@@@@@@@@@
@@@@@@@@@@@@@@@@@@.T.T..TT.....TTT.TT.TTT..T..T...T.........T.T...T...TT..TT..@@@@@@@@@@@@@@
@@@@@@@@@@@@@@@@@@@TT....T.T..T.TT.TTTTT.TT.T.T.TT.T.T..T.T....TTTT....T.T.@@@@@@@@@@@@@@@@@
@@@@@@@@@@@@@@@@@@@@..TTTT.T...TTTT..TT.T...TTTT....TT.TT......TT.T..TT@@@@@@@@@@@@@@@@@@@@@
@@@@@@@@@@@@@@@@@@@@@@....T.TTTTTT.T.T.TT.TTTTTTTT.T..TT.....T.T....@@@@@@@@@@@@@@@@@@@@@@@@
@@@@@@@@@@@@@@@@@@@@@@@TTTTT..TT...T.TTT....TT.T.T.T...T.TTTT.T..T.@@@@@@@@@@@@@@@@@@@@@@@@@
@@@@@@@@@@@@@@@@@@@@@@@@@@@.T....T...T.T......T..TTTTT.T.T.....@@@@@@@@@@@@@@@@@@@@@@@@@@@@@
@@@@@@@@@@@@@@@@@@@@@@@@@@@@@@T..T....T..T....TT.TTTT.TT...T@@@@@@@@@@@@@@@@@@@@@@@@@@@@@@@@
@@@@@@@@@@@@@@@@@@@@@@@@@@@@@@@@TT..T...TTT.......T.TT.TT.@@@@@@@@@@@@@@@@@@@@@@@@@@@@@@@@@@
@@@@@@@@@@@@@@@@@@@@@@@@@@@@@@@@@@@@.T.TTTT.TT..TTT.TTT.@@@@@@@@@@@@@@@@@@@@@@@@@@@@@@@@@@@@
@@@@@@@@@@@@@@@@@@@@@@@@@@@@@@@@@@@@@@@@@@@@@@@@@@@@@@@@@@@@@@@@@@@@@@@@@@@@@@@@@@@@@@@@@@@@
@@@@@@@@@@@@@@@@@@@@@@@@@@@@@@@@@@@@@@@@@@@@@@@@@@@@@@@@@@@@@@@@@@@@@@@@@@@@@@@@@@@@@@@@@@@@
@@@@@@@@@@@@@@@@@@@@@@@@@@@@@@@@@@@@@@@@@@@@@@@@@@@@@@@@@@@@@@@@@@@@@@@@@@@@@@@@@@@@@@@@@@@@
