type octile
height 64
width 60
map
@@@@@@@@@@@@@@@@@@@@@@@@@@@@@@@@@@@@@@@@@@@@@@@@@@@@@@@@@@@@
@@@@@@@@@@@@@@@@@@@@@@@@@@@@@@@@@@@@@@@@@@@@@@@@@@@@@@@@@@@@
@@@@@@@@@@@@@@@@@@@@@@@@@@@@@@@@@@@@@@@@@@@@@@@@@@@@@@@@@@@@
@@@@@@@@@@@@@@@@@@@@@@@@@@@@@@@@@@@@@@@@@@@@@@@@@@@@@@@@@@@@
@@@@@@@@@@@@@@@@@@@@@@@@@@@@@@@@@@@@@@@@@@@@@@@@@@@@@@@@@@@@
@@@@@@@@@@@@@@@@@@@@@@@@@@@@@@@@@@@@@@@@@@@@@@@@@@@@@@@@@@@@
@@@@@@@@@@@@@@@@@@@@@@@@@@@@@@@@@@@@@@@@@@@@@@@@@@@@@@@@@@@@
@@@@@@@@@@@@@@@@@@@@@@@@@@@@@@@@@@@@@@@@@@@@@@@@@@@@@@@@@@@@
@@@@@@@@@@@@@@@@@@@@@@@@@@@@@@@@@@@@@@@@@@@@@@@@@@@@@@@@@@@@
@@@@@@@@@@@@@@@@@@@@@@@@@@@@@@@@@@@@@@@@@@@@@@@@@@@@@@@@@@@@
@@@@@@@@@@@@@@@@@@@@@@@@@@@@@@@@@@@@@@@@@@@@@@@@@@@@@@@@@@@@
@@@@@@@@@@@@@@@@@@@@@@@@@@@@@@@@@@@@@@@@@@@@@@@@@@@@@@@@@@@@
@@@@@@@@@@@@@@@@@@@@@@@@@@@@@@@@@@@@@@@@@@@@@@@@@@@@@@@@@@@@
@@@@@@@@@@@@@@@@@@@@@@@@@@@@@@@@@@@@@TTT@@@@@@@@@@@@@@@@@@@@
@@@@@@@@@@@@@@@@@@@@@@@@@@@@@@@@@@@@@@@T.@@@@@@@@@@@@@@@@@@@
@@@@@@@@@@@@@@@@@@@@@@@@@@@@@@@@@@T@@@@@T.@@@@@@@@@@@@@@@@@@
@@@@@@@@@@@@@@@@@@@@@@@@@@@@@@@@@T..@@@@@T.@@@@@@@@@@@@@@@@@
@@@@@@@@@@@@@@@@@@@@@@@@@@@@@@@@TT...@@@@@TT@@@@@@@@@@@@@@@@
@@@@@@@@@@@@@@@@@@@@@@@@@@@@@@@..TT.T@@@@@...@@@@@@@@@@@@@@@
@@@@@@@@@@@@@@@@@@@@@@@@@@@@@@@@@.TT.@@@@.TT..TT@@@@@@@@@@@@
@@@@@@@@@@@@@@@@@@@@@@@@@@@@@@@@@T...TTTTT.TTT@..@@@@@@@@@@@
@@@@@@@@@@@@@@@@@@@@@@@@@@@@@@@T..T.T.TTTTTT.@@@TT@@@@@@@@@@
@@@@@@@@@@@@@@@@@@@@@@@@@@@@@@.T.TT..TTT....@@@.TT.@@@@@@@@@
@@@@@@@@@@@@@@@@@@@@@@@@@@@@@TTTT......TTT.@@@@@T...@@@@@@@@
@@@@@@@@@@@@@@@@@@@@@@@@@@T.@@T.TT.T.T.T.TT@@@@@@@@.T@@@@@@@
@@@@@@@@@@@@@@@@@@@@@@@T@@.@@@T..TT.T.T..T@@@@@@@@@T..@@@@@@
@@@@@@@@@@@@@@@@@@@@@@@TTT..TT.T.TT.T....T@@@.@@TTT.TTT@@@@@
@@@@@@@@@@@@@@@@@@@@@@TT.....T.TT.T@@@.TT..TTT..TT.TTTTT@@@@
@@@@@@@@@@@@@@@@@@@@TTTT...T.T...T.@@@T...TT.T.TTT.T....@@@@
@@@@@@@@@@@@@@@@@@@....T.T.TT.T.....T.TTT.T.T...TTT.T.T@@@@@
@@@@@@@@@@@@@@@@@@..T..@@T.T.TT.T..T.T.T..T.TTTTT.T..T@@@@@@
@@@@@@@@@@@@@@@@@.T.T.@@@@TT@@T.TTTTT.T..T..TT.T..T.T@@@@@@@
@@@@@@@@@@@@@@@@@T.TT@@@@@@@@@..T.TTTTT...TTTTTTTTTT@@@@@@@@
@@@@@@@@@@@@@@@@TTT@@@@@@@@@TT.T..TT..T.TT...T.T.T.@@@@@@@@@
@@@@@@@@@@@@@@@..T@@@@@@@@@@@T.@@.TT...TT..TTTT...@@@@@@@@@@
@@@@@@@@@@@@@@T...T@@@@@@@@@@@@@@.T..TTTT.TTTTTTT@@@@@@@@@@@
@@@@@@@@@@@@@T..T.T@@@@@@@@@@@@.T.TT....T.T.T.T.@@@@@@@@@@@@
@@@@@@@@@@@..TT.TT.T@T.@@@@@@@@@.TTT....TT.....@@@@@@@@@@@@@
@@@@@@@@@@@.......T.T.TT@@@@@@@@@.TTTTT.......@@@@@@@@@@@@@@
@@@@@@@@@@@@..T.TT..T..T@@@@@@@@@@..T..T.T.T.@@@@@@@@@@@@@@@
@@@@@@@@@@@TT..T.....TT.@@@@@@@@..TT..T..T..@@@@@@@@@@@@@@@@
@@@@@@@.@@T..T.T.TTTT..@@@@@@@@.T...T...TTT@@@@@@@@@@@@@@@@@
@@@@@@.T.TT.T..T...TTT@@@@@@@@.....T.T.T..@@@@@@@@@@@@@@@@@@
@@@@@..T.T.T.TT.TT.TT@@@@@@@@@@..T...TTTT@@@@@@@@@@@@@@@@@@@
@@@@....TTTTTTT..TT.@@@@@@@@@@T....TT.T.@@@@@@@@@@@@@@@@@@@@
@@@@TT...TTT.T...T.@@@@@@@@T.TT...TTTT.@@@@@@@@@@@@@@@@@@@@@
@@@@@TT.T.TTTTTT..@@@@@@@@@@..TT..TT..@@@@@@@@@@@@@@@@@@@@@@
@@@@@@T....TT.TT.@@@@@@@@.@.TT.....T.@@@@@@@@@@@@@@@@@@@@@@@
@@@@@@@.T..T.T..@@@@@@@@TT...T.T.T..@@@@@@@@@@@@@@@@@@@@@@@@
@@@@@@@@.TT....@@@@@@@@TTT..T..T.T.@@@@@@@@@@@@@@@@@@@@@@@@@
@@@@@@@@@TTT..@@@@@@@@@TT..T...TT.@@@@@@@@@@@@@@@@@@@@@@@@@@
@@@@@@@@@@.TT..@@@@@@@...TTTT..TT@@@@@@@@@@@@@@@@@@@@@@@@@@@
@@@@@@@@@@@.TTT.@@@@TTTT.T....T.@@@@@@@@@@@@@@@@@@@@@@@@@@@@
@@@@@@@@@@@@....T@@.TTT........@@@@@@@@@@@@@@@@@@@@@@@@@@@@@
@@@@@@@@@@@@@T..TTTTTT.T..T.T.@@@@@@@@@@@@@@@@@@@@@@@@@@@@@@
@@@@@@@@@@@@@@..TTT...T.T..T@@@@@@@@@@@@@@@@@@@@@@@@@@@@@@@@
@@@@@@@@@@@@@@@.TT.TT...TTT@@@@@@@@@@@@@@@@@@@@@@@@@@@@@@@@@
@@@@@@@@@@@@@@@@T.T.TT.TT.@@@@@@@@@@@@@@@@@@@@@@@@@@@@@@@@@@
@@@@@@@@@@@@@@@@@T..T.T.T@@@@@@@@@@@@@@@@@@@@@@@@@@@@@@@@@@@
@@@@@@@@@@@@@@@@@@@..T.T@@@@@@@@@@@@@@@@@@@@@@@@@@@@@@@@@@@@
@@@@@@@@@@@@@@@@@@@@T..@@@@@@@@@@@@@@@@@@@@@@@@@@@@@@@@@@@@@
@@@@@@@@@@@@@@@@@@@@@@@@@@@@@@@@@@@@@@@@@@@@@@@@@@@@@@@@@@@@
@@@@@@@@@@@@@@@@@@@@@@@@@@@@@@@@@@@@@@@@@@@@@@@@@@@@@@@@@@@@
@@@@@@@@@@@@@@@@@@@@@@@@@@@@@@@@@@@@@@@@@@@@@@@@@@@@@@@@@@@@
