type octile
height 54
width 60
map
@@@@@@@@@@@@@@@@@@@@@@@@@@@@@@@@@@@@@@@@@@@@@@@@@@@@@@@@@@@@
@@@@@@@@@@@@@@@@@@@@@@@@@@@@@@@@@@@@@@@@@@@@@@@@@@@@@@@@@@@@
@@@@@@@@@@@@@@@@@@@@@@@@@@@@@@@@@@@@@@@@@@@@@@@@@@@@@@@@@@@@
@@@@@@@@@@@@@@@@@@@@@@@@@@@@@@@@@@@@@@@@@@@@@@@@@@@@@@@@@@@@
@@@@@@@@@@@@@@@@@@@@@@@@@@@@@@@@@@@@@@@@@@@@@@@@@@@@@@@@@@@@
@@@@@@@@@@@@@@@@@@@@@@@@@@@@@@@@@@@@@@@@@@@@@@@@@@@@@@@@@@@@
@@@@@@@@@@@@@@@@@@@@@@@@@@@@@@@@@@@@@@@@@@@@@@@@@@@@@@@@@@@@
@@@@@@@@@@@@@@@@@@@@@@@@@@@@@@@@@@@@@@@@@@@@@@@@@@@@@@@@@@@@
@@@@@@@@@@@@@@@@@@@@@@@@@@@@@@@@@@@@@@@@@@@@@@@@@@@@@@@@@@@@
@@@@@@@@@@@@@@@@@@@@@@.....TT....T..T.T@@@@@@@@@@@@@@@@@@@@@
@@@@@@@@@@@@@@@@@@@T..TT....TTTT...T.T.T..@@@@@@@@@@@@@@@@@@
@@@@@@@@@@@@@@@@@TTT.T....T.T..T...TTTT.T.T.@@@@@@@@@@@@@@@@
@@@@@@@@@@@@@@@.T.T..T..T..TT....T..T.TT.TT..T@@@@@@@@@@@@@@
@@@@@@@@@@@@@....TTTTTTTT.TTT..T.T.T..TT...T.TT@@@@@@@@@@@@@
@@@@@@@@@@@@TT..T.TTTTTT.TT.T.TT.TT.T.TTTT...T..@@@@@@@@@@@@
@@@@@@@@@@@TT..T.T.T....TT@@@@.TT.T.T..TT...TT...@@@@@@@@@@@
@@@@@@@@@@T...TT@@T.TTT.TT@@@@@@@.T..TTTT.......T.@@@@@@@@@@
@@@@@@@@@.....T@@@...T@T.T.TT@@@@.TT.T..T.TT.T.T..T@@@@@@@@@
@@@@@@@@T.T.T.@@@T.T.T@..TTT..T.TTTTT....TT...TT.T.T@@@@@@@@
@@@@@@@....T.@@@T...T...TT.TT.T..T@@T..TT@.T.T..T.TT.@@@@@@@
@@@@@@..TTTT@@@.T..TT.TTTTTTT..TT@@@@.T..@.......T.TT@@@@@@@
@@@@@@..T.TTT@.....TTT.TT.T..TTT.TT@@@@T.TT..T.TT.T...@@@@@@
@@@@@.TT.T.TTT.T..TTT.TT.TTTT....TTT@@@@T...TT.TT@.TTT@@@@@@
@@@@@.TTT.TT...TTT...TT..T.T.T..TT.T.@.....T.T..@@@....@@@@@
@@@@....TTT.TTTT.TT...T...TTT.TTT.T.T..TT@TTT.TTT@@@T...@@@@
@@@@......TT.TTT.TT...TT.T@@T.TT.T.T.T..@@@@@.T..T@@@.@.@@@@
@@@@.TT.....T..T.TT...T..@@@@@@TTTTT..T@@@@@@@TTTTT@@@@T@@@@
@@@@T..TT..TTTTTT...TTT..T@@@@@@TT.TTT..TT.@@T.T..T@@@@@@@@@
@@@@TT.T..TT.TTTTT.T.T.TTT..@@TT.T..TTTT.T....TT..TT@@@@@@@@
@@@@.TTT..T@@.TT.TT.TTT.TTTT.T...T.TT..T....TTTTTT.T@@@@@@@@
@@@@TTTTT..T@.TT....T.....T.T.T.TT.T..T.T..TT..TT.T..@@@@@@@
@@@@.T....TT.TT..TTT.T@@@.T......TTTTT.TTTTTT.TT.TT.T.@@@@@@
@@@@.@@T.TTT.TTT@@.T.@@@@@TT.TT@....T.T...T..T.TTTT.T.T.@@@@
@@@@@@@@TT...TT@@@@...T@@@@@TT@@TT.TTTT....TTT.T.TT..TTT@@@@
@@@@@@@@@T.....@@@@T.TTT.@@@TT.TTT...T.TTT......@T..TT.T@@@@
@@@@.@@@TTTT.T@@@@@..TT.TT@.T..T....T.T.T....T..@@...TTT@@@@
@@@@TT@@.TT.TTT.@T@@T.....TTT..T...TTT.TT.T.TTTT.T.TT...@@@@
@@@@T....TT..T.TTT.T....T.TTTT.T.TT...@@TT....TT..TTTTT.@@@@
@@@@T...T.TTT...TT..T..TTT.TTTT..TT..@@@TT...T.T.@@TTTT.@@@@
@@@@T..T.TT.TT.T.T.T..TT.....TTT..T.T@@@@..TT...@@@@.T..@@@@
@@@@@..T..T..T.T....T.TT.TTTTT.TT...@@@@T.TT...T@@@@....@@@@
@@@@@T..T..T..TTTTT..TTT...T.TT.TTTTTT.@.T...T.@@@@@...T@@@@
@@@@@@.TT.T@@..TT....T....TT...TTTTTT..TTTT..T...@@@@..T@@@@
@@@@@@T.T.@@@@.T.T..T..T.TT...T........TTT.T.TTTT.TTTTT.@@@@
@@@@@@@.T@@@@@@...TTT.TT.TTTTT.TT.TTT.T...TTT.T.TTTTTT.@@@@@
@@@@@@@TT..@@@@.TTTTT.T.TTT..TTTTT.....TT.....TT.T.T..@@@@@@
@@@@@@@@T..T@@TT..T..T.....T.TT.TT..TTTTT..T@@@@TT..T.@@@@@@
@@@@@@@@.TT.T.T.......T.......TTTT.T..T..TTT@@@@T.TTT@@@@@@@
@@@@@@@@@.TTTT.TTT@..T..T...T.T...T..T.TT.T@@@@@T...@@@@@@@@
@@@@@@@@@.T.T.T..T@@.TT....T.TT.T@@.T..TT.TT...TT..@@@@@@@@@
@@@@@@@@@@TTTT....TT....T.T.....@@@@T..TTTTT..TTTT@@@@@@@@@@
@@@@@@@@@@@@.T.T.TT.TT..T..T...T@@@@TTTT@@TTT.T..@@@@@@@@@@@
@@@@@@@@@@@@@@TTTT.T.TTT....TTT.@@@@@T..T...TT.@@@@@@@@@@@@@
@@@@@@@@@@@@@@@@@@@@@@@@@@@@@@@@@@@@@@@@@@@@@@@@@@@@@@@@@@@@
