type octile
height 54
width 56
map
@@@@@@@@@@@@@@@@@@@@@@@@@@@@@@@@@@@@@@@@@@@@@@@@@@@@@@@@
@@@@@@@@@@@@@@@@@@@@@@@@@@@@@@@@@@@@@@@@@@@@@@@@@@@@@@@@
@@@@@@@@@@@@@@@@@@@@@@@@@@@@@@@@@@@@@@@@@@@@@@@@@@@@@@@@
@@@@@@@@@@@@@@@@@@@@@@@@@@@@@@@@@@@@@@@@@@@@@@@@@@@@@@@@
@@@@@@@@@@@@@@@@@@@@@@@@@@@@@@@@@@@@@@@@@@@@@@@@@@@@@@@@
@@@@@@@@@@@@@@@@@@@@@@@@@@@@@@@@@@@@@@@@@@@@@@@@@@@@@@@@
@@@@@@@@@@@@@@@@@@@@@@@@@@@@@@@@@@@@@@@@@@@@@@@@@@@@@@@@
@@@@@@@@@@@@@@@@@@@@@@@@@@@@@@@@@@@@@@@@@@@@@@@@@@@@@@@@
@@@@@@@@@@@@@@@@@@@@@@@@@@@@@@@@@@@@@@@@@@@@@@@@@@@@@@@@
@@@@@@@@@@@@@@@@@@@@@@@@@@@@@@@@@@@@@@@@@@@@@@@@@@@@@@@@
@@@@@@@@@@@@@@@@@@@@@T.@@@@@@@@@@@@@@@@@@@@@@@@@@@@@@@@@
@@@@@@@@@@@@@@@@@@@@..TT@@@@@@@@@@@@@@@@@@@@@@@@@@@@@@@@
@@@@@@@@@@@@@@@@@@@TTTTTT@@@@@@@@@@@@@@@T@@@@@@@@@@@@@@@
@@@@@@@@@@@@@@@@@@.T.TT..T@@@@@@@@@@@@@T.T@@@@@@@@@@@@@@
@@@@@@@@@@@@@@@@@TTT..T.T..@@@@@@@@@@@.T.T.@@@@@@@@@@@@@
@@@@@@@@@@@@@@@@T.T.@@T...T.@@@@@@@@@@....T@@@@@@@@@@@@@
@@@@@@@@@@@@@@@.T.T@@@.TT..TT@@@@@@@@.T.TT.@@@@@@@@@@@@@
@@@@@@@@@@@@@@T.TT@@@@...TTT.T@@@@@@.TTTT..@@@@@@@@@@@@@
@@@@@@@@@@@@@T..T.@@@.TT..TT.TT@@@@TTTTTT.T@@@@@@@@@@@@@
@@@@@@@@@@@@.T.TTTT@TT...TT.T...@@.T..T.@@@@@@@@@@@@@@@@
@@@@@@@@@@T...T.TT..T...TT..TTTT.TT..T.@@@@@@@@@@@@@@@@@
@@@@@@@@@..TTTT.TT..TTTT......T.TTT..TT@@@@@@@@@@@@@@@@@
@@@@@@@@TT......T.T.T..TT@@@@.TT..TT.TT.@@TT.T@@@@@@@@@@
@@@@@@@@@T.T.TTT..TTT.T..@@@@@T..TT..TTT.TT..@@@@@@@@@@@
@@@@@@@@@@T.TTT....T.TT.@@@@@@@..TT.T.TTT...@@@@@@@@@@@@
@@@@@@@@@@@.T..TTT.T.TT.@@@@@@@@......T....@@@@@@@@@@@@@
@@@@@@@@@@@@@T...@..T.TT@@@@@@@@@.T..T.T.@@@@@@@@@@@@@@@
@@@@@@@@@@@@@@@..@@..TTT.@@@@@@@@@T.T.TT@@@@@@@@@@@@@@@@
@@@@@@@@@@@@@@@T.T@@T..T.T@@@@@@@@@.TT.@@@@@@@@@@@@@@@@@
@@@@@@@@@@@@@@@@TT@@@T.T...@@@@@@@@.T..T@@@@@@@@@@@@@@@@
@@@@@@@@@@@@@@@@.T@@@@TT.T..@@@@@@TT.TT..@@@@@@@@@@@@@@@
@@@@@@@@@@@@@@@@@.@@@@@TT.TT.@@@@TT.....T.@@@@@@@@@@@@@@
@@@@@@@@@@@@@@@@@@@@@@@@.TTT.@@@TT.T...TT.T@@@@@@@@@@@@@
@@@@@@@@@@@@@@@@@@@@@@@@..TT..T.T.....T..T..@@@@@@@@@@@@
@@@@@@@@@@@@@@@@@@@@@@@@T.TT..T...T.TTTTTTTTT@@@@@@@@@@@
@@@@@@@@@@@@@@@.@@@@@@@@TT.....T..T.T.T.T....T@@@@@@@@@@
@@@@@@@@@@@@..TT.......TT.T.T.....T.TTTT.TT.TT@@@@@@@@@@
@@@@@@@@@@....T.TT..TTTTTT....T..TT..@T.TT.T.@@@@@@@@@@@
@@@@@@@@.TTTT...TT.TT........TT.T.TT@@@.TT..@@@@@@@@@@@@
@@@@@@@T.T.@@.....T.....TTTT.TTT....@@@@TTT@@@@@@@@@@@@@
@@@@@@.T..@@.TTTTT...T..T.T...T.TTT..@@@@T@@@@@@@@@@@@@@
@@@@@@TT..T.TT.....TT.TTT@..T.TT.T.T.T@@@@@@@@@@@@@@@@@@
@@@@@@.TT..TTTT...TT..T.@@@TT...T.T...T@@@@@@@@@@@@@@@@@
@@@@@@.TTTTTTTT..T..T.T@@@@@.TT.T..T.TT@@@@@@@@@@@@@@@@@
@@@@@@@T...TTT...T..T.@@@@@@@...T.T...@@@@@@@@@@@@@@@@@@
@@@@@@@@..T..TTTT..T.@@@@@@@@@T.T..T.@@@@@@@@@@@@@@@@@@@
@@@@@@@@@.T.T..T.TTT@@@@@@@@@@@@T..T@@@@@@@@@@@@@@@@@@@@
@@@@@@@@@@T.T..TTTT@@@@@@@@@@@@@@.@@@@@@@@@@@@@@@@@@@@@@
@@@@@@@@@@@..TTTT.@@@@@@@@@@@@@@@@@@@@@@@@@@@@@@@@@@@@@@
@@@@@@@@@@@@TT..@@@@@@@@@@@@@@@@@@@@@@@@@@@@@@@@@@@@@@@@
@@@@@@@@@@@@@@T@@@@@@@@@@@@@@@@@@@@@@@@@@@@@@@@@@@@@@@@@
@@@@@@@@@@@@@@@@@@@@@@@@@@@@@@@@@@@@@@@@@@@@@@@@@@@@@@@@
@@@@@@@@@@@@@@@@@@@@@@@@@@@@@@@@@@@@@@@@@@@@@@@@@@@@@@@@
@@@@@@@@@@@@@@@@@@@@@@@@@@@@@@@@@@@@@@@@@@@@@@@@@@@@@@@@
