type octile
height 86
width 88
map
@@@@@@@@@@@@@@@@@@@@@@@@@@@@@@@@@@@@@@@@@@@@@@@@@@@@@@@@@@@@@@@@@@@@@@@@@@@@@@@@@@@@@@@@
@@@@@@@@@@@@@@@@@@@@@@@@@@@@@@@@@@@@@@@@@@@@@@@@@@@@@@@@@@@@@@@@@@@@@@@@@@@@@@@@@@@@@@@@
@@@@@@@@@@@@@@@@@@@@@@@@@@@@@@@@@@@@@@@@@@@@@@@@@@@@@@@@@@@@@@@@@@@@@@@@@@@@@@@@@@@@@@@@
@@@@@@@@@@@@@@@@@@@@@@@@@@@@@@@@@@@@@@@@@@@@@@@@@@@@@@@@@@@@@@@@@@@@@@@@@@@@@@@@@@@@@@@@
@@@@@@@@@@@@@@@@@@@@@@@@@@@@@@@@@@@@@@@@@@@@@@@@@@@@@@@@@@@@@@@@@@@@@@@@@@@@@@@@@@@@@@@@
@@@@@@@@@@@@@@@@@@@@@@@@@@@@@@@@@@@@@@@@@@@@@@@@@@@@@@@@@@@@@@@@@@@@@@@@@@@@@@@@@@@@@@@@
@@@@@@@@@@@@@@@@@@@@@@@@@@@@@@@@@@@@@@@@@@@@@@@@@@@@@@@@@@@@@@@@@@@@@@@@@@@@@@@@@@@@@@@@
@@@@@@@@@@@@@@@@@@@@@@@@@@@@@@@@@@@@@@@@@@@@@@@@@@@@@@@@@@@@@@@@@@@@@@@@@@@@@@@@@@@@@@@@
@@@@@@@@@@@@@@@@@@@@@@@@@@@@@...@@@@@@T@@@@@@@@@@@@@@@@@@@@@@@@@@@@@@@@@@@@@@@@@@@@@@@@@
@@@@@@@@@@@@@@@@@@@@@@@@@@@@TT..T@@@@.T@@@@@@@@@@@@@@@@@@@@@@@@@@@@@@@@@@@@@@@@@@@@@@@@@
@@@@@@@@@@@@@@@@@@@@@@@@@@@....T@@@@..TT@@@@@@@@@@@@@@@@@@@@@@@@@@@@@@@@@@@@@@@@@@@@@@@@
@@@@@@@@@@@@@@@@@@@@@@@@@@.TTT.@@@@.....@@@@@@@@@@@@@@@@@@@@@@@@@@@@@@@@@@@@@@@@@@@@@@@@
@@@@@@@@@@@@@@@@@@@@@@@@@T.T..@@@@@@....@@@@@@@@@@@@@@@@@@@@@@@@@@@@@@@@@@@@@@@@@@@@@@@@
@@@@@@@@@@@@@@@@@@@@@@@@.T.TT@@@@@@@@..T@@@@@@@@@@@@@@@@@@@@@@@@@@@@@@@@@@@@@@@@@@@@@@@@
@@@@@@@@@@@@@@@@@@@@@@@...T.@@@@@@@@@TTT@@@@@@@@@@@@@@@@@@@@@@@@@@@@@@@@@@@@@@@@@@@@@@@@
@@@@@@@@@@@@@@@@@@@@@@@.TT.@@@@@@@@@@..T@@@@@@@@@@@@@@@@@@@@@@@@@@@@@@@@@@@@@@@@@@@@@@@@
@@@@@@@@@@@@@@@@@@@@@@TT.T@@@@@@@@@@...T@@@@@@@@@@@@@@@@@@@@@@@@@@@@@@@@@@@@@@@@@@@@@@@@
@@@@@@@@@@@@@@@@@@@@@T..T@@@@@@@@@@.T...T.@@@@@@@@@@@@@@@@@@@@@@@@@@@@@@@@@@@@@@@@@@@@@@
@@@@@@@@@@@@@@@@@@@@@...@@@@@@@@@@.T.TTTT.T@@@@@@@@@@@@@@@@@@@@@@@@@@@@@@@@@@@@@@@@@@@@@
@@@@@@@@@@@@@@@@@@@TTTTT@@@@@@@@@...T.T.T...@@@@@@@@@@@@@@@@@@@@@@@@@@@@@@@@@@@@@@@@@@@@
@@@@@@@@@@@@@@@@@@@...T@@@@@@@@@TT..TTT..TT.T@@@@@@@@@@@@@@@@@@@@@@@@@@@@@@@@@@@@@@@@@@@
@@@@@@@@@@@@@@@@@@@T..T@@@@@@@@TTT......T.....@@@@@@@@@@@@@@@@@@@@@@@@@@@@@@@@@@@@@@@@@@
@@@@@@@@@@@@@@@@@@@.TT.@@@@@@@TT.T....TT.TTTTTT@@@@@@@@@@@@@@@@@@@@@@@@@@@@@@@@@@@@@@@@@
@@@@@@@@@@@@@@@@@@TTTTT.@@@@@T.TT...TT...T...T..@@@@@@@@@@@@@@@@@@@@@@@@@@@@@@@@@@@@@@@@
@@@@@@@@@@@@@@@@@@T...T.@@@@.....TT..TTT..TT..T..@@@@@@@@@@@@@@@@@@@@@@@@@@@@@@@@@@@@@@@
@@@@@@@@@@@@@@@@@@@TT.TTT@@@@TT..TTT.TT...T....TTTT@@@@@@@@@@@@@@@@@@@@@@@@@@@@@@@@@@@@@
@@@@@@@@@@@@@@@@@@@@..TT..@@@@.TTT....T..T.T...TT..T@@@@@@@@@@@@@@@@@@@@@@@@@@@@@@@@@@@@
@@@@@@@@@@@@@@@@@@@@@.....@@@@T.T.T.T...@@.......TTTT@@@@@@@@@@@@@@@@@@@@@@@@@@@@@@@@@@@
@@@@@@@@@@@@@@@@@@@@@@...T.@@@@..T....T.@@@@@TT..TT.TT@@@@@@@@@@@@@@@@@@@@@@@@@@@@@@@@@@
@@@@@@@@@@@@@@@@@@@@@@@..TT.@@@@..TTTTTT.@@@@@.T.TTTT.T.@@@@@@@@@@@@@@@@@@@@@@@@@@@@@@@@
@@@@@@@@@@@@@@@..@@@@@@@@.TT.@@@T.T..TTT@@@@@@@@..TTTT..TT@@@@@@@@@@@@@@@@@@@@@@@@@@@@@@
@@@@@@@@@@@@@...TT@@@@@@@@.TT.@@T.T.T...@@@@@@@@..TT.T.TTT.@@@@@@@@@@@@@@@@@@@@@@@@@@@@@
@@@@@@@@@@@@.TT...T@@@@@@@@..T@T.TTT.T...@@@@@@@@.TTTTTT.T.T@@@@@@@@@@@@@@@@@@@@@@@@@@@@
@@@@@@@@@@@TTT.T.T..TT@@@@@@T.TTTTT.TTT..T@@@@@@@@T..T.TTTT.T@@@@@@@@@@@@@@@@@@@@@@@@@@@
@@@@@@@@@@..T..TTT.TT.@@@@@@..T..T......TT.@@@@@@@@..T....TT.T.@@@@@@@@@@@@@@@@@@@@@@@@@
@@@@@@@@@TT.T.......T.@@.@@@TT.T..TTT....TTT@@@@@@@@TT.T....T..@@@@@@@@@@@@@@@@@@@@@@@@@
@@@@@@.....TT..@.T.TTTT.TT@@T..TT..TT..T....T@@@@@@@@...T.T....@@@@@@@@@@@@@@@@@@@@@@@@@
@@@@@TT.T.TTT.@@@...T.TT.TT@TT@@@..TT.TT.TTT..@@@@@@@@T.TT..TTT.@@@@@@@@@@@@@@@@@@@@@@@@
@@@@...TTTT..@@@@@TT..T..T.TT.@@@TTT...T...T..T@@@@@@@@..TT.TT..@@@@@@@@@@@@@@@@@@@@@@@@
@@@@TT.T..TT.@@@@@.TT...TTT...T@@@@T.T..TT.TTT..@@@@@@@@..TTT..TT@@@@@@@@@@@@@@@@@@@@@@@
@@@@@...TT.TT.@@@@TTT.T.T...TT@@@@@@@TT.TT.TT...T@@@@@@@@....T.T...@@@@@@@@@@@@@@@@@@@@@
@@@@@@T.T.T....@..T..T..T....@@@@@@@@@TTT.TT.TTT..@@@@@@@@..T..T..T..@@@@@@@@@@@@@@@@@@@
@@@@@@@...TT..TTT..T.T.T...TT@@@@@@@@@@TTT.TTTT...T@@@@@@@@TTTT....T.@@@@@@@@@@@@@@@@@@@
@@@@@@@@.T.T.T....T....TT...@@@@@@@@@@@@T.TTT....T..@@@@@@@@........T@@@@@@@@@@@@@@@@@@@
@@@@@@@@@.T.TT.TTTT.TTTTT@@@@@@@@@@@@@@@@..T.T.T....T.@@@@@@@..T...T.@@@@@@@@@@@@@@@@@@@
@@@@@@@@@@.TT..TT..TTTTTT@@@@@@@@@@@@@@@@@.TT.TT.T.TTTT@@@@@@.TT....TT@@@@@@@@@@@@@@@@@@
@@@@@@@@@@@TT......TT...T.@@@@@@@@@@@@@@@@.TT..TTTT..T.T@@@@@T.TT..T..T@@@@@@@@@@@@@@@@@
@@@@@@@@@@@@....TT.T.@@T....TT.T@@@@TT@@@TT.T.TT.TT.T.T..@@@@.TTT.TTTT...@@@@@@@@@@@@@@@
@@@@@@@@@@@@@.......@@@@T...T....@@.TTT@.T.@@TTTTTTT....T.TTTT.T..T..TT.TT@@@@@@@@@@@@@@
@@@@@@@@@@@@@@T.T..@@@@@@TT...T.TTT..T....@@@@.TT.....T..T.....TTT.TTT.TTTT@@@@@@@@@@@@@
@@@@@@@@@@@@@@@...@@@@@@@T.TTT....T.T...TT@@@@@...TT..T.T...T.TT.T.T....TTT..@@@@@@@@@@@
@@@@@@@@@@@@@@@@.@@@@@@@..TTT.T.T.TTT.....@@@@@T..T...T....T.T..@@@@TT..T.T.TT@@@@@@@@@@
@@@@@@@@@@@@@@@@@@@@@@@.T...T.T.T..TTT..T..@@@@@..T..T..T.T..T.T@@@@@.TTT.T.TTT@@@@@@@@@
@@@@@@@@@@@@@@@@@@@@@@...T.T.T..T.T..TT...TT@@@@@.TT.T..TT...TT.@@@@@T..T@@..T@@@@@@@@@@
@@@@@@@@@@@@@@@@@@@@@.......T..T.TT.TT.TTT..@@@@@@..TTTT.....TT@@@@@.T.TT@@@T@@@@@@@@@@@
@@@@@@@@@@@@@@@@@@@@T.TT.TTTT..T.....TT..TT.@@@@@@@TTTTT.......@@@@@T..T@@@@@@@@@@@@@@@@
@@@@@@@@@@@@@@@@@@@@TTTT.T.T.....TT..TTT.TT.@@@@@@@...TT..TTTT.T@@@...T@@@@@@@@@@@@@@@@@
@@@@@@@@@@@@@@@@@@@@@T.TTTTT....T...TT...TTTT.@@@@@@T.TT....T..TT.T....@@@@@@@@@@@@@@@@@
@@@@@@@@@@@@@@@@@@@@@@.T.T..T.T.T...T...T...T.@@@@@@@.....T..TT.T.T..@@@@T@@@@@@@@@@@@@@
@@@@@@@@@@@@@@@@@@@@@@@...TT....T.T.....TT...@@@@@@@@@@...TT@@@@TT.TT@@@...T@@@@@@@@@@@@
@@@@@@@@@@@@@@@@@@@@@@@@T......T...TTT...TTT@@@@@@@@@@T.T.T..@@@@@TT@@@TT..TT@@@@@@@@@@@
@@@@@@@@@@@@@@@@@@@@@@@@@TTT.T.TT...T......T@@@@@@T.@..@.T...TT@@@@@@@...TT...@@@@@@@@@@
@@@@@@@@@@@@@@@@@@@@@@@@@@.TTTTTT....TT....TT@@@@..T.T@@@....TTT@@@@@@..TTT.T@@@@@@@@@@@
@@@@@@@@@@@@@@@@@@@@@@@@@@@.T...TTTT...TT@..T.@@@T....@@@@.TT....T@@@.TTTTTT@@@@@@@@@@@@
@@@@@@@@@@@@@@@@@@@@@@@@@@@@TTTT..T.TT.T@@@@.TT@TT..T..@@@@.T.TTTTT.T...TT.@@@@@@@@@@@@@
@@@@@@@@@@@@@@@@@@@@@@@@@@@@@..TT..TT.T@@@@@...TT..TTT..@@@@TT....T.T.T..T@@@@@@@@@@@@@@
@@@@@@@@@@@@@@@@@@@@@@@@@@@@@@TTTT....@@@@@TT.TTTT..T....@@@@TTT.TT.TTT.T@@@@@@@@@@@@@@@
@@@@@@@@@@@@@@@@@@@@@@@@@@@@@@@TT..T.@@@@@.TT...TT.T.T.T.T@@@@.TT..T.T.T@@@@@@@@@@@@@@@@
@@@@@@@@@@@@@@@@@@@@@@@@@@@@@@@@TTT.@@@@@T...TTT...T.TT...@@@@@.TT.TTTT@@@@@@@@@@@@@@@@@
@@@@@@@@@@@@@@@@@@@@@@@@@@@@@@@@@@T@@@@@@...T.T..T.@@@@TTT@@@@@@TT.TTT@@@@@@@@@@@@@@@@@@
@@@@@@@@@@@@@@@@@@@@@@@@@@@@@@@@@@@@@@@@.TTT...T..@@@@@TTT@@@@@@@.TTT@@@@@@@@@@@@@@@@@@@
@@@@@@@@@@@@@@@@@@@@@@@@@@@@@@@@@@@@@@@T.T.T..TTT.@@@@@...T@@@@@@@T.@@@@@@@@@@@@@@@@@@@@
@@@@@@@@@@@@@@@@@@@@@@@@@@@@@@@@@@@@@@T..TT.T.T..@@@@@....T@@@@@@@@@@@@@@@@@@@@@@@@@@@@@
@@@@@@@@@@@@@@@@@@@@@@@@@@@@@@@@@@@@@@..T..T.T.T.@@@@@TTT.@@@@@@@@@@@@@@@@@@@@@@@@@@@@@@
@@@@@@@@@@@@@@@@@@@@@@@@@@@@@@@@@@@@@@@...TT..T.@@@@@T..T@@@@@@@@@@@@@@@@@@@@@@@@@@@@@@@
@@@@@@@@@@@@@@@@@@@@@@@@@@@@@@@@@@@@@@@@.T......@@@@..TT@@@@@@@@@@@@@@@@@@@@@@@@@@@@@@@@
@@@@@@@@@@@@@@@@@@@@@@@@@@@@@@@@@@@@@@@@@TTT.T.T@@@.TTT@@@@@@@@@@@@@@@@@@@@@@@@@@@@@@@@@
@@@@@@@@@@@@@@@@@@@@@@@@@@@@@@@@@@@@@@@@@@..TTT.TTTT..T@@@@@@@@@@@@@@@@@@@@@@@@@@@@@@@@@
@@@@@@@@@@@@@@@@@@@@@@@@@@@@@@@@@@@@@@@@@@@TTT.T.T..T.T@@@@@@@@@@@@@@@@@@@@@@@@@@@@@@@@@
@@@@@@@@@@@@@@@@@@@@@@@@@@@@@@@@@@@@@@@@@@@@T.TT.TT...TT@@@@@@@@@@@@@@@@@@@@@@@@@@@@@@@@
@@@@@@@@@@@@@@@@@@@@@@@@@@@@@@@@@@@@@@@@@@@@@..T...TT....@@@@@@@@@@@@@@@@@@@@@@@@@@@@@@@
@@@@@@@@@@@@@@@@@@@@@@@@@@@@@@@@@@@@@@@@@@@@@@T..T..T.T.@@@@@@@@@@@@@@@@@@@@@@@@@@@@@@@@
@@@@@@@@@@@@@@@@@@@@@@@@@@@@@@@@@@@@@@@@@@@@@@@.T.T...T@@@@@@@@@@@@@@@@@@@@@@@@@@@@@@@@@
@@@@@@@@@@@@@@@@@@@@@@@@@@@@@@@@@@@@@@@@@@@@@@@@@.TTT@@@@@@@@@@@@@@@@@@@@@@@@@@@@@@@@@@@
@@@@@@@@@@@@@@@@@@@@@@@@@@@@@@@@@@@@@@@@@@@@@@@@@@T.@@@@@@@@@@@@@@@@@@@@@@@@@@@@@@@@@@@@
@@@@@@@@@@@@@@@@@@@@@@@@@@@@@@@@@@@@@@@@@@@@@@@@@@@@@@@@@@@@@@@@@@@@@@@@@@@@@@@@@@@@@@@@
