type octile
height 70
width 56
map
@@@@@@@@@@@@@@@@@@@@@@@@@@@@@@@@@@@@@@@@@@@@@@@@@@@@@@@@
@@@@@@@@@@@@@@@@@@@@@@@@@@@@@@@@@@@@@@@@@@@@@@@@@@@@@@@@
@@@@@@@@@@@@@@@@@@@@@@@@@@@@@@@@@@@@@@@@@@@@@@@@@@@@@@@@
@@@@@@@@@@@@@@@@@@@@@@@@@@@@@@@@@@@@@@@@@@@@@@@@@@@@@@@@
@@@@@@@@@@@@@@@@@@@@@@@@@@@@@@@@@@@@@@@@@@@@@@@@@@@@@@@@
@@@@@@@@@@@@@@@@@@@@@@@@@@@@@@@@@@@@@@@@@@@@@@@@@@@@@@@@
@@@@@@@@@@@@@@@@@@@@@@@@@@@@@@@@@@@@@@@@@@@@@@@@@@@@@@@@
@@@@@@@@@@@@@@@@@@@@@@@@@@@@@@@@@@@@@@@@@@@@@@@@@@@@@@@@
@@@@@@@@@@@@@@@@@@@@@@@@@@@@@@@@@@@@@@@@@@@@@@@@@@@@@@@@
@@@@@@@@@@@@@@@@@@@@@@@@@@@@@@@@@@@@@@@@@@@@@@@@@@@@@@@@
@@@@@@@@@@@@@@@@@@@@@@@@@@@@@@@@@@@@@.@@@@@@@@@@@@@@@@@@
@@@@@@@@@@@@@@@@@@@@@@@@@@@@@@@@@@@@@T.@@@@@@@@@@@@@@@@@
@@@@@@@@@@@@@@@@@@@@@@@@@@@@@@@@@@@@@TT.@@@@@@@@@@@@@@@@
@@@@@@@@@@@@@@@@@@@@@@@@@@@@@@@@@@@.T.TT.@@@@@@@@@@@@@@@
@@@@@@@@@@@@@@@@@@@@@@@@@@@@@@@@@@@TT....T@@@@@@@@@@@@@@
@@@@@@@@@@@@@@@@@@@@@@@@@@@@@@@@@....T.T..@@@@@@@@@@@@@@
@@@@@@@@@@@@@@@@@@@@@@@@@@@@@@@@@..T.TTT.@@@@@@@@@@@@@@@
@@@@@@@@@@@@@@@@@@@@@@@@@@@@@@@@@T..T.T@@@@@@@@@@@@@@@@@
@@@@@@@@@@@@@@@@@@@@@@@@@@@@@@T.....TT@@@@@@@@@@@@@@@@@@
@@@@@@@@@@@@@@@@@@@@@@@@@@T@@@T.TT..@@@@@@@@@@@@@@@@@@@@
@@@@@@@@@@@@@@@@@@@@@@@T.TTT@@@T.TT@@@@@@@@@@@@@@@@@@@@@
@@@@@@@@@@@@@@@@@@@@@@...TT...TT.@@@@@@@@@@@@@@@@@@@@@@@
@@@@@@@@@@@@@@@@@@@@@@@TT.T.TTTT.@@@@@@@@@@@@@@@@@@@@@@@
@@@@@@@@@@@@@@@@@@@@@@@@.....TT..@@@@@@@@@@@@@@@@@@@@@@@
@@@@@@@@@@@@@@@@@@@@@@@@@.T.TTT..@@@@@@@@@@@@@@@@@@@@@@@
@@@@@@@@@@@@@@@@@@.@@@@@@@.T..T@@@@@@@@@@@@@@@@@@@@@@@@@
@@@@@@@@@@@@@@@@.TTT@@@@@@@TTT@@@@@@@@@@@@@@@@@@@@@@@@@@
@@@@@@@@@@@@@@@@TTT.T@@@@@T.T.@@@@@@@@@@@@@@@@@@@@@@@@@@
@@@@@@@@@@@@@@@@T.....@@@..T..@@@@@@.@@@@@@@@@@@@@@@@@@@
@@@@@@@@@@@@@@@TT.TTT.T..TT.T.T@@@@..T@@@@@@@@@@@@@@@@@@
@@@@@@@@@@@@@@@@..T...T.TT..TT@@@@.TTT.@@@@@@@@@@@@@@@@@
@@@@@@@@@@@@@@@@@TTTT..TTTT..@@@@T..TTTT@@@@@@@@@@@@@@@@
@@@@@@@@@@@@@@@@@@..T.TT..T.T..@@TT.....@@@@@@@@@@@@@@@@
@@@@@@@@@@@@@@@@@TTT..TTTT..TTT@@TT.T...@@@@@@@@@@@@@@@@
@@@@@@@@@@@@@@@@TT..TT.T@TT...T.@@TT@TT..@@@@@@@@@@@@@@@
@@@@@@@@@@@@.@@..T.TTTT@@@T..T...@@@@.TT.@@@@@@@@@@@@@@@
@@@@T@@@@@@TTT..TT...T@@@@@.T.T.TT...T.T.T@@@@@@@@@@@@@@
@@@..T..TTT.TTTT.TT..@@@@@@@.TTTTT...TT.TT@@@@@@@@@@@@@@
@@.T.TT...TTTTT...TT.@@@@@@@.T.T..TT.TT..T@@@@@@@@@@@@@@
@@@.T....TTT.T.T.TTTTT@@@@@@@TTT.T...TT..TT@@@@@@@@@@@@@
@@@.TTTT...T.TTTTT.TT.T@@@@@@@.@@...T..T..TT@@@@@@@@@@@@
@@@@TTT.TTTT.T@@T.TTTT.@@@@@@@@@@.TTT.....TTT.T@@@@@@@@@
@@@@@T.TTT..T@@@@.T..TT.@@@@@@@@@....TT.TT.T.T.T@@@@@@@@
@@@@@@T.TT..@@@@@T..T.TTT@@@@@@@@TT.TT...T.....T.@@@@@@@
@@@@@@@TT.T@@@@T@@..TTTT.T@@@@@@@T..T@@@@...TTTT.T@@@@@@
@@@@@@@@.T@@@@T.T@.T.T.T..T@@@@@.TTTT@@@@@@...T.T...@@@@
@@@@@@@@@@@@@@T.T@@T.T.T.T..@@@@TT.T@@@@@@@T.....TTTTTT@
@@@@@@@@@@@@@@T..T@.TTT.T..T..T.TTT@@@@@@@TTTTTTTT.T..@@
@@@@@@@@@@@@@@@TTT@@...T.TTTT.TTTT.@@@@@@@T.....TTT..@@@
@@@@@@@@@@@@@@@.TT.@@.T..TTTT.T..T.TT..@@@....T...TT@@@@
@@@@@@@@@@@@@@@@T.T@@@T..TTTTTT.TT.T...TTT...T.TTTT@@@@@
@@@@@@@@@@@@@@@@TTT.@.T..TTTT..T..TT..TTTT.T..T.T.@@@@@@
@@@@@@@@@@@@@@@@@...@T.TTTTT.TTT.T.T....TT.T....T@@@@@@@
@@@@@@@@@@@@@@@@@T.T@@.TTT..TTTT...TT.TTT.T.TT..@@@@@@@@
@@@@@@@@@@@@@@@@@@T.T...T..TT..TT.T.TT.T.TT....@@@@@@@@@
@@@@@@@@@@@@@@@@@@@T.TT..TT..T..T.TT..T.TTT.T.@@@@@@@@@@
@@@@@@@@@@@@@@@@@@TT...TT...TTTT.T.T.TT....TT@@@@@@@@@@@
@@@@@@@@@@@@@@@@@T.TTTT.T....TTTT.TT.TT...T@@@@@@@@@@@@@
@@@@@@@@@@@@@@@@@.......TTT..T...T.TT....T@@@@@@@@@@@@@@
@@@@@@@@@@@@@@@@@@T.T......T.TT.TTTT.T..T@@@@@@@@@@@@@@@
@@@@@@@@@@@@@@@@@@@..TTT..T..TTT.T..TT..@@@@@@@@@@@@@@@@
@@@@@@@@@@@@@@@@@@@@T.TTT.....T.TT...TT@@@@@@@@@@@@@@@@@
@@@@@@@@@@@@@@@@@@@@@....TTT.T.TT..T..@@@@@@@@@@@@@@@@@@
@@@@@@@@@@@@@@@@@@@@@@TTT.TTT..T.T.T.@@@@@@@@@@@@@@@@@@@
@@@@@@@@@@@@@@@@@@@@@@@.T.T.TT....T.@@@@@@@@@@@@@@@@@@@@
@@@@@@@@@@@@@@@@@@@@@@@@.TT...TTTT@@@@@@@@@@@@@@@@@@@@@@
@@@@@@@@@@@@@@@@@@@@@@@@@T.....T.@@@@@@@@@@@@@@@@@@@@@@@
@@@@@@@@@@@@@@@@@@@@@@@@@@@T..TT@@@@@@@@@@@@@@@@@@@@@@@@
@@@@@@@@@@@@@@@@@@@@@@@@@@@@@@@@@@@@@@@@@@@@@@@@@@@@@@@@
@@@@@@@@@@@@@@@@@@@@@@@@@@@@@@@@@@@@@@@@@@@@@@@@@@@@@@@@
