type octile
height 150
width 140
map
@@@@@@@@@@@@@@@@@@@@@@@@@@@@@@@@@@@@@@@@@@@@@@@@@@@@@@@@@@@@@@@@@@@@@@@@@@@@@@@@@@@@@@@@@@@@@@@@@@@@@@@@@@@@@@@@@@@@@@@@@@@@@@@@@@@@@@@@@@@@
@TT.TTT@@@@@@@@@@@@@@@@@@@@@@@@@@@@@@@@@@@@@@@@@@@@@@@@@@@@@@@@@@@@@@@@@@@@@@@@@@@@@@@@@@@@@@@@@@@@@@@@@@@@@@@@@@@@@@@@@@@@@@@@@@@@@@@@@@@@@
@...T.T@@@@@@@@@@@@@@@@@@@@@@@@@@@@@@@@@@@@@@@@@@@@@@@@@@@@@@@@@@@@@@@@@@@@@@@@@@@@@@@@@@@@@@@@@@@@@@@@@@@@@@@@@@@@@@@@@@@@@@@@@@@@@@@@@@@@@
@.T.TTT@@@@@@@@@@@@@@@@@@@@@@@@@@@@@@@@@@@@@@@@@@@@@@@@@@@@@@@@@@@@@@@@@@@@@@@@@@@@@@@@@@@@@@@@@@@@@@@@@@@@@@@@@@@@@@@@@@@@@@@@@@@@@@@@@@@@@
@...TTT@@@@@@@@@@@@@@@@@@@@@@@@@@@@@@@@@@@@@@@@@@@@@@@@@@@@@@@@@@@@@@@@@@@@@@@@@@@@@@@@@@@@@@@@@@@@@@@@@@@@@@@@@@@@@@@@@@@@@@@@@@@@@@@@@@@@@
@.T...T@@@@@@@@@@@@@@@@@@@@@@@@@@@@@@@@@@@@@@@@@@@@@@@@@@@@@@@@@@@@@@@@@@@@@@@@@@@@@@@@@@@@@@@@@@@@@@@@@@@@@@@@@@@@@@@@@@@@@@@@@@@@@@@@@@@@@
@T.T..T@@@@@@@@@@@@@@@@@@@@@@@@@@@@@@@@@@@@@@@@@@@@@@@@@@@@@@@@@@@@@@@@@@@@@@@@@@@@@@@@@@@@@@@@@@@@@@@@@@@@@@@@@@@@@@@@@@@@@@@@@@@@@@@@@@@@@
@@@@@@@@@@@@@@@@@@@@@@@@@@@@@@@@@@@@@@@@@@@@@@@@@@@@@@@@@@@@@@@@@@@@@@@@@@@@@@@@@@@@@@@@@@@@@@@@@@@@@@@@@@@@@@@@@@@@@@@@@@@@@@@@@@@@@@@@@@@@
@@@@@@@@@@@@@@@@@@@@@@@@@@@@@@@@@@@@@@@@@@@@@@@@@@@@@@@@@@@@@@@@@@@@@@@@@@@@@@@@@@@@@@@@@@@@@@@@@@@@@@@@@@@@@@@@@@@@@@@@@@@@@@@@@@@@@@@@@@@@
@@@@@@@@@@@@@@@@@@@@@@@@@@@@@@@@@@@@@@@@@@@@@@@@@@@@@@@@@@@@@@@@@@@@@@@@@@@@@@@@@@@@@@@@@@@@@@@@@@@@@@@@@@@@@@@@@@@@@@@@@@@@@@@@@@@@@@@@@@@@
@@@@@@@@@@@@@@@@@@@@@@@@@@@@@@@@@@@@@@@@@@@@@@@@@@@@@@@@@@@@@@@@@@@@@@@@@@@@@@@@@@@@@@@@@@@@@@@@@@@@@@@@@@@@@@@@@@@@@@@@@@@@@@@@@@@@@@@@@@@@
@@@@@@@@@@@@@@@@@@@@@@@@@@@@@@@@@@@@@@@@@@@@@@@@@@@@@@@@@@@@@@@@@@@@@@@@@@@@@@@@@@@@@@@@@@@@@@@@@@@@@@@@@@@@@@@@@@@@@@@@@@@@@@@@@@@@@@@@@@@@
@@@@@@@@@@@@@@@@@@@@@@@@@@@@@@@@@@@@@@@@@@@@@@@@@@@@@@@@@@@@@@@@@@@@@@@@@@@@@@@@@@@@@@@T@@@@@@@@@@@@@@@@@@@@@@@@@@@@@@@@@@@@@@@@@@@@@@@@@@@@
@@@@@@@@@@@@@@@@@@@@@@@@@@@@@@@@@@@@@@@@@@@@@@@@@@@@@@@@@@@@@@@@@@@@@@@@@@@@@@@@@@@@@@.T@@@@@@@@@@@@@@@@@@@@@@@@@@@@@@@@@@@@@@@@@@@@@@@@@@@@
@@@@@@@@@@@@@@@@@@@@@@@@@@@@@@@@@@@@@@@@@@@@@@@@@@@@@@@@@@@@@@@@@@@@@@@@@@@@@@@@@@@@@TTTT@@@@@@@@@@@@@@@@@@@@@@@@@@@@@@@@@@@@@@@@@@@@@@@@@@@
@@@@@@@@@@@@@@@@@@@@@@@@@@@@@@@@@@@@@@@@@@@@@@@@@@@@@@@@@@@@@@@@@@@@@@@@@@@@@@@@@@@@TT..TT@@@@@@@@@@@@@@@@@@@@@@@@@@@@@@@@@@@@@@@@@@@@@@@@@@
@@@@@@@@@@@@@@@@@@@@@@@@@@@@@@@@@@@@@@@@@@@@@@@@@@@@@@@@@@@@@@@@@@@@@@@@@@@@@@@@@@@..TTTT.T@@@@@@@@@@@@@@@@@@@@@@@@@@@@@@@@@@@@@@@@@@@@@@@@@
@@@@@@@@@@@@@@@@@@@@@@@@@@@@@@@@@@@@@@@@@@@@@@@@@@@@@@@@@@@@@@@@@@@@@@@@@@@@@@@@@@@@.TT.T..@@@@@@@@@@@@@@@@@@@@@@@@@@@@@@@@@@@@@@@@@@@@@@@@@
@@@@@@@@@@@@@@@@@@@@@@@@@@@@@@@@@@@@@@@@@@@@@@@@@@@@@@@@@@@@@@@@@@@@@@@@@@@@@@@@@@@@@T..T....@@@@@@@@@@@@@@@@@@@@@@@@@@@@@@@@@@@@@@@@@@@@@@@
@@@@@@@@@@@@@@@@@@@@@@@@@@@@@@@@@@@@@@@@@@@@@@@@@@@@@@@@@@@@@@@@@@@@@@@@@@@@@@@@@@@@@@TT...T.T@@@@@@@@@@@@@@@@@@@@@@@@@@@@@@@@@@@@@@@@@@@@@@
@@@@@@@@@@@@@@@@@@@@@@@@@@@@@@@@@@@@@@@@@@@@@@@@@@@@@@@@@@@@@@@@.@@@@@@@@@@@@@@@@@@@@@@T...TT..@@@@@@@@@@@@@@@@@@@@@@@@@@@@@@@@@@@@@@@@@@@@@
@@@@@@@@@@@@@@@@@@@@@@@@@@@@@@@@@@@@@@@@@@@@@@@@@@@@@@@@@@@@@@@.TTT@@@@@@@@@@@@@@@@@@@@@T.T.TTT.@@@@@@@@@@@@@@@@@@@@@@@@@@@@@@@@@@@@@@@@@@@@
@@@@@@@@@@@@@@@@@@@@@@@@@@@@@@@@@@@@@@@@@@@@@@@@@@@@@@@@@@@@@@@.TTT.@@@@@@@@@@@@@@@@@@@@@T..TTT.TT@@@@@@@@@@@@@@@@@@@@@@@@@@@@@@@@@@@@@@@@@@
@@@@@@@@@@@@@@@@@@@@@@@@@@@@@@@@@@@@@@@@@@@@@@@@@@@@@@@@@@@@@@...T...@@@@@@@@@@@@@@@@@@@@@T.T..T..T@@@@@@@@@@@@@@@@@@@@@@@@@@@@@@@@@@@@@@@@@
@@@@@@@@@@@@@@@@@@@@@@@@@@@@@@@@@@@@@@@@@@@@@@@@@@@@@@@@@@@@..T.@@....@@@@@@@@@@@@@@@@@@@@@.TTTTT.TT@@@@@@@@@@@@@@@@@@@@@@@@@@@@@@@@@@@@@@@@
@@@@@@@@@@@@@@@@@@@@@@@@@@@@@@@@@@@@@@@@@@@@@@@@@@@@@@@@@@@T..T@@@@.T..T@@@@@@@@@@@@@@@@@@@@T.TT...T.@@@@@@@@@@@@@@@@@@@@@@@@@@@@@@@@@@@@@@@
@@@@@@@@@@@@@@@@@@@@@@@@@@@@@@@@@@@@@@@@@@@@@@@@@@@@@@@@@@.T.T@@@@@@.T.T.@@@@@@@@@@@@@@@@@@@@T........@@@@@@@@@@@@@@@@@@@@@@@@@@@@@@@@@@@@@@
@@@@@@@@@@@@@@@@@@@@@@@@@@@@@@@@@@@@@@@@@@@@@@@@@@@@@@@@@..T.@@@@@@@@.TTT.@@@@@@@@@@@@@@@@@@@@.....T.T.@@@@@@@@@@@@@@@@@@@@@@@@@@@@@@@@@@@@@
@@@@@@@@@@@@@@@@@@@@@@@@@@@@@@@@@@@@@@@@@@@@@@@@@@@@@@@@.TTT@@@@@@@@@@T.T..@@@@@@@@@@@@@@@@@@@@.TT...TT.@@@@@@@@@@@@@@@@@@@@@@@@@@@@@@@@@@@@
@@@@@@@@@@@@@@@@@@@@@@@@@@@@@@@@@@@@@@@@@@@@@@@@@@@@@@@.T..@@@@@@@@@@@@.TT.T@@@@@@@@@@@@@@@@@@TTT..TTT.T@@@@@@@@@@@@@@@@@@@@@@@@@@@@@@@@@@@@
@@@@@@@@@@@@@@@@@@@@@@@@@@@@@@@@@@@@@@@@@@@@@@@@@@@@@TT..T@@@@@@@@@@@@@T.TT.T@@@@@@@@@@@@@@@@TT........@@@@@@@@@@@@@@@@@@@@@@@@@@@@@@@@@@@@@
@@@@@@@@@@@@@@@@@@@@@@@@@@@@@@@@@@@@@@@@@@@@@@@@@@@@.TT..@@@@@@@@@@@@@@.T.TTT.@@@@@@@@@@@@@@T.TTT...T.@@@@@@@@@@@@@@@@@@@@@@@@@@@@@@@@@@@@@@
@@@@@@@@@@@@@@@@@@@@@@@@@@@@@@@@@@@@@@@@@@@@@@@@@@@T..T.@@@@@@@@@@@@@@@T.TTT.T.@@@@@@@@@@@@....T..TT.@@@@@@@@@@@@@@@@@@@@@@@@@@@@@@@@@@@@@@@
@@@@@@@@@@@@@@@@@@@@@@@@@@@@@@@@@@@@@@@@@@@@@@@@@@TT...@@@@@@@@..@@@@@@T.T....T.@@@@@@@@@@TT.T.TTTTT@@@@@@@@@@@@@@@@@@@@@@@@@@@@@@@@@@@@@@@@
@@@@@@@@@@@@@@@@@@@@@@@@@@@@@@@@@@@@@@@@@@@@@@@@@...T.@@@@@@@@@T.TT@@@@..T.T....@@@@@@@@@TT..T....T@@@@@@@@@@@@@@@@@@@@@@@@@@@@@@@@@@@@@@@@@
@@@@@@@@@@@@@@@@@@@@@@@@@@@@@@@@@@@@@@@@@@@@@@@@.T.T.@@@@@@@@@@T.T...T.T..TT@@.TT@@@@@@@T..T.TT.TT@@@@@@@@@@@@@@@@@@@@@@@@@@@@@@@@@@@@@@@@@@
@@@@@@@@@@@@@@@@@@@@@@@@@@@@@@@@@@@@@@@@@@@@@@@..T.@@@@@@@@@@@T.T..TTT.TTT@@@@@T...@@@@T.....T.TT@@@@@@@@@@@@@@@@@@@@@@@@@@@@@@@@@@@@@@@@@@@
@@@@@@@@@@@@@@@@@@@@@@@@@@@@@@@@@@@@@@@@@@@@@@T...@@@@@@@@@@@TT.T.T..TTT.@@@@@@@.T.T@@T...T..TT.@@@@@@@@@@@@@@@@@@@@@@@@@@@@@@@@@@@@@@@@@@@@
@@@@@@@@@@@@@@@@@@@@@@@@@@@@@@@@@@@@@@@@@@@@@.T..@@@@@@@@@@@T...TT.TT..TT@@@@@@@@TTT..TTTT.T.T@@@@@@@@@@@@@@@@@@@@@@@@@@@@@@@@@@@@@@@@@@@@@@
@@@@@@@@@@@@@@@@@@@@@@@@@@@@@@@@@@@@@@@@@@@@TTT.@@@@@@@@@@@.T..T.T..TT..T@@@@@@@@@.TT.TT..TT.@@@@@@@@@@@@@@@@@@@@@@@@@@@@@@@@@@@@@@@@@@@@@@@
@@@@@@@@@@@@@@@@@@@@@@@@@@@@@@@@@@@@@@@@@@@.TTT@@@@@@@@@@@@TTT....T.TTT.T.@@@@@@@@@...T.T..T@@@@@@@@@@@@@@@@@@@@@@@@@@@@@@@@@@@@@@@@@@@@@@@@
@@@@@@@@@@@@@@@@@@@@@@@@@@@@@@@@@@@@@@@@@@T.T.@@@@@@@@@@@@@@...TTTT..T....@@@@@@@@@@TT.TTTT@@@@@@@@@@@@@@@@@@@@.T@@@@@@@@@@@@@@@@@@@@@@@@@@@
@@@@@@@@@@@@@@@@@@@@@@@@@@@@@@@@@@@@@@@@@.T..@@@@@@@@@@@@@@@@T.TT.......T..@@@@@@@@@@.TT.T@@@@@@@@@@@@@@@@@@@@...T@@@@@@@@@@@@@@@@@@@@@@@@@@
@@@@@@@@@@@@@@@@@@@@@@@@@@@@@@@@@@@@@@@@T.T.@@@@@@@@@@@@@@@@@@TT.TTT...T...@@@@@@@@@@@TT...@@@@@@@@@@@@@@@@@@.T..T.@@@@@@@@@@@@@@@@@@@@@@@@@
@@@@@@@@@@@@@@@@@@@@@@@@@@@@@@@@@@@@@@@TTTT@@@@@@@@@@@@@@@@@@@@TTTT..TTT.TT@@@@@@@@@@@@TTT.@@@@@@@@@@@@@@@@@TT.TT...@@@@@@@@@@@@@@@@@@@@@@@@
@@@@@@@@@@@@@@@@@@@@@@@@@@@@@@@@@@@@@@....@@@@@@@@@@@@@@@@@@@@@@TT.TT...TT@@@@@@@@@@@@@.....@@@@@@@@@@@@@@@..T...T.T.@@@@@@@@@@@@@@@@@@@@@@@
@@@@@@@@@@@@@@@@@@@@@@@@@@@@@@@@@@@@@T.T.@@@@@@@@@@@@@@@@@@@@@@@@TTTTT.T.@@@@@@@@@@@@@@@.T...@@@@@@@@@@@@@.T.TT.TT..TT@@@@@@@@@@@@@@@@@@@@@@
@@@@@@@@@@@@@@@@@@@@@@@@@@@@@@@@@@@TTTTT@@@@@@@@@@@@@@@@@@@@@@@@@@...TTT@@@@@@@@@@@@@@@@.T....@@@@@@@@@@@TT..TT..T.TTTT@@@@@@@@@@@@@@@@@@@@@
@@@@@@@@@@@@@@@@@@@@@@@@@@@@@@@@@@..TT.@@@@@@@@@@@@@@@@@@@@@@@@@@@@..TT@@@@@@@@@@@@@@@@@T.TTT.T.@@@@@@@@T.TTT.T....T.TT.@@@@@@@@@@@@@@@@@@@@
@@@@@@@@@@@@@@@@@@@@@@@@@@@@@@@@@.TTT.@@@@@@@@@@@@@@@@@@@@@@@@@@@@@@T.@@@@@@@@@@TT@@@@@@.T..T....@@@@@@.T.TT.T.TTT.T..TTT@@@@@@@@@@@@@@@@@@@
@@@@@@@@@@@@@@@@@@@@@@@@@@@@@@@@..T..@@@@@@@@@@@@@@@@@@@@@@@@@@@@@@@@@@@@@@@@@@....T@@@TTTTTT@....@@@@T....TT....TT......T@@@@@@@@@@@@@@@@@@
@@@@@@@@@@@@@@@@@@@@@@@@@@@@@@@@.T.T@@@@@@@@@@@@@@@@@@@@@.T@@@@@@@@@@@@@@@@@@@TT.T.T....T.T.@@@.TTT@@@T..T@..T...TT...T.T..@@@@@@@@@@@@@@@@@
@@@@@@@@@@@@@@@@@@@@@@@@@@@@@@@@T..@@@@@@@@@@@@@@@@@@@@@TT.T@@@@@@@@@@@@@@@@@.T..TT.T.T...T@@@@@TT..@@TTT@@@TT.TTT.T.T.T.TT.@@@@@@@@@@@@@@@@
@@@@@@@@@@@@@@@@@@@@@@@@@@@@@@@.T@@@@@@@@@@@@@@@@@@@@@@@.TTT@@@@@@@@@@@@@@@@T...T...T.T..T@@@@@@@TT.TT..@@@@@@TTT.TTTTTTT..TT@@@@@@@@@@@@@@@
@@@@@@@@@@@@@@@@@@@@@@@@@@@@@@TT@@@@@@@@@@@@@TT.T@@@@@@@T..T@@@@@@@@@@@@@@@.T.TTTT.TT....@@@@@@@@@T....T@@@@@@@..TTT..TTTTTTT.@@@@@@@@@@@@@@
@@@@@@@@@@@@@@@@@@@@@@@@@@@@@T.@@@@@@@@@@@@@.TT.T.T@@@@@@..@@@@@@@@@@@@@@@@..T.TTTT..T..T.@@@@@@@@@T..TT@@@@@@@@TTTTTTT.T..TT@@@@@@@@@@@@@@@
@@@@@@@@@@@@@@@@@@@@@@@@@@@T.T@@@@@@@@@@@@@@TTTT.TT@@@@@@@@@@@@@@@@@@@@@@@@@.T.TT.T.TTTT.T@@@@@@@@@@TTT..@@@@@@@@TT.TTT..TT.@@@@@@@@@@@@@@@@
@@@@@@@@@@@@@@@@@@@@@@@@@@.TT@@@@@@@@@@@@@@@..T.TT.@@@@@@@@@@@@@@@@@@@@@@@@@@...T..TTT.TTTT@@@@@@@@@@TTTT.@@@@@@@@.T.TTTTT.@@@@@@@@@@@@@@@@@
@@@@@@@@@@@@@@@@@@@@@@@@@@.T@@@@@@@@@@@@@@@@..T.T.@@@@@@@@@@@@@@@@@@@@@@@@@@@@..T...T.TTT...@@@@@@@@@@@.T.T@@@@@@@@TT.T.T.@@@@@@@@@@@@@@@@@@
@@@@@@@@@@@@@@@@@@@@@@@.TT.@@@@@@@@@@@@@@@@@@TTTT@@@@@@@@@@@@@@@@@@@@@@@@@@@@@@TTT....TT...T@@@@@@@@@@@@TT..@@@@@@@@@T.TT@@@@@@@@@@@@@@@@@@@
@@@@@@@@@@@@@@@@@@@@@@TT.T@@@@@@@@@@@@@@@@@@@@@@@@@@@@@@@@@@@@@@@@@@@@@@@@@@@@@@TT.T.T.TT.T@@@@@@@@@@@@@@.TT.@@@@@@@@@.T@@@@@@@@@@@@@@@@@@@@
@@@@@@@@@@@@@@@@@@@@@....@@@@@@@@@@@@@@@@@@@@@@@@@@@@@@@@@@@@@@@@@T.T.@@@@@@@@@@@TT.T..T..@@@@@@@@@@@@@@@@...T@@@@@@@@@@@@@@@@@@@@@@@@@@@@@@
@@@@@@@@@@@@@@@@@@@@...T@@@@@@@@@@@@@@@@@@@@@@@@@@@@T@@@@@@@@@@@@@..TT@@@@@@@@@@@@.......@@@@@@@@@@@@@@@@@T.TTT@@@@@@@@@@@@@@@@@@@@@@@@@@@@@
@@@@@@@@@@@@@@@@@@@..TT@@@@@@@@@@@@@@@@@@@@@@@@@@@@...@@@@@@@@@@@@T.TT.@@@@@@@@@@@@.....@@@@@@@@@@@@@@@@@@...TTT@@@@@@@@@@@@@@@@@@@@@@@@@@@@
@@@@@@@@@@@@@@@@@@TTTT@@@@@@@@@@@@@@@@@@@@@@@@@@@T.TT.T@@@@@@@@@@@@...@@@@@@@@@@@@@@T.T@@@@@@@@@@@@@@@@@@@T.T....@@@@@@@@@@@@@@@@@@@@@@@@@@@
@@@@@@@@@@@@@@@@@.T...@@@@@@@@@@@@@@@@@@@@@@@@T......TTT@@@@@@@@@@@@@@@@@@@@@@@@@@@@@@@@@@@@@@@@@...@@@@@@...TT...@@@@@@@@@@@@@@@@@@@@@@@@@@
@@@@@@@@@@@@@@@@TTT..T@@@@@@@@@@@@@@@@@@@@@@@@@.T..T..TT.@@@@@@@@@@@@@@@@@@@@@@@@@@@@@@@@@@@@@@@..TT.@@@@@TTTTT.TTT@@@@@@@@@@@@@@@@@@@@@@@@@
@@@@@@@@@@@@@@@TT.T.T@@@@@@@@@@@@@@@@@@@@@@@@@@...TTTTTTTT@@@@@@@@@@@@@@@@@@@@@@@@@@@@@@@@@@@@@TT.TTTT.@@@T..TT@T...@@@@@@@@@@@@@@@@@@@@@@@@
@@@@@@@@@@@@@@.T....T@@@@@@@@@@@@@@@@@@@@@@@@@@@@@@@..T..T.@@@@@@@@@@@@@@@@@@@@@@@@@@@@@@@@@@TT..T.TT....TTTT.@@@TT.T@@@@@@@@@@@@@@@@@@@@@@@
@@@@@@@@@@@@@.TT.....@@@@@@@@@@@@@@@@@@@@@@@@@@@@@@@@..T..TT@@@@@@@@@@@@@@@@@@@@@@@@@@@@@@@@TTTT....TT.TTT.T.@@@@@....@@@@@@@@@@@@@@@@@@@@@@
@@@@@@@@@@@@.TT..T..T@@@@@@@@@@@@@@@@@@@@@@@@@@@@@@@@@T..T.T.TT@@@@@@@@@@@@@@.T@@@@@@@@@@@@T....TT..T.TT.T.T@@@@@@@.TTT@@@@@@@@@@@@@@@@@@@@@
@@@@@@@@@@@..TTT...T..@@@@@@@@@@@@@@@@@@@@@@@@@@@@@@@@@@@.TTT..@@@@@@@@@@@@@..TT@@@@@@@@@@@TT.T.T.TT.TT.T...@@@@@@@@..T.@@@@@@@@@@@@@@@@@@@@
@@@@@@@@@@..TT.TT@T..T.@@@@@.@@@@@@@@@@@@@@@@@@@@@@@@@@@@..T..T.@@@@@@@@@@@@TT.T@@@@@@@@@@@@....T.TT..TT.T.T.T@@@@@@@T..T@@@@@@@@@@@@@@@@@@@
@@@@@@@@@.TTTT.T@@@T.TT.@@@.TT@@@@@@@.@@@@@@@@.TT@@@@@@@.T..T.TT.@@@.@@@@@@@..TT@@@@@@@@@@@@@.T..TT..T..TT..TT@@@@@@@@T..T@@@@@@@@@@@@@@@@@@
@@@@@@@@TTTT...@@@@@.T.TT@@TT...TT.TT@@@@@@@@TTTTT@@@@@@@.TT.T.T....T@@@@@@@..T@@@@@@@@@@@@@@@..TTT..TTT.T..T.@@@@@@@@@TT.T@@@@@@@@@@@@@@@@@
@@@@@@@...T.T.@@@@@@@...T..T..T....TT@@@@@@@@.TT.T@@@@@@@@..T..TT.T@@@@@@@@@@@@@@@@@@@@@@@@@@@@.TTTTT..T.T...@@@@@@@@@@@..T.@@@@@@@@@@@@@@@@
@@@@@@TTT....T@@@@@@@@......T..TTTT.T@@@@@@@@T..T@@@@@@@@@TT.T.T...@@@@@@@@@@@@@@@@@@@@@@@@@@@@@TT......T.TT@@@@@@@@@@@@@.TT.@@@@@@@@@@@@@@@
@@@@@T.T...T...@@@@@@@@.T...T..T...T.@@@@@@@@@@@@@.T@@@@@@TTT.TT..TT@@@@@@@@@@@@@@@@@@@@@@@@@@@@@TT.TTTT...@@@@@@@@@@@@@@@.TTT@@@@@@@@@@@@@@
@@@@@TTTTTTT....@@@@@@@@.T..T.T.TT..T@@@@@@@@@@@@TT..@@@@@.T.T.T...TT@@@T.@@@@@@@@@@@@@@@@@@@@@@@@TT...T.T@@@@@@@@@@@@@@@@@T.T..@@@@@@@@@@@@
@@@@@@TTTTT..TTT@@@@@@@@@TT.TTT.T..T.@@@@@@@@@@@.TT.T.@@@@TTTT..T...TT@TT@@@@@@@@@@@@@@@@@@@@@@@@@@@.TTT.@@@@@@@@.TT@@@@@@@@TTTT.@@@@@@@@@@@
@@@@@@@T.T.TT.T..@@@@@@@@@TT...T.T..@@@@@@@@@@@@@T...T@@@T.T.TT.T...T...T@@@@@@@@@@@@@@TT.@@@@@@@@@@@TT.@@@@@@@@@.TT@@@@@@@@@TTTT.@@@@@@@@@@
@@@@@@@@T.T.TT...TT@@@@@@@@TTTTT..T..@@@@@@@@@@@@@T..TT@@T.....TT.T....T.T@@@@@@@@@@@@.T..@@@@@@@@@@@@@@@@@@@@@@@T..@@@@@@@@@@...TT@@@@@@@@@
@@@@@@@@@TT.T.TTT..T@@@@@@@@T..TT.TT.@@@@@@@@@@@@@...T.@..TTTT.T.TTTTT.T.T@@@@@@@@@@@@T...@@@@@@@@@@@@@@@@@@@@@@@.TT.@@@@@@@@@.T.T..@@@@@@@@
@@@@@@@@@@T..TT..TT..@@@@@@@@......T.T.@@@@@@@@@@@@.TTT..T..T.....TTTT..TTTT@@@@@@@@@@.T.T@@@@@@@@@@@@@@@@@@@@@TT.T.T.T@@@@@@@..TTT.T@@@@@@@
@@@@@@@@@@@T.TT..TTT..@@@@@@@@TTT......@@@@@@@@@@@@@T.TTT.T.TT.T..T....TT...T@@@@@@@@@@@@@@@@@@@@@@@@@@@@@@@@@T......T.@@.@@@@@.T.TT.T@@@@@@
@@@@@@@@@@@@T..T...TTTT@@@@@@@@.TTTT...@@@@@@@@@@@@@..TTT...TTT.TT.T..TT.T.TTT@@@@@@@@@@@@@@@@@@@@@@@@@@@@@..T..TT..TTT.TTTT@@@T...T...@@@@@
@@@@@@@@@@@@@T.TT.TT....@@@@@@@@T...T.T@@@@@@@@@@@@@TT...TTTTT..T.T.T.TT.....T@@@@@@@@@@@@@@@@@@@@@@@@@@@@@@T..T.TTT.T....TT@@@...TTT..T@@@@
@@@@@@@@@@@@@@T.TTTTT..T.@@@@@@@@T.TT..T.T..TT@@@@@T...TTT....T..T.........TTTT@@@@@@@@@@@@@@@@@@@@@@@@@@@@@@T..T...TTT.TT..@@@TTT.TT.T@@@@@
@@@@@@@@@@@@@@@..T.T...T.T@@@@@@@@T.T.T.TTT..T..TTTTTT...TTTTT.T...T...TT....TTT.TT@@@@@@@@@@@@@@@@@@@@@@@@@@@..TTT.@@@@TT..@@TTTTT.TT@@@@@@
@@@@@@@@@@@@@@@@TTT.TTTT.TT@@@@@@@@@.TT..T.T.TTTTTTTT.T..T...T.T..TTT...TTT....T..T@@@@@@@@@@@@@@@@@@@@@@@@@@@@T.TT@@@@@@T.T.T....T.T@@@@@@@
@@@@@@@@@@@@@@@@@......TT.TT@@@@@@@@@..TTT.T.T.TTTT.T.......T.T.T..T.T.T..T.TT.TTT.@@@@@@@@@@@@@@@@@@@@@@@@@@@@@..@@@@@@@@T....TTT.T@@@@@@@@
@@@@@@@@@@@@@@@@@@T..TTTTT..T@@@@@@@@@..T.TT....TT..T.T..T.TTTTTTTTTT.TT..TT.....TT@@@@@@@@@@@@@@@@@@TT@@@@@@@@@@@@@@@@@@.TTT..TT.T@@@@@@@@@
@@@@@@@@@@@@@@@@@@@T.T.T.TTTTT@@@@@@@@@TTTTTT.TT..TTTTT..T.T.T.TT..T.T.T.T.T.TTTT....T@@@@@@@@@@@@@@TTT.@@@@@@@@@@@@@@@@@.T.....TT@@@@@@@@@@
@@@@@@@@@@@@@@@@@@@@...T.TT....@@@@@@@@@.T..TT..T.TT.TT.T.....T...T...T...T.T.T..TT.TT@@@@@@@@@@@@@@@T.T@@@@@@@@@@@@@@@@.T.TTTT.T@@@@@@@@@@@
@@@@@@@@@@@@@@@@@@@@@...TT.TTT..@@@@@@@@@...T...T.TT....TT.TT...T..TT..TT...T.TTT....@@@@@@@@@@@@@@@TT..T@@@@@@@@@@@@@@TTT..T...@@@@@@@@@@@@
@@@@@@@@@@@@@@@@@@@@@@.....T.T.TT@@@@@@@@@....T.T.....TT.......T..TT...TTT.....TTT..@@@@@@@@@@@@@@@.T...T@@@@@@@@@@@@@T.TT..T..@@@@@@@@@@@@@
@@@@@@@@@@@@@@@@@@@@@@@@.T..TT...T@@@@@@@@@...TT.TTT...T.TT..T.TTTTT...T...T..T....@@@@@@@@@@@@T@@.TT...T..T.@@@@@@@@T.T.T.TT.@@@@@@@@@@@@@@
@@@@@@@@@@@@@@@@@@@@@@@@@T..TT...TTT@@@@@@@@..TT.TTTTT..TTT.T.T...TTTT.TTT.T.TTTT...@@@@@@@@@@@TTT...TT..TTT@@@@@@@@.TTT...TT@@@@@@@@@@@@@@@
@@@@@@@@@@@@@@@@@@@@@@@@@@TTT...TTT.T@@@@@@@@T....T.T.T......TTT..T.T.T.TT.....TTTT.@@@@@@@@@@@..T.T.TTT..T.@@@@@@@T.T.T.TTT@@@@@@@@@@@@@@@@
@@@@@@@@@@@@@@@@@@@@@@@@@@.TTT..TT.TT.@@@@@@@@T.TTT....T...TT..T.TT.TT...T..TTTT@TTT@@@@@@@@@@@@..TTTT...TTT@@@@@@TT.T.T.TT@@@@@@@@@@@@@@@@@
@@@@@@@@@@@@@@@@@@@@@@@@@@@......TT....@@@@@@@@@TT.T...T....T..T..T...TT..T.T.T@@.T@@@@@@@@@@@@@@..T.TT.T..T@@@@@T.TTTT..T@@@@@@@@@@@@@@@@@@
@@@@@@@@@@@@@@@@@@@@@@@@@@@.TTTT..TT.T..@@@@@@@@@.T.TTT.TTTTTT.TT....TTT.TT..T@@@@@@@@@@@@@@@@@@@@T..TTT....T@@T.T..TTTT.@@@@@@@@@@@@@@@@@@@
@@@@@@@@@@@@@@@@@@@@@@@@@@@.TT...TTT.TT.T@@@@@@@@TTTTTTT.TTTTTT.......TT....T@@@@@@@@@@@@@T.@@@@@@@.TTT@@T.TT@T.TTTT..T.@@@@@@@@@@@@@@@@@@@@
@@@@@@@@@@@@@@@@@@@@@@@@@..TT.T.T.T.T...T.@@@@@@@@TTTT.TT..TTTT.T.TT..T....T@@@@@@@@@@@@@..@@@@@@@@@.T@@@TTT.TT.T..TT..@@@@@@@@@@@@@@@@@@@@@
@@@@@@@@@@@@@@@@@@@@@@@@T.T.....T..T.TT.TTT@@@@@@@@..T...T.....TT..T..T..TT@@@@@@@@@@@@@..T@@@@@@@@@@@@@@@..T..T.T...T@@@@@@@@@@@@@@@@@@@@@@
@@@@@@@@@@@@@@@@@@@@@@@...T.TTT.T.T..TT.TT.T@@@@@@@@@@@@..T........TT..T..@@@@@@@@@@@@@@T.TT@@@@@@@@@@@@@@T...T.T....@@@@@@@@@@@@@@@@@@@@@@@
@@@@@@@@@@@@@@@@@@@@@@.T.TTTT.T..@@T.TT.T.TT.@@@@@@@@@@.T..T...TTTT.TTT.T.@@@@@@@@@@@@@@.TTTT@@@@@@@@@@@@@...T.TT.TT@@@@@@@@@@@@@@@@@@@@@@@@
@@@@@@@@@@@@@@@@@@@@@T.T....TT..@@@@.TTTT.T....@@@@.TTTT.TT.TT.TT.TTTT..T.T@@@@@@@@@@@@.TT.TTT@@@@@@@@@@@T.....TT.T@@@@@@@@@@@@@@@@@@@@@@@@@
@@@@@@@@@@@@@@@@@@@TTTT.T.T.T.@@@@@@@TT..T.T..T@@@@.T.T.T....T...T.TTTT.T.@@@@@@@@@@@@TTT.....TTT@@@@@@@T..TTTT.T.@@@@@@@@@@@@@@@@@@@@@@@@@@
@@@@@@@@@@@@@@@@@@..TTTTT.T.T@@@@@@@@@...T.TTT..T@@...T.@@@@.T.T.T....@..@@@@@@@@@@..TTTT..T.T.TT@@@@@@.T...TT...@@@@@@@@@@@@@@@@@@@@@@@@@@@
@@@@@@@@@@@@@@@@@TTT..TT.T.@@@@@@@@@@@@..TT.TT...@@.TT.T@@@@@@T.T..TT@@@@@@@@@@@@@@.T.T.TTTTTT.TT@@@@@.T.TT.TTTT@@@@@@@@@@@@@@@@@@@@@@@@@@@@
@@@@@@@@@@@@@@@@.TTTTTTT.T@@@@@@@@@@@@@@.TT.TT.TT.T.TT@@@@@@@@TTTT..@@@@@@@@@@@@@@@@T..TT.TT...T.@@@@TT..T.TT.T@@@@@@@@@@@@@@@@@@@@@@@@@@@@@
@@@@@@@@@@@@@@@T..TT.T.TT@@@@@@@@@@@@@@@@.TT..TT....T@@@@@@@T.T.TT.@@@@@@@@@@@@@@@@@@.T.T..TT.TTT@@@TTTTT.TTTT@@@@@@@@@@@@@@@@@@@@@@@@@@@@@@
@@@@@@@@@@@@@@TT.TT.TTTT@@@@TTT.@@@@@@@@@@T.T....TTTT@@@@@@@@TT...@@@@@@@@@@@@@@@@@@@@T.TTT@T.T.T@@T....T.TT.T@@@@@@@@@@@@@@@@@@@@@@@@@@@@@@
@@@@@@@@@@@@@@TT..TT.TT.....TTT..@@@@@@@@@@T.T...T...T@@@@@@@@..T@@@@@@@@@@@@..@@@@@@@@T.T@@@T.TTT.T..TT..T.T.@@@@@@@@@@@@@@@@@@@@@@@@@@@@@@
@@@@@@@@@@@@@@@..TT..T...TTTTT...@@@@@@@@@@@TT.TT...TT.@@@@@@@@T@@@@@@@@@@@@....@@@@@@@@@@@@@@TTT.TT..T.TTT.TT.@@@@@@@@@@@@@@@@@@@@@@@@T@@@@
@@@@@@@@@@@@@@@@.T.T.TTTT.T..T.T@@@@@@@@@@@@@.T.TT...TT.@@@@@@@@@@@@@@@@@@@@...@@@@@@@@@@@@@@@@TTT..TTT.TTT.TTTT@@@@@@@@@@@@@@@@@@@@@@T.@@@@
@@@@@@@@@@@@@@@@@TTT....TTTTT..@@@@@@@@@@@@@@@.TT.T.T....@@@@@@@@@@@@@@@@@@@.TTT@@@@@@@@@@@@@@@...T..T.TTTTTTT.T.@@@@@@@@@@@@@@@@@@@.T.@@@@@
@@@@@@@@@@@@@@@@@@@@@...T.TTTT@@@@@@@@@@@@@@@@@TTT.T..TTTT@@@@@@@@@@@@@@@@@TTT..T@@@@@@@@@@@@@TTTT.T.T.T...TT...TT@@@@@@@@...T..T.TT..@@@@@@
@@@@@@@@@@@@@@@@@@@@@@@@.TTTT@@@@@@@@@@@@@@@@@@@TTT...TTT.T@@@@@@@@@@@@@@@T.TT.T..@@@@@@@@@@@T..TTTTT.@@T...TTTT..T.@@@@@......TTT..T@@@@@@@
@@@@@@@@@@@@@@@@@@@@@@@@@@@@@@@@@@@@@@@@@@@@@@@@@..TT.TT.T..@@@@@@@@@@@@@...T...TTT.@@@@@@@@...TTT.TT@@@@TTT.T.....T.@@@T...TTTT.T..@@@@@@@@
@@@@@@@@@@@@@@@@@@@@@@@@@@@@@@@@@@@@@@@@@@@@@@@@@@TT...TTTTTT@@@@@@@@@T....T.T......@@@@@@@TT.TT.T.T@@@@@@.T.TTT.T.TT@@@T..TTT.TT.T@@@@@@@@@
@@@@@@@@@@@@@@@@@@@@@@@@@@@@@@@@@@@@@@@@@@@@@@@@@@@TT.T.....T.@@@@@@@@@TT.....TT...@@@@@@@TT.TT..T.@@@@@@@@TTTT..T..T..T.......T.T@@@@@@@@@@
@@@@@@@@@@@@@@@@@@@@@@@@@@@@@@@@@@@@@@@@@@@@@@@@@@@@..TT..TTTTT@@@@@@@@@T.T.TTT.TT@@@@@@@....T.TT.@@@@@@@@@@T.TTT..T.T.TT.TT..T.T@@@@@@@@@@@
@@@@@@@@@@@@@@@@@@@@@@@@@@@@@@@@@@@@@@@@@@@@@@@@@@@@@T.T..T.T...@@@@@@@@@T..T.TTTT@@@@@@TT..TTT..@@@@@@@@@@@@T..T.T...TT..T..TTT@@@@@@@@@@@@
@@@@@@@@@@@@@@@@@@@@@@@@@@@@@@@@@@@@@@@@@@@@@@@@@@@@@@.TTTTT.TT..@@@@@@@@@TT.TTT.T.@@@.TT.TTT..T@@@@@@@@@@@@@@.TT...T.TT.TT..T.@@@@@@@@@@@@@
@@@@@@@@@@@@@@@@@@@@@@@@@@@@@@@@@@@@@@@@@@@@@@@@@@@@@@@.TT.TT.T.T.@@@@@@@@@T.@@@TT.T@..TTT.TT..@@@@@@@@@@@@@@@@T.TT.TTT..TTT.T@@@@@@@@@@@@@@
@@@@@@@@@@@@@@@@@@@@@@@@@@@@@@@@@@@@@@@@@@@@@@@@@@@@@@@@..TT..TTTT.T@@@@@@@@@@@@.T..TT..T.T...@@@@@@@@@@@@@@@@@@..T.TTTT.T...@@@@@@@@@@@@@@@
@@@@@@@@@@@@@@@@@@@@@@@@@@@@@@@@@@@@@@@@@@@@@@@@@@@@@@@@@..T.T.T.TT..@@@@@@@@@@@@@T.TT.T.TTTT@@@@@@@@@@@@@@@@@@@@..TTT.TTT.T@@@@@@@@@@@@@@@@
@@@@@@@@@@@@@@@@@@@@@@@@@@@@@@@@@@@@@@@@@@@@@@@@@@@@@@@@@@TTT...T.T..T@@@@@@@@@@@@TTTT.TT..T@@@@@@@@@@@@@@@@@@@@@@.TT..TTTT@@@@@@@@@@@@@@@@@
@@@@@@@@@@@@@@@@@@@@@@@@@@@@@@@@@@@@@@@@@@@@@@@@@@@@@@@@@@@T.....TT..T.@@@@@@@@@@.T...TTTTT@@@@@@@@@@@@@@@@@@@@@@@@T.T..TT@@@@@@@@@@@@@@@@@@
@@@@@@@@@@@@@@@@@@@@@@@@@@@@@@@@@@@@@@@@@@@@@@@@@@@@@@@@@@@@TT..TT......@@@@@@@@.T.TTT.TTT@@@@@@@@@@@@@@@@@@@@@@@@@@.T.TT@@@@@@@@@@@@@@@@@@@
@@@@@@@@@@@@@@@@@@@@@@@@@@@@@@@@@@@@@@@@@@@@@@@@@@@@@@@@@@@@@T.T.T.T.T.T.@@@@@@...TTTT...@@@@@@@@@@@@@@@@@@@@@@@@@@@@...@@@@@@@@@@@@@@@@@@@@
@@@@@@@@@@@@@@@@@@@@@@@@@@@@@@@@@@@@@@@@@@@@@@@@@@@@@@@@@@@@@@.T..T.T..TTT@@@@.TTT..TT.T@@@@@@@@@@@@@@@@@@@@@@@@@@@@@@T@@@@@@@@@@@@@@@@@@@@@
@@@@@@@@@@@@@@@@@@@@@@@@@@@@@@@@@@@@@@@@@@@@@@@@@@@@@@@@@@@@@@@..TTTT.TT.T@@@..TTT..TTT@@@@@@@@@@@@@@@@@@@@@@@@@@@@@@@@@@@@@@@@@@@@@@@@@@@@@
@@@@@@@@@@@@@@@@@@@@@@@@@@@@@@@@@@@@@@@@@@@@@@@@@@@@@@@@@@@@@@@@...TTT.T..T...T...TTTT@@@@@@@@@@@@@@@@@@@@@@@@@@@@@@@@@@@@@@@@@@@@@@@@@@@@@@
@@@@@@@@@@@@@@@@@@@@@@@@@@@@@@@@@@@@@@@@@@@@@@@@@@@@@@@@@@@@@@@@@..T....TT.T.TTT..TTT@@@@@@@@@@@@@@@@@@@@@@@@@@@@@@@@@@@@@@@@@@@@@@@@@@@@@@@
@@@@@@@@@@@@@@@@@@@@@@@@@@@@@@@@@@@@@@@@@@@@@@@@@@@@@@@@@@@@@@@@@@.T..TTTTT.TTT.T.TT@@@@@@@@@@@@@@@@@@@@@@@@@@@@@@@@@@@@@@@@@@@@@@@@@@@@@@@@
@@@@@@@@@@@@@@@@@@@@@@@@@@@@@@@@@@@@@@@@@@@@@@@@@@@@@@@@@@@@@@@@@@@T.T.TT.T..T.T.T.@@@@@@@@@@@@@@@@@@@@@@@@@@@@@@@@@@@@@@@@@@@@@@@@@@@@@@@@@
@@@@@@@@@@@@@@@@@@@@@@@@@@@@@@@@@@@@@@@@@@@@@@@@@@@@@@@@@@@@@@@@@@@@TTTT..TT......@@@@@@@@@@@@@@@@@@@@@@@@@@@@@@@@@@@@@@@@@@@@@@@@@@@@@@@@@@
@@@@@@@@@@@@@@@@@@@@@@@@@@@@@@@@@@@@@@@@@@@@@@@@@@@@@@@@@@@@@@@@@@@@@TTT.TTTTTT.T@@@@@@@@@@@@@@@@@@@@@@@@@@@@@@@@@@@@@@@@@@@@@@@@@@@@@@@@@@@
@@@@@@@@@@@@@@@@@@@@@@@@@@@@@@@@@@@@@@@@@@@@@@@@@@@@@@@@@@@@@@@@@@@@@@....TTTT..@@@@@@@@@@@@@@@@@@@@@@@@@@@@@@@@@@@@@@@@@@@@@@@@@@@@@@@@@@@@
@@@@@@@@@@@@@@@@@@@@@@@@@@@@@@@@@@@@@@@@@@@@@@@@@@@@@@@@@@@@@@@@@@@@@@@..T.TTTT@@@@@@@@@@@@@@@@@@@@@@@@@@@@@@@@@@@@@@@@@@@@@@@@@@@@@@@@@@@@@
@@@@@@@@@@@@@@@@@@@@@@@@@@@@@@@@@@@@@@@@@@@@@@@@@@@@@@@@@@@@@@@@@@@@@@@@.TTT.T@@@@@@@@@@@@@@@@@@@@@@@@@@@@@@@@@@@@@@@@@@@@@@@@@@@@@@@@@@@@@@
@@@@@@@@@@@@@@@@@@@@@@@@@@@@@@@@@@@@@@@@@@@@@@@@@@@@@@@@@@@@@@@@@@@@@@@@@....@@@@@@@@@@@@@@@@@@@@@@@@@@@@@@@@@@@@@@@@@@@@@@@@@@@@@@@@@@@@@@@
@@@@@@@@@@@@@@@@@@@@@@@@@@@@@@@@@@@@@@@@@@@@@@@@@@@@@@@@@@@@@@@@@@@@@@@@@@T.@@@@@@@@@@@@@@@@@@@@@@@@@@@@@@@@@@@@@@@@@@@@@@@@@@@@@@@@@@@@@@@@
@@@@@@@@@@@@@@@@@@@@@@@@@@@@@@@@@@@@@@@@@@@@@@@@@@@@@@@@@@@@@@@@@@@@@@@@@@@@@@@@@@@@@@@@@@@@@@@@@@@@@@@@@@@@@@@@@@@@@@@@@@@@@@@@@@@@@@@@@@@@
@@@@@@@@@@@@@@@@@@@@@@@@@@@@@@@@@@@@@@@@@@@@@@@@@@@@@@@@@@@@@@@@@@@@@@@@@@@@@@@@@@@@@@@@@@@@@@@@@@@@@@@@@@@@@@@@@@@@@@@@@@@@@@@@@@@@@@@@@@@@
@@@@@@@@@@@@@@@@@@@@@@@@@@@@@@@@@@@@@@@@@@@@@@@@@@@@@@@@@@@@@@@@@@@@@@@@@@@@@@@@@@@@@@@@@@@@@@@@@@@@@@@@@@@@@@@@@@@@@@@@@@@@@@@@@@@@@@@@@@@@
@@@@@@@@@@@@@@@@@@@@@@@@@@@@@@@@@@@@@@@@@@@@@@@@@@@@@@@@@@@@@@@@@@@@@@@@@@@@@@@@@@@@@@@@@@@@@@@@@@@@@@@@@@@@@@@@@@@@@@@@@@@@@@@@@@@@@@@@@@@@
