type octile
height 91
width 84
map
@@@@@@@@@@@@@@@@@@@@@@@@@@@@@@@@@@@@@@@@@@@@@@@@@@@@@@@@@@@@@@@@@@@@@@@@@@@@@@@@@@@@
@@@@@@@@@@@@@@@@@@@@@@@@@@@@@@@@@@@@@@@@@@@@@@@@@@@@@@@@@@@@@@@@@@@@@@@@@@@@@@@@@@@@
@@@@@@@@@@@@@@@@@@@@@@@@@@@@@@@@@@@@@@@@@@@@@@@@@@@@@@@@@@@@@@@@@@@@@@@@@@@@@@@@@@@@
@@@@@@@@@@@@@@@@@@@@@@@@@@@@@@@@@@@@@@@@@@@@@@@@@@@@@@@@@@@@@@@@@@@@@@@@@@@@@@@@@@@@
@@@@@@@@@@@@@@@@@@@@@@@@@@@@@@@@@@@@@@@@@@@@@@@@@@@@@@@@@@@@@@@@@@@@@@@@@@@@@@@@@@@@
@@@@@@@@@@@@@@@@@@@@@@@@@@@@@@@@@@@@@@@@@@@@@@@@@@@@@@@@@@@@@@@@@@@@@@@@@@@@@@@@@@@@
@@@@@@@@@@@@@@@@@@@@@@@@@@@@@@@@@@@@@@@@@@@@@@@@@@@@@@@@@@@@@@@@@@@@@@@@@@@@@@@@@@@@
@@@@@@@@@@@@@@@@@@@@@@@@@@@@@@@@@@@@@@@@@@@@@@@@@@@@@@@@@@@@@@@@@@@@@@@@@@@@@@@@@@@@
@@@@@@@@@@@@@@@@@@@@@@@@@@@@@@@@@@@@@@@@@@@@@@@@@@@@@@@@@@@@@@@@@@@@@@@@@@@@@@@@@@@@
@@@@@@@@@@@@@@@@@@@@@@@@@@@@@@@@@@@@@@@@@@@@@@@@@@@@@@@@@@@@@@@@@@@@@@@@@@@@@@@@@@@@
@@@@@@@@@@@@@@@@@@@@@@@@@@@@@@@@@@@@@@@@@@@@@@@@@@@@@@@@@@@@@@@@@@@@@@@@@@@@@@@@@@@@
@@@@@@@@@@@@@@@@@@@@@@@@@@@@@@@@@@@@@@@@@@@@@@@@@@@@@@@@@@@@@@@@@@@@@@@@@@@@@@@@@@@@
@@@@@@@@@@@@@@@@@@@@@@@@@@@@@@@@@@@@@@@@@@@@@@@@@@@@@@@@@@@@@@@@@@@@@@@@@@@@@@@@@@@@
@@@@@@@@@@@@@@@@@@@@@@@@@@@@@@@@@@@@@@@@@@@@@@@@@@@@@@@@@@@@@@@@@@@@@@@@@@@@@@@@@@@@
@@@@@@@@@@@@@@@@@@@@@@@@@@@@@@@@@@@@@@@@@@@@@@@@@@@@@@@@@@@@@@@@@@@@@@@@@@@@@@@@@@@@
@@@@@@@@@@@@@@@@@@@@@@@@@@@@@@@@@@@@@@@@@@@@@@@@@@@@@@@@@@@@@@@@@@@@@@@@@@@@@@@@@@@@
@@@@@@@@@@@@@@@@@@@@@@@@@@@@@@@@@@@@@@@@@@@@@@@@@@@@@@@@@@@@@@@@@@@@@@@@@@@@@@@@@@@@
@@@@@@@@@@@@@@@@@@@@@@@@@@@@@@@@@@@@@@@@@@@@@@@@@@@@@@@@@@@@@@@@@@@@@@@@@@@@@@@@@@@@
@@@@@@@@@@@@@@@@@@@@@@@@@@@@@@@@@@@T.@@@@@@@@@@@@@@@@@@@@@@@@@@@@@@@@@@@@@@@@@@@@@@@
@@@@@@@@@@@@@@@@@@@@@@@@@@@@@@@@@@@TT@@@@@@@@@@@@@@@@@@@@@@@@@@@@@@@@@@@@@@@@@@@@@@@
@@@@@@@@@@@@@@@@@@@@@@@@@@@@@@@@@@.TT@@@@@@@@@@@@@@@@@@@@@@@@@@@@@@@@@@@@@@@@@@@@@@@
@@@@@@@@@@@@@@@@@@@@@@@@@@...@@@@.TT..@@@@@@@@@@@@@@@@@@@@@@@@@@@@@@@@@@@@@@@@@@@@@@
@@@@@@@@@@@@@@@@@@@@@@@@@@T..T@TT.T.T...@@@@@@@@@@@@@@@@@@@@@@@@@@@@@@@@@@@@@@@@@@@@
@@@@@@@@@@@@@@@@@@@@@@@@@@@T..TT.T...T.@@T@@@@@@@@@@@@@@@@@@@@@@@@@@@@@@@@@@@@@@@@@@
@@@@@@@@@@@@@@@@@@@@@@@@@@@T.T.TTT...T.@@.T@@@@@@@@@@@@@@@@@@@@@@@@@@@@@@@@@@@@@@@@@
@@@@@@@@@@@@@@@@@@@@@@@@@..T.T..TT....T..T.T@@@@@@@@@@@@@@@@@@@@@@@@@@@@@@@@@@@@@@@@
@@@@@@@@@@@@@@@@@@@@@@@@T..TT...T...T.TT.TTT@@@@@@@@@@@@@@@@@@@@@@@@@@@@@@@@@@@@@@@@
@@@@@@@@@@@@@@@@@@@@@...TT.TT..TT.T....T.T..T@@@@@@@@@@@@@@@@@@@@@@@@@@@@@@@@@@@@@@@
@@@@@@@@@@@@@@@@@@@@.TTT.T...TTT.TTT.TT...T..T@@@@@@@@@@@@@@@@@@@@@@@@@@@@@@@@@@@@@@
@@@@@@@@@@@@@@@@@@@T.T.T...T......TT.T...TT.T..@@@@@@@@@@@@@@@@@@@@@@@@@@@@@@@@@@@@@
@@@@@@@@@@@@@@@@@@@..T.....T.T.TT..T..TTTTTT.T.T@@@@@@@@@@@@@@@@@@@@@@@@@@@@@@@@@@@@
@@@@@@@@@@@@@@@@@@@@....T.TTT..TTTT...TT.T...TTTT@@@@@@@@@@@@@@@@@@@@@@@@@@@@@@@@@@@
@@@@@@@@@@@@@@@@@@@@@.TT.TTT.T...T....TT..TT..TT@@T.@@@@@@@@@@@@@@@@@@@@@@@@@@@@@@@@
@@@@@@@@@@@@@@@@@@@@@@.T..T....T..TTT.T.TT.T...@@.TT.@@@@@@@@@@@@@@@@@@@@@@@@@@@@@@@
@@@@@@@@@@@@@@@@@@@@@@@TT....TTTTT...TTTT....T@@T..T..@@@@@@@@@@@@@@@@@@@@@@@@@@@@@@
@@@@@@@@@@@@@@@@@@@@@@@@T..T..T.TTT.TTTTTT.T.@@TT.@.TTT@@@@@@@@@@@@@@@@@@@@@@@@@@@@@
@@@@@@@@@@@@@@@@@@@@@@@@@TT..TT..TT.T...T.T.@@..T@@@TTTT@@@@@@@@@@@@@@@@@@@@@@@@@@@@
@@@@@@@@@@@@@@@@@@@@@@@@@@T......TTTTTT....@@@@T@@@@@.T.T@@@@@@@@@@@@@@@@@@@@@@@@@@@
@@@@@@@@@@@@@@@@@@@@@@@.@@@T.T.T.TTT.T.TTT@@@@@@@T@@@@.T..@@@@@@@@@@@@@@@@@@@@@@@@@@
@@@@@@@@@T@@@@@@@@@@@..T@@@@...T..TTT.TT.@@@@@@@@T.@@@TT.TT@@@@@@@@@@@@@@@@@@@@@@@@@
@@@@@@@@@TT@@@@@@@@@.TTT.@@.TTTTT.TTTT.T@@@@@@@@...T......T.@@@@@@@@@@@@@@@@@@@@@@@@
@@@@@@@@@.T.T@@T@@@@@@@.T.@..T..TT.TT.T@@@@@@@..TTTT.T...T.TT@@@@@@@@@@@@@@@@@@@@@@@
@@@@@@T..T....@.@@@@@@@@...TT@@TT.T.T@@@@@@@@.T.T.T.TT..TT...T@@@@@@@@@@@@@@@@@@@@@@
@@@@@TTTTT@T.@@.@@@@@@@@.T..T.@@T.T.@@@T@@@@T.T..T...TT..TTT.T.@@@@@@@@@@@@@@@@@@@@@
@@@@.T.T..@@@@TT@@@@@@@@@TT..T.@@T.@@@T..T..T.T.T..TT.T.T.TTT@@@@@@@@@@@@@@@@@@@@@@@
@@@.T.T....TT..T@@@@@@@@@.T.T.TT@@@@@TTT..TTTTTTT..T.TTTTTTT@@@@@@@@@@@@@@@@@@@@@@@@
@@..TTT..TT...TT@@@@@@...TT.TTTT@@@@@TTTTTTT.T...T.TT...T..@@@@@@@@@@@@@@@@@@@@@@@@@
@@@.T..TT....T..@@.T.T..TTT..T.@@@@@@@TTTT.T.TTTT.T..TTTTT@@@@@@@@@@@@@@@@@@@@@@@@@@
@@@@TTTTTT..TT......T.T.TTTT..@@@@@@@@@TT..TTTT..TTTT.T.T.T@@@@@@@@@@@@@@@@@@@@@@@@@
@@@@@T.....T.T.TTT.T.........@@@@@@@@@@@T.T.T..TT..T.T.T.T..@@@@@@@@TT@@@@@@@@@@@@@@
@@@@@@T.TTT..T......TTT..TTTT.T@@@@@@@@@@....T.TTT.T.TTTTTT..@@@@@@T...@@@@@@@@@@@@@
@@@@@@@T....TTTTT.T.TT.TT.TTT.T.@@@@@@T..TT..TT....TTT.TT.T.T.@@@...T.TT.@@@@@@@@@@@
@@@@@@@@..T...TTT..TT.T.TTT..T..T@@@@T....T.T.T.TT.T...TT.TT.T.@.T..TTT..T@@@@@@@@@@
@@@@@@@@@TTT....T...T@@T.TTT...TT.@@TT.TTT.TT....TTTT@@..T.T@@@@.T.TTT.T...@@@@@@@@@
@@@@@@@@@@..T..T.T..@@@@..T.TTT..T@@TT.TT...TTTTTTT.@@@@T.T@@@@@@@@TTT....TT@@@@@@@@
@@@@@@@@@@@TT......@@@@@@..TTTTTTTT..TTTTTT.T...T..@@@@@@..@@.T..@@@T.T...T@@@@@@@@@
@@@@@@@@@@@@.TTT..@@@@@@@T.T....TT....T..TT.T.T..T@@@@@@@@TT....@@@@@..TTT@@@@@@@@@@
@@@@@@@@@@@@@..T.@@@@@@@..T.TT.TTTTTT..TT.....T..@@@@@@@@@@T.T.@@@@@@TTTT@@@@@@@@@@@
@@@@@@@@@@@@@@T.@@@@@@@...@.T..TTT.T.T.T.TT..T.T@@@@@@@@@@@TT.@@@@@@@@TT@@@@@@@@@@@@
@@@@@@@@@@@@@@@@@@@@@@.T.@@@....TTTTT...T.....T.@@@@@@@@@@@..@@@@@@@@@@@@@@@@@@@@@@@
@@@@@@@@@@@@@@@@@@@@@TTT@@@@@.TT.TT..T.T..TT....T@@@@@@@@T..@@@@@@@@.T@@@@@@@@@@@@@@
@@@@@@@@@@@@@@@@@@@@@TT@@@@@@@...TTT.TT...TT...T...@@@@@T.T@@@@@@@@..T..@@@@@@@@@@@@
@@@@@@@@@@@@@@@@@@@@@@@@@@@@@@@TTTTT..T.TT...T.T....@@@.TT@@@@@@@@....T.T@@@@@@@@@@@
@@@@@@@@@@@@@@@@@@@@@@@@@@@@@@@@....TTTTT......T.T@@@@T.T.T@@@@@@....TT...@@@@@@@@@@
@@@@@@@@@@@@@@@@@@@@@@@@@@@@@@@@TT.T..T..TT...T.T@@@@T....TT@@@@TT.@@TT.TT.@@@@@@@@@
@@@@@@@@@@@@@@@@@@@@@@@@@@@@@@@@@T....TTTTTT.TT.T@@@T..T.@.TT@@T.@@@@T....T.@@@@@@@@
@@@@@@@@@@@@@@@@@@@@@@@@@@@@@@@@@@..TTT....@TTTT.@TTTT.T.@@..TTT@@@.TTT..T...@@@@@@@
@@@@@@@@@@@@@@@@@@@@@@@@@@@@@@@@@@@T.T.T..@@@T.T....TTT.@@@@T..T@TTTTTTTTTT.TT@@@@@@
@@@@@@@@@@@@@@@@@@@@@@@@@@@@@@@@@@@@.T..T@@@@@T..T.TT@.@@@@@@T.TTTT.T..T.T..T@@@@@@@
@@@@@@@@@@@@@@@@@@@@@@@@@@@@@@@@@@@@.TT.@@@@@@@..TTT.@@@T@@...TT...T...TT...@@@@@@@@
@@@@@@@@@@@@@@@@@@@@@@@@@@@@@@@@@@@@@..@@@@@@@@@.TTTTT@@.T@@....TTTT.TTT..@@@@@@@@@@
@@@@@@@@@@@@@@@@@@@@@@@@@@@@@@@@@@@@@.TT@@@@@@@@@.T..TT@@.TT...T.TT.T....@@@@@@@@@@@
@@@@@@@@@@@@@@@@@@@@@@@@@@@@@@@@@@@@@@TT.@@@@@.T.T...T.T..T.TTTT.....TT.@@@@@@@@@@@@
@@@@@@@@@@@@@@@@@@@@@@@@@@@@@@@@@@@@@@@.TT@@@T...TTT@T.T.TTT.TTTTT.TTT.@@@@@@@@@@@@@
@@@@@@@@@@@@@@@@@@@@@@@@@@@@@@@@@@@@@@@@@TTT....T.T@@@@TTT.....TT.TTTT@@@@@@@@@@@@@@
@@@@@@@@@@@@@@@@@@@@@@@@@@@@@@@@@@@@@@@@@@TTTTT...TT@@@@TTTTTTT..T.TT@@@@@@@@@@@@@@@
@@@@@@@@@@@@@@@@@@@@@@@@@@@@@@@@@@@@@@@@@.T....TT.T.@@@@@T.TTT..T..T@@@@@@@@@@@@@@@@
@@@@@@@@@@@@@@@@@@@@@@@@@@@@@@@@@@@@@@@@TT..@@.TTTT@@@@@@@TTTTTT.TT@@@@@@@@@@@@@@@@@
@@@@@@@@@@@@@@@@@@@@@@@@@@@@@@@@@@@@@@..TT...@@@..@@@@@@@@@....TT.@@@@@@@@@@@@@@@@@@
@@@@@@@@@@@@@@@@@@@@@@@@@@@@@@@@@@@@@@.TT@@.T@@@@@@@@@@@@@@@@...T@@@@@@@@@@@@@@@@@@@
@@@@@@@@@@@@@@@@@@@@@@@@@@@@@@@@@@@@@@@TT...@@@@@@@@@@@@@@@@@@T.@@@@@@@@@@@@@@@@@@@@
@@@@@@@@@@@@@@@@@@@@@@@@@@@@@@@@@@@@@@@@T.T@@@@@@@@@@@@@@@@@@@T@@@@@@@@@@@@@@@@@@@@@
@@@@@@@@@@@@@@@@@@@@@@@@@@@@@@@@@@@@@@@@@@T@@@@@@@@@@@@@@@@@@@@@@@@@@@@@@@@@@@@@@@@@
@@@@@@@@@@@@@@@@@@@@@@@@@@@@@@@@@@@@@@@@@@@@@@@@@@@@@@@@@@@@@@@@@@@@@@@@@@@@@@@@@@@@
@@@@@@@@@@@@@@@@@@@@@@@@@@@@@@@@@@@@@@@@@@@@@@@@@@@@@@@@@@@@@@@@@@@@@@@@@@@@@@@@@@@@
@@@@@@@@@@@@@@@@@@@@@@@@@@@@@@@@@@@@@@@@@@@@@@@@@@@@@@@@@@@@@@@@@@@@@@@@@@@@@@@@@@@@
@@@@@@@@@@@@@@@@@@@@@@@@@@@@@@@@@@@@@@@@@@@@@@@@@@@@@@@@@@@@@@@@@@@@@@@@@@@@@@@@@@@@
@@@@@@@@@@@@@@@@@@@@@@@@@@@@@@@@@@@@@@@@@@@@@@@@@@@@@@@@@@@@@@@@@@@@@@@@@@@@@@@@@@@@
@@@@@@@@@@@@@@@@@@@@@@@@@@@@@@@@@@@@@@@@@@@@@@@@@@@@@@@@@@@@@@@@@@@@@@@@@@@@@@@@@@@@
@@@@@@@@@@@@@@@@@@@@@@@@@@@@@@@@@@@@@@@@@@@@@@@@@@@@@@@@@@@@@@@@@@@@@@@@@@@@@@@@@@@@
@@@@@@@@@@@@@@@@@@@@@@@@@@@@@@@@@@@@@@@@@@@@@@@@@@@@@@@@@@@@@@@@@@@@@@@@@@@@@@@@@@@@
