type octile
height 59
width 56
map
@@@@@@@@@@@@@@@@@@@@@@@@@@@@@@@@@@@@@@@@@@@@@@@@@@@@@@@@
@@@@@@@@@@@@@@@@@@@@@@@@@@@@@@@@@@@@@@@@@@@@@@@@@@@@@@@@
@@@@@@@@@@@@@@@@@@@@@@@@@@@@@@@@@@@@@@@@@@@@@@@@@@@@@@@@
@@@@@@@@@@@@@@@@@@@@@@@@@@@@@@@@@@@@@@@@@@@@@@@@@@@@@@@@
@@@@@@@@@@@@@@@@@@@@@@@@@@@@@@@@@@@@@@@@@@@@@@@@@@@@@@@@
@@@@@@@@@@@@@@@@@@@@@@@@@@@@@@@@@@@@@@@@@@@@@@@@@@@@@@@@
@@@@@@@@@@@@@@@@@@@@@@@@@@@@@@@@@@@@@@@@@@@@@@@@@@@@@@@@
@@@@@@@@@@@@@@@@@@@@@@@@@@@@@@@@@@@@@@@@@@@@@@@@@@@@@@@@
@@@@@@@@@@@@@@@@@@@@@@@@@@@@@@@@@@@@@@@@@@@@@@@@@@@@@@@@
@@@@@@@@@@@@@@@@@@@@@@@@@@@@@@@@@@@@@@@@@@@@@@@@@@@@@@@@
@@@@@@@@@@@@@@@@@@@@@@@@@@@@@@@@@@@@@@@@@@@@@@@@@@@@@@@@
@@@@@@@@@@@@@@@@@@@@@@@@@@@@@@@@@@@@@@@@@@@@@@@@@@@@@@@@
@@@@@@@@@@@@@@@@@@@@@@@@@@@@@@@@@@@@@@@@@@@@@@@@@@@@@@@@
@@@@@@@@@@@@@@@@@@@@@@@@@@@@@@@@.@@@@@@@@@@@@@@@@@@@@@@@
@@@@@@@@@@@@@@@@@@@@@@@@@@@@@@@TT.TTT@@@@@@@@@@@@@@@@@@@
@@@@@@@@@@@@@@@@@@@@@@@@@@@@@@.TT...T@@@@@@@@@@@@@@@@@@@
@@@@@@@@@@@@@@@@@@@@@@@@@@@@T..T.T@@@@@@@@@@@@@@@@@@@@@@
@@@@@@@@@@@@@@@@@@@@@@@@@@@TTTT.T@@@@@.@@@@@@@@@@@@@@@@@
@@@@@@@@@@@@@@@@@@@@@@@@@@...@@TT@@@@@T.T.@@@@@@@@@@@@@@
@@@@@@@@@@@@@@@@@@@@@@@@@@.T@@@..@@@@@..TTTT@@@@@@@@@@@@
@@@@@@@@@@@@@@@@@@@@@@@@@T.@@@@T.@@@@@.T@@.T@@@@@@@@@@@@
@@@@@@@@@@@@@@@@@@@@@@@@T.@@@TT....@@@TT@@@@@@@@@@@@@@@@
@@@@@@@@@@@@@@@@@@@@@@@@TT@@@TTTTT.TTT..@@@@@@@@@@@@@@@@
@@@@@@@@@@@@@@@@@@@@@..T...T..T.TT.TTTTTTT@@@@@@@@@@@@@@
@@@@@@@@@@@@@@@@@@@@TTT@......T.T.T..TTTT..@@@@@@@@@@@@@
@@@@@@@@@@@@@@@@@@@TT.@@@T.TT..T.T.TT..T.T.T@@.@@@@@@@@@
@@@@@@@@@@@@@@@@@@@@.@@@@@TTTT..TT...TTTTT.T.T..T@@@@@@@
@@@@@@@@@@@@@@@@@@@@T@@@@@@.T.T...TT....T.T....TT.T@@@@@
@@@@@@@@@@@@@@@@@@@..@@@@@@@T.TT.TT.TT.T.T...TT...T.@@@@
@@@@@@@@@@@@@@@@@T..T@@@@@TT..T.TTT.....T...T...TT.T@@@@
@@@@@@@@@@@@@@@@@@@.T..@@TT..TT......TTT.T.T.......@@@@@
@@@@@@@@@@@@@@@@@@@@TT..T....TTTT.T..T.TT..T.T.TT.@@@@@@
@@@@@@@@@@@@@@@@@@@@T.T..T@TT.TT.T..T..T.T.T.....@@@@@@@
@@@@@@@@@@@@@@@@@@@.T.TT.@@@TT.T..T.TT.T.T.T...T@@@@@@@@
@@@@@@@@@T@@@TT@@@.TT..@@@@@TT.T.T.T.TTTT.TT..T@@@@@@@@@
@@@@@@@@.T@@@...@TT.T..@@@@@@T..TT.T.T.....TT.@@@@@@@@@@
@@@@@@@..T.@@TTTT..T.T.@@@@@.TT...TTT.T.T...T@@@@@@@@@@@
@@@@@TT.T..T@..@@T.TTTTTT@..TTT...T....TT...@@@@@@@@@@@@
@@@@T.TTTTT..T@@@@..T.TTTT..TT.T.TT...T.T..@@@@@@@@@@@@@
@@@TTT..T.....@@@@@T..T.TTT.TT..TT.T.TTT.T@@@@@@@@@@@@@@
@@....TTTTT.TTT@@@@TTT.TTT.T.T.T.TTTTTT.T@@@@@@@@@@@@@@@
@T..T...TT.TTTT.@@@.TT......T.T.TTT.....@@@@@@@@@@@@@@@@
@@TTT...T.TTTT.TT@..TTTTT.TTTTTT.T....T@@@@@@@@@@@@@@@@@
@@@.TTT.T.T..T..TTTT.TTT.T..T.TTTT..TT@@@@@@@@@@@@@@@@@@
@@@@TTTT........TT.T.T.TTTTTT..T.TTTT@@@@@@@@@@@@@@@@@@@
@@@@@TT.TT.TT...TTTTT.T.T..T.T..T.T.@@@@@@@@@@@@@@@@@@@@
@@@@@@TT....TT...TTTT.T.T...TT.TT.T@@@@@@@@@@@@@@@@@@@@@
@@@@@@@TTT.....TT.T.........TT..TT@@@@@@@@@@@@@@@@@@@@@@
@@@@@@@@TT.T.TTTT.T...TTTT.T..TTT@@@@@@@@@@@@@@@@@@@@@@@
@@@@@@@@@.T.TTT.TTT...T.TTT...T.@@@@@@@@@@@@@@@@@@@@@@@@
@@@@@@@@@@.T.TT..TTTT...TT...T.@@@@@@@@@@@@@@@@@@@@@@@@@
@@@@@@@@@@@TTT..TTTTT.T.T.T..T@@@@@@@@@@@@@@@@@@@@@@@@@@
@@@@@@@@@@@@T.TTT..T.TT.TT.TT@@@@@@@@@@@@@@@@@@@@@@@@@@@
@@@@@@@@@@@@@.T...TTTTT.T..T@@@@@@@@@@@@@@@@@@@@@@@@@@@@
@@@@@@@@@@@@@@TTTT..TT...T.@@@@@@@@@@@@@@@@@@@@@@@@@@@@@
@@@@@@@@@@@@@@@T.T...TT..T@@@@@@@@@@@@@@@@@@@@@@@@@@@@@@
@@@@@@@@@@@@@@@@...T.TT..@@@@@@@@@@@@@@@@@@@@@@@@@@@@@@@
@@@@@@@@@@@@@@@@@.T.T..T@@@@@@@@@@@@@@@@@@@@@@@@@@@@@@@@
@@@@@@@@@@@@@@@@@@@@@@@@@@@@@@@@@@@@@@@@@@@@@@@@@@@@@@@@
