type octile
height 86
width 88
map
@@@@@@@@@@@@@@@@@@@@@@@@@@@@@@@@@@@@@@@@@@@@@@@@@@@@@@@@@@@@@@@@@@@@@@@@@@@@@@@@@@@@@@@@
@@@@@@@@@@@@@@@@@@@@@@@@@@@@@@@@@@@@@@@@@@@@@@@@@@@@@@@@@@@@@@@@@@@@@@@@@@@@@@@@@@@@@@@@
@@@@@@@@@@@@@@@@@@@@@@@@@@@@@@@@@@@@@@@@@@@@@@@@@@@@@@@@@@@@@@@@@@@@@@@@@@@@@@@@@@@@@@@@
@@@@@@@@@@@@@@@@@@@@@@@@@@@@@@@@@@@@@@@@@@@@@@@@@@@@@@@@@@@@@@@@@@@@@@@@@@@@@@@@@@@@@@@@
@@@@@@@@@@@@@@@@@@@@@@@@@@@@@@@@@@@@@@@@@@@@@@@@@@@@@@@@@@@@@@@@@@@@@@@@@@@@@@@@@@@@@@@@
@@@@@@@@@@@@@@@@@@@@@@@@@@@@@@@@@@@@@@@@@@@@@@@@@@@@@@@@@@@@@@@@@@@@@@@@@@@@@@@@@@@@@@@@
@@@@@@@@@@@@@@@@@@@@@@@@@@@@@@@@@@@@@@@@@@@@@@@@@@@@@@@@@@@@@@@@@@@@@@@@@@@@@@@@@@@@@@@@
@@@@@@@@@@@@@@@@@@@@@@@@@@@@@@@@@@@@@@@@@@@@@@@@@@@@@@@@@@@@@@@@@@@@@@@@@@@@@@@@@@@@@@@@
@@@@@@@@@@@@@@@@@@@@@@@@@@@@@@@@@@@@@@@@@@@@@@@@@@@@@@@@@@@@@@@@@@@@@@@@@@@@@@@@@@@@@@@@
@@@@@@@@@@@@@@@@@@@@@@@@@@@@@@@@@@@@@@@@@@@@@@@@@@@@@@@@@@@@@@@@@@@@@@@@@@@@@@@@@@@@@@@@
@@@@@@@@@@@@@@@@@@@@@@@@@@@@@T@@@@@@@@@@@@@@@@@@@@@@@@@@@@@@@@@@@@@@@@@@@@@@@@@@@@@@@@@@
@@@@@@@@@@@@@@@@@@@@@@@@@@@@T..@@@@@TT@@@@@@@@@@@@@@@@@@@@@@@@@@@@@@@@@@@@@@@@@@@@@@@@@@
@@@@@@@@@@@@@@@@@@@@@@@@@@@..T..@@@..T@@@@@@@@@@@@@@@@@@@@@@@@@@@@@@@@@@@@@@@@@@@@@@@@@@
@@@@@@@@@@@@@@@@@@@@@@@@@@.T.TT@@@@...@@@@@@@@@@@@@@@@@@@@@@@@@@@@@@@@@@@@@@@@@@@@@@@@@@
@@@@@@@@@@@@@@@@@@@@@@@@@.T.T.@@@@@...T@@@@@@@@@@@@@@@@@@@@@@@@@@@@@@@@@@@@@@@@@@@@@@@@@
@@@@@@@@@@@@@@@@@@@@@@@@T.TT.@@@@@@T.T..T@@@@@@@@@@@@@@@@@@@@@@@@@@@@@@@@@@@@@@@@@@@@@@@
@@@@@@@@@@@@@@@@@@@@@@@.T.TT@@@@@@@...T@@@@@@@@@@@@@@@@@@@@@@@@@@@@@@@@@@@@@@@@@@@@@@@@@
@@@@@@@@@@@@@@@@@@@@@@@.T..@@@@@@@@TTT.@@@@@@@@@@@@@@@@@@@@@@@@@@@@@@@@@@@@@@@@@@@@@@@@@
@@@@@@@@@@@@@@@@@@@@@@T..T@@@@@@@@@.TT.T@@@@@@@@@@@@@@@@@@@@@@@@@@@@@@@@@@@@@@@@@@@@@@@@
@@@@@@@@@@@@@@@@@@@@@.T.T.@@@@@@@@@T...T.@@@@@@@@@@@@@@@@@@@@@@@@@@@@@@@@@@@@@@@@@@@@@@@
@@@@@@@@@@@@@@@@@@@@..TT.@@@@@@@@@@.T.TT.T@@@@@@@@@@@@@@@@@@@@@@@@@@@@@@@@@@@@@@@@@@@@@@
@@@@@@@@@@@@@@@@@@@.....@@@@@@@@@....T.TTTT@.@@@@@@@@@@@@@@@@@@@@@@@@@@@@@@@@@@@@@@@@@@@
@@@@@@@@@@@@@@@@@@T...T@@@@@@@@@..T..TT.T.T.TT@@@@@@@@@@@@@@@@@@@@@@@@@@@@@@@@@@@@@@@@@@
@@@@@@@@@@@@@@@@@TTT..T@@@@@@@@@@.T.T.TTTTTT.@@@@@@@@@@@@@@@@@@@@@@@@@@@@@@@@@@@@@@@@@@@
@@@@@@@@@@@@@@@@@.T....@@@@@@@.@@.T.TT...TT...@@@@@@@@@@@@@@@@@@@@@@@@@@@@@@@@@@@@@@@@@@
@@@@@@@@@@@@@@@@@T....T.@@@.T..@@TT..T.TT...T.T@@@@@@@@@@@@@@@@@@@@@@@@@@@@@@@@@@@@@@@@@
@@@@@@@@@@@@@@@@@.T...TTT@@.TTTT.T.T.TTT.T.T..TT@@@@@@@@@@@@@@@@@@@@@@@@@@@@@@@@@@@@@@@@
@@@@@@@@@@@@@@@@@@T.T.....@....T...TTT.TTTT....T..T.@@@@@@@@@@@@@@@@@@@@@@@@@@@@@@@@@@@@
@@@@@@@@@@@@@@@@@@@TTT.T.T@@.T..T.T.TTTT.T.TT......T@@@@@@@@@@@@@@@@@@@@@@@@@@@@@@@@@@@@
@@@@@@@@@@@@@@@@@@@@..T.TT.@.T..T...TTTT.T..TTT.TTTTT@@@@@@@@@@@@@@@@@@@@@@@@@@@@@@@@@@@
@@@@@@@@@@@@@TT@@@@@@TT.T.T@@.T.T.TTT.T....T..TT.T..T@@@@@@@@@@@@@@@@@@@@@@@@@@@@@@@@@@@
@@@@@@@@@@@@.....@@@@@.....T@@TTTTT.TTTTT..T..TT..T..T@@@@@@@@@@@@@@@@@@@@@@@@@@@@@@@@@@
@@@@@@@@@@@@@.T.T.@@@@@T..T.T@@..TTTTT....T....TT...TTTT@@@@@@@@@@@@@@@@@@@@@@@@@@@@@@@@
@@@@@@@@@@@@TTT..T.@@@@@.T.TTT@.TT.TT.TTTT....T..TT...TT..@@@@@@@@@@@@@@@@@@@@@@@@@@@@@@
@@@@@@@@@@@@..TT.T@@@@@@@TT.TTTTT.T.T......TT.T.T.TT.T.T...@@@@@@@@@@@@@@@@@@@@@@@@@@@@@
@@@@@@@@@@@@..TT..@@@@@@@@TT..TTTT.....T.TTT.....TTT.TT@@....@@@@@@@@@@@@@@@@@@@@@@@@@@@
@@@@@@@@@@@..T.T...@@@@@@@T.TTTT..TT..TT..T.T.TTT..T...@@TT.TT@@@@@@@@@@@@@@@@@@@@@@@@@@
@@@@@@@.T.T.T.T.T.TT@@@T@@@..TT.....T....T.....T.T..T.T@@..T.T@@@@@@@@@@@@@@@@@@@@@@@@@@
@@@@.@@TT...TT...TTT.....@@@T..TTTTTTTTTT.TT.T..T..T.T.TTT.@..@@@@@@@@@@@@@@@@@@@@@@@@@@
@@@....TTTT..T.T.T...TTTT@@@.TTT.....TTTTTT..T.T...TTT..T.@@...@@@@@@@@@@@@@@@@@@@@@@@@@
@@...TT..@@.TT@@TTT.....TTT.TT.TTTT.TT.TT..TTTT...T.TT...T@@.T..@@@@@@@@@@@@@@@@@@@@@@@@
@@@T.TT.T@@@@.@@T.TT..T..TT.TT@@.T.T.....T..TTTTT....T..T.....T.@@@@@@@@@@@@@@@@@@@@@@@@
@@@@T.TT.@@@@@@@@T....T.T..TT@@@@@TT.TTT..TTT..T.....T..T.....TT.@@@@@@@@@@@@@@@@@@@@@@@
@@@@@TTTT@@@@@@@@@..T.T.T.T@@@@@@@@..TT.TTTT.TT...T.TTT.TT....T.TT@@@@@@@@@@@@@@@@@@@@@@
@@@@@@T.TT@@@@@@@@@.T..TT.@@@@@@@@@@.TTT.T.T.T...T.TT.T.TT.T.T.TTT@@@@@@@@@@@@@@@@@@@@@@
@@@@@@@TT.T@@@@@@@@@T.T.T@@@@@@@@@@@@.TT.TT.T.T..T.T...TTT..T.T..T.@@@@@@@@@@@@@@@@@@@@@
@@@@@@@@TTTT.@@T.....T.T.@@@@@@@@@@@@@..TT..T..T.TT..TT......TTTTTT.@@@@@@@@@@@@@@@@@@@@
@@@@@@@@@.T....T.T.TTTTTT.@@@@@@..@@@@@.T....T.TTT..T.TTTTTT..T...TTT@@@@@@@@@@@@@@@@@@@
@@@@@@@@@@T.TTT.TT.T.TT..T@@@@@...T.@@@@@TTT.T..TT.T.TTT....TT.T......@@@@@@@@@@@@@@@@@@
@@@@@@@@@@@T.T.......@@TT.T@T.T..T...@@@@..TT.TT..TT..TT.TT.TT..TT...TT@.@@@@@@@@@@@@@@@
@@@@@@@@@@@@...TTT..@@@.T.TT..TTT..TT@@@....TTTTT.TT.TT....T..T..T..TT.T.T@@@@@@@@@@@@@@
@@@@@@@@@@@@@TTTTTT@@@@@TTTT...T.....TTT.TTTTT.TT.T...TT...T.T.T.T..T..T.T.@@@@@@@@@@@@@
@@@@@@@@@@@@@@TTT@@@@@@@TTT.TT...TT.T.TTTT.TTT.TTT.TTT...TTT.T.T.T..T.T..T.@@@@@@@@@@@@@
@@@@@@@@@@@@@@@@@@@@@@@T....TTTT.T....TT.T@@.TTT.TT...TTTTTTT.T...T.TTTT.TT.@@@@@@@@@@@@
@@@@@@@@@@@@@@@@@@@@@@@@TTT..T...@@.......@@@TTT.TT......TT.TT.TTTT.TT....T@@@@@@@@@@@@@
@@@@@@@@@@@@@@@@@@TT..@@TT.T.T..@@@@TTTT.T@@@@.T...TTTTT..TT.T...TTTT..T.T@@@@@@@@@@@@@@
@@@@@@@@@@@@@@@@@T.T.TTT..T..TT@@@@@@TT..T.@@@@@..TT.T.TTT.TT.TTT.TTT.TTT@@@T@@@@@@@@@@@
@@@@@@@@@@@@@@@@@@...TT..TT..@@@@@@@@T....TT@@@@@.TTTT.TTTTTTTT.TT....TT@@@..T@@@@@@@@@@
@@@@@@@@@@@@@@@@@@@TT....T.TT@@@@@@@@T..TT.TT@@@@@...T.T..TTTT..T.TT.TT.@@..TTT@@@@@@@@@
@@@@@@@@@@@@@@@@@@@@TTT.TT..T.@@@@@@@.TTTT...@@@@@.TT.T...T.T...T..TTTT@@...TTTT@@@@@@@@
@@@@@@@@@@@@@@@@@@@@@.....TTT....@@@.T....TTT.@@@@@TTTT.T.TTTT.T..T.TT@@T..TTTT..@@@@@@@
@@@@@@@@@@@@@@@@@@@@@@.T.T.TT.TTT@@@.T...TTTT@@@@@@@@......T.....TTT.@@TTTT..T..@@@@@@@@
@@@@@@@@@@@@@@@@@@@@@@..T.T.TT...@@@T.T...TT@@@@@@@@@@TTT.TT@@.TTTT.@@...T.TT.T@@@@@@@@@
@@@@@@@@@@@@@@@@@@@@@TT......TT...@.TT...T.@@@@@@@T@@TTT...T@@@....@@@TT..T..T@@@@@@@@@@
@@@@@@@@@@@@@@@@@@@@@@TTTTT.TTTTTTTT..TTT..@@@@@@@T.T.TTT....@@@TT.@@TTT.TTTT@@@@@@@@@@@
@@@@@@@@@@@@@@@@@@@@@@@T.T.T.T..TT.TT.TT..@@@@T@@@.TT@@T@@TTTT.@@@@@TTTTT.T.@@@@@@@@@@@@
@@@@@@@@@@@@@@@@@@@@@@@T.T.TT...T.TTTT....@@@T..T.T..T@@@@@@T...@@@TT..T...@@@@@@@@@@@@@
@@@@@@@@@@@@@@@@@@@@@@@@T@@.TT..TTT.TTTT.T@@.TT..TTTTT.@@@@@@.TTT.TT....TT@@@@@@@@@@@@@@
@@@@@@@@@@@@@@@@@@@@@@@@@@@@..T..T..TT.@....T.T.T..T.TT.@@@@@@@T...T.TT.T@@@@@@@@@@@@@@@
@@@@@@@@@@@@@@@@@@@@@@@@@@@@@TT..TT...@@@.T.T.TTTT.T.TT.T@@@@@@@..TT..T.@@@@@@@@@@@@@@@@
@@@@@@@@@@@@@@@@@@@@@@@@@@@@@@.TTTTT@@@@@@T..T.TT..TTTT..@@@@@@@@..T..T@@@@@@@@@@@@@@@@@
@@@@@@@@@@@@@@@@@@@@@@@@@@@@@@@.T.@@@@@@.@@T...TTTTTT...TT@@@@@@@@@T..@@@@@@@@@@@@@@@@@@
@@@@@@@@@@@@@@@@@@@@@@@@@@@@@@@@T@@@@@@T.TTT.TTTTTT.T..T....@@@@@@@@@@@@@@@@@@@@@@@@@@@@
@@@@@@@@@@@@@@@@@@@@@@@@@@@@@@@@@@@@@@TTTT.TT..TTT.TTTTT..T.T@@@@@@@@@@@@@@@@@@@@@@@@@@@
@@@@@@@@@@@@@@@@@@@@@@@@@@@@@@@@@@@@T..T.TTT.TT...TT.@@@@@@@TT@@@@@@@@@@@@@@@@@@@@@@@@@@
@@@@@@@@@@@@@@@@@@@@@@@@@@@@@@@@@@@T.T.....T....TTTT@@@@@@@@...@@@@@@@@@@@@@@@@@@@@@@@@@
@@@@@@@@@@@@@@@@@@@@@@@@@@@@@@@@@@@@TTTTT..T..T.T@@T@@@@@@@@..T.@@@@@@@@@@@@@@@@@@@@@@@@
@@@@@@@@@@@@@@@@@@@@@@@@@@@@@@@@@@@@@TT...TT...TT.@@@@@@@@@@T...@@@@@@@@@@@@@@@@@@@@@@@@
@@@@@@@@@@@@@@@@@@@@@@@@@@@@@@@@@@@@@@T....T......@@@@@@@@@@...@@@@@@@@@@@@@@@@@@@@@@@@@
@@@@@@@@@@@@@@@@@@@@@@@@@@@@@@@@@@@@@@@.TTTTTT...T@@@@@@@@@@TT.@@@@@@@@@@@@@@@@@@@@@@@@@
@@@@@@@@@@@@@@@@@@@@@@@@@@@@@@@@@@@@@@@@TTTTTT..TT@@@@@@@@@..T@@@@@@@@@@@@@@@@@@@@@@@@@@
@@@@@@@@@@@@@@@@@@@@@@@@@@@@@@@@@@@@@@@@@TTTT..T.T.@@@@@@..TT@@@@@@@@@@@@@@@@@@@@@@@@@@@
@@@@@@@@@@@@@@@@@@@@@@@@@@@@@@@@@@@@@@@@@@T...TTTT...T.T.TT@@@@@@@@@@@@@@@@@@@@@@@@@@@@@
@@@@@@@@@@@@@@@@@@@@@@@@@@@@@@@@@@@@@@@@@@@.T.TT.TT.....T.@@@@@@@@@@@@@@@@@@@@@@@@@@@@@@
@@@@@@@@@@@@@@@@@@@@@@@@@@@@@@@@@@@@@@@@@@@@.T...T.T.TT..@@@@@@@@@@@@@@@@@@@@@@@@@@@@@@@
@@@@@@@@@@@@@@@@@@@@@@@@@@@@@@@@@@@@@@@@@@@@@@@@@@@@@@@@@@@@@@@@@@@@@@@@@@@@@@@@@@@@@@@@
