type octile
height 80
width 80
map
@@@@@@@@@@@@@@@@@@@@@@@@@@@@@@@@@@@@@@@@@@@@@@@@@@@@@@@@@@@@@@@@@@@@@@@@@@@@@@@@
@@@@@@@@@@@@@@@@@@@@@@@@@@@@@@@@@@@@@@@@@@@@@@@@@@@@@@@@@@@@@@@@@@@@@@@@@@@@@@@@
@@@@@@@@@@@@@@@@@@@@@@@@@@@@@@@@@@@@@@@@@@@@@@@@@@@@@@TTTT.T.T..T..T.TTT..T..T@@
@@@@@@@@@@@@@@@@@@@@@@@@@@@@@@@@@@@@@@@@@@@@@@@@@@@@@@.....T...TT.T.......T...@@
@@@@@@@@@@@@@@@@@@@@@@@@@@@@@@@@@@@@@@@@@@@@@@@@@@@@@@@.T....T.T.T.T...TTT..T.@@
@@@@@@@@@@@@@@@@@@@@@@@@@@@@@@@@@@@@@@@@@@@@@@@@@@@@@@@.T.....T.TT.TT...T....T@@
@@@@@@@@@@@@@@@@@@@@@@@@@@@@@@@@@@@@@@@@@@@@@@@@@@@@@@.TTTT...T..T.T.T....T...@@
@@@@@@@@@@@@@@@@@@@@@@@@@@@@@@@@@@@@@@@@@@@@@@@@@@@@@T.TTTTT...T...T...T.TT.T.@@
@@@@@@@@@@@@@@@@@@@@@@@@@@@@@@@@@@@@@@@@@@@@@@@@@@@@..T......TTT..T.T...TT.T.T@@
@@@@@@@@@@@@@@@@@@@@@@@@@@@@@@@@@@@@@@@@@@@@@@@@@@@T..T......T..T..TT.....T...@@
@@@@@@@@@@@@@@@@@@@@@@@@@@@@@@@@@@@@@@@@@@@@@@@@@@T..TTTT...T.....T.TTT.TTTT.T@@
@@@@@@@@@@@@@@@@@@@@@@@@@@@@@@@@@@@@@@@@@@@@@@@@@...T.T.T....T...T..T...T.TT..@@
@@@@@@@@@@@@@@@@@@@@@@@@@@@@@@@@@@@@@@@@@@@@@@@@@@.T.T.T.TT...T.....T...T.T...@@
@@@@@@@@@@@@@@@@@@@@@@@@@@@@@@@@@@@@@@@@@@@@@@@@@..TTT.TTT.T.T..T..T...T......@@
@@@@@@@@@@@@@@@@@@@@@@@@@@@@@@@@@@@@@@@@@@@@@@@@@T...T..T.T..T...T.T.TT..T..TT@@
@@@@@@@@@@@@@@@@@@@@@@@@@@@@@@@@@@@@@@@@@@@@@@@@T..TTTT..T.T..T..T.T.T........@@
@@@@@@@@@@@@@@@@@@@@@@@@@@@@@@@@@@@@@@@@@@@@@@@.T....T..TT........T.T.T...T..@@@
@@@@@@@@@@@@@@@@@@@@@@@@@@@@@@@@@@@@@@@@@@@@@...TTT..T...TT...T.TT....TT.T..@@@@
@@@@@@@@@@@@@@@@@@@@@@@@@@@@@@@@@@@@@@@@@T.TTT..TT.....T.........T..T.T.TTT@@@@@
@@@@@@@@@@@@@@@@@@@@@@@@@@@@@@@@@@@@@@@@......T....T.TT...T.TT...TT...T..T@@@@@@
@@@@@@@@@@@@@@@@@@@@@@@@@@@@@@@@@@@@@@@@..T.T.TTTT....TT.T..TT.TT.T......@@@@@@@
@@@@@@@@@@@@@@@@@@@@@@@@@@@@@@@@@@@@@@@@@..TT......TTTT.T.......T....TTT@@@@@@@@
@@@@@@@@@@@@@@@@@@@@@@@@@@@@@@@@@@@@@@@@.T.TT....TT.....T...TT.TTTT..TT@@@@@@@@@
@@@@@@@@@@@@@@@@@@@@@@@@@@@@@@@@@@@@@@.T.T.T...TT.....T.TT....TTT..T..@@@@@@@@@@
@@@@@@@@@@@@@@@@@@@@@@@@@@@@@@@@@@@@TT.T.T.....TTTT...T...T...T.TT...@@@@@@@@@@@
@@@@@@@@@@@@@@@@@@@@@@@@@@@@@@@@@@@TT.....T.TTTT...T.T..T...........@@@@@@@@@@@@
@@@@@@@@@@@@@@@@@@@@@@@@@@@@@@@@@@@T..T......T.......T.TT.TT..T..T.T@@@@@@@@@@@@
@@@@@@@@@@@@@@@@@@@@@@@@@@@@@@@@@@@.......T......T..TT....T.TT..T..@@@@@@@@@@@@@
@@@@@@@@@@@@@@@@@@@@@@@@@@@@@@@@@@@........TTT.TT...T...TTT..T..T.@@@@@@@@@@@@@@
@@@@@@@@@@@@@@@@@@@@@@@@@@@@@@@@@@@T...TTTTT......T.T.T.......TT.@@@@@@@@@@@@@@@
@@@@@@@@@@@@@@@@@@@@@@@@@@@@@@@@@@T...T.TT...T..T.T......T...T..T@@@@@@@@@@@@@@@
@@@@@@@@@@@@@@@@@@@@@@@@@@T@@@@@@...T.T.TT...TT.TT...T....TT....@@@@@@@@@@@@@@@@
@@@@@@@@@@@@@@@@@@@@@@@@@T.@@.T....TT.TT....T..T.TT....TT.T..T.@@@@@@@@@@@@@@@@@
@@@@@@@@@@@@@@@@@@@@@@@@.TT...TT...TT..T.T.TTTT.TT.TT.......TT@@@@@@@@@@@@@@@@@@
@@@@@@@@@@@@@@@@@@@@@@@@.TT..T..TTTT.TTT....T..TT...TTT..TT..@@@@@@@@@@@@@@@@@@@
@@@@@@@@@@@@@@@@@@@@@@@@.TT.TT.....T....T.TTT....T..T..TTT..@@@@@@@@@@@@@@@@@@@@
@@@@@@@@@@@@@@@@@@@@@@@T..T..TT...T....TTTT..........T...T.@@@@@@@@@@@@@@@@@@@@@
@@@@@@@@@@@@@@@@@@@@@@.TTT..T...TT...T...T.T......T.T.T.T.@@@@@@@@@@@@@@@@@@@@@@
@@@@@@@@@@@@@@@@@@@@@@@@...TTT.T.T.T..TT..TT....T.TTT...T@@@@@@@@@@@@@@@@@@@@@@@
@@@@@@@@@@@@@@@@@@@@@@@@@..T...T......T....T.T...T..T.T.@@@@@@@@@@@@@@@@@@@@@@@@
@@@@@@@@@@@@@T@@@@@@@@@@...T.T.TT...TT..TT.....TT.T.T..@@@@@@@@@@@@@@@@@@@@@@@@@
@@@@@@@@@@@@T.@@@@@@@@@@@.TTTTT...TT.T.TT..T........T.@@@@@@@@@@@@@@@@@@@@@@@@@@
@@@@@@@@@@@...@@@@@@@@@@@.TT..TT.TT.....T.TT.....TT..@@@@@@@@@@@@@@@@@@@@@@@@@@@
@@@@@@@@@@@@.T@@@@@@TTTTTTTT.T..T............T....TT.@@@@@@@@@@@@@@@@@@@@@@@@@@@
@@@@@@@@@@@@TT@@@@@......TTT..TT...T..T.T.T.T.TT....@@@@@@@@@@@@@@@@@@@@@@@@@@@@
@@@@@@@@@@@...T.@@@TTTT.T.T.T..T..T.T..TT.T.T..T.T.@@@@@@@@@@@@@@@@@@@@@@@@@@@@@
@@@@@@@@@@.T.T.TT..TTT..T...T.TTTTT....T..TT..T..T@@@@@@@@@@@@@@@@@@@@@@@@@@@@@@
@@@@@@@@@..T....TT..T...T...T..TT....TTTT...T..TT@@@@@@@@@@@@@@@@@@@@@@@@@@@@@@@
@@@@@@@@@@T.T..TT..T.T..TTT..TTTTT...TT.T...TT.T@@@@@@@@@@@@@@@@@@@@@@@@@@@@@@@@
@@@@@@@@@@@@..T.....TTT.T..T.T.T.TTT.T.......TT@@@@@@@@@@@@@@@@@@@@@@@@@@@@@@@@@
@@@@@@@@@@@@.TT......T.TT.T.T..T.T..TT.T.T..TT@@@@@@@@@@@@@@@@@@@@@@@@@@@@@@@@@@
@@@@@@@@@@@@TTTTTT.TTTTT..T....TT.T.T..T....T@@@@@@@@@@@@@@@@@@@@@@@@@@@@@@@@@@@
@@@@@@@@@@@@T.TTTTTT....T..TTT.TTT.TTT...TT.@@@@@@@@@@@@@@@@@@@@@@@@@@@@@@@@@@@@
@@@@@@@@@@@@T..T..T......T.TTT.....TTTT...T.@@@@@@@@@@@@@@@@@@@@@@@@@@@@@@@@@@@@
@@@@@@@@@@@@..T.............T....T..T......@@@@@@@@@@@@@@@@@@@@@@@@@@@@@@@@@@@@@
@@@@@@@@@@@@..T...T...TTTT.T.T.T.T.T..T..T@@@@@@@@@@@@@@@@@@@@@@@@@@@@@@@@@@@@@@
@@@@@@@@.@@....T.T.TT...T..T......TT.....@@@@@@@@@@@@@@@@@@@@@@@@@@@@@@@@@@@@@@@
@@@@@@@@T@@TTT.TTT...TT....T.T...TTT..T.@@@@@@@@@@@@@@@@@@@@@@@@@@@@@@@@@@@@@@@@
@@@@@.@@.@@...TT.T.....T.T......TTT.TT.@@@@@@@@@@@@@@@@@@@@@@@@@@@@@@@@@@@@@@@@@
@@@@..@@.@@TTT...TT.TT.T....T..T.T....@@@@@@@@@@@@@@@@@@@@@@@@@@@@@@@@@@@@@@@@@@
@@@@.TT...T..TTTT.TTT...T......T.....T@@@@@@@@@@@@@@@@@@@@@@@@@@@@@@@@@@@@@@@@@@
@@@@........TTT..T..T.......TTTT....T@@@@@@@@@@@@@@@@@@@@@@@@@@@@@@@@@@@@@@@@@@@
@@@@..TT....T..TTT.TT..T.T..T.T.T...@@@@@@@@@@@@@@@@@@@@@@@@@@@@@@@@@@@@@@@@@@@@
@@@@@T..T.T..T....T.TT..TTT.....T...@@@@@@@@@@@@@@@@@@@@@@@@@@@@@@@@@@@@@@@@@@@@
@@@@@@T.....T.TT..T..TT.T.T....TTTT@@@@@@@@@@@@@@@@@@@@@@@@@@@@@@@@@@@@@@@@@@@@@
@@@@@@@..T.T..T...T.TT...TTTTT....@@@@@@@@@@@@@@@@@@@@@@@@@@@@@@@@@@@@@@@@@@@@@@
@@@@@@@..T....T.TTT.T.T..TTT...T.T@@@@@@@@@@@@@@@@@@@@@@@@@@@@@@@@@@@@@@@@@@@@@@
@@@@@@@.TTT..T..T...T.T..TTTT....@@@@@@@@@@@@@@@@@@@@@@@@@@@@@@@@@@@@@@@@@@@@@@@
@@@@@@@T...TT.T.T.TTT.T.TT.T..T.@@@@@@@@@@@@@@@@@@@@@@@@@@@@@@@@@@@@@@@@@@@@@@@@
@@@@@@@..T.....T..T....T.T.T.T.@@@@@@@@@@@@@@@@@@@@@@@@@@@@@@@@@@@@@@@@@@@@@@@@@
@@@@@@@@TT.....T...TT.T...T..T.@@@@@@@@@@@@@@@@@@@@@@@@@@@@@@@@@@@@@@@@@@@@@@@@@
@@@@@@@@@.T.T..T.T.TT...........@@@@@@@@@@@@@@@@@@@@@@@@@@@@@@@@@@@@@@@@@@@@@@@@
@@@@@@@@@@TTT..TTTT..TT.....T..TT@@@@@@@@@@@@@@@@@@@@@@@@@@@@@@@@@@@@@@@@@@@@@@@
@@@@@@@@@@@TTT..TT..TTT......T..T.@@@@@@@@@@@@@@@@@@@@@@@@@@@@@@@@@@@@@@@@@@@@@@
@@@@@@@@@@@@T..TT..T.T..TTTTT.T.T@@@@@@@@@@@@@@@@@@@@@@@@@@@@@@@@@@@@@@@@@@@@@@@
@@@@@@@@@@@@@TTT.@TTTTTTT.TT.T...@@@@@@@@@@@@@@@@@@@@@@@@@@@@@@@@@@@@@@@@@@@@@@@
@@@@@@@@@@@@@@.T@@@.T.TTT....T..@@@@@@@@@@@@@@@@@@@@@@@@@@@@@@@@@@@@@@@@@@@@@@@@
@@@@@@@@@@@@@@@..@T.........TTTT.@@@@@@@@@@@@@@@@@@@@@@@@@@@@@@@@@@@@@@@@@@@@@@@
@@@@@@@@@@@@@@@@@@@@@@@@@@@@@@@@@@@@@@@@@@@@@@@@@@@@@@@@@@@@@@@@@@@@@@@@@@@@@@@@
@@@@@@@@@@@@@@@@@@@@@@@@@@@@@@@@@@@@@@@@@@@@@@@@@@@@@@@@@@@@@@@@@@@@@@@@@@@@@@@@
