type octile
height 80
width 80
map
@@@@@@@@@@@@@@@@@@@@@@@@@@@@@@@@@@@@@@@@@@@@@@@@@@@@@@@@@@@@@@@@@@@@@@@@@@@@@@@@
@@@@@@@@@@@@@@@@@@@@@@@@@@@@@@@@@@@@@@@@@@@@@@@@@@@@@@@@@@@@@@@@@@@@@@@@@@@@@@@@
@@@@@@@@@@@@@@@@@@@@@@@@@@@@@@@@@@@@@@@@@@@@@@@@@@@@@@.TT.........T..T.TT..TT.@@
@@@@@@@@@@@@@@@@@@@@@@@@@@@@@@@@@@@@@@@@@@@@@@@@@@@@@@T..T..T.....T......T.T.T@@
@@@@@@@@@@@@@@@@@@@@@@@@@@@@@@@@@@@@@@@@@@@@@@@@@@@@@T.TTTT...T..T...T..T.T..T@@
@@@@@@@@@@@@@@@@@@@@@@@@@@@@@@@@@@@@@@@@@@@@@@@@@@@@.T..T.T.T......T..T.T..TTT@@
@@@@@@@@@@@@@@@@@@@@@@@@@@@@@@@@@@@@@@@@@@@@@@@@@@@T..T.T.T....TT.........TT.T@@
@@@@@@@@@@@@@@@@@@@@@@@@@@@@@@@@@@@@@@@@@@@@@@@@@@@@.T.T....T....TTTTT..T.TTT.@@
@@@@@@@@@@@@@@@@@@@@@@@@@@@@@@@@@@@@@@@@@@@@@@@@@@@@@...T.T.T....TT..T.T..T...@@
@@@@@@@@@@@@@@@@@@@@@@@@@@@@@@@@@@@@@@@@@@@@@@@@@@@@@....T.T...T.TTT...TT..T..@@
@@@@@@@@@@@@@@@@@@@@@@@@@@@@@@@@@@@@@@@@@@@@@@@@@@@@@.T..TTT........T..T.T...T@@
@@@@@@@@@@@@@@@@@@@@@@@@@@@@@@@@@@@@@@@@@@@@@@@@@@@@..........T..TT..T..T.TT..@@
@@@@@@@@@@@@@@@@@@@@@@@@@@@@@@@@@@@@@@@@@@@@@@@@@@....T.......T..TT..T.T.TTT.T@@
@@@@@@@@@@@@@@@@@@@@@@@@@@@@@@@@@@@@@@@@@@@@@@@@@@@.T..TT..T....T...TTTT...T.T@@
@@@@@@@@@@@@@@@@@@@@@@@@@@@@@@@@@@@@@T.@@@@@@@@@@@@T..T.TT....T..T.T....T.....@@
@@@@@@@@@@@@@@@@@@@@@@@@@@@@@@@@@@@@.T.@@@@@@@@@TTT..TTTT..T......T@@T.TT..TT.@@
@@@@@@@@@@@@@@@@@@@@@@@@@@@@@@@@@@@@T.T.@@@@@@@..TT.....T.T......@@@@T.......T@@
@@@@@@@@@@@@@@@@@@@@@@@@@@@@@@@@@@@T.TT.@@T.....T.T..T.T.T...T.@@@@@@@TT.TTT.T@@
@@@@@@@@@@@@@@@@@@@@@@@@@@@@@@@@@@T..T.T...T..T..TT.T...T.TT.T@@@@@@@@TT....T.@@
@@@@@@@@@@@@@@@@@@@@@@@@@@@@@@@@@@T@@T....TT..TTT.T..T.T..TT.T@@@@@@@@@.....TT@@
@@@@@@@@@@@@@@@@@@@@@@@@@@@@@@@@@@@@@...TT.TTTT.T...T..TT..TTT.@@@@@@@@.T....T@@
@@@@@@@@@@@@@@@@@@@@@@@@@@@@@@@@@@@@@@.TT.T.T.TTTT.T..TT...T.TT@@@@@@@@.T..T..@@
@@@@@@@@@@@@@@@@@@@@@@@@@@@@@@@@@@@@T.....T..T..TTTT.T.T.TTT...@@@@@@@..TT..TT@@
@@@@@@@@@@@@@@@@@@@@@@@@@@@@@@@@@@@@..T..T.TT...T.TT..T.T.TTT.TT@@@@@T.......T@@
@@@@@@@@@@@@@@@@@@@@@@@@@@@@@@@@@@@@T..TTTTTTTT.T.T..T..T..T.T..T@TTTT....T..T@@
@@@@@@@@@@@@@@@@@@@@@@@@@@@@@@@@@@.TT.T.T..T.TTT..T.T..T..TT.TTTT........T.TT.@@
@@@@@@@@@@@@@@@@@@@@@@@@@@@@@@@@@@T...TT....TTT...TTTTT....TT...T..T..T.TT..T@@@
@@@@@@@@@@@@@@@@@@@@@@@@@@@@@@@@@@TT.........TTTTT..TTT.T...T...T...TT...TTT@@@@
@@@@@@@@@@@@@@@@@@@@@@@@@@@@@@@@@@.T.......T..T.TT..TTT..TT..TT..TT..T.TT..@@@@@
@@@@@@@@@@@@@@@@@@@@@@TT...@@@@@@.T..T..T..T.T..TTT.TT.T.T.TTTT...TT...T.@@@@@@@
@@@@@@@@@@@@@@@@@@@@@..T.T.@@@@@@T..TT.TT..T.T...T..T...TT.T.TTT.T.T..TT@@@@@@@@
@@@@@@@@@@@@@@@@.@@@.T....T.T..T..TT..T....T....TT...TT...TT.T.TT..T.TT@@@@@@@@@
@@@@@@@@@@@@@@@..T.TT...TT..T.T..T.T.TTTT......T.......T.....T...TTT..T@@@@@@@@@
@@@@@@@@@@@@@TT.T..T...T..TT.T..T.T...T..T..TTT.TT.T.T..TTTTTTTT....T.@@@@@@@@@@
@@@@@@@@@@@@..T...T..T.T...TT....TTT.TT.T.T.T...T.T...TT.....TT..TTTT@@@@@@@@@@@
@@@@@@@@@@@....T.TT.T...T...T.TT..TT....T..T.....T...T...TT.......T.@@@@@@@@@@@@
@@@@@@@@@@TT..T..T.TT.....TTT..TTT..T..T....TT.T...T..T....T..T..T.@@@@@@@@@@@@@
@@@@@@@@@.T...T.T..T..T.....T...T..TT.TT.T..T....T.T.....TT..T.T..@@@@@@@@@@@@@@
@@@@@@@@........T.......TTT.T..T.T...TT..TTTTT......TTT...TTT....@@@@@@@@@@@@@@@
@@@@@@TTT...T....T@@@@@@@...T..TTT.T.T..TTTT.T..TT.TTT.T..TTT....@@@@@@@@@@@@@@@
@@@@@TT...TTT.T..@@@@@@@@T......TT.TT...TTT...T..T.TTT..T.TT.T..@@@@@@@@@@@@@@@@
@@@@T..T.....T...@@@@@@@@T..T.T.T..TT.T.TT...TT.T.....TT.....T.@@@@@@@@@@@@@@@@@
@@@.TT...T.TT..TT.@@@@@@@TTT.TT.T......TTT...T..T..TTT..TT....@@@@@@@@@@@@@@@@@@
@@TT.T.T.TT..T....@@@@@T..TT.T.T.TT....TTTT.T..T..T...TT...T.@@@@@@@@@@@@@@@@@@@
@@..T.....TTTT.TTT..@@.T.TT..T..T.........T.....T..T........@@@@@@@@@@@@@@@@@@@@
@@.TTTTT..T....T.T.....T........TT..T...T..T....T.T.T..T..T@@@@@@@@@@@@@@@@@@@@@
@@.T.T.@....TT.T....TT..T.T...TTT..TT......TT......T.TT.TT@@@@@@@@@@@@@@@@@@@@@@
@@TT.T@@@@T.T.TT...T...T...T.T....T...T..T.TT........T.T@@@@@@@@@@@@@@@@@@@@@@@@
@@T.@@@@@@@@..TT..T..T...T.TT.T..T....T..TTTTT...TTTTT.@@@@@@@@@@@@@@@@@@@@@@@@@
@@.@@@@@@@@@@TT..T.T..T.T.TTTT.T.....TT.TT.T.T.TTTTT.T@@@@@@@@@@@@@@@@@@@@@@@@@@
@@@@@@@@@@@@@@TT...TTT..T.T.T...T..........T.TT.T.TT@@@@@@@@@@@@@@@@@@@@@@@@@@@@
@@@@@@@@@@@@@@@.T.TT.T...TTT...TTT.T.T.T......TTT..@@@@@@@@@@@@@@@@@@@@@@@@@@@@@
@@@@@@@@@@@@@@@@.T.TT.TT...T.T.T.T...TT.TT..TT.T.T@@@@@@@@@@@@@@@@@@@@@@@@@@@@@@
@@@@@@@@@@@@@@@@@...T...TT...T.T...TTTTT.T.T.T..T@@@@@@@@@@@@@@@@@@@@@@@@@@@@@@@
@@@@@@@@@@@@@@@@@@T....TTT.TTTT....TTTTTT.TTT.T.@@@@@@@@@@@@@@@@@@@@@@@@@@@@@@@@
@@@@@@@@@@@@@@@@@@@...T.....T...T.T..T.....TT.T@@@@@@@@@@@@@@@@@@@@@@@@@@@@@@@@@
@@@@@@@@@@@@@@@@@@@@....TT....T.........T.T...@@@@@@@@@@@@@@@@@@@@@@@@@@@@@@@@@@
@@@@@@@@@@@@@@@@@@@@@T...T...T.T.TTT...T......@@@@@@@@@@@@@@@@@@@@@@@@@@@@@@@@@@
@@@@@@@@@@@@@@@@@@@@@@T..TT.T...TTTTT.TT...TT@@@@@@@@@@@@@@@@@@@@@@@@@@@@@@@@@@@
@@@@@@@@@@@@@@@@@@@@@@@T..T.T.T.....T.TT....@@@@@@@@@@@@@@@@@@@@@@@@@@@@@@@@@@@@
@@@@@@@@@@@@@@@@@@@@@@@@.T.T......TT.TTTT.T@@@@@@@@@@@@@@@@@@@@@@@@@@@@@@@@@@@@@
@@@@@@@@@@@@@@@@@@@@@@@@@..TT....TT..TT..T@@@@@@@@@@@@@@@@@@@@@@@@@@@@@@@@@@@@@@
@@@@@@@@@@@@@@@@@@@@@@@@@.TT..T.T..T.....@@@@@@@@@@@@@@@@@@@@@@@@@@@@@@@@@@@@@@@
@@@@@@@@@@@@@@@@@@@@@@@@@.TT..TT.T...TTT@@@@@@@@@@@@@@@@@@@@@@@@@@@@@@@@@@@@@@@@
@@@@@@@@@@@@@@@@@@@@@@@@@..TT.TTTT..T..@@@@@@@@@@@@@@@@@@@@@@@@@@@@@@@@@@@@@@@@@
@@@@@@@@@@@@@@@@@@@@@@@@@@TT.TTT.T....@@@@@@@@@@@@@@@@@@@@@@@@@@@@@@@@@@@@@@@@@@
@@@@@@@@@@@@@@@@@@@@@@@@@@@...TT.T....@@@@@@@@@@@@@@@@@@@@@@@@@@@@@@@@@@@@@@@@@@
@@@@@@@@@@@@@@@@@@@@@@@@@@@@.TT.TTT.T.@@@@@@@@@@@@@@@@@@@@@@@@@@@@@@@@@@@@@@@@@@
@@@@@@@@@@@@@@@@@@@@@@@@@@@@@T.T.TT..T@@@@@@@@@@@@@@@@@@@@@@@@@@@@@@@@@@@@@@@@@@
@@@@@@@@@@@@@@@@@@@@@@@@@@@@@@.....T.T.@@@@@@@@@@@@@@@@@@@@@@@@@@@@@@@@@@@@@@@@@
@@@@@@@@@@@@@@@@@@@@@@@@@@@@@@@@TTT.T...@@@@@@@@@@@@@@@@@@@@@@@@@@@@@@@@@@@@@@@@
@@@@@@@@@@@@@@@@@@@@@@@@@@@@@@@@@TT...T.T@@@@@@@@.T@@@@@@@@@@@@@@@@@@@@@@@@@@@@@
@@@@@@@@@@@@@@@@@@@@@@@@@@@@@@@@@@...T.T..@@@@@@TT.T@@@@@@@@@@@@@@@@@@@@@@@@@@@@
@@@@@@@@@@@@@@@@@@@@@@@@@@@@@@@@@@@TT..TT..@@@@TT....@@@@@@@@@@@@@@@@@@@@@@@@@@@
@@@@@@@@@@@@@@@@@@@@@@@@@@@@@@@@@@@@.TT.....@@T...T..@@@@@@@@@@@@@@@@@@@@@@@@@@@
@@@@@@@@@@@@@@@@@@@@@@@@@@@@@@@@@@@@@TT.TT...T..TTT.T@@@@@@@@@@@@@@@@@@@@@@@@@@@
@@@@@@@@@@@@@@@@@@@@@@@@@@@@@@@@@@@@@@..T..T.TTT.TTT.T@@@@@@@@@@@@@@@@@@@@@@@@@@
@@@@@@@@@@@@@@@@@@@@@@@@@@@@@@@@@@@@@@@@T.T..T.........@@@@@@@@@@@@@@@@@@@@@@@@@
@@@@@@@@@@@@@@@@@@@@@@@@@@@@@@@@@@@@@@@@@@@@@@@@@@@@@@@@@@@@@@@@@@@@@@@@@@@@@@@@
@@@@@@@@@@@@@@@@@@@@@@@@@@@@@@@@@@@@@@@@@@@@@@@@@@@@@@@@@@@@@@@@@@@@@@@@@@@@@@@@
