type octile
height 64
width 60
map
@@@@@@@@@@@@@@@@@@@@@@@@@@@@@@@@@@@@@@@@@@@@@@@@@@@@@@@@@@@@
@@@@@@@@@@@@@@@@@@@@@@@@@@@@@@@@@@@@@@@@@@@@@@@@@@@@@@@@@@@@
@@@@@@@@@@@@@@@@@@@@@@@@@@@@@@@@@@@@@@@@@@@@@@@@@@@@@@@@@@@@
@@@@@@@@@@@@@@@@@@@@@@@@@@@@@@@@@@@@@@@@@@@@@@@@@@@@@@@@@@@@
@@@@@@@@@@@@@@@@@@@@@@@@@@@@@@@@@@@@@@@@@@@@@@@@@@@@@@@@@@@@
@@@@@@@@@@@@@@@@@@@@@@@@@@@@@@@@@@@@@@@@@@@@@@@@@@@@@@@@@@@@
@@@@@@@@@@@@@@@@@@@@@@@@@@@@@@@@@@@@@@@@@@@@@@@@@@@@@@@@@@@@
@@@@@@@@@@@@@@@@@@@@@@@@@@@@@@@@@@@@@@@@@@@@@@@@@@@@@@@@@@@@
@@@@@@@@@@@@@@@@@@@@@@@@@@@@@@@@@@@@@@@@@@@@@@@@@@@@@@@@@@@@
@@@@@@@@@@@@@@@@@@@@@@@@@@@@@@@@@@@@@@@@@@@@@@@@@@@@@@@@@@@@
@@@@@@@@@@@@@@@@@@@@@@@@@@@@@@@@@@@@@@@@@@@@@@@@@@@@@@@@@@@@
@@@@@@@@@@@@@@@@@@@@@@@@@@@@@@@@@@@@@@@@@@@@@@@@@@@@@@@@@@@@
@@@@@@@@@@@@@@@@@@@@@@@@@@@@@@@@@@@@@@@@@@@@@@@@@@@@@@@@@@@@
@@@@@@@@@@@@@@@@@@@@@@@@@@@@@@@@@@@@@TTT@@@@@@@@@@@@@@@@@@@@
@@@@@@@@@@@@@@@@@@@@@@@@@@@@@@@@@@@@@@@TT@@@@@@@@@@@@@@@@@@@
@@@@@@@@@@@@@@@@@@@@@@@@@@@@@@@@@@T@@@@@..@@@@@@@@@@@@@@@@@@
@@@@@@@@@@@@@@@@@@@@@@@@@@@@@@@@@T..@@@@@.T@@@@@@@@@@@@@@@@@
@@@@@@@@@@@@@@@@@@@@@@@@@@@@@@@@..TTT@@@@@..@@@@@@@@@@@@@@@@
@@@@@@@@@@@@@@@@@@@@@@@@@@@@@@@....T.@@@@@..T@@@@@@@@@@@@@@@
@@@@@@@@@@@@@@@@@@@@@@@@@@@@@@@@@....@@@@T.T.T..@@@@@@@@@@@@
@@@@@@@@@@@@@@@@@@@@@@@@@@@@@@@@@T..T..TT.TT..@TT@@@@@@@@@@@
@@@@@@@@@@@@@@@@@@@@@@@@@@@@@@@.T.....T......@@@TT@@@@@@@@@@
@@@@@@@@@@@@@@@@@@@@@@@@@@@@@@...TT..TT..T.T@@@TT..@@@@@@@@@
@@@@@@@@@@@@@@@@@@@@@@@@@@@@@..T..T.T.T....@@@@@..T.@@@@@@@@
@@@@@@@@@@@@@@@@@@@@@@@@@@..@@....T...T..T.@@@@@@@@T.@@@@@@@
@@@@@@@@@@@@@@@@@@@@@@@.@@T@@@.T.T.TTT....@@@@@@@@@TT.@@@@@@
@@@@@@@@@@@@@@@@@@@@@@@.TT...T.TT..T......@@@.@@....TT.@@@@@
@@@@@@@@@@@@@@@@@@@@@@T..TTT..T....@@@.T.T...T....TTTT.T@@@@
@@@@@@@@@@@@@@@@@@@@T..........TT..@@@T...........TT....@@@@
@@@@@@@@@@@@@@@@@@@....T.T.T........T.....T.TT.TT...T.T@@@@@
@@@@@@@@@@@@@@@@@@..T..@@..T..T...TT..T....TT.T.TT....@@@@@@
@@@@@@@@@@@@@@@@@.....@@@@T.@@.TT..T...T.TT..TT.T.TTT@@@@@@@
@@@@@@@@@@@@@@@@@.TT.@@@@@@@@@.TT...T.....TT.T...T.T@@@@@@@@
@@@@@@@@@@@@@@@@..T@@@@@@@@@.T.T..T...TTTTTT.T.T..T@@@@@@@@@
@@@@@@@@@@@@@@@T..@@@@@@@@@@@.T@@..T.T.TT....TT..T@@@@@@@@@@
@@@@@@@@@@@@@@TT...@@@@@@@@@@@@@@..TT.TTT.T.TT..T@@@@@@@@@@@
@@@@@@@@@@@@@T.....@@@@@@@@@@@@.T....TTT........@@@@@@@@@@@@
@@@@@@@@@@@.TT...T..@..@@@@@@@@@.....T..TTT....@@@@@@@@@@@@@
@@@@@@@@@@@T.T.T.T....TT@@@@@@@@@T.TTTT.TT.TTT@@@@@@@@@@@@@@
@@@@@@@@@@@@.T...TTT.T..@@@@@@@@@@T.....T....@@@@@@@@@@@@@@@
@@@@@@@@@@@....T.T..T...@@@@@@@@TT..T.......@@@@@@@@@@@@@@@@
@@@@@@@.@@TTT.....T.T.T@@@@@@@@...TT.T..T..@@@@@@@@@@@@@@@@@
@@@@@@.TT..T....T..TTT@@@@@@@@....T..T....@@@@@@@@@@@@@@@@@@
@@@@@T.T.T.TT..T.T.T.@@@@@@@@@@...TT...T.@@@@@@@@@@@@@@@@@@@
@@@@.T.TT.....T..T.T@@@@@@@@@@.TT...T.TT@@@@@@@@@@@@@@@@@@@@
@@@@T..T.TT.TT.TT..@@@@@@@@T.TT.T.T..T.@@@@@@@@@@@@@@@@@@@@@
@@@@@.T.TT...TT...@@@@@@@@@@..T.TTT..T@@@@@@@@@@@@@@@@@@@@@@
@@@@@@TTT..TT...T@@@@@@@@.@....TT..T.@@@@@@@@@@@@@@@@@@@@@@@
@@@@@@@..T..T.TT@@@@@@@@.....T.T..TT@@@@@@@@@@@@@@@@@@@@@@@@
@@@@@@@@.......@@@@@@@@....T...TT.T@@@@@@@@@@@@@@@@@@@@@@@@@
@@@@@@@@@T....@@@@@@@@@.......TT.T@@@@@@@@@@@@@@@@@@@@@@@@@@
@@@@@@@@@@...TT@@@@@@@....TT.T...@@@@@@@@@@@@@@@@@@@@@@@@@@@
@@@@@@@@@@@.TT..@@@@T.....T.....@@@@@@@@@@@@@@@@@@@@@@@@@@@@
@@@@@@@@@@@@T.T..@@.T.TT..TT..T@@@@@@@@@@@@@@@@@@@@@@@@@@@@@
@@@@@@@@@@@@@.T.T..TTTTTT.T...@@@@@@@@@@@@@@@@@@@@@@@@@@@@@@
@@@@@@@@@@@@@@..T..T.TTT..T.@@@@@@@@@@@@@@@@@@@@@@@@@@@@@@@@
@@@@@@@@@@@@@@@...T..T.T.T.@@@@@@@@@@@@@@@@@@@@@@@@@@@@@@@@@
@@@@@@@@@@@@@@@@...TTT.TT.@@@@@@@@@@@@@@@@@@@@@@@@@@@@@@@@@@
@@@@@@@@@@@@@@@@@.TTT.T..@@@@@@@@@@@@@@@@@@@@@@@@@@@@@@@@@@@
@@@@@@@@@@@@@@@@@@@T.TT.@@@@@@@@@@@@@@@@@@@@@@@@@@@@@@@@@@@@
@@@@@@@@@@@@@@@@@@@@T.T@@@@@@@@@@@@@@@@@@@@@@@@@@@@@@@@@@@@@
@@@@@@@@@@@@@@@@@@@@@@@@@@@@@@@@@@@@@@@@@@@@@@@@@@@@@@@@@@@@
@@@@@@@@@@@@@@@@@@@@@@@@@@@@@@@@@@@@@@@@@@@@@@@@@@@@@@@@@@@@
@@@@@@@@@@@@@@@@@@@@@@@@@@@@@@@@@@@@@@@@@@@@@@@@@@@@@@@@@@@@
