type octile
height 70
width 64
map
@@@@@@@@@@@@@@@@@@@@@@@@@@@@@@@@@@@@@@@@@@@@@@@@@@@@@@@@@@@@@@@@
@@@@@@@@@@@@@@@@@@@@@@@@@@@@@@@@@@@@@@@@@@@@@@@@@@@@@@@@@@@@@@@@
@@@@@@@@@@@@@@@@@@@@@@@@@@@@@@@@@@@@@@@@@@@@@@@@@@@@@@@@@@@@@@@@
@@@@@@@@@@@@@@@@@@@@@@@@@@@@@@@@@@@@@@@@@@@@@@@@@@@@@@@@@@@@@@@@
@@@@@@@@@@@@@@@@@@@@@@@@@@@@@@@@@@@@@@@@@@@@@@@@@@@@@@@@@@@@@@@@
@@@@@@@@@@@@@@@@@@@@@@@@@@@@@@@@@@@@@@@@@@@@@@@@@@@@@@@@@@@@@@@@
@@@@@@@@@@@@@@@@@@@@@@@@@@@@@@@@@@@@@@@@@@@@@@@@@@@@@@@@@@@@@@@@
@@@@@@@@@@@@@@@@@@@@@@@@@@@@@@@@@@@@@@@@@@@@@@@@@@@@@@@@@@@@@@@@
@@@@@@@@@@@@@@@@@@@@@@@@@@@@@@@@@@@@@@@@@@@@@@@@@@@@@@@@@@@@@@@@
@@@@@@@@@@@@@@@@@@@@@@@@@@@@@@@@@@@@@@@@@@@@@@@@@@@@@@@@@@@@@@@@
@@@@@@@@@@@@@@@@@@@@@@@@@@@@@@@@@@@@@@@@@@@@@@@@@@@@@@@@@@@@@@@@
@@@@@@@@@@@@@@@@@@@@@@@@@@@@@@@@@@@@@@@@@@@@@@@@@@@@@@@@@@@@@@@@
@@@@@@@@@@@@@@@@@@@@@@@@@@@@@@@@@@@@@@@@@@@@@@@@@@@@@@@@@@@@@@@@
@@@@@@@@@@@@@@@@@@@@@@@@@@@@@@@@@@@@@@@@@@@@@@@@@@@@@@@@@@@@@@@@
@@@@@@@@@@@@@@@@@@@@@@@@@@@@@@@@@@@@@@@@@@@@@@@@@@@@@@@@@@@@@@@@
@@@@@@@@@@@@@@@@@@@@@@@@@@@@@@@@@.@@@@@@@@@@@@@@@@@@@@@@@@@@@@@@
@@@@@@@@@@@@@@@@@@@@@@@@@@@@@@@@..T@@@@@@@@@@@@@@@@@@@@@@@@@@@@@
@@@@@@@@@@@@@@@@@@@@@@@@@@@@@@@@@...@@@@@@.T@@@@@@@@@@@@@@@@@@@@
@@@@@@@@@@@@@@@@@@@@@@@@@@@@@@@@@@T..@@@@.TT.@@@@@@@@@@@@@@@@@@@
@@@@@@@@@@@@@@@@@@@@@@@@@@@@@@@@@@@.TT@@.T.TT@@@@@@@@@@@@@@@@@@@
@@@@@@@@@@@@@@@@@@@@@@@@@@@@.@@..@@@.TT.T.TT.@@@@@@@@@@@@@@@@@@@
@@@@@@@@@@@@@@@@@@@@@@@@@@@@T.@TT@@@@....TT..TTT@@@@@@@@@@@@@@@@
@@@@@@@@@@@@@@@@@@@@@@@@@@@@T..TT..T.TTTT..T..TT.@@@@@@@@@@@@@@@
@@@@@@@@@@@@@@@@@@@@@@@@@@@@@.T....T..TT.T.TT.T.TT@@@@@@@@@@@@@@
@@@@@@@@@@@@@@@@@@@@@@@@@@@@@@T..T..T...T..T...T...@@@@@@@@@@@@@
@@@@@@@@@@@@@@@@@@@@@@@@@@@@@@@TTTT....TT..T..TTTTT@@@@@@@@@@@@@
@@@@@@@@@@@@@@@@@@@@@@@@@@@@@@@@.....TT..T.TT..T.T.@@@@@@@@@@@@@
@@@@@@@@@@@@@@@@@@@@@@@T.@@@@@@..T....T...TT......T.TT.@@@@@@@@@
@@@@@@@@@@@@@@@@@@@@@@@@..@@@@..T......T.T..T..TTT.T....@@@@@@@@
@@@@@@@@@@@@@@@@@@@@@@@@@TT@@T...T...T...@T..T.........@@@@@@@@@
@@@@@@@@@@@@@@@@@@@@@@@@@@....TTTTTT..T.@@@T....TT..TT@@@@@@@@@@
@@@@@@@@@@@@@@@@@@@@@@@@@@@...T.T.T..T..@@@..T.....T.@@@@@@@@@@@
@@@@@@@@@@@@@@@@@@@@@@@@@@.TT..T...T..T.@@@T.T.TT...@@@@@@@@@@@@
@@@@@@@@@@@@@@@@@.@@@@@@@.T...TT.T....T.TT..T....T@T.@@@@@@@@@@@
@@@@@@@@@@@@@@@@T.@@@@T@T...T..T.......T..TTTT..T@@@TT@@@@@@@@@@
@@@@@@@@@@@@.@@....@@@..TT....T...TT.....T.T.....@@@@..@@@@@@@@@
@@@@@@@@@@@..@@...T.T...T.TT..T....T.TT.T...T.T.@@@@@@TT@@@@@@@@
@@@@@@@@@@..T.T..TT..T.T......TTT.T...TT..T.T...TT.@@@@T.@@@@@@@
@@@@@@@@@TT...TTT.T.T.TTTT......T.....T.TT....T..TT@@@@@.@@@@@@@
@@@@@@@@TT..TT.T.T.TTTTT.......TT.TT.T..T...@...T.T@@@@@@@@@@@@@
@@@@@@@....TT@....T........T@...T...T......@@@....TT@@@@@@@@@@@@
@@@@@@...TTT@@@.T.T...TT..T@@@.......T....@@@@@.T.TT.@@@@@@@@@@@
@@@@@....T..@@@@.....T.TTTT@@@T....T..TT.@@@@@@@.T...@@@@@@@@@@@
@@@@.TT...T..@@@@T....T..T.@@@.TT..T.T...@@@@@@@@..TT@@@@@@@@@@@
@@@...TT.TTT.@@@@@@@..TT...T.TT..T.TTTT.TT@@@@@@@@..@@@@@@@@@@@@
@@@....T....TT@@@@@@.T...TT...T.....TT@@T.T@@@@@@@@@@@@@@@@@@@@@
@@@@....@TTT.T@@@@@@.T..T..T........T@@@@.TT@@@@@@@@@@@@@@@@@@@@
@@@@@..@@@T..T@@@@TT..T.T.TT.T.T.TT@@@@@@@T..@@@@@@@@@@@@@@@@@@@
@@@@@@...@@T.@@@@....T.....T..TT..@@@@@@@@@T.@@@@@@@@@@@@@@@@@@@
@@@@@@@TT@@@@@@@....TTTT..T.....T@@@@@@@@@@@@@@@@@@@@@@@@@@@@@@@
@@@@@@@@T.T@@@@......TT.TTTT...T.@@@@@@@@@@@@@@@@@@@@@@@@@@@@@@@
@@@@@@@@@.T@@@TTT..TTT@@..T..T.T..T@@@@@@@@@@@@@@@@@@@@@@@@@@@@@
@@@@@@@@@@TTTT..T..T..@@@@@@..TT..T@@@@@@@@@@@@@@@@@@@@@@@@@@@@@
@@@@@@@@@@@TTT..TTT...@@@@@@TT.TTT..T@@@@@@@@@@@@@@@@@@@@@@@@@@@
@@@@@@@@@@@@T.T.TT...T@@@@@@..T..TT..T@@@@@@@@@@@@@@@@@@@@@@@@@@
@@@@@@@@@@@@@..T.TT..@@@@@@@.TTT.T.TT..@@@@@@@@@@@@@@@@@@@@@@@@@
@@@@@@@@@@@@@@.T..T@@@@@@@@.T.T.T.T....@@@@@@@@@@@@@@@@@@@@@@@@@
@@@@@@@@@@@@@@@.T.T@@@...TTT..TT....TT.@@@@@@@@@@@@@@@@@@@@@@@@@
@@@@@@@@@@@@@@@@T.....T.T.TTT.T.T.T..T@@@@@@@@@@@@@@@@@@@@@@@@@@
@@@@@@@@@@@@@@@@@...T.....TT.TTT.T...@@@@@@@@@@@@@@@@@@@@@@@@@@@
@@@@@@@@@@@@@@@@@@......T.....T....T@@@@@@@@@@@@@@@@@@@@@@@@@@@@
@@@@@@@@@@@@@@@@@@@.TTTT.TTT.T.....@@@@@@@@@@@@@@@@@@@@@@@@@@@@@
@@@@@@@@@@@@@@@@@@@@..TT.TT.T.TT.T@@@@@@@@@@@@@@@@@@@@@@@@@@@@@@
@@@@@@@@@@@@@@@@@@@@@.T.T..T...TT@@@@@@@@@@@@@@@@@@@@@@@@@@@@@@@
@@@@@@@@@@@@@@@@@@@@@@TTTT.T...T@@@@@@@@@@@@@@@@@@@@@@@@@@@@@@@@
@@@@@@@@@@@@@@@@@@@@@@@..T..TT.@@@@@@@@@@@@@@@@@@@@@@@@@@@@@@@@@
@@@@@@@@@@@@@@@@@@@@@@@@....T.@@@@@@@@@@@@@@@@@@@@@@@@@@@@@@@@@@
@@@@@@@@@@@@@@@@@@@@@@@@@.TTT@@@@@@@@@@@@@@@@@@@@@@@@@@@@@@@@@@@
@@@@@@@@@@@@@@@@@@@@@@@@@@..@@@@@@@@@@@@@@@@@@@@@@@@@@@@@@@@@@@@
@@@@@@@@@@@@@@@@@@@@@@@@@@@@@@@@@@@@@@@@@@@@@@@@@@@@@@@@@@@@@@@@
