type octile
height 59
width 56
map
@@@@@@@@@@@@@@@@@@@@@@@@@@@@@@@@@@@@@@@@@@@@@@@@@@@@@@@@
@@@@@@@@@@@@@@@@@@@@@@@@@@@@@@@@@@@@@@@@@@@@@@@@@@@@@@@@
@@@@@@@@@@@@@@@@@@@@@@@@@@@@@@@@@@@@@@@@@@@@@@@@@@@@@@@@
@@@@@@@@@@@@@@@@@@@@@@@@@@@@@@@@@@@@@@@@@@@@@@@@@@@@@@@@
@@@@@@@@@@@@@@@@@@@@@@@@@@@@@@@@@@@@@@@@@@@@@@@@@@@@@@@@
@@@@@@@@@@@@@@@@@@@@@@@@@@@@@@@@@@@@@@@@@@@@@@@@@@@@@@@@
@@@@@@@@@@@@@@@@@@@@@@@@@@@@@@@@@@@@@@@@@@@@@@@@@@@@@@@@
@@@@@@@@@@@@@@@@@@@@@T.@@@@@@@@@@@@@@@@@@@@@@@@@@@@@@@@@
@@@@@@@@@@@@@@@@@@@@T.T.@@@@@@@@@@@@@@@@@@@@@@@@@@@@@@@@
@@@@@@@@@@@@@@@@@@@....T.@@@@@@@@@@@@@@@@@@@@@@@@@@@@@@@
@@@@@@@@@@@@@@@@@@TTT..T..@@@@@@@@@@@@@@@@@@@@@@@@@@@@@@
@@@@@@@@@@@@@@@@@.T..TTTT..@@@@@@@@@@@@@@@@@@@@@@@@@@@@@
@@@@@@@@@@@@@@@@.......TT.T@@@@@@@@@@@@@@@@@@@@@@@@@@@@@
@@@@@@@@@@@@@@@....TT...TT@@@@@@@@@@@@@@@@@@@@@@@@@@@@@@
@@@@@@@@@@@@@@@.TTT.TT...@@@@@@@@@@...TT@@@@@@@@@@@@@@@@
@@@@@@@@@@@@@@.TTT.T....@@@@@@@@@@......T@@@@@@@@@@@@@@@
@@@@@@@@@@@@@@......TTT@@@@@@@@@@T.....T...@@@@@@@@@@@@@
@@@@@@@@@@@@@T......TT@@@@@@@@@@T...@T.T..TT@@@@@@@@@@@@
@@@@@@@@@@@@..T.T...T@@@@@@@@@@@@T.@@TT....@@@@@@@@@@@@@
@@@@@@@@@@@TTTTTT...@@@@@@@@@@@@@@@@@@@@@..T..@@@@@@@@@@
@@@@@@@@@@TTTTT.T.T.@@@@@@...T@@@@@@@@@@@T..TTT@@@@@@@@@
@@@@@@@@@TT....T..T@@@@TTT..TTT@@@@@@@@@T....T.T@@@@@@@@
@@@@@@@@@TTTTT.TT.T@@.T.T......T.TT..TT.T.T....T.@@@@@@@
@@@@@@@@@...TT..TT..T...T..TT..T..T.T.T.T......TT@@@@@@@
@@@@@@@@@T.T.....T.TT....T..TTT.....TT.T.T..T..@@@@@@@@@
@@@@@@@.TTTTT....T..T......TT.T.@@@@TTTT.....T@@@@@@@@@@
@@@@@@@TT..T...T.....TT...T@@@@@@@@@@.......TT@@@@@@@@@@
@@@@@@@..TT.........TT..@@@@@@@@@@@@@@.TTTTT.T@@@@@@@@@@
@@@@@@@......T..TT...@@@@@@@@@@@@@@@@@..TTT...@@@@@@@@@@
@@@@@@@..T.T..T...T.@@@@@@@@@@@@@@@@@@@....T..@@@@@@@@@@
@@@@@@@T.T.....T...@@@@@@@@@@@@@@@@@@@@TTT..T.@@@@@@@@@@
@@@@@@@.TTT.T.@@TT.@@@@@@@@@@@@@@@@@@@@TTTT.TTT@@@@@@@@@
@@@@@@@...@@@@@@.TT@@@@@@@@@@@@@@@@@@@@@T....T.@@@@@@@@@
@@@@@@@T.@@@@@@@@.@@@@@@@@@@@@@@@@@@@@@@.T.TTT.@@@@@@@@@
@@@@@@@.TT.@@@@@@.@@@@@@@@@@@@@@@@@@@@@@T.TTTTTTT...@@@@
@@@@@@.T.TTT@@@@@T@@@@@@@@@@@@@@@@@@@@@@..T...TT.T..@@@@
@@@@@@...T..T@@@@.@@@@@@@@@@@@@@@@@@@@@@T...T.T.T..T@@@@
@@@@@@TT.T..T.@@@.@@@@@@@@@@@@@@@@@@@@@@...TT.T....T@@@@
@@@@@@.T...T..TT...@@@@@@@@@@@@@@@@@@@@.T......T..TT@@@@
@@@@@T.T.T..T..T.TT@@@@@@@@@@@@@@@@@@@@..TTT....TT..@@@@
@@@@@.TT.TT@@@.TT...@@@@@@@@@@@@@@@@@@..T..T.TTTTTTT@@@@
@@@@@TTT.T.@@@@..TT.T@@@@@@@@@@@@@@@@@T.TTT..T.TT...@@@@
@@@@@T..T..T@@@....TT@@@@@@@@@@@@@@@@@.T...TTT....T.@@@@
@@@@@@.......T.TT....TT@@@@@@@@@@@@@@@@..TT.........@@@@
@@@@@@@T..TTT..TTT...T.T@@@@@@@@@@@@@@TTT..........T@@@@
@@@@@@@@TT.T....T.T.TTT..T.@@@@@@@@@.TT.....T.TTTT..@@@@
@@@@@@@@@T.T.TTT.........TT...@@...TTTTTT.TT....TT.@@@@@
@@@@@@@@@@...TT...T.T.....T......T..TTT.T..TT....T@@@@@@
@@@@@@@@@@@..T....T.T..T..TT..T.T.TT......T..TT@T@@@@@@@
@@@@@@@@@@@@@..T.T...TTT..T...TT.TT...TT.TT.T.@@@@@@@@@@
@@@@@@@@@@@@@@@......T.T....T..TTTT.T..T..T.@@@@@@@@@@@@
@@@@@@@@@@@@@@@@T.T.T..T.T...TT......TT...@@@@@@@@@@@@@@
@@@@@@@@@@@@@@@@@T..TT..TT....T......T..@@@@@@@@@@@@@@@@
@@@@@@@@@@@@@@@@@@@TTT.T..TT.TTT...T...@@@@@@@@@@@@@@@@@
@@@@@@@@@@@@@@@@@@@@@@...TT...T.TT..T@@@@@@@@@@@@@@@@@@@
@@@@@@@@@@@@@@@@@@@@@@@@@@@@@@@@@@@@@@@@@@@@@@@@@@@@@@@@
@@@@@@@@@@@@@@@@@@@@@@@@@@@@@@@@@@@@@@@@@@@@@@@@@@@@@@@@
@@@@@@@@@@@@@@@@@@@@@@@@@@@@@@@@@@@@@@@@@@@@@@@@@@@@@@@@
@@@@@@@@@@@@@@@@@@@@@@@@@@@@@@@@@@@@@@@@@@@@@@@@@@@@@@@@
