type octile
height 54
width 52
map
@@@@@@@@@@@@@@@@@@@@@@@@@@@@@@@@@@@@@@@@@@@@@@@@@@@@
@@@@@@@@@@@@@@@@@@@@@@@@@@@@@@@@@@@@@@@@@@@@@@@@@@@@
@@@@@@@@@@@@@@@@@@@@@@@@@@@@@@@@@@@@@@@@@@@@@@@@@@@@
@@@@@@@@@@@@@@@@@@@@@@@@@@@@@@@@@@@@@@@@@@@@@@@@@@@@
@@@@@@@@@@@@@@@@@@@@@@@@@@@@@@@@@@@@@@@@@@@@@@@@@@@@
@@@@@@@@@@@@@@@@@@@@@@@@@@@@@@@@@@@@@@@@@@@@@@@@@@@@
@@@@@@@@@@@@@@@@@@@@@@@@@@@@@@@@@@@@@@@@@@@@@@@@@@@@
@@@@@@@@@@@@@@@@@@@@@@@@@@@@@@@@@@@@@@@@@@@@@@@@@@@@
@@@@@@@@@@@@@@@@@@@@@@@@@@@@@@@@@@@@@@@@@@@@@@@@@@@@
@@@@@@@@@@@@@@@@@@@@@@@@@@@@@@@@@@@@@@@@@@@@@@@@@@@@
@@@@@@@@@@@@@@@@@@@@@@@@@@@@@@@@@@@@@@@@@@@@@@@@@@@@
@@@@@@@@@@@@@@@@@@@@@@@@@@@@@@@.@@@@@@@@@@@@@@@@@@@@
@@@@@@@@@@@@@@@@@@@@@@@@@@@@@@@TT@@@@@@@@@@@@@@@@@@@
@@@@@@@@@@@@@@@@@@@@@@@@@@@@@@@TT.@@@@@@@@@@@@@@@@@@
@@@@@@@@@@@@@@@@@@@@@@@@@@@@@@@@T.T@@@@@@@@@@@@@@@@@
@@@@@@@@@@@@@@@@@@@@@@@@@@@T@@@TT.T@@@@@@@@@@@@@@@@@
@@@@@@@@@@@@@@@@@@@@@@@@@@..TT.TTT@@@@@@@@@@@@@@@@@@
@@@@@@@@@@@@@@@@@@@@@@@@@..T.T.T.@@@@@@@@@@@@@@@@@@@
@@@@@@@@@@@@@@@@@@@@@@@@T.T.T...@@@@@@@@@@@@@@@@@@@@
@@@@@@@@@@@@@@@@@@@@@@@.TTTT...@@@@@@@@@@@@@@@@@@@@@
@@@@@@@@@@@@@@@@@@@@@@TT..TT.T@@@@@@@@.@.@@@@@@@@@@@
@@@@@@@@@@@@@@@@@@@@@@TTTT..T.@@@@@@@TT..T@@@@@@@@@@
@@@@@@@@@@@@@@@@@@@@@@...TT....@@@@@T.T.TT.@@@@@@@@@
@@@@@@@@@@@@@@@@@@@@.T..T...T...@@@.T...T.TT@@@@@@@@
@@@@@@@@@@@@@@@@@@@.T..TTT.T.T.....T....T...T@@@@@@@
@@@@@@@@@@@@@@@@@@.....T..TT...TT.TTT.T.TT.T.@@@@@@@
@@@@@@@@@@@@@@@@...T...T@@@...TT...T...TT..T@@@@@@@@
@@@@@@@@@@@@@@@.T..TTTTT@@@@@..T.....TTT.T.@@@@@@@@@
@@@@@@@@@@@@@@T.TT...T..T@@@@@.T...T.T....@@@@@@@@@@
@@@@@@@@@@@@@..T...@TT..T..@@@.T..TT.TTTT@@@@@@@@@@@
@@@@@@@@@@@TT..T.@@@@.@@@@.@@.....T..T..@@@@@@@@@@@@
@@@@@@@@@@TTT.TT.T@@@@@@@@....T.TTT..T.@@@@@@@@@@@@@
@@@@@@@@@@@@.T..T.@@@@@@@@T.T.T.T..TTT@@@@@@@@@@@@@@
@@@@@@@@@@@@@T..TTT@@@@@@..T.........@@@@@@@@@@@@@@@
@@@@@@@@@@@@@@......@@@@@@..TTTT...T@@@@@@@@@@@@@@@@
@@@@@@@@@@@@@@TTT.T.T@@@@@T.T.T.TT.@@@@@@@@@@@@@@@@@
@@@@@@@@@@@@@.TT..TT.T@@@...TT.T..@@@@@@@@@@@@@@@@@@
@@@@@@@..TT.T..T...TT...T...T....@@@@@@@@@@@@@@@@@@@
@@@@@@@@TTT.TT.....T..T.T.......@@@@@@@@@@@@@@@@@@@@
@@@@@@@@@TTT.....T.....TTTT.TT.@@@@@@@@@@@@@@@@@@@@@
@@@@@@@@@@..TT.T...T..T.T..T..@@@@@@@@@@@@@@@@@@@@@@
@@@@@@@@@@@.T..T.TTT.....T.TT@@@@@@@@@@@@@@@@@@@@@@@
@@@@@@@@@@@@TTT.T....T...T..@@@@@@@@@@@@@@@@@@@@@@@@
@@@@@@@@@@@@@.T..T...TTT.T.@@@@@@@@@@@@@@@@@@@@@@@@@
@@@@@@@@@@@@@@T.....T.TT.T@@@@@@@@@@@@@@@@@@@@@@@@@@
@@@@@@@@@@@@@@@.T..T.T..T@@@@@@@@@@@@@@@@@@@@@@@@@@@
@@@@@@@@@@@@@@@@TTTTTT..@@@@@@@@@@@@@@@@@@@@@@@@@@@@
@@@@@@@@@@@@@@@@@.TTTT.@@@@@@@@@@@@@@@@@@@@@@@@@@@@@
@@@@@@@@@@@@@@@@@@.TT.@@@@@@@@@@@@@@@@@@@@@@@@@@@@@@
@@@@@@@@@@@@@@@@@@@.T@@@@@@@@@@@@@@@@@@@@@@@@@@@@@@@
@@@@@@@@@@@@@@@@@@@@@@@@@@@@@@@@@@@@@@@@@@@@@@@@@@@@
@@@@@@@@@@@@@@@@@@@@@@@@@@@@@@@@@@@@@@@@@@@@@@@@@@@@
@@@@@@@@@@@@@@@@@@@@@@@@@@@@@@@@@@@@@@@@@@@@@@@@@@@@
@@@@@@@@@@@@@@@@@@@@@@@@@@@@@@@@@@@@@@@@@@@@@@@@@@@@
