type octile
height 91
width 84
map
@@@@@@@@@@@@@@@@@@@@@@@@@@@@@@@@@@@@@@@@@@@@@@@@@@@@@@@@@@@@@@@@@@@@@@@@@@@@@@@@@@@@
@@@@@@@@@@@@@@@@@@@@@@@@@@@@@@@@@@@@@@@@@@@@@@@@@@@@@@@@@@@@@@@@@@@@@@@@@@@@@@@@@@@@
@@@@@@@@@@@@@@@@@@@@@@@@@@@@@@@@@@@@@@@@@@@@@@@@@@@@@@@@@@@@@@@@@@@@@@@@@@@@@@@@@@@@
@@@@@@@@@@@@@@@@@@@@@@@@@@@@@@@@@@@@@@@@@@@@@@@@@@@@@@@@@@@@@@@@@@@@@@@@@@@@@@@@@@@@
@@@@@@@@@@@@@@@@@@@@@@@@@@@@@@@@@@@@@@@@@@@@@@@@@@@@@@@@@@@@@@@@@@@@@@@@@@@@@@@@@@@@
@@@@@@@@@@@@@@@@@@@@@@@@@@@@@@@@@@@@@@@@@@@@@@@@@@@@@@@@@@@@@@@@@@@@@@@@@@@@@@@@@@@@
@@@@@@@@@@@@@@@@@@@@@@@@@@@@@@@@@@@@@@@@@@@@@@@@@@@@@@@@@@@@@@@@@@@@@@@@@@@@@@@@@@@@
@@@@@@@@@@@@@@@@@@@@@@@@@@@@@@@@@@@@@@@@@@@@@@@@@@@@@@@@@@@@@@@@@@@@@@@@@@@@@@@@@@@@
@@@@@@@@@@@@@@@@@@@@@@@@@@@@@@@@@@@@@@@@@@@@@@@@@@@@@@@@@@@@@@@@@@@@@@@@@@@@@@@@@@@@
@@@@@@@@@@@@@@@@@@@@@@@@@@@@@@@@@@@@@@@@@@@@@@@@@@@@@@@@@@@@@@@@@@@@@@@@@@@@@@@@@@@@
@@@@@@@@@@@@@@@@@@@@@@@@@@@@@@@@@@@@@@@@@@@@@@@@@@@@@@@@@@@@@@@@@@@@@@@@@@@@@@@@@@@@
@@@@@@@@@@@@@@@@@@@@@@@@@@@@@@@@@@@@@@@@@@@@@@@@@@@@@@@@@@@@@@@@@@@@@@@@@@@@@@@@@@@@
@@@@@@@@@@@@@@@@@@@@@@@@@@@@@@@@@@@@@@@@@@@@@@@@@@@@@@@@@@@@@@@@@@@@@@@@@@@@@@@@@@@@
@@@@@@@@@@@@@@@@@@@@@@@@@@@@@@@@@@@@@@@@@@@@@@@@@@@@@@@@@@@@@@@@@@@@@@@@@@@@@@@@@@@@
@@@@@@@@@@@@@@@@@@@@@@@@@@@@@@@@@@@@@@@@@@@@@@@@@@@@@@@@@@@@@@@@@@@@@@@@@@@@@@@@@@@@
@@@@@@@@@@@@@@@@@@@@@@@@@@@@@@@@@@@@@@@@@@@@@@@@@@@@@@@@@@@@@@@@@@@@@@@@@@@@@@@@@@@@
@@@@@@@@@@@@@@@@@@@@@@@@@@@@@@@@@@@@@@@@@@@@@@@@@@@@@@@@@@@@@@@@@@@@@@@@@@@@@@@@@@@@
@@@@@@@@@@@@@@@@@@@@@@@@@@@@@@@@@@@@@@@@@@@@@@@@@@@@@@@@@@@@@@@@@@@@@@@@@@@@@@@@@@@@
@@@@@@@@@@@@@@@@@@@@@@@@@@@@@@@@@@@..@@@@@@@@@@@@@@@@@@@@@@@@@@@@@@@@@@@@@@@@@@@@@@@
@@@@@@@@@@@@@@@@@@@@@@@@@@@@@@@@@@@T.@@@@@@@@@@@@@@@@@@@@@@@@@@@@@@@@@@@@@@@@@@@@@@@
@@@@@@@@@@@@@@@@@@@@@@@@@@@@@@@@@@TT.@@@@@@@@@@@@@@@@@@@@@@@@@@@@@@@@@@@@@@@@@@@@@@@
@@@@@@@@@@@@@@@@@@@@@@@@@@.TT@@@@.TT..@@@@@@@@@@@@@@@@@@@@@@@@@@@@@@@@@@@@@@@@@@@@@@
@@@@@@@@@@@@@@@@@@@@@@@@@@T...@T...T..T.@@@@@@@@@@@@@@@@@@@@@@@@@@@@@@@@@@@@@@@@@@@@
@@@@@@@@@@@@@@@@@@@@@@@@@@@..T.T.T..TTT@@T@@@@@@@@@@@@@@@@@@@@@@@@@@@@@@@@@@@@@@@@@@
@@@@@@@@@@@@@@@@@@@@@@@@@@@TT.TTT..T.T.@@T.@@@@@@@@@@@@@@@@@@@@@@@@@@@@@@@@@@@@@@@@@
@@@@@@@@@@@@@@@@@@@@@@@@@T.TTT..T...T.TT.T..@@@@@@@@@@@@@@@@@@@@@@@@@@@@@@@@@@@@@@@@
@@@@@@@@@@@@@@@@@@@@@@@@.T...TTT..T..T.TTT..@@@@@@@@@@@@@@@@@@@@@@@@@@@@@@@@@@@@@@@@
@@@@@@@@@@@@@@@@@@@@@T.....TTT.........T..TT.@@@@@@@@@@@@@@@@@@@@@@@@@@@@@@@@@@@@@@@
@@@@@@@@@@@@@@@@@@@@TTTT..T..TTTTT.T..TT.....T@@@@@@@@@@@@@@@@@@@@@@@@@@@@@@@@@@@@@@
@@@@@@@@@@@@@@@@@@@......T.T...TT.TT...TT.T.TT.@@@@@@@@@@@@@@@@@@@@@@@@@@@@@@@@@@@@@
@@@@@@@@@@@@@@@@@@@.....T..T.T...T......T.TT....@@@@@@@@@@@@@@@@@@@@@@@@@@@@@@@@@@@@
@@@@@@@@@@@@@@@@@@@@T...T..T.T..TT...TT..T.TT....@@@@@@@@@@@@@@@@@@@@@@@@@@@@@@@@@@@
@@@@@@@@@@@@@@@@@@@@@T..TT..T..T...TT..T.T..T.T.@@.T@@@@@@@@@@@@@@@@@@@@@@@@@@@@@@@@
@@@@@@@@@@@@@@@@@@@@@@..T......TTTT...T.T....T.@@T..T@@@@@@@@@@@@@@@@@@@@@@@@@@@@@@@
@@@@@@@@@@@@@@@@@@@@@@@T.TT..T.TTTTTT.....T...@@..T..T@@@@@@@@@@@@@@@@@@@@@@@@@@@@@@
@@@@@@@@@@@@@@@@@@@@@@@@.....T.....T...T.T.T.@@.T.@.T..@@@@@@@@@@@@@@@@@@@@@@@@@@@@@
@@@@@@@@@@@@@@@@@@@@@@@@@...T..TT.......T..T@@.T.@@@TTTT@@@@@@@@@@@@@@@@@@@@@@@@@@@@
@@@@@@@@@@@@@@@@@@@@@@@@@@.TTT.T...TT..T.T.@@@@.@@@@@..T.@@@@@@@@@@@@@@@@@@@@@@@@@@@
@@@@@@@@@@@@@@@@@@@@@@@.@@@.T.TT.T.....T..@@@@@@@T@@@@T...@@@@@@@@@@@@@@@@@@@@@@@@@@
@@@@@@@@@.@@@@@@@@@@@T..@@@@..T..TTTT...T@@@@@@@@.T@@@..TT.@@@@@@@@@@@@@@@@@@@@@@@@@
@@@@@@@@@.T@@@@@@@@@..T..@@.T.T.TT..T..T@@@@@@@@T..T.......T@@@@@@@@@@@@@@@@@@@@@@@@
@@@@@@@@@TT.T@@T@@@@@@@TT.@..T....T.TTT@@@@@@@..T...TT.T...T.@@@@@@@@@@@@@@@@@@@@@@@
@@@@@@.....TT.@T@@@@@@@@T.T..@@T.T.T.@@@@@@@@T.TT....T.TT..T..@@@@@@@@@@@@@@@@@@@@@@
@@@@@T..T.@.T@@.@@@@@@@@.T...T@@....@@@.@@@@TT.TTTTTTTT.T...TTT@@@@@@@@@@@@@@@@@@@@@
@@@@T...TT@@@@..@@@@@@@@@.TT...@@T.@@@TTTTT...TT.TTTTTT.TTT..@@@@@@@@@@@@@@@@@@@@@@@
@@@..TTTT....T..@@@@@@@@@..TT.T.@@@@@.......TTT......TTT.T..@@@@@@@@@@@@@@@@@@@@@@@@
@@TTTT..T..T....@@@@@@.T..TTT.TT@@@@@...TTTT..T.T..T.T....T@@@@@@@@@@@@@@@@@@@@@@@@@
@@@.T.T...TTT.T.@@.T.....T.....@@@@@@@..TTTT.TT.TT.T.T.TT.@@@@@@@@@@@@@@@@@@@@@@@@@@
@@@@T....T.T..T..TTT.T.TTT....@@@@@@@@@T...T.T.TT.T..TT....@@@@@@@@@@@@@@@@@@@@@@@@@
@@@@@TT..T.TT..TT..T.....T.TT@@@@@@@@@@@TT.T.....TT...T.T...@@@@@@@@.T@@@@@@@@@@@@@@
@@@@@@TT.T..TTTT.T.T.TT.T.T...T@@@@@@@@@@..........T....T....@@@@@@..T.@@@@@@@@@@@@@
@@@@@@@.....T.TT.T..T.TT....TTT.@@@@@@...T.....T.T..........T.@@@...T.TT.@@@@@@@@@@@
@@@@@@@@T.TTTTT....TT.T....T.TT..@@@@T..T.T..TT....T...T..TT.T.@.TT.TTTT..@@@@@@@@@@
@@@@@@@@@T..T.TTTT...@@.....TT.TT.@@T........T....TTT@@..T..@@@@..T.TT.....@@@@@@@@@
@@@@@@@@@@TT........@@@@.T.TT..T..@@..T.TT.T..TT.T..@@@@T..@@@@@@@@....T.T..@@@@@@@@
@@@@@@@@@@@T.T..TTT@@@@@@.TTTT.TT.TTTTT...TTTTT.TTT@@@@@@.T@@..TT@@@..T...T@@@@@@@@@
@@@@@@@@@@@@TTTTTT@@@@@@@TT.TT.....T.....T..T...TT@@@@@@@@TT.TT.@@@@@..TTT@@@@@@@@@@
@@@@@@@@@@@@@TT..@@@@@@@T.....TTT...............T@@@@@@@@@@..T.@@@@@@.TT.@@@@@@@@@@@
@@@@@@@@@@@@@@..@@@@@@@...@TT.....T...T..T..TT..@@@@@@@@@@@T.T@@@@@@@@..@@@@@@@@@@@@
@@@@@@@@@@@@@@@@@@@@@@...@@@T.TT......TTTT...T..@@@@@@@@@@@TT@@@@@@@@@@@@@@@@@@@@@@@
@@@@@@@@@@@@@@@@@@@@@.TT@@@@@T.....TT....TT.T.T.T@@@@@@@@...@@@@@@@@..@@@@@@@@@@@@@@
@@@@@@@@@@@@@@@@@@@@@..@@@@@@@T...T.T.T.TT...T.T..T@@@@@TTT@@@@@@@@TTT.T@@@@@@@@@@@@
@@@@@@@@@@@@@@@@@@@@@@@@@@@@@@@..TT....TT.T..T.T.T..@@@...@@@@@@@@T.TT.T.@@@@@@@@@@@
@@@@@@@@@@@@@@@@@@@@@@@@@@@@@@@@.TTT.T..T..TT.TT..@@@@T.T.T@@@@@@TTTT...T.@@@@@@@@@@
@@@@@@@@@@@@@@@@@@@@@@@@@@@@@@@@.T..T....T..TTTT.@@@@T..T...@@@@.TT@@T..T..@@@@@@@@@
@@@@@@@@@@@@@@@@@@@@@@@@@@@@@@@@@TTTT....T..TT...@@@T...T@T..@@..@@@@...T..T@@@@@@@@
@@@@@@@@@@@@@@@@@@@@@@@@@@@@@@@@@@T.T..T..T@.TT..@TTT.T.T@@...T.@@@TT.......T@@@@@@@
@@@@@@@@@@@@@@@@@@@@@@@@@@@@@@@@@@@TT.TT.T@@@.TTTT.TT..T@@@@....@TTTTTT..T..TT@@@@@@
@@@@@@@@@@@@@@@@@@@@@@@@@@@@@@@@@@@@T....@@@@@.T..TTT@.@@@@@@..T..TTT.TT...T.@@@@@@@
@@@@@@@@@@@@@@@@@@@@@@@@@@@@@@@@@@@@TT.T@@@@@@@.T....@@@T@@..T..TTT..TT..T.T@@@@@@@@
@@@@@@@@@@@@@@@@@@@@@@@@@@@@@@@@@@@@@TT@@@@@@@@@..TT.T@@.T@@T..TT..T.T.T.T@@@@@@@@@@
@@@@@@@@@@@@@@@@@@@@@@@@@@@@@@@@@@@@@T.T@@@@@@@@@.T...T@@TTT......T..T..T@@@@@@@@@@@
@@@@@@@@@@@@@@@@@@@@@@@@@@@@@@@@@@@@@@T.T@@@@@T.T.TT...TT..T.T...T....T.@@@@@@@@@@@@
@@@@@@@@@@@@@@@@@@@@@@@@@@@@@@@@@@@@@@@.T.@@@..TT..T@..T...TT.T........@@@@@@@@@@@@@
@@@@@@@@@@@@@@@@@@@@@@@@@@@@@@@@@@@@@@@@@...TTTT.T.@@@@T.T...T.TTT....@@@@@@@@@@@@@@
@@@@@@@@@@@@@@@@@@@@@@@@@@@@@@@@@@@@@@@@@@.T.TTT..TT@@@@T.T...TT.TTTT@@@@@@@@@@@@@@@
@@@@@@@@@@@@@@@@@@@@@@@@@@@@@@@@@@@@@@@@@.TT..T.....@@@@@.T....T.TTT@@@@@@@@@@@@@@@@
@@@@@@@@@@@@@@@@@@@@@@@@@@@@@@@@@@@@@@@@T..T@@.....@@@@@@@..TTT.T..@@@@@@@@@@@@@@@@@
@@@@@@@@@@@@@@@@@@@@@@@@@@@@@@@@@@@@@@...T.TT@@@TT@@@@@@@@@.T.T...@@@@@@@@@@@@@@@@@@
@@@@@@@@@@@@@@@@@@@@@@@@@@@@@@@@@@@@@@T..@@.T@@@@@@@@@@@@@@@@.T.T@@@@@@@@@@@@@@@@@@@
@@@@@@@@@@@@@@@@@@@@@@@@@@@@@@@@@@@@@@@T..T.@@@@@@@@@@@@@@@@@@T.@@@@@@@@@@@@@@@@@@@@
@@@@@@@@@@@@@@@@@@@@@@@@@@@@@@@@@@@@@@@@...@@@@@@@@@@@@@@@@@@@T@@@@@@@@@@@@@@@@@@@@@
@@@@@@@@@@@@@@@@@@@@@@@@@@@@@@@@@@@@@@@@@@.@@@@@@@@@@@@@@@@@@@@@@@@@@@@@@@@@@@@@@@@@
@@@@@@@@@@@@@@@@@@@@@@@@@@@@@@@@@@@@@@@@@@@@@@@@@@@@@@@@@@@@@@@@@@@@@@@@@@@@@@@@@@@@
@@@@@@@@@@@@@@@@@@@@@@@@@@@@@@@@@@@@@@@@@@@@@@@@@@@@@@@@@@@@@@@@@@@@@@@@@@@@@@@@@@@@
@@@@@@@@@@@@@@@@@@@@@@@@@@@@@@@@@@@@@@@@@@@@@@@@@@@@@@@@@@@@@@@@@@@@@@@@@@@@@@@@@@@@
@@@@@@@@@@@@@@@@@@@@@@@@@@@@@@@@@@@@@@@@@@@@@@@@@@@@@@@@@@@@@@@@@@@@@@@@@@@@@@@@@@@@
@@@@@@@@@@@@@@@@@@@@@@@@@@@@@@@@@@@@@@@@@@@@@@@@@@@@@@@@@@@@@@@@@@@@@@@@@@@@@@@@@@@@
@@@@@@@@@@@@@@@@@@@@@@@@@@@@@@@@@@@@@@@@@@@@@@@@@@@@@@@@@@@@@@@@@@@@@@@@@@@@@@@@@@@@
@@@@@@@@@@@@@@@@@@@@@@@@@@@@@@@@@@@@@@@@@@@@@@@@@@@@@@@@@@@@@@@@@@@@@@@@@@@@@@@@@@@@
@@@@@@@@@@@@@@@@@@@@@@@@@@@@@@@@@@@@@@@@@@@@@@@@@@@@@@@@@@@@@@@@@@@@@@@@@@@@@@@@@@@@
