type octile
height 50
width 50
map
@@@@@@@@@@@@@@@@@@@@@@@@@@@@@@@@@@@@@@@@@@@@@@@@@@
@@@@@@@@@@@@@@@@@@@@@@@@@@@@@@@@@@@@@@@@@@@@@@@@@@
@@@@@@@@@@@@@@@@@@@@@@@@@@@@@@@@@@@@@@@@@@@@@@@@@@
@@@@@@@@@@@@@@@@@@@@@@@@@@@@@@@@@@@@@@@@@@@@@@@@@@
@@@@@@@@@@@@@@@@@@@@@@@@@@@@@@@@@@@@@@@@@@@@@@@@@@
@@@@@@@@@@@@@@@@@@@@@@@@@@@@@@@@@@@@@@@@@@@@@@@@@@
@@@@@@@@@@@@@@@@@@@@@@@@@@@@@@@@@@@@@@@@@@@@@@@@@@
@@@@@@@@@@@@@@@@@@@@@@@@@@@@@@@@@@@@@@@@@@@@@@@@@@
@@@@@@@@@@@@@@@@@@@@@@@@@@@@@@@@@@@@@@@@@@@@@@@@@@
@@@@@@@@@@@@@@@@@@@@@@@@@@@@@@@@@@@@@@@@@@@@@@@@@@
@@@@@@@@@@@@@@@@@@@@@@@@@@@@@@@@@@@@@@@@@@@@@@@@@@
@@@@@@@@@@@@@@@@@@@@@@@@@@@@@@@@@@@@@@@@@@@@@@@@@@
@@@@@@@@@@@@@@@@@@@@@@@@@@@@@@@@@@@@@@@@@@@@@@@@@@
@@@@@@@@@@@@@@@@@@@@@@@@@@@@@@@@@@@@@@@@@@@@@@@@@@
@@@@@@@@@@@@@@@@@@@@@@@@@@@@@@@@@@@@@@@@@@@@@@@@@@
@@@@@@@@@@@@@@@@@@@@@@@@@@@@@@@@@@@@@@@@@@@@@@@@@@
@@@@@@@@@@@@@@@@@@@@@@@@@@@@@@@@@@@@@@@@@@@@@@@@@@
@@@@@@@@@@@@@@@@@@@@@@@@@@@@@@@@@@@@@@@@@@@@@@@@@@
@@@@@@@@@@@@@@@@@@@@@@@@@@@@@@@@@@@@@@@@@@@@@@@@@@
@@@@@@@@@@@@@@@@@@@@@@@@@@@@@@@@@@@@@@@@@@@@@@@@@@
@@@@@@@@@@@@@@@@@@@@@@@@@@@@@@@@@@@@@@@@@@@@@@@@@@
@@@@@@@@@@@@@@@@@@@@@@@@@@@@@@@@@@@@@@@@@@@@@@@@@@
@@@@@@@@@@@@@@@@@@@@@@@@@@@T@@@@@@@@@@@@@@@@@@@@@@
@@@@@@@@@@@@@@@@@@@@@@@@@T.T.@@@@@@@@@@@@@@@@@@@@@
@@@@@@@@@@@@@@@@@@@@@@@@.....T@@@@@@@@@@@@@@@@@@@@
@@@@@@@@@@@@@@@@@@@@@@@T.@T...T@@@@@@@@@@@@@@@@@@@
@@@@@@@@@@@@@@@@@@@@@@..@@@...@@@@@@@@@@@@@@@@@@@@
@@@@@@@@@@@@@@@@@@@@@.T@@@@@@.....@@@@@@@@@@@@@@@@
@@@@@@@@@@@@@@@@@@@@..@@@@@@@@...TT@@@@@@@@@@@@@@@
@@@@@@@@@@@@@@@@@@@.T..@@@@@@@@TT...T@@@@@@@@@@@@@
@@@@@@@@@@@@@@@@@@..T@.T.@@@@@@TT....T@@@@@@@@@@@@
@@@@@@@@@@@@@@@@@...@@@.TT@@@@.T.T.....@@@@@@@@@@@
@@@@@@@@@@@@@@@@@..T@@@@@TT@@T.TT.T...@@@@@@@@@@@@
@@@@@@@@@@@@@@@@..T.T@@@@@.T....T.T..@@@@@@@@@@@@@
@@@@@@@@@@@@@@@....TTT@@@@T.TTT.T..T@@@@@@@@@@@@@@
@@@@@@@@@@@@@@T...T.T..@@T...TT..TT@@@@@@@@@@@@@@@
@@@@@@@@@@@@T.T.T..T.TT..T.T.....T@@@@@@@@@@@@@@@@
@@@@@@@@@@@T...T.....T.T..T.....T@@@@@@@@@@@@@@@@@
@@@@@@@@@@.T.T.TTTT.TTTT..T.T...@@@@@@@@@@@@@@@@@@
@@@@@@@@@@...TTTT.TTT..TT..T...@@@@@@@@@@@@@@@@@@@
@@@@@@@@@..T......T.TTTT.TT.TT.@@@@@@@@@@@@@@@@@@@
@@@@@@@@@@TT.T...T....T.T.....@@@@@@@@@@@@@@@@@@@@
@@@@@@@@@@@.T...TTTT.T.....TT@@@@@@@@@@@@@@@@@@@@@
@@@@@@@@@@@@..TT...TT....T.T@@@@@@@@@@@@@@@@@@@@@@
@@@@@@@@@@@@@..T......T.TT.@@@@@@@@@@@@@@@@@@@@@@@
@@@@@@@@@@@@@@T.TT...T...T@@@@@@@@@@@@@@@@@@@@@@@@
@@@@@@@@@@@@@@@..TT.T...T@@@@@@@@@@@@@@@@@@@@@@@@@
@@@@@@@@@@@@@@@@T.....TT@@@@@@@@@@@@@@@@@@@@@@@@@@
@@@@@@@@@@@@@@@@@TT.T.T@@@@@@@@@@@@@@@@@@@@@@@@@@@
@@@@@@@@@@@@@@@@@@@@@@@@@@@@@@@@@@@@@@@@@@@@@@@@@@
