type octile
height 150
width 140
map
@@@@@@@@@@@@@@@@@@@@@@@@@@@@@@@@@@@@@@@@@@@@@@@@@@@@@@@@@@@@@@@@@@@@@@@@@@@@@@@@@@@@@@@@@@@@@@@@@@@@@@@@@@@@@@@@@@@@@@@@@@@@@@@@@@@@@@@@@@@@
@TT..T.@@@@@@@@@@@@@@@@@@@@@@@@@@@@@@@@@@@@@@@@@@@@@@@@@@@@@@@@@@@@@@@@@@@@@@@@@@@@@@@@@@@@@@@@@@@@@@@@@@@@@@@@@@@@@@@@@@@@@@@@@@@@@@@@@@@@@
@TT...T@@@@@@@@@@@@@@@@@@@@@@@@@@@@@@@@@@@@@@@@@@@@@@@@@@@@@@@@@@@@@@@@@@@@@@@@@@@@@@@@@@@@@@@@@@@@@@@@@@@@@@@@@@@@@@@@@@@@@@@@@@@@@@@@@@@@@
@...T.T@@@@@@@@@@@@@@@@@@@@@@@@@@@@@@@@@@@@@@@@@@@@@@@@@@@@@@@@@@@@@@@@@@@@@@@@@@@@@@@@@@@@@@@@@@@@@@@@@@@@@@@@@@@@@@@@@@@@@@@@@@@@@@@@@@@@@
@TT..T.@@@@@@@@@@@@@@@@@@@@@@@@@@@@@@@@@@@@@@@@@@@@@@@@@@@@@@@@@@@@@@@@@@@@@@@@@@@@@@@@@@@@@@@@@@@@@@@@@@@@@@@@@@@@@@@@@@@@@@@@@@@@@@@@@@@@@
@T..TTT@@@@@@@@@@@@@@@@@@@@@@@@@@@@@@@@@@@@@@@@@@@@@@@@@@@@@@@@@@@@@@@@@@@@@@@@@@@@@@@@@@@@@@@@@@@@@@@@@@@@@@@@@@@@@@@@@@@@@@@@@@@@@@@@@@@@@
@T..T..@@@@@@@@@@@@@@@@@@@@@@@@@@@@@@@@@@@@@@@@@@@@@@@@@@@@@@@@@@@@@@@@@@@@@@@@@@@@@@@@@@@@@@@@@@@@@@@@@@@@@@@@@@@@@@@@@@@@@@@@@@@@@@@@@@@@@
@@@@@@@@@@@@@@@@@@@@@@@@@@@@@@@@@@@@@@@@@@@@@@@@@@@@@@@@@@@@@@@@@@@@@@@@@@@@@@@@@@@@@@@@@@@@@@@@@@@@@@@@@@@@@@@@@@@@@@@@@@@@@@@@@@@@@@@@@@@@
@@@@@@@@@@@@@@@@@@@@@@@@@@@@@@@@@@@@@@@@@@@@@@@@@@@@@@@@@@@@@@@@@@@@@@@@@@@@@@@@@@@@@@@@@@@@@@@@@@@@@@@@@@@@@@@@@@@@@@@@@@@@@@@@@@@@@@@@@@@@
@@@@@@@@@@@@@@@@@@@@@@@@@@@@@@@@@@@@@@@@@@@@@@@@@@@@@@@@@@@@@@@@@@@@@@@@@@@@@@@@@@@@@@@@@@@@@@@@@@@@@@@@@@@@@@@@@@@@@@@@@@@@@@@@@@@@@@@@@@@@
@@@@@@@@@@@@@@@@@@@@@@@@@@@@@@@@@@@@@@@@@@@@@@@@@@@@@@@@@@@@@@@@@@@@@@@@@@@@@@@@@@@@@@@@@@@@@@@@@@@@@@@@@@@@@@@@@@@@@@@@@@@@@@@@@@@@@@@@@@@@
@@@@@@@@@@@@@@@@@@@@@@@@@@@@@@@@@@@@@@@@@@@@@@@@@@@@@@@@@@@@@@@@@@@@@@@@@@@@@@@@@@@@@@@@@@@@@@@@@@@@@@@@@@@@@@@@@@@@@@@@@@@@@@@@@@@@@@@@@@@@
@@@@@@@@@@@@@@@@@@@@@@@@@@@@@@@@@@@@@@@@@@@@@@@@@@@@@@@@@@@@@@@@@@@@@@@@@@@@@@@@@@@@@@@.@@@@@@@@@@@@@@@@@@@@@@@@@@@@@@@@@@@@@@@@@@@@@@@@@@@@
@@@@@@@@@@@@@@@@@@@@@@@@@@@@@@@@@@@@@@@@@@@@@@@@@@@@@@@@@@@@@@@@@@@@@@@@@@@@@@@@@@@@@@.T@@@@@@@@@@@@@@@@@@@@@@@@@@@@@@@@@@@@@@@@@@@@@@@@@@@@
@@@@@@@@@@@@@@@@@@@@@@@@@@@@@@@@@@@@@@@@@@@@@@@@@@@@@@@@@@@@@@@@@@@@@@@@@@@@@@@@@@@@@.T..@@@@@@@@@@@@@@@@@@@@@@@@@@@@@@@@@@@@@@@@@@@@@@@@@@@
@@@@@@@@@@@@@@@@@@@@@@@@@@@@@@@@@@@@@@@@@@@@@@@@@@@@@@@@@@@@@@@@@@@@@@@@@@@@@@@@@@@@.TT..T@@@@@@@@@@@@@@@@@@@@@@@@@@@@@@@@@@@@@@@@@@@@@@@@@@
@@@@@@@@@@@@@@@@@@@@@@@@@@@@@@@@@@@@@@@@@@@@@@@@@@@@@@@@@@@@@@@@@@@@@@@@@@@@@@@@@@@.T......@@@@@@@@@@@@@@@@@@@@@@@@@@@@@@@@@@@@@@@@@@@@@@@@@
@@@@@@@@@@@@@@@@@@@@@@@@@@@@@@@@@@@@@@@@@@@@@@@@@@@@@@@@@@@@@@@@@@@@@@@@@@@@@@@@@@@@.TTT...@@@@@@@@@@@@@@@@@@@@@@@@@@@@@@@@@@@@@@@@@@@@@@@@@
@@@@@@@@@@@@@@@@@@@@@@@@@@@@@@@@@@@@@@@@@@@@@@@@@@@@@@@@@@@@@@@@@@@@@@@@@@@@@@@@@@@@@...TTTTT@@@@@@@@@@@@@@@@@@@@@@@@@@@@@@@@@@@@@@@@@@@@@@@
@@@@@@@@@@@@@@@@@@@@@@@@@@@@@@@@@@@@@@@@@@@@@@@@@@@@@@@@@@@@@@@@@@@@@@@@@@@@@@@@@@@@@@T.TTTT..@@@@@@@@@@@@@@@@@@@@@@@@@@@@@@@@@@@@@@@@@@@@@@
@@@@@@@@@@@@@@@@@@@@@@@@@@@@@@@@@@@@@@@@@@@@@@@@@@@@@@@@@@@@@@@@.@@@@@@@@@@@@@@@@@@@@@@T.TT..T.@@@@@@@@@@@@@@@@@@@@@@@@@@@@@@@@@@@@@@@@@@@@@
@@@@@@@@@@@@@@@@@@@@@@@@@@@@@@@@@@@@@@@@@@@@@@@@@@@@@@@@@@@@@@@.T..@@@@@@@@@@@@@@@@@@@@@.....T.T@@@@@@@@@@@@@@@@@@@@@@@@@@@@@@@@@@@@@@@@@@@@
@@@@@@@@@@@@@@@@@@@@@@@@@@@@@@@@@@@@@@@@@@@@@@@@@@@@@@@@@@@@@@@T.T..@@@@@@@@@@@@@@@@@@@@@TT.T...T.@@@@@@@@@@@@@@@@@@@@@@@@@@@@@@@@@@@@@@@@@@
@@@@@@@@@@@@@@@@@@@@@@@@@@@@@@@@@@@@@@@@@@@@@@@@@@@@@@@@@@@@@@T....T.@@@@@@@@@@@@@@@@@@@@@.T...T...@@@@@@@@@@@@@@@@@@@@@@@@@@@@@@@@@@@@@@@@@
@@@@@@@@@@@@@@@@@@@@@@@@@@@@@@@@@@@@@@@@@@@@@@@@@@@@@@@@@@@@.TT.@@.T..@@@@@@@@@@@@@@@@@@@@@TTT.T.T..@@@@@@@@@@@@@@@@@@@@@@@@@@@@@@@@@@@@@@@@
@@@@@@@@@@@@@@@@@@@@@@@@@@@@@@@@@@@@@@@@@@@@@@@@@@@@@@@@@@@T.T.@@@@.T.TT@@@@@@@@@@@@@@@@@@@@...T..T..@@@@@@@@@@@@@@@@@@@@@@@@@@@@@@@@@@@@@@@
@@@@@@@@@@@@@@@@@@@@@@@@@@@@@@@@@@@@@@@@@@@@@@@@@@@@@@@@@@T...@@@@@@.T...@@@@@@@@@@@@@@@@@@@@T....T...@@@@@@@@@@@@@@@@@@@@@@@@@@@@@@@@@@@@@@
@@@@@@@@@@@@@@@@@@@@@@@@@@@@@@@@@@@@@@@@@@@@@@@@@@@@@@@@@TT..@@@@@@@@...TT@@@@@@@@@@@@@@@@@@@@.TTTTT.TT@@@@@@@@@@@@@@@@@@@@@@@@@@@@@@@@@@@@@
@@@@@@@@@@@@@@@@@@@@@@@@@@@@@@@@@@@@@@@@@@@@@@@@@@@@@@@@..T.@@@@@@@@@@T..TT@@@@@@@@@@@@@@@@@@@@T...TT..T@@@@@@@@@@@@@@@@@@@@@@@@@@@@@@@@@@@@
@@@@@@@@@@@@@@@@@@@@@@@@@@@@@@@@@@@@@@@@@@@@@@@@@@@@@@@T...@@@@@@@@@@@@.....@@@@@@@@@@@@@@@@@@TT..T....T@@@@@@@@@@@@@@@@@@@@@@@@@@@@@@@@@@@@
@@@@@@@@@@@@@@@@@@@@@@@@@@@@@@@@@@@@@@@@@@@@@@@@@@@@@.T...@@@@@@@@@@@@@.T.T.T@@@@@@@@@@@@@@@@.T.TTT.T..@@@@@@@@@@@@@@@@@@@@@@@@@@@@@@@@@@@@@
@@@@@@@@@@@@@@@@@@@@@@@@@@@@@@@@@@@@@@@@@@@@@@@@@@@@..T..@@@@@@@@@@@@@@TTT..T.@@@@@@@@@@@@@@T....T.T.T@@@@@@@@@@@@@@@@@@@@@@@@@@@@@@@@@@@@@@
@@@@@@@@@@@@@@@@@@@@@@@@@@@@@@@@@@@@@@@@@@@@@@@@@@@T.T..@@@@@@@@@@@@@@@T....T.T@@@@@@@@@@@@..T......T@@@@@@@@@@@@@@@@@@@@@@@@@@@@@@@@@@@@@@@
@@@@@@@@@@@@@@@@@@@@@@@@@@@@@@@@@@@@@@@@@@@@@@@@@@TT...@@@@@@@@..@@@@@@T....T...@@@@@@@@@@TT...TT...@@@@@@@@@@@@@@@@@@@@@@@@@@@@@@@@@@@@@@@@
@@@@@@@@@@@@@@@@@@@@@@@@@@@@@@@@@@@@@@@@@@@@@@@@@.....@@@@@@@@@T.T.@@@@.TT......@@@@@@@@@..........@@@@@@@@@@@@@@@@@@@@@@@@@@@@@@@@@@@@@@@@@
@@@@@@@@@@@@@@@@@@@@@@@@@@@@@@@@@@@@@@@@@@@@@@@@....T@@@@@@@@@@T..T..T..T...@@.T.@@@@@@@..TTTT....@@@@@@@@@@@@@@@@@@@@@@@@@@@@@@@@@@@@@@@@@@
@@@@@@@@@@@@@@@@@@@@@@@@@@@@@@@@@@@@@@@@@@@@@@@TT..@@@@@@@@@@@......TT....@@@@@TTTT@@@@T..TT...T.@@@@@@@@@@@@@@@@@@@@@@@@@@@@@@@@@@@@@@@@@@@
@@@@@@@@@@@@@@@@@@@@@@@@@@@@@@@@@@@@@@@@@@@@@@..T.@@@@@@@@@@@....T.T.....@@@@@@@T...@@...TT..T..@@@@@@@@@@@@@@@@@@@@@@@@@@@@@@@@@@@@@@@@@@@@
@@@@@@@@@@@@@@@@@@@@@@@@@@@@@@@@@@@@@@@@@@@@@.T.T@@@@@@@@@@@.TTTT.T.T.TTT@@@@@@@@....T.......T@@@@@@@@@@@@@@@@@@@@@@@@@@@@@@@@@@@@@@@@@@@@@@
@@@@@@@@@@@@@@@@@@@@@@@@@@@@@@@@@@@@@@@@@@@@...T@@@@@@@@@@@..T.T..T..TT..@@@@@@@@@TT...TT....@@@@@@@@@@@@@@@@@@@@@@@@@@@@@@@@@@@@@@@@@@@@@@@
@@@@@@@@@@@@@@@@@@@@@@@@@@@@@@@@@@@@@@@@@@@....@@@@@@@@@@@@...TT....T.T.TT@@@@@@@@@T..T....T@@@@@@@@@@@@@@@@@@@@@@@@@@@@@@@@@@@@@@@@@@@@@@@@
@@@@@@@@@@@@@@@@@@@@@@@@@@@@@@@@@@@@@@@@@@....@@@@@@@@@@@@@@TT.....TTTT.TT@@@@@@@@@@...TTTT@@@@@@@@@@@@@@@@@@@@..@@@@@@@@@@@@@@@@@@@@@@@@@@@
@@@@@@@@@@@@@@@@@@@@@@@@@@@@@@@@@@@@@@@@@T.T.@@@@@@@@@@@@@@@@..........T.T.@@@@@@@@@@.....@@@@@@@@@@@@@@@@@@@@...T@@@@@@@@@@@@@@@@@@@@@@@@@@
@@@@@@@@@@@@@@@@@@@@@@@@@@@@@@@@@@@@@@@@T.TT@@@@@@@@@@@@@@@@@@...TTTT.T.TT.@@@@@@@@@@@T....@@@@@@@@@@@@@@@@@@...TTT@@@@@@@@@@@@@@@@@@@@@@@@@
@@@@@@@@@@@@@@@@@@@@@@@@@@@@@@@@@@@@@@@TTTT@@@@@@@@@@@@@@@@@@@@T.TTT..TTT..@@@@@@@@@@@@..T.@@@@@@@@@@@@@@@@@...T....@@@@@@@@@@@@@@@@@@@@@@@@
@@@@@@@@@@@@@@@@@@@@@@@@@@@@@@@@@@@@@@.T.T@@@@@@@@@@@@@@@@@@@@@@..TT.T..TT@@@@@@@@@@@@@.TT..@@@@@@@@@@@@@@@TT....T..T@@@@@@@@@@@@@@@@@@@@@@@
@@@@@@@@@@@@@@@@@@@@@@@@@@@@@@@@@@@@@TTTT@@@@@@@@@@@@@@@@@@@@@@@@..TTTT..@@@@@@@@@@@@@@@.T..T@@@@@@@@@@@@@..T...TT..T.@@@@@@@@@@@@@@@@@@@@@@
@@@@@@@@@@@@@@@@@@@@@@@@@@@@@@@@@@@TTTT.@@@@@@@@@@@@@@@@@@@@@@@@@@T.T..T@@@@@@@@@@@@@@@@TT..TT@@@@@@@@@@@...T.T.T..TTTT@@@@@@@@@@@@@@@@@@@@@
@@@@@@@@@@@@@@@@@@@@@@@@@@@@@@@@@@..TT.@@@@@@@@@@@@@@@@@@@@@@@@@@@@TTT.@@@@@@@@@@@@@@@@@..T..T..@@@@@@@@.T.......T....T.@@@@@@@@@@@@@@@@@@@@
@@@@@@@@@@@@@@@@@@@@@@@@@@@@@@@@@..TTT@@@@@@@@@@@@@@@@@@@@@@@@@@@@@@.T@@@@@@@@@@T.@@@@@@T....T..T@@@@@@TT.....TT.....TT..@@@@@@@@@@@@@@@@@@@
@@@@@@@@@@@@@@@@@@@@@@@@@@@@@@@@TTTTT@@@@@@@@@@@@@@@@@@@@@@@@@@@@@@@@@@@@@@@@@@T....@@@.T....@....@@@@........T..T.T...T..@@@@@@@@@@@@@@@@@@
@@@@@@@@@@@@@@@@@@@@@@@@@@@@@@@@T..T@@@@@@@@@@@@@@@@@@@@@.T@@@@@@@@@@@@@@@@@@@..T....TTTT...@@@..TT@@@..TT@TT..TTT.T.T.....@@@@@@@@@@@@@@@@@
@@@@@@@@@@@@@@@@@@@@@@@@@@@@@@@@..T@@@@@@@@@@@@@@@@@@@@@.TTT@@@@@@@@@@@@@@@@@.T..T.TT..T...@@@@@TTT.@@TT.@@@.TTT..TT.TTTT...@@@@@@@@@@@@@@@@
@@@@@@@@@@@@@@@@@@@@@@@@@@@@@@@.T@@@@@@@@@@@@@@@@@@@@@@@...T@@@@@@@@@@@@@@@@.TTT..TTT...TT@@@@@@@.T..TTT@@@@@@TTTT..T...T.TT.@@@@@@@@@@@@@@@
@@@@@@@@@@@@@@@@@@@@@@@@@@@@@@..@@@@@@@@@@@@@.T..@@@@@@@TT..@@@@@@@@@@@@@@@T..TT......TTT@@@@@@@@@.T..TT@@@@@@@T.TTT.T.....T.T@@@@@@@@@@@@@@
@@@@@@@@@@@@@@@@@@@@@@@@@@@@@T.@@@@@@@@@@@@@.TTTTTT@@@@@@.T@@@@@@@@@@@@@@@@TTT.T...T.T.T.T@@@@@@@@@T..T.@@@@@@@@...........TT@@@@@@@@@@@@@@@
@@@@@@@@@@@@@@@@@@@@@@@@@@@.TT@@@@@@@@@@@@@@T...TTT@@@@@@@@@@@@@@@@@@@@@@@@@TTTTTTTT.T.T.T@@@@@@@@@@T..T.@@@@@@@@....TTTT...@@@@@@@@@@@@@@@@
@@@@@@@@@@@@@@@@@@@@@@@@@@TTT@@@@@@@@@@@@@@@......T@@@@@@@@@@@@@@@@@@@@@@@@@@TTT.T..TTT....@@@@@@@@@@TTT..@@@@@@@@....T..TT@@@@@@@@@@@@@@@@@
@@@@@@@@@@@@@@@@@@@@@@@@@@TT@@@@@@@@@@@@@@@@T.T..T@@@@@@@@@@@@@@@@@@@@@@@@@@@@T.TT...T..T.T.@@@@@@@@@@@.T..@@@@@@@@..T.T..@@@@@@@@@@@@@@@@@@
@@@@@@@@@@@@@@@@@@@@@@@TTT.@@@@@@@@@@@@@@@@@@....@@@@@@@@@@@@@@@@@@@@@@@@@@@@@@..T.TTTTT..T.@@@@@@@@@@@@....@@@@@@@@@TT..@@@@@@@@@@@@@@@@@@@
@@@@@@@@@@@@@@@@@@@@@@...T@@@@@@@@@@@@@@@@@@@@@@@@@@@@@@@@@@@@@@@@@@@@@@@@@@@@@@.T.T..T.T.T@@@@@@@@@@@@@@...T@@@@@@@@@..@@@@@@@@@@@@@@@@@@@@
@@@@@@@@@@@@@@@@@@@@@.TT.@@@@@@@@@@@@@@@@@@@@@@@@@@@@@@@@@@@@@@@@@....@@@@@@@@@@@TTT.....T@@@@@@@@@@@@@@@@T...@@@@@@@@@@@@@@@@@@@@@@@@@@@@@@
@@@@@@@@@@@@@@@@@@@@T.TT@@@@@@@@@@@@@@@@@@@@@@@@@@@@.@@@@@@@@@@@@@T.T.@@@@@@@@@@@@...T...@@@@@@@@@@@@@@@@@TTT..@@@@@@@@@@@@@@@@@@@@@@@@@@@@@
@@@@@@@@@@@@@@@@@@@.T.T@@@@@@@@@@@@@@@@@@@@@@@@@@@@..T@@@@@@@@@@@@.T...@@@@@@@@@@@@T....@@@@@@@@@@@@@@@@@@T...T.@@@@@@@@@@@@@@@@@@@@@@@@@@@@
@@@@@@@@@@@@@@@@@@.TT.@@@@@@@@@@@@@@@@@@@@@@@@@@@T.T...@@@@@@@@@@@@..T@@@@@@@@@@@@@@...@@@@@@@@@@@@@@@@@@@.T..TTT@@@@@@@@@@@@@@@@@@@@@@@@@@@
@@@@@@@@@@@@@@@@@TT...@@@@@@@@@@@@@@@@@@@@@@@@TT.T.T...T@@@@@@@@@@@@@@@@@@@@@@@@@@@@@@@@@@@@@@@@@T.T@@@@@@T....T..@@@@@@@@@@@@@@@@@@@@@@@@@@
@@@@@@@@@@@@@@@@.T...T@@@@@@@@@@@@@@@@@@@@@@@@@....T..T.T@@@@@@@@@@@@@@@@@@@@@@@@@@@@@@@@@@@@@@@T.T..@@@@@.T...T...@@@@@@@@@@@@@@@@@@@@@@@@@
@@@@@@@@@@@@@@@TTTTT.@@@@@@@@@@@@@@@@@@@@@@@@@@...TT.T..T.@@@@@@@@@@@@@@@@@@@@@@@@@@@@@@@@@@@@@.TT..TT.@@@.T...@...T@@@@@@@@@@@@@@@@@@@@@@@@
@@@@@@@@@@@@@@.....TT@@@@@@@@@@@@@@@@@@@@@@@@@@@@@@@..TTTTT@@@@@@@@@@@@@@@@@@@@@@@@@@@@@@@@@@..T.TT.T.T.T.TTT.@@@.TT.@@@@@@@@@@@@@@@@@@@@@@@
@@@@@@@@@@@@@........@@@@@@@@@@@@@@@@@@@@@@@@@@@@@@@@.T.TT..@@@@@@@@@@@@@@@@@@@@@@@@@@@@@@@@........TTTT...T.@@@@@...T@@@@@@@@@@@@@@@@@@@@@@
@@@@@@@@@@@@T.T...TT.@@@@@@@@@@@@@@@@@@@@@@@@@@@@@@@@@.TTTT.T.T@@@@@@@@@@@@@@..@@@@@@@@@@@@........TT.T.....@@@@@@@....@@@@@@@@@@@@@@@@@@@@@
@@@@@@@@@@@..TTT....T.@@@@@@@@@@@@@@@@@@@@@@@@@@@@@@@@@@@TTTT..@@@@@@@@@@@@@...T@@@@@@@@@@@...T....T.....TTT@@@@@@@@.T..@@@@@@@@@@@@@@@@@@@@
@@@@@@@@@@..TT..T@.TTTT@@@@@.@@@@@@@@@@@@@@@@@@@@@@@@@@@@..TTTT.@@@@@@@@@@@@T.T.@@@@@@@@@@@@..T....T.....T..TT@@@@@@@..T.@@@@@@@@@@@@@@@@@@@
@@@@@@@@@.T.....@@@.T.TT@@@.T.@@@@@@@T@@@@@@@@...@@@@@@@...T.....@@@T@@@@@@@..T.@@@@@@@@@@@@@TT.TTTT.TTT..T.TT@@@@@@@@....@@@@@@@@@@@@@@@@@@
@@@@@@@@TT..T.T@@@@@TTTTT@@.T.T......@@@@@@@@.TT..@@@@@@@TT...T......@@@@@@@.T.@@@@@@@@@@@@@@@T.T...T....TTT..@@@@@@@@@T...@@@@@@@@@@@@@@@@@
@@@@@@@....TTT@@@@@@@T.....TT..T.T.TT@@@@@@@@.....@@@@@@@@T.....T.T@@@@@@@@@@@@@@@@@@@@@@@@@@@@.TTT.TT.T..TT.@@@@@@@@@@@..T.@@@@@@@@@@@@@@@@
@@@@@@.....T.T@@@@@@@@.T......T.T..T.@@@@@@@@T...@@@@@@@@@..T..TTT.@@@@@@@@@@@@@@@@@@@@@@@@@@@@@...T..T...T.@@@@@@@@@@@@@.T..@@@@@@@@@@@@@@@
@@@@@TT..T..T..@@@@@@@@..TT.TTT.T...T@@@@@@@@@@@@@TT@@@@@@...TT...T.@@@@@@@@@@@@@@@@@@@@@@@@@@@@@..T.T.TT..@@@@@@@@@@@@@@@...T@@@@@@@@@@@@@@
@@@@@..TT....T..@@@@@@@@...T...TT....@@@@@@@@@@@@TTTT@@@@@T....TTTTTT@@@.T@@@@@@@@@@@@@@@@@@@@@@@@.T......@@@@@@@@@@@@@@@@@T....@@@@@@@@@@@@
@@@@@@T.TTT...T.@@@@@@@@@........T..T@@@@@@@@@@@..T.TT@@@@....T..T..T.@T.@@@@@@@@@@@@@@@@@@@@@@@@@@@TT...@@@@@@@@TT.@@@@@@@@.....@@@@@@@@@@@
@@@@@@@T......TTT@@@@@@@@@.....T..T.@@@@@@@@@@@@@.T..T@@@....TTT......TT.@@@@@@@@@@@@@@TTT@@@@@@@@@@@.T.@@@@@@@@@..T@@@@@@@@@TTTT.@@@@@@@@@@
@@@@@@@@TT..T.TT...@@@@@@@@..TTTT...T@@@@@@@@@@@@@TTTTT@@.TT.T...TT.TTT..T@@@@@@@@@@@@.T..@@@@@@@@@@@@@@@@@@@@@@@T.T@@@@@@@@@@TT.T.@@@@@@@@@
@@@@@@@@@....TTT....@@@@@@@@...T.T..T@@@@@@@@@@@@@..T.T@........T..T.T.T.T@@@@@@@@@@@@..T.@@@@@@@@@@@@@@@@@@@@@@@....@@@@@@@@@..TTTT@@@@@@@@
@@@@@@@@@@.TTT.TTTTT.@@@@@@@@TT.T.T.T..@@@@@@@@@@@@....TT.T....T....T.TT.TTT@@@@@@@@@@.TTT@@@@@@@@@@@@@@@@@@@@@..TT.TT.@@@@@@@T..TT..@@@@@@@
@@@@@@@@@@@.TT...T.T.T@@@@@@@@T..T.TT..@@@@@@@@@@@@@..TT.T..TT.TT.TT.T.TT....@@@@@@@@@@@@@@@@@@@@@@@@@@@@@@@@@...T...T.@@T@@@@@T.T...T@@@@@@
@@@@@@@@@@@@.T.TT..TT.T@@@@@@@@.T.TT.T.@@@@@@@@@@@@@.TT..T.TT.T..T.TT..T....T.@@@@@@@@@@@@@@@@@@@@@@@@@@@@@.....TT...T..TT.T@@@.....T..@@@@@
@@@@@@@@@@@@@...TT...T..@@@@@@@@T.TTT.T@@@@@@@@@@@@@TTT.T.T.....TTTTT..T.T....@@@@@@@@@@@@@@@@@@@@@@@@@@@@@@T.....TT.TTTT...@@@.T..T..TT@@@@
@@@@@@@@@@@@@@.TTT.TTTT..@@@@@@@@.T.......T.TT@@@@@.T.TT.T.T....T.T...T..TT.TTT@@@@@@@@@@@@@@@@@@@@@@@@@@@@@@TT.TTTT.T....T.@@@T..T....@@@@@
@@@@@@@@@@@@@@@.T.T....T..@@@@@@@@.T..T....T.TT..T.TTT.....TT...T....T.TT.T........@@@@@@@@@@@@@@@@@@@@@@@@@@@...T.T@@@@.T..@@..T.....@@@@@@
@@@@@@@@@@@@@@@@..T....T...@@@@@@@@@..T..T.....TTT.....T.TT.T..TTTTTTT....T....TT..@@@@@@@@@@@@@@@@@@@@@@@@@@@@..T.@@@@@@T.T.T.TTT.T.@@@@@@@
@@@@@@@@@@@@@@@@@.T.TTTT....@@@@@@@@@T..T...T..T.....TTTT......T.T..T.TTT.TT....TTT@@@@@@@@@@@@@@@@@@@@@@@@@@@@@..@@@@@@@@.T.TT.....@@@@@@@@
@@@@@@@@@@@@@@@@@@T..T.T..T.T@@@@@@@@@..T.......TT..T....T.......TT.......TTTT.T.TT@@@@@@@@@@@@@@@@@@..@@@@@@@@@@@@@@@@@@.T......TT@@@@@@@@@
@@@@@@@@@@@@@@@@@@@T...T..T...@@@@@@@@@.TT.TTT.T.T.T.......T...T...T....T.T.T..T...T..@@@@@@@@@@@@@@.T..@@@@@@@@@@@@@@@@@....T..T.@@@@@@@@@@
@@@@@@@@@@@@@@@@@@@@.....T.TTT.@@@@@@@@@T.T..TTTT.....TTT...TTTTT....TTTT.TT..T.TTTT..@@@@@@@@@@@@@@@.TT@@@@@@@@@@@@@@@@T..TT.T.T@@@@@@@@@@@
@@@@@@@@@@@@@@@@@@@@@TT..T...T..@@@@@@@@@....TTT..T........T......TTTTTTT...T..T..T..@@@@@@@@@@@@@@@..T..@@@@@@@@@@@@@@TTT...TTT@@@@@@@@@@@@
@@@@@@@@@@@@@@@@@@@@@@TT.TTT..TT.@@@@@@@@@....T......T....T.T..T...TTT.TTT.TT.T...TT@@@@@@@@@@@@@@@..T.TT@@@@@@@@@@@@@...TTT.T.@@@@@@@@@@@@@
@@@@@@@@@@@@@@@@@@@@@@@@.T.T.T...T@@@@@@@@@T..T...T..TTTT.T....T..T..T...T.TT.TT...@@@@@@@@@@@@.@@.T.T......T@@@@@@@@.....TT..@@@@@@@@@@@@@@
@@@@@@@@@@@@@@@@@@@@@@@@@T.......T.T@@@@@@@@TT.TTTTTT..T.T......TT.....TT.....T.T...@@@@@@@@@@@.....T...TT..@@@@@@@@.T..T.T..@@@@@@@@@@@@@@@
@@@@@@@@@@@@@@@@@@@@@@@@@@TTTTTT..T.T@@@@@@@@TT....TT..T.....T...TTTTTTT.T..T.T...TT@@@@@@@@@@@.TT....TTT...@@@@@@@T..TT....@@@@@@@@@@@@@@@@
@@@@@@@@@@@@@@@@@@@@@@@@@@..T......TTT@@@@@@@@.....TT..T.TT.T.TT.T.T.T...T.TT.T.@.TT@@@@@@@@@@@@T.TT....T..T@@@@@@.TT.T..TT@@@@@@@@@@@@@@@@@
@@@@@@@@@@@@@@@@@@@@@@@@@@@.T...T.T.TT.@@@@@@@@@T....T.....T.....T...T..TT.....@@.T@@@@@@@@@@@@@@..TT.T.T...@@@@@T..T...T.@@@@@@@@@@@@@@@@@@
@@@@@@@@@@@@@@@@@@@@@@@@@@@TT..TT.TT....@@@@@@@@@T......TT.T..T...T..T.T...TT.@@@@@@@@@@@@@@@@@@@@.T..TTTTT..@@.........T@@@@@@@@@@@@@@@@@@@
@@@@@@@@@@@@@@@@@@@@@@@@@@@T..TTT.TT.....@@@@@@@@.T.T..TTT...T....TTT..TT.T..@@@@@@@@@@@@@.T@@@@@@@TT.T@@T..T@.T.....T.T@@@@@@@@@@@@@@@@@@@@
@@@@@@@@@@@@@@@@@@@@@@@@@...T..TTT.T..T.TT@@@@@@@@...T.TT..T.T........T..TT.@@@@@@@@@@@@@T.@@@@@@@@@.T@@@.......T......@@@@@@@@@@@@@@@@@@@@@
@@@@@@@@@@@@@@@@@@@@@@@@T.TT..TT..T....T...@@@@@@@@.T...T.T.T.T.T.T...TT.T.@@@@@@@@@@@@@TTT@@@@@@@@@@@@@@@T..TTTTT.TTT@@@@@@@@@@@@@@@@@@@@@@
@@@@@@@@@@@@@@@@@@@@@@@.T..TT.T.TT.T....T..T@@@@@@@@@@@@...T...T.T.T.....T@@@@@@@@@@@@@@....@@@@@@@@@@@@@@...TTTTT..T@@@@@@@@@@@@@@@@@@@@@@@
@@@@@@@@@@@@@@@@@@@@@@TT.......T.@@.T.TT.TTT.@@@@@@@@@@..T...T.T.TTTT..T..@@@@@@@@@@@@@@.T.T.@@@@@@@@@@@@@T.T.T.T..T@@@@@@@@@@@@@@@@@@@@@@@@
@@@@@@@@@@@@@@@@@@@@@T.....T.T..@@@@...T.....TT@@@@TT.......TTT.......T.T.T@@@@@@@@@@@@T..T..T@@@@@@@@@@@...T....TT@@@@@@@@@@@@@@@@@@@@@@@@@
@@@@@@@@@@@@@@@@@@@TTTTT.TTT..@@@@@@@...T...T.T@@@@TT..T..TTT.T.T.....T...@@@@@@@@@@@@.T...TTT...@@@@@@@T...T.TT.T@@@@@@@@@@@@@@@@@@@@@@@@@@
@@@@@@@@@@@@@@@@@@..TTT..TT..@@@@@@@@@.TT.TT...TT@@.TTTT@@@@...TT..T.T@TT@@@@@@@@@@...T....TTTTTT@@@@@@.TT.....T.@@@@@@@@@@@@@@@@@@@@@@@@@@@
@@@@@@@@@@@@@@@@@TT.T.T..T.@@@@@@@@@@@@..T...T..T@@TTT..@@@@@@T..T.T.@@@@@@@@@@@@@@T.TT.T.T...T..@@@@@.T...TT...@@@@@@@@@@@@@@@@@@@@@@@@@@@@
@@@@@@@@@@@@@@@@.T.T......@@@@@@@@@@@@@@...T.T.T......@@@@@@@@...TTT@@@@@@@@@@@@@@@@...T.......T.@@@@T....TTT..@@@@@@@@@@@@@@@@@@@@@@@@@@@@@
@@@@@@@@@@@@@@@T...TTT.TT@@@@@@@@@@@@@@@@..T....TTT.T@@@@@@@.T...TT@@@@@@@@@@@@@@@@@@..T..T.T...T@@@.T.T..TTT.@@@@@@@@@@@@@@@@@@@@@@@@@@@@@@
@@@@@@@@@@@@@@T...TT...T@@@@..TT@@@@@@@@@@...TTT.....@@@@@@@@TTT.T@@@@@@@@@@@@@@@@@@@@....T@T..T.@@T.T...T..T.@@@@@@@@@@@@@@@@@@@@@@@@@@@@@@
@@@@@@@@@@@@@@T....T.T.T..TTT.TTT@@@@@@@@@@TTT.TT....T@@@@@@@@T..@@@@@@@@@@@@..@@@@@@@@...@@@...TT...T.....T..@@@@@@@@@@@@@@@@@@@@@@@@@@@@@@
@@@@@@@@@@@@@@@.T.T......T...T.T.@@@@@@@@@@@TTTTTT.TTTT@@@@@@@@.@@@@@@@@@@@@TT..@@@@@@@@@@@@@@T.T..TTT..T..TTT.@@@@@@@@@@@@@@@@@@@@@@@@T@@@@
@@@@@@@@@@@@@@@@TTTT...T....T...@@@@@@@@@@@@@.TT.TTT....@@@@@@@@@@@@@@@@@@@@.T.@@@@@@@@@@@@@@@@T...T.T.....TT.TT@@@@@@@@@@@@@@@@@@@@@@T.@@@@
@@@@@@@@@@@@@@@@@.TT...TTT.....@@@@@@@@@@@@@@@T.T.T...TT.@@@@@@@@@@@@@@@@@@@..TT@@@@@@@@@@@@@@@T.TTT......TT....T@@@@@@@@@@@@@@@@@@@T..@@@@@
@@@@@@@@@@@@@@@@@@@@@T..TTT.TT@@@@@@@@@@@@@@@@@TTTTTTTTTT.@@@@@@@@@@@@@@@@@TT.T..@@@@@@@@@@@@@T....T.TTTTTT.TTT...@@@@@@@@T....T..T.TT@@@@@@
@@@@@@@@@@@@@@@@@@@@@@@@...TT@@@@@@@@@@@@@@@@@@@.TTT.T.TTTT@@@@@@@@@@@@@@@TT...TTT@@@@@@@@@@@...T.TTTT@@.T..T.T..T..@@@@@.TT..TTT....@@@@@@@
@@@@@@@@@@@@@@@@@@@@@@@@@@@@@@@@@@@@@@@@@@@@@@@@@T...TT....T@@@@@@@@@@@@@.T.T.....T.@@@@@@@@.T..T...T@@@@TT.TT.T.T..T@@@..TTTTT.....@@@@@@@@
@@@@@@@@@@@@@@@@@@@@@@@@@@@@@@@@@@@@@@@@@@@@@@@@@@..T..T..TTT@@@@@@@@@...T....T..T..@@@@@@@.....TTTT@@@@@@T..TT.TT...@@@.T.TT...T..@@@@@@@@@
@@@@@@@@@@@@@@@@@@@@@@@@@@@@@@@@@@@@@@@@@@@@@@@@@@@......TTTT.@@@@@@@@@..T.T.T..T.T@@@@@@@TT...TTT.@@@@@@@@T.T..TTT.TTT.TT.TTT...T@@@@@@@@@@
@@@@@@@@@@@@@@@@@@@@@@@@@@@@@@@@@@@@@@@@@@@@@@@@@@@@.T..TT..T.T@@@@@@@@@...T.TTT..@@@@@@@.TTTTT.TT@@@@@@@@@@TT..T.TT...TTT.T.....@@@@@@@@@@@
@@@@@@@@@@@@@@@@@@@@@@@@@@@@@@@@@@@@@@@@@@@@@@@@@@@@@.TT.T..TTT.@@@@@@@@@.T...T...@@@@@@T.TTTT.TT@@@@@@@@@@@@....T.T.TT.T...T...@@@@@@@@@@@@
@@@@@@@@@@@@@@@@@@@@@@@@@@@@@@@@@@@@@@@@@@@@@@@@@@@@@@TT..T......@@@@@@@@@......T.T@@@...T...TT.@@@@@@@@@@@@@@TT..TT.TTT..T..T.@@@@@@@@@@@@@
@@@@@@@@@@@@@@@@@@@@@@@@@@@@@@@@@@@@@@@@@@@@@@@@@@@@@@@..T.T...T..@@@@@@@@@..@@@T...@.T.T.TT...@@@@@@@@@@@@@@@@T..T.T......TT.@@@@@@@@@@@@@@
@@@@@@@@@@@@@@@@@@@@@@@@@@@@@@@@@@@@@@@@@@@@@@@@@@@@@@@@..T...TT..T.@@@@@@@@@@@@.....T...T....@@@@@@@@@@@@@@@@@@T..TTTTT...T.@@@@@@@@@@@@@@@
@@@@@@@@@@@@@@@@@@@@@@@@@@@@@@@@@@@@@@@@@@@@@@@@@@@@@@@@@TT....TT.TT.@@@@@@@@@@@@@.T...T.....@@@@@@@@@@@@@@@@@@@@TTT.T.T.T..@@@@@@@@@@@@@@@@
@@@@@@@@@@@@@@@@@@@@@@@@@@@@@@@@@@@@@@@@@@@@@@@@@@@@@@@@@@TT...T......@@@@@@@@@@@@T..TTT.TT.@@@@@@@@@@@@@@@@@@@@@@.TT......@@@@@@@@@@@@@@@@@
@@@@@@@@@@@@@@@@@@@@@@@@@@@@@@@@@@@@@@@@@@@@@@@@@@@@@@@@@@@.TTT..TTT..T@@@@@@@@@@TTTTTT...T@@@@@@@@@@@@@@@@@@@@@@@@..T.T..@@@@@@@@@@@@@@@@@@
@@@@@@@@@@@@@@@@@@@@@@@@@@@@@@@@@@@@@@@@@@@@@@@@@@@@@@@@@@@@.T.TTT..TTT.@@@@@@@@T.T..T.T..@@@@@@@@@@@@@@@@@@@@@@@@@@...T.@@@@@@@@@@@@@@@@@@@
@@@@@@@@@@@@@@@@@@@@@@@@@@@@@@@@@@@@@@@@@@@@@@@@@@@@@@@@@@@@@T..T..TT....@@@@@@T.T.T.TTTT@@@@@@@@@@@@@@@@@@@@@@@@@@@@.T.@@@@@@@@@@@@@@@@@@@@
@@@@@@@@@@@@@@@@@@@@@@@@@@@@@@@@@@@@@@@@@@@@@@@@@@@@@@@@@@@@@@.T..T..T....@@@@T..TT.TTT.@@@@@@@@@@@@@@@@@@@@@@@@@@@@@@T@@@@@@@@@@@@@@@@@@@@@
@@@@@@@@@@@@@@@@@@@@@@@@@@@@@@@@@@@@@@@@@@@@@@@@@@@@@@@@@@@@@@@...TTTTT.T.@@@.TT..T.TTT@@@@@@@@@@@@@@@@@@@@@@@@@@@@@@@@@@@@@@@@@@@@@@@@@@@@@
@@@@@@@@@@@@@@@@@@@@@@@@@@@@@@@@@@@@@@@@@@@@@@@@@@@@@@@@@@@@@@@@..T...TTTTT.TT....T.TT@@@@@@@@@@@@@@@@@@@@@@@@@@@@@@@@@@@@@@@@@@@@@@@@@@@@@@
@@@@@@@@@@@@@@@@@@@@@@@@@@@@@@@@@@@@@@@@@@@@@@@@@@@@@@@@@@@@@@@@@T..TT....TT.T.T..T.T@@@@@@@@@@@@@@@@@@@@@@@@@@@@@@@@@@@@@@@@@@@@@@@@@@@@@@@
@@@@@@@@@@@@@@@@@@@@@@@@@@@@@@@@@@@@@@@@@@@@@@@@@@@@@@@@@@@@@@@@@@T.TT.TT........TTT@@@@@@@@@@@@@@@@@@@@@@@@@@@@@@@@@@@@@@@@@@@@@@@@@@@@@@@@
@@@@@@@@@@@@@@@@@@@@@@@@@@@@@@@@@@@@@@@@@@@@@@@@@@@@@@@@@@@@@@@@@@@T..TT...T..T..T.@@@@@@@@@@@@@@@@@@@@@@@@@@@@@@@@@@@@@@@@@@@@@@@@@@@@@@@@@
@@@@@@@@@@@@@@@@@@@@@@@@@@@@@@@@@@@@@@@@@@@@@@@@@@@@@@@@@@@@@@@@@@@@.T..TT.T...T..@@@@@@@@@@@@@@@@@@@@@@@@@@@@@@@@@@@@@@@@@@@@@@@@@@@@@@@@@@
@@@@@@@@@@@@@@@@@@@@@@@@@@@@@@@@@@@@@@@@@@@@@@@@@@@@@@@@@@@@@@@@@@@@@.T.TT..T..T.@@@@@@@@@@@@@@@@@@@@@@@@@@@@@@@@@@@@@@@@@@@@@@@@@@@@@@@@@@@
@@@@@@@@@@@@@@@@@@@@@@@@@@@@@@@@@@@@@@@@@@@@@@@@@@@@@@@@@@@@@@@@@@@@@@.TT...TT..@@@@@@@@@@@@@@@@@@@@@@@@@@@@@@@@@@@@@@@@@@@@@@@@@@@@@@@@@@@@
@@@@@@@@@@@@@@@@@@@@@@@@@@@@@@@@@@@@@@@@@@@@@@@@@@@@@@@@@@@@@@@@@@@@@@@T.......@@@@@@@@@@@@@@@@@@@@@@@@@@@@@@@@@@@@@@@@@@@@@@@@@@@@@@@@@@@@@
@@@@@@@@@@@@@@@@@@@@@@@@@@@@@@@@@@@@@@@@@@@@@@@@@@@@@@@@@@@@@@@@@@@@@@@@.TTT..@@@@@@@@@@@@@@@@@@@@@@@@@@@@@@@@@@@@@@@@@@@@@@@@@@@@@@@@@@@@@@
@@@@@@@@@@@@@@@@@@@@@@@@@@@@@@@@@@@@@@@@@@@@@@@@@@@@@@@@@@@@@@@@@@@@@@@@@TT..@@@@@@@@@@@@@@@@@@@@@@@@@@@@@@@@@@@@@@@@@@@@@@@@@@@@@@@@@@@@@@@
@@@@@@@@@@@@@@@@@@@@@@@@@@@@@@@@@@@@@@@@@@@@@@@@@@@@@@@@@@@@@@@@@@@@@@@@@@T.@@@@@@@@@@@@@@@@@@@@@@@@@@@@@@@@@@@@@@@@@@@@@@@@@@@@@@@@@@@@@@@@
@@@@@@@@@@@@@@@@@@@@@@@@@@@@@@@@@@@@@@@@@@@@@@@@@@@@@@@@@@@@@@@@@@@@@@@@@@@@@@@@@@@@@@@@@@@@@@@@@@@@@@@@@@@@@@@@@@@@@@@@@@@@@@@@@@@@@@@@@@@@
@@@@@@@@@@@@@@@@@@@@@@@@@@@@@@@@@@@@@@@@@@@@@@@@@@@@@@@@@@@@@@@@@@@@@@@@@@@@@@@@@@@@@@@@@@@@@@@@@@@@@@@@@@@@@@@@@@@@@@@@@@@@@@@@@@@@@@@@@@@@
@@@@@@@@@@@@@@@@@@@@@@@@@@@@@@@@@@@@@@@@@@@@@@@@@@@@@@@@@@@@@@@@@@@@@@@@@@@@@@@@@@@@@@@@@@@@@@@@@@@@@@@@@@@@@@@@@@@@@@@@@@@@@@@@@@@@@@@@@@@@
@@@@@@@@@@@@@@@@@@@@@@@@@@@@@@@@@@@@@@@@@@@@@@@@@@@@@@@@@@@@@@@@@@@@@@@@@@@@@@@@@@@@@@@@@@@@@@@@@@@@@@@@@@@@@@@@@@@@@@@@@@@@@@@@@@@@@@@@@@@@
