type octile
height 59
width 56
map
@@@@@@@@@@@@@@@@@@@@@@@@@@@@@@@@@@@@@@@@@@@@@@@@@@@@@@@@
@@@@@@@@@@@@@@@@@@@@@@@@@@@@@@@@@@@@@@@@@@@@@@@@@@@@@@@@
@@@@@@@@@@@@@@@@@@@@@@@@@@@@@@@@@@@@@@@@@@@@@@@@@@@@@@@@
@@@@@@@@@@@@@@@@@@@@@@@@@@@@@@@@@@@@@@@@@@@@@@@@@@@@@@@@
@@@@@@@@@@@@@@@@@@@@@@@@@@@@@@@@@@@@@@@@@@@@@@@@@@@@@@@@
@@@@@@@@@@@@@@@@@@@@@@@@@@@@@@@@@@@@@@@@@@@@@@@@@@@@@@@@
@@@@@@@@@@@@@@@@@@@@@@@@@@@@@@@@@@@@@@@@@@@@@@@@@@@@@@@@
@@@@@@@@@@@@@@@@@@@@@@@@@@@@@@@@@@@@@@@@@@@@@@@@@@@@@@@@
@@@@@@@@@@@@@@@@@@@@@@@@@@@@@@@@@@@@@@@@@@@@@@@@@@@@@@@@
@@@@@@@@@@@@@@@@@@@@@@@@@@@@@@@@@@@@@@@@@@@@@@@@@@@@@@@@
@@@@@@@@@@@@@@@@@@@@@@@@@@@@@..@@@@@@@@@@@@@@@@@@@@@@@@@
@@@@@@@@@@@@@@@@@@@@@@@@@@@@@@.T@@@@@@@@@@@@@@@@@@@@@@@@
@@@@@@@@@@@@@@@@@@@@@@@@@@@@@@@TT@@@@@@@@@@@@@@@@@@@@@@@
@@@@@@@@@@@@@@@@@@@@@@@@@@@@@@@@T.T.@@@@@@@@@@@@@@@@@@@@
@@@@@@@@@@@@@@@@@@@@@@@@@@@@@@@@@.TT.@@@@@@@@@@@@@@@@@@@
@@@@@@@@@@@@@@@@@@@@@@@@@@@@@@@@@@T.TT@@@@@.@@@@@@@@@@@@
@@@@@@@@@@@@@@@@@@@@@@@.T@@@@@@@@@.TTTT@@@.T.@@@@@@@@@@@
@@@@@@@@@@@@@@@@@@@@@@...@@@@@@@@@T....T@T.T@@@@@@@@@@@@
@@@@@@@@@@@@@@@@@@@@@T...TT@@@@@@.T.T..TT..@@@@@@@@@@@@@
@@@@@@@@@@@@@@@@@@@@TT.T.T@@@@@@TT....TT.T.@@@@@@@@@@@@@
@@@@@@@@@@@@@@@@@@@@@T....@@@@@TTT.....TT...@@@@@@@@@@@@
@@@@@@@@@@@@@@@@@@@@@@....T@@@T...T..T.T.TTT.@@@@@@@@@@@
@@@@@@@@@@@@@@@@@@@@@@@....TT..TTT.TT...T....@@@@@@@@@@@
@@@@@@@@@@@@@@@@@@@@@@@@..TT..T.TTT....TT@@@@@@@@@@@@@@@
@@@@@@@@@@@@@@@@@@@@@@@@@TT....T..T.T..TT@@@@@@@@@@@@@@@
@@@@@@@@@@@@@@@@@@@@@@@@@.TTTT....T......@.....@@@@@@@@@
@@@@@@@@@@@@@@@..@@@@@@T...TT.........TTT@TT.....T@@@@@@
@@@@@@@@@@@@T..TT@@@@@@T..TT.T.......TT.....TT@@@..@@@@@
@@@@@@@@@@@...T.T@@@@.T.T..TT.T...TTT.TT......@@@@T.@@@@
@@@@@@@@@@.T.TT..@@@@.T...TT.TTT.T.T.T..@@T...@@@@..@@@@
@@@@@@@@@@..T....T..T..T..TT....T.......@@...@@@@@.@@@@@
@@@@@@@@@@@T.TT.TTT..TTTTTTTTTTT.T.TT..T@@TT.@@@@@@@@@@@
@@@@@@@@@@@@@.T..TT..T......TT..T......T@@....@@@@@@@@@@
@@@@@@@@@@@@@@.TTT...TTT.T.T....T.TT....@@T...TT@@@@@@@@
@@@@.@@@@@@@@@@.TT.....TT...TT.T..T.T..@@TT.TT.T@@@@@@@@
@@@.T.@@@@@@@@@T.TTT..T.TT.T.TTT.TT.T..@@@.T...@@@@@@@@@
@@..T.T@@@@@@.T..TTT.TT.T......TT.T.....@@....@@@@@@@@@@
@@.T.TT@@@@@T...T.TTT...TTT.TT..@@...T..T@T..@@@@@@@@@@@
@@.TT...@@..TTTT.T.T...TT.T....T@@TT.T....T.@@@@@@@@@@@@
@@TT..T........T..T.....T.TTTT.@@@@.T.T.TTT@@@@@@@@@@@@@
@@@TTTTTT.TT.T..T.........T.T@@@@@@@@.TTTT@@@@@@@@@@@@@@
@@@@TT...TT.T....TT.......T.T@@@@@@@@T...@@@@@@@@@@@@@@@
@@@@@.TTT.T..T.....TT.TTT..T.@@@@@@@..TT@@@@@@@@@@@@@@@@
@@@@@@T.TT.TTT.TT..T....TT...TT@@@@TT.@@@@@@@@@@@@@@@@@@
@@@@@@@.T...T.T..TTTTT...T.T.....T.T.@@@@@@@@@@@@@@@@@@@
@@@@@@@@...T...T..T.TT.@@....TT..TT.@@@@@@@@@@@@@@@@@@@@
@@@@@@@@@......T.TT.T..@@@..TT...TT@@@@@@@@@@@@@@@@@@@@@
@@@@@@@@@@.T..T..T...T@@@@.T...T..@@@@@@@@@@@@@@@@@@@@@@
@@@@@@@@@@@.T...T.TT@@@@@@TT..T.T@@@@@@@@@@@@@@@@@@@@@@@
@@@@@@@@@@@@.......T@@@@@@@....T@@@@@@@@@@@@@@@@@@@@@@@@
@@@@@@@@@@@@@..T.T..T.@@@@@T.TT@@@@@@@@@@@@@@@@@@@@@@@@@
@@@@@@@@@@@@@@TT...T...@@@@TT.@@@@@@@@@@@@@@@@@@@@@@@@@@
@@@@@@@@@@@@@@@...T.TT.TTTTT.@@@@@@@@@@@@@@@@@@@@@@@@@@@
@@@@@@@@@@@@@@@@.TT..TTTTT..@@@@@@@@@@@@@@@@@@@@@@@@@@@@
@@@@@@@@@@@@@@@@@.T.T...T..@@@@@@@@@@@@@@@@@@@@@@@@@@@@@
@@@@@@@@@@@@@@@@@@TT.TTT.T@@@@@@@@@@@@@@@@@@@@@@@@@@@@@@
@@@@@@@@@@@@@@@@@@@...TT.@@@@@@@@@@@@@@@@@@@@@@@@@@@@@@@
@@@@@@@@@@@@@@@@@@@@.T..@@@@@@@@@@@@@@@@@@@@@@@@@@@@@@@@
@@@@@@@@@@@@@@@@@@@@@@@@@@@@@@@@@@@@@@@@@@@@@@@@@@@@@@@@
