type octile
height 64
width 60
map
@@@@@@@@@@@@@@@@@@@@@@@@@@@@@@@@@@@@@@@@@@@@@@@@@@@@@@@@@@@@
@@@@@@@@@@@@@@@@@@@@@@@@@@@@@@@@@@@@@@@@@@@@@@@@@@@@@@@@@@@@
@@@@@@@@@@@@@@@@@@@@@@@@@@@@@@@@@@@@@@@@@@@@@@@@@@@@@@@@@@@@
@@@@@@@@@@@@@@@@@@@@@@@@@@@@@@@@@@@@@@@@@@@@@@@@@@@@@@@@@@@@
@@@@@@@@@@@@@@@@@@@@@@@@@@@@@@@@@@@@@@@@@@@@@@@@@@@@@@@@@@@@
@@@@@@@@@@@@@@@@@@@@@@@@@@@@@@@@@@@@@@@@@@@@@@@@@@@@@@@@@@@@
@@@@@@@@@@@@@@@@@@@@@@@@@@@@@@@@@@@@@@@@@@@@@@@@@@@@@@@@@@@@
@@@@@@@@@@@@@@@@@@@@@@@@@@@@@@@@@@@@@@@@@@@@@@@@@@@@@@@@@@@@
@@@@@@@@@@@@@@@@@@@@@@@@@@@@@@@@@@@@@@@@@@@@@@@@@@@@@@@@@@@@
@@@@@@@@@@@@@@@@@@@@@@@@@@@@@@@@@@@@@@@@@@@@@@@@@@@@@@@@@@@@
@@@@@@@@@@@@@@@@@@@@@@@@@@@@@@@@@@@@@@@@@@@@@@@@@@@@@@@@@@@@
@@@@@@@@@@@@@@@@@@@@@@@@@@@@@@@@@@@@@@@@@@@@@@@@@@@@@@@@@@@@
@@@@@@@@@@@@@@@@@@@@@@@@@@@@@@@@@@@@@@@@@@@@@@@@@@@@@@@@@@@@
@@@@@@@@@@@@@@@@@@@@@@@@@@@@@@@@@@@@@@@@@@@@@@@@@@@@@@@@@@@@
@@@@@@@@@@@@@@@@@@@@@@@@@@@@@@@@@@@@@@@@@@@@@@@@@@@@@@@@@@@@
@@@@@@@@@@@@@@@@@@@@@@@@@@@@@@@@@@@@@@@@@@@@@@@@@@@@@@@@@@@@
@@@@@@@@@@@@@@@@@@@@@@@@@@@@@@@@@@@@..@@@@@@@@@@@@@@@@@@@@@@
@@@@@@@@@@@@@@@@@@@@@@@@@@@@@@@@@@@@T..T..@@@@@@@@@@@@@@@@@@
@@@@@@@@@@@@@@@@@@@@@@@@@@@@@@@@@@@T...T..@@@@@@@@@@@@@@@@@@
@@@@@@@@@@@@@@@@@@@@@@@@@@@@@@@@@@T...T..T.@@@@@@@@@@@@@@@@@
@@@@@@@@@@@@@@@@@@@@@@@@@@@@@@@@@TT.T.T...TT.@@@@@@@@@@@@@@@
@@@@@@@@@@@@@@@@@@@@@@@@@@@@@@@@.T......T.TT..@@@@@@@@@@@@@@
@@@@@@@@@@@@@@@@@@@@@@@@@@@@@@@@@.@@TT..TTTT...@@@@@@@@@@@@@
@@@@@@@@@@@@@@@@@@@@@@@@@@@@@@@@@.@@..T...T.T...@@@@@@@@@@@@
@@@@@@@@@@@@@@@@@@@@@@@@@@@@@@@@T.....T..@@....T@@@@@@@@@@@@
@@@@@@@@@@@@@@@@@@@@@@@@@@@.@@..TT...T...@@..T.T.@@@TT@@@@@@
@@@@@@@@@@@@@@@@@@@@@@@@@@TT...........T.@.TT..TT.@@T.T@@@@@
@@@@@@@@@@@@@@@@@@@@@@@@@@..T.T......T....T.TT....T..TT@@@@@
@@@@@@@@@@@@@@@@@@@@@@@@@.TT.T..T..TTT..T..TT.T....TTT..@@@@
@@@@@@@@@@@@@@@@@@@@@@@@.T..TTT.T.TTTT...T.TT...........@@@@
@@@@@@@@@@@@@@@@@@@@@T......T@...T.T...T..T.TTT....TT..@@@@@
@@@@@@@@@@@@@@@@@@@@@@@T....@@@..T..TT.T.T.T........T.@@@@@@
@@@@@@@@@@@@@@@@@@@@@@@@T..@@@@@.......T..TTTT....T..@@@@@@@
@@@@@@@@@@@@@@@@@@@@@@@@..@@@@@@@TTT..TT..T..T..T...@@@@@@@@
@@@@@@@@@@@@@@@@@@@@@@@.TT@@@@@@@@T.TT..T.T...T....@@@@@@@@@
@@@@@@@@@@@@@@@@@@@@@.TT...@@@@@@@@T.....T.....T..@@@@@@@@@@
@@@@@@@@@@@@@@@@@@@@.TT.T...@@@@@@@.....T.TTTTT.T@@@@@@@@@@@
@@@@@@@@@@@@@@@@@@@...T.T.TTT@@@@@.T....T...TTT.@@@@@@@@@@@@
@@@@@@@@@@@@@@@@@@TT.TTTT.T..T@@@..TT..TT.TTT.T@@@@@@@@@@@@@
@@@@@@@@@@@@@@@@@...TTT..T.T.TT..TT....TT.....@@@@@@@@@@@@@@
@@@@@@@@@@@@@@@@T..T.T.T...TTTTT.T.T...T.T.T.@@@@@@@@@@@@@@@
@@@@@@@@@@@@@@@..@@@TT.T.T.TTT.....TT..TT..T@@@@@@@@@@@@@@@@
@@@@@@T@@@@@@@@.@@@@@..T....T.....TTT..T..T@@@@@@@@@@@@@@@@@
@@@@@...@@@@@@T.@@@@@@TTT..T.TTTTT...TTTT.@@@@@@@@@@@@@@@@@@
@@@@......@@@TTT.@@@@@@T..TT..TTT..TTTT..@@@@@@@@@@@@@@@@@@@
@@@..TTTT..@T.T.T.@@@@@..T.TT.T..TT.....@@@@@@@@@@@@@@@@@@@@
@@.T......TT.......@@@TT...TT.....TTT..@@@@@@@@@@@@@@@@@@@@@
@@......T....TTT..T...T.T.T.TT..TT..T.@@@@@@@@@@@@@@@@@@@@@@
@@@TTTT.T..T..T..T..T.T.TTT.T.TT.TTT.@@@@@@@@@@@@@@@@@@@@@@@
@@@@.TTT.TT.T....T......T.T.T.TTT..T@@@@@@@@@@@@@@@@@@@@@@@@
@@@@@T..T.T..T....T....T..TT......T@@@@@@@@@@@@@@@@@@@@@@@@@
@@@@@@...T.TTT.TT.T.......T..TT...@@@@@@@@@@@@@@@@@@@@@@@@@@
@@@@@@@T.T.T..TT.T....T....TT....@@@@@@@@@@@@@@@@@@@@@@@@@@@
@@@@@@@@T.TT.TT.....TT.T..T....T@@@@@@@@@@@@@@@@@@@@@@@@@@@@
@@@@@@@@@TTT.TT...T....T..TT.TT@@@@@@@@@@@@@@@@@@@@@@@@@@@@@
@@@@@@@@@@....T.T....TTTTT.TT.@@@@@@@@@@@@@@@@@@@@@@@@@@@@@@
@@@@@@@@@@@....T.......TT..T@@@@@@@@@@@@@@@@@@@@@@@@@@@@@@@@
@@@@@@@@@@@@....T.TTT....T.@@@@@@@@@@@@@@@@@@@@@@@@@@@@@@@@@
@@@@@@@@@@@@@.T..T.TT.TT.T@@@@@@@@@@@@@@@@@@@@@@@@@@@@@@@@@@
@@@@@@@@@@@@@@T...TT...T.@@@@@@@@@@@@@@@@@@@@@@@@@@@@@@@@@@@
@@@@@@@@@@@@@@@.T.T.T.T.@@@@@@@@@@@@@@@@@@@@@@@@@@@@@@@@@@@@
@@@@@@@@@@@@@@@@TTT..T.@@@@@@@@@@@@@@@@@@@@@@@@@@@@@@@@@@@@@
@@@@@@@@@@@@@@@@@@@@@@@@@@@@@@@@@@@@@@@@@@@@@@@@@@@@@@@@@@@@
@@@@@@@@@@@@@@@@@@@@@@@@@@@@@@@@@@@@@@@@@@@@@@@@@@@@@@@@@@@@
