type octile
height 86
width 88
map
@@@@@@@@@@@@@@@@@@@@@@@@@@@@@@@@@@@@@@@@@@@@@@@@@@@@@@@@@@@@@@@@@@@@@@@@@@@@@@@@@@@@@@@@
@@@@@@@@@@@@@@@@@@@@@@@@@@@@@@@@@@@@@@@@@@@@@@@@@@@@@@@@@@@@@@@@@@@@@@@@@@@@@@@@@@@@@@@@
@@@@@@@@@@@@@@@@@@@@@@@@@@@@@@@@@@@@@@@@@@@@@@@@@@@@@@@@@@@@@@@@@@@@@@@@@@@@@@@@@@@@@@@@
@@@@@@@@@@@@@@@@@@@@@@@@@@@@@@@@@@@@@@@@@@@@@@@@@@@@@@@@@@@@@@@@@@@@@@@@@@@@@@@@@@@@@@@@
@@@@@@@@@@@@@@@@@@@@@@@@@@@@@@@@@@@@@@@@@@@@@@@@@@@@@@@@@@@@@@@@@@@@@@@@@@@@@@@@@@@@@@@@
@@@@@@@@@@@@@@@@@@@@@@@@@@@@@@@@@@@@@@@@@@@@@@@@@@@@@@@@@@@@@@@@@@@@@@@@@@@@@@@@@@@@@@@@
@@@@@@@@@@@@@@@@@@@@@@@@@@@@@@@@@@@@@@@@@@@@@@@@@@@@@@@@@@@@@@@@@@@@@@@@@@@@@@@@@@@@@@@@
@@@@@@@@@@@@@@@@@@@@@@@@@@@@@@@@@@@@@@@@@@@@@@@@@@@@@@@@@@@@@@@@@@@@@@@@@@@@@@@@@@@@@@@@
@@@@@@@@@@@@@@@@@@@@@@@@@@@@@TT.@@@@@@.@@@@@@@@@@@@@@@@@@@@@@@@@@@@@@@@@@@@@@@@@@@@@@@@@
@@@@@@@@@@@@@@@@@@@@@@@@@@@@.....@@@@T.@@@@@@@@@@@@@@@@@@@@@@@@@@@@@@@@@@@@@@@@@@@@@@@@@
@@@@@@@@@@@@@@@@@@@@@@@@@@@.T.TT@@@@....@@@@@@@@@@@@@@@@@@@@@@@@@@@@@@@@@@@@@@@@@@@@@@@@
@@@@@@@@@@@@@@@@@@@@@@@@@@.T..T@@@@..T.T@@@@@@@@@@@@@@@@@@@@@@@@@@@@@@@@@@@@@@@@@@@@@@@@
@@@@@@@@@@@@@@@@@@@@@@@@@T....@@@@@@T...@@@@@@@@@@@@@@@@@@@@@@@@@@@@@@@@@@@@@@@@@@@@@@@@
@@@@@@@@@@@@@@@@@@@@@@@@.T.TT@@@@@@@@TTT@@@@@@@@@@@@@@@@@@@@@@@@@@@@@@@@@@@@@@@@@@@@@@@@
@@@@@@@@@@@@@@@@@@@@@@@..T.T@@@@@@@@@TT.@@@@@@@@@@@@@@@@@@@@@@@@@@@@@@@@@@@@@@@@@@@@@@@@
@@@@@@@@@@@@@@@@@@@@@@@T..T@@@@@@@@@@.T.@@@@@@@@@@@@@@@@@@@@@@@@@@@@@@@@@@@@@@@@@@@@@@@@
@@@@@@@@@@@@@@@@@@@@@@TT..@@@@@@@@@@TT..@@@@@@@@@@@@@@@@@@@@@@@@@@@@@@@@@@@@@@@@@@@@@@@@
@@@@@@@@@@@@@@@@@@@@@....@@@@@@@@@@..TT.TT@@@@@@@@@@@@@@@@@@@@@@@@@@@@@@@@@@@@@@@@@@@@@@
@@@@@@@@@@@@@@@@@@@@@T..@@@@@@@@@@.........@@@@@@@@@@@@@@@@@@@@@@@@@@@@@@@@@@@@@@@@@@@@@
@@@@@@@@@@@@@@@@@@@.T...@@@@@@@@@TT....T.T.T@@@@@@@@@@@@@@@@@@@@@@@@@@@@@@@@@@@@@@@@@@@@
@@@@@@@@@@@@@@@@@@@T.T.@@@@@@@@@..T....T..TT.@@@@@@@@@@@@@@@@@@@@@@@@@@@@@@@@@@@@@@@@@@@
@@@@@@@@@@@@@@@@@@@.T..@@@@@@@@.TTT.TT.......T@@@@@@@@@@@@@@@@@@@@@@@@@@@@@@@@@@@@@@@@@@
@@@@@@@@@@@@@@@@@@@.T..@@@@@@@T.T..TTT...TT...T@@@@@@@@@@@@@@@@@@@@@@@@@@@@@@@@@@@@@@@@@
@@@@@@@@@@@@@@@@@@T....T@@@@@..TTT.T...TT.T.T..T@@@@@@@@@@@@@@@@@@@@@@@@@@@@@@@@@@@@@@@@
@@@@@@@@@@@@@@@@@@......@@@@T......TTT.T......T.T@@@@@@@@@@@@@@@@@@@@@@@@@@@@@@@@@@@@@@@
@@@@@@@@@@@@@@@@@@@..TTT.@@@@T..T..........T....T.T@@@@@@@@@@@@@@@@@@@@@@@@@@@@@@@@@@@@@
@@@@@@@@@@@@@@@@@@@@.....T@@@@.TTTT.TT.TTT...T.T.T..@@@@@@@@@@@@@@@@@@@@@@@@@@@@@@@@@@@@
@@@@@@@@@@@@@@@@@@@@@TT.T.@@@@TT.......T@@.T.T....TTT@@@@@@@@@@@@@@@@@@@@@@@@@@@@@@@@@@@
@@@@@@@@@@@@@@@@@@@@@@...T.@@@@T....T...@@@@@..TT...TT@@@@@@@@@@@@@@@@@@@@@@@@@@@@@@@@@@
@@@@@@@@@@@@@@@@@@@@@@@..T..@@@@.T...T..T@@@@@T...TT.T..@@@@@@@@@@@@@@@@@@@@@@@@@@@@@@@@
@@@@@@@@@@@@@@@.T@@@@@@@@TT..@@@T.T..T..@@@@@@@@.TT.T.T.T.@@@@@@@@@@@@@@@@@@@@@@@@@@@@@@
@@@@@@@@@@@@@...TT@@@@@@@@.TTT@@TT..TTTT@@@@@@@@........TT.@@@@@@@@@@@@@@@@@@@@@@@@@@@@@
@@@@@@@@@@@@..TTTT.@@@@@@@@..T@T....T.T..@@@@@@@@...........@@@@@@@@@@@@@@@@@@@@@@@@@@@@
@@@@@@@@@@@T...TT.T.T.@@@@@@T....T....TT..@@@@@@@@......TTTTT@@@@@@@@@@@@@@@@@@@@@@@@@@@
@@@@@@@@@@T...T.T...T.@@@@@@....T......T..T@@@@@@@@.........T.T@@@@@@@@@@@@@@@@@@@@@@@@@
@@@@@@@@@.T..T.....TT.@@.@@@T..TT.....TTT.T.@@@@@@@@TT.T....T..@@@@@@@@@@@@@@@@@@@@@@@@@
@@@@@@....TTTT.@........TT@@...T...T.TT..TT..@@@@@@@@.T........@@@@@@@@@@@@@@@@@@@@@@@@@
@@@@@.T.....T.@@@.TT...TT..@T.@@@..TTT....TT..@@@@@@@@..T..TT.TT@@@@@@@@@@@@@@@@@@@@@@@@
@@@@...T..TTT@@@@@T.TTTT..T..T@@@T..TTT.T..TT.T@@@@@@@@TT.TT....@@@@@@@@@@@@@@@@@@@@@@@@
@@@@...T.TTT.@@@@@T.T.TTTTTTTTT@@@@TT.TTT.T..TT.@@@@@@@@T...T...T@@@@@@@@@@@@@@@@@@@@@@@
@@@@@TTT..T..T@@@@.T.TT.T....T@@@@@@@........TT..@@@@@@@@..TT..T.TT@@@@@@@@@@@@@@@@@@@@@
@@@@@@.....T...@T...TT....T..@@@@@@@@@.........T.T@@@@@@@@...TTTT....@@@@@@@@@@@@@@@@@@@
@@@@@@@....T..TT...TTT.....T.@@@@@@@@@@...TT..T...T@@@@@@@@T.....T.TT@@@@@@@@@@@@@@@@@@@
@@@@@@@@T....T......T....T.T@@@@@@@@@@@@T..T....T...@@@@@@@@.........@@@@@@@@@@@@@@@@@@@
@@@@@@@@@..T.T..T...T....@@@@@@@@@@@@@@@@.TT...T.T..TT@@@@@@@..TT.T..@@@@@@@@@@@@@@@@@@@
@@@@@@@@@@..T.TTT.T.T...T@@@@@@@@@@@@@@@@@...TTT..T.T..@@@@@@.T.T.T...@@@@@@@@@@@@@@@@@@
@@@@@@@@@@@.T.TT.T...T.T.T@@@@@@@@@@@@@@@@.TTTTTT.TT....@@@@@.TTTTT..TT@@@@@@@@@@@@@@@@@
@@@@@@@@@@@@....T..T.@@.T...TTT.@@@@..@@@......T..TT.....@@@@.T.T..TTT..T@@@@@@@@@@@@@@@
@@@@@@@@@@@@@T..T...@@@@TT.TT....@@....@TT.@@.T.TTT.TTT..T..T.TTT.TTT.TT..@@@@@@@@@@@@@@
@@@@@@@@@@@@@@....T@@@@@@T.T.T.TT..TTTT.TT@@@@.....T..TTTT..T..TT...T.T.T..@@@@@@@@@@@@@
@@@@@@@@@@@@@@@.T.@@@@@@@..T.TTT....TT.TT.@@@@@TT.TTT..T.T..T.T....TT.T....TT@@@@@@@@@@@
@@@@@@@@@@@@@@@@.@@@@@@@.T.T...T..T...T...@@@@@T......TT....T.T.@@@@..TT...T.T@@@@@@@@@@
@@@@@@@@@@@@@@@@@@@@@@@..T.T...TTT..TTT..T.@@@@@........T.T..T.T@@@@@.TT...T.T.@@@@@@@@@
@@@@@@@@@@@@@@@@@@@@@@T..T..T.TT.T...T..T...@@@@@.TT.T......TTT.@@@@@TTTT@@.T.@@@@@@@@@@
@@@@@@@@@@@@@@@@@@@@@TTT.TTT...T.T.....T....@@@@@@TTT......TTTT@@@@@T...T@@@T@@@@@@@@@@@
@@@@@@@@@@@@@@@@@@@@.T.....T..T...T......TTT@@@@@@@T.TTT.TTT...@@@@@.TT.@@@@@@@@@@@@@@@@
@@@@@@@@@@@@@@@@@@@@..T.T........TT..TTT....@@@@@@@...T....T.T..@@@TTT.@@@@@@@@@@@@@@@@@
@@@@@@@@@@@@@@@@@@@@@T..TT.T.T..TT.T....T..T..@@@@@@T..T.T.T.T..T.TT...@@@@@@@@@@@@@@@@@
@@@@@@@@@@@@@@@@@@@@@@T..TT...TTT....TT.T.....@@@@@@@...T.T....T..T.T@@@@T@@@@@@@@@@@@@@
@@@@@@@@@@@@@@@@@@@@@@@TT..TT.....T.T...T..TT@@@@@@@@@@...TT@@@@.....@@@T..T@@@@@@@@@@@@
@@@@@@@@@@@@@@@@@@@@@@@@.TTT.T....TT.T.T..TT@@@@@@@@@@TT.TT.T@@@@@.T@@@.T....@@@@@@@@@@@
@@@@@@@@@@@@@@@@@@@@@@@@@.....T...TT....T...@@@@@@.T@.T@T.TTTT.@@@@@@@.TT.T..T@@@@@@@@@@
@@@@@@@@@@@@@@@@@@@@@@@@@@TT..T.TTT.TT....T..@@@@T.T..@@@.TTTTTT@@@@@@T.TT...@@@@@@@@@@@
@@@@@@@@@@@@@@@@@@@@@@@@@@@.....T.TT..TT.@.TTT@@@...T.@@@@.....T..@@@......T@@@@@@@@@@@@
@@@@@@@@@@@@@@@@@@@@@@@@@@@@TTT.TT....TT@@@@T..@..T.T.T@@@@TTTT.TTT...TT..T@@@@@@@@@@@@@
@@@@@@@@@@@@@@@@@@@@@@@@@@@@@.TTT.T....@@@@@T....TT....T@@@@T..TTTT.TTT.T.@@@@@@@@@@@@@@
@@@@@@@@@@@@@@@@@@@@@@@@@@@@@@T..T..T.@@@@@T..TT.T..TTT..@@@@.T......TT.T@@@@@@@@@@@@@@@
@@@@@@@@@@@@@@@@@@@@@@@@@@@@@@@...TT.@@@@@T.TT.TT.T....T.T@@@@.TT...TT..@@@@@@@@@@@@@@@@
@@@@@@@@@@@@@@@@@@@@@@@@@@@@@@@@....@@@@@T..TTTTTT........@@@@@T...T...@@@@@@@@@@@@@@@@@
@@@@@@@@@@@@@@@@@@@@@@@@@@@@@@@@@@.@@@@@@TT..TTTTT.@@@@...@@@@@@...T..@@@@@@@@@@@@@@@@@@
@@@@@@@@@@@@@@@@@@@@@@@@@@@@@@@@@@@@@@@@.T.....T..@@@@@T..@@@@@@@..T.@@@@@@@@@@@@@@@@@@@
@@@@@@@@@@@@@@@@@@@@@@@@@@@@@@@@@@@@@@@..TT.TT..TT@@@@@TTT.@@@@@@@.T@@@@@@@@@@@@@@@@@@@@
@@@@@@@@@@@@@@@@@@@@@@@@@@@@@@@@@@@@@@TTTT.T....T@@@@@..TTT@@@@@@@@@@@@@@@@@@@@@@@@@@@@@
@@@@@@@@@@@@@@@@@@@@@@@@@@@@@@@@@@@@@@..T....T...@@@@@T.TT@@@@@@@@@@@@@@@@@@@@@@@@@@@@@@
@@@@@@@@@@@@@@@@@@@@@@@@@@@@@@@@@@@@@@@.......T.@@@@@T...@@@@@@@@@@@@@@@@@@@@@@@@@@@@@@@
@@@@@@@@@@@@@@@@@@@@@@@@@@@@@@@@@@@@@@@@T.TT....@@@@..T.@@@@@@@@@@@@@@@@@@@@@@@@@@@@@@@@
@@@@@@@@@@@@@@@@@@@@@@@@@@@@@@@@@@@@@@@@@T.T..TT@@@..TT@@@@@@@@@@@@@@@@@@@@@@@@@@@@@@@@@
@@@@@@@@@@@@@@@@@@@@@@@@@@@@@@@@@@@@@@@@@@...T....T.T..@@@@@@@@@@@@@@@@@@@@@@@@@@@@@@@@@
@@@@@@@@@@@@@@@@@@@@@@@@@@@@@@@@@@@@@@@@@@@.T..T...T..T@@@@@@@@@@@@@@@@@@@@@@@@@@@@@@@@@
@@@@@@@@@@@@@@@@@@@@@@@@@@@@@@@@@@@@@@@@@@@@..T..T...TT.@@@@@@@@@@@@@@@@@@@@@@@@@@@@@@@@
@@@@@@@@@@@@@@@@@@@@@@@@@@@@@@@@@@@@@@@@@@@@@..T.T...TTT.@@@@@@@@@@@@@@@@@@@@@@@@@@@@@@@
@@@@@@@@@@@@@@@@@@@@@@@@@@@@@@@@@@@@@@@@@@@@@@..T...T.T.@@@@@@@@@@@@@@@@@@@@@@@@@@@@@@@@
@@@@@@@@@@@@@@@@@@@@@@@@@@@@@@@@@@@@@@@@@@@@@@@.T..T..T@@@@@@@@@@@@@@@@@@@@@@@@@@@@@@@@@
@@@@@@@@@@@@@@@@@@@@@@@@@@@@@@@@@@@@@@@@@@@@@@@@@T...@@@@@@@@@@@@@@@@@@@@@@@@@@@@@@@@@@@
@@@@@@@@@@@@@@@@@@@@@@@@@@@@@@@@@@@@@@@@@@@@@@@@@@TT@@@@@@@@@@@@@@@@@@@@@@@@@@@@@@@@@@@@
@@@@@@@@@@@@@@@@@@@@@@@@@@@@@@@@@@@@@@@@@@@@@@@@@@@@@@@@@@@@@@@@@@@@@@@@@@@@@@@@@@@@@@@@
