type octile
height 118
width 128
map
@@@@@@@@@@@@@@@@@@@@@@@@@@@@@@@@@@@@@@@@@@@@@@@@@@@@@@@@@@@@@@@@@@@@@@@@@@@@@@@@@@@@@@@@@@@@@@@@@@@@@@@@@@@@@@@@@@@@@@@@@@@@@@@@
@@@@@@@@@@@@@@@@@@@@@@@@@@@@@@@@@@@@@@@@@@@@@@@@@@@@@@@@@@@@@@@@@@@@@@@@@@@@@@@@@@@@@@@@@@@@@@@@@@@@@@@@@@@@@@@@@@@@@@@@@@@@@@@@
@@@@@@@@@@@@@@@@@@@@@@@@@@@@@@@@@@@@@@@@@@@@@@@@@@@@@@@@@@@@@@@@@@@@@@@@@@@@@@@@@@@@@@@@@@@@@@@@@@@@@@@@@@@@@@@@@@@@@@@@@@@@@@@@
@@@@@@@@@@@@@@@@@@@@@@@@@@@@@@@@@@@@@@@@@@@@@@@@@@@@@@@@@@@@@@@@@@@@@@@@@@@@@@@@@@@@@@@@@@@@@@@@@@@@@@@@@@@@@@@@@@@@@@@@@@@@@@@@
@@@@@@@@@@@@@@@@@@@@@@@@@@@@@@@@@@@@@@@@@@@@@@@@@@@@@@@@@@@@@@@@@@@@@@@@@@@@@@@@@@@@@@@@@@@@@@@@@@@@@@@@@@@@@@@@@@@@@@@@@@@@@@@@
@@@@@@@@@@@@@@@@@@@@@@@@@@@@@@@@@@@@@@@@@@@@@@@@@@@@@@@@@@@@@@@@@@@@@@@@@@@@@@@@@@@@@@@@@@@@@@@@@@@@@@@@@@@@@@@@@@@@@@@@@@@@@@@@
@@@@@@@@@@@@@@@@@@@@@@@@@@@@@@@@@@@@@@@@@@@@@@@@@@@@@@@@@@@@@@@@@@@@@@@@@@@@@@@@@@@@@@@@@@@@@@@@@@@@@@@@@@@@@@@@@@@@@@@@@@@@@@@@
@@@@@@@@@@@@@@@@@@@@@@@@@@@@@@@@@@@@@@@@@@@@@@@@@@@@@@@@@@@@@@@@@@@@@@@@@@@@@@@@@@@@@@@@@@@@@@@@@@@@@@@@@@@@@@@@@@@@@@@@@@@@@@@@
@@@@@@@@@@@@@@@@@@@@@@@@@@@@@@@@@@@@@@@@@@@@@@@@@@@@@@@@@@@@@@@@@@@@@@@@@@@@@@@@@@@@@@@@@@@@@@@@@@@@@@@@@@@@@@@@@@@@@@@@@@@@@@@@
@@@@@@@@@@@@@@@@@@@@@@@@@@@@@@@@@@@@@@@@@@@@@@@@@@@@@@@@@@@@@@@@@@@@@@@@@@@@@@@@@@@@@@@@@@@@@@@@@@@@@@@@@@@@@@@@@@@@@@@@@@@@@@@@
@@@@@@@@@@@@@@@@@@@@@@@@@@@@@@@@@@@@@@@@@@@@@@@@@@@@@@@@@@@@@@@@@@@@@@@@@@@@@@@@@@@@@@@@@@@@@@@@@@@@@@@@@@@@@@@@@@@@@@@@@@@@@@@@
@@@@@@@@@@@@@@@@@@@@@@@@@@@@@@@@@@@@@@@@@@@@@@@@@@@@@@@@@@@@@@@@@@@@@@@@@@@@@@@@@@@@@@@@@@@@@@@@@@@@@@@@@@@@@@@@@@@@@@@@@@@@@@@@
@@@@@@@@@@@@@@@@@@@@@@@@@@@@@@@@@@@@@@@@@@@@@@@@@@@@@@@@@@@@@@@@@@@@@@@@@@@@@@@@@@@@@T.@@@@@@@@@@@@@@@@@@@@@@@@@@@@@@@@@@@@@@@@@
@@@@@@@@@@@@@@@@@@@@@@@@@@@@@@@@@@@@@@@@@@@@@@@@@@@@@@@@@@@@@@@@@@@@@@@@@@@@@@@@@@@@TT..@@@@@@@@@@@@@@@@@@@@@@@@@@@@@@@@@@@@@@@@
@@@@@@@@@@@@@@@@@@@@@@@@@@@@@@@@@@@@@@@@@@@@@@@@@@@@@@@@@@@@@@@@@@@@@@@@@@@@@@@@@...T...@@@@@@@@@@@@@@@@@@@@@@@@@@@@@@@@@@@@@@@@
@@@@@@@@@@@@@@@@@@@@@@@@@@@@@@@@@@@@@@@@@@@@@@@@@@@@@@@@@@@@@@@@@@@@@@@@@@@@@@@@....@@.T@@@@@@@@@@@@@@@@@@@@@@@@@@@@@@@@@@@@@@@@
@@@@@@@@@@@@@@@@@@@@@@@@@@@@@@@@@@@@@@@@@@@@@@@@@@@@@@@@@@@@@@@@@@@@@@@@@@@@@@@@TTTT@@TT.@@@@@@@@@@@@@@@@@@@@@@@@@@@@@@@@@@@@@@@
@@@@@@@@@@@@@@@@@@@@@@@@@@@@@@@@@@@@@@@@@@@@@@@@@@@@@@@@@@@@@@@@@@@@@@@@@@@@@@@@..TTT@T.TT@@@@@@@@@@@@@@@@@@@@@@@@@@@@@@@@@@@@@@
@@@@@@@@@@@@@@@@@@@@@@@@@@@@@@@@@@@@@@@@@@@@@@@@@@@@@@@@@@@@@@@@@@@@@@@@@@@@@@@T.T...@.T.@@TT@@@@@@@@@@@@@@@@@@@@@@@@@@@@@@@@@@@
@@@@@@@@@@@@@@@@@@@@@@@@@@@@@@@@@@@@@@@@@@@@@@@@@@@@@@@@@@@@@@@@@@@@@@@@@@@@@@TTT.T...T.@@@..T.@@@@@@@@@@@@@@@@@@@@@@@@@@@@@@@@@
@@@@@@@@@@@@@@@@@@@@@@@@@@@@@@@@@@@@@@@@@@@@@@@@@@@@@@@@@@@@@@@@@@@@@@@@@@@T...T.T...TTT@@T.TT.@@@@@@@@@@@@@@@@@@@@@@@@@@@@@@@@@
@@@@@@@@@@@@@@@@@@@@@@@@@@@@@@@@@@@@@@@@@@@@@@@@@@@@@@@@@@@@@@@@@@@@@@@@@@.TT.TTTTTTT..TTT...T@@@@@@@@@@@@@@@@@@@@@@@@@@@@@@@@@@
@@@@@@@@@@@@@@@@@@@@@@@@@@@@@@@@@@@@@@@@@@@@@@@@@@@@@@@@@@@@@@@@@@@@@@@@@TT.TTT..T.TT...TT.TT.@@@@@@@@@@@@@@@@@@@@@@@@@@@@@@@@@@
@@@@@@@@@@@@@@@@@@@@@@@@@@@@@@@@@@@@@@@@@@@@@@@@@@@@@@@@@@@@@@@@@@@@@@@@T..T.....T.T...TTT..TT.@@@@@@@@@@@@@@@@@@@@@@@@@@@@@@@@@
@@@@@@@@@@@@@@@@@@@@@@@@@@@@@@@@@@@@@@@@@@@@@@@@@@@@@@@@@@@@@@@@@@@@@@@.........T..TT...TTT@@T..T.TT@@@@@@@@@@@@@@@@@@@@@@@@@@@@
@@@@@@@@@@@@@@@@@@@@@@@@@@@@@@@@@@@@@@@@@@@@@@@@@@@@@@@@@@@@@@@@@@@@@@TT.TT.T.T.T.TTTT..TT@@@.....T.T@@@@@@@@@@@@@@@@@@@@@@@@@@@
@@@@@@@@@@@@@@@@@@@@@@@@@@@@@@@@@@@@@@@@@@@@@@@@@@@@@@@@@@@@@@@@@@@@@..T..T......T...T....@@T......T..@@@@@@@@@@@@@@@@@@@@@@@@@@
@@@@@@@@@@@@@@@@@@@@@@@@@@@@@@@@@@@@@@@@@@@@@@@@@@@@@@@@@@@@@@@@@@@@..TT..T.T....T.T...TTT.@.T...T..T@@@@@@@@@@@@@@@@@@@@@@@@@@@
@@@@@@@@@@@@@@@@@@@@@@@@@@@@@@@@@@@@@@@@@@@@@@@@@@@@@@@@@@@@@@@@@@@TT.TT.....TTT.T....TT....T.T.T.T.TT@@@@@@@@@@@@@@@@@@@@@@@@@@
@@@@@@@@@@@@@@@@@@@@@@@@@@@@@@@@@@@@@@@@@@@@@@@@@@@@@@@@@@@@@@@@@@T..T.T.T..T..T...T.T......T...TT..TT.@@@@@@@@@@@@@@@@@@@@@@@@@
@@@@@@@@@@@@@@@@@@@@@@@@@@@@@@@@@@@@@@@@@@@@@@@@@@@@@@@@@@@@@@@@@.T.T..TTT..T.TT....T.T.TT.TT..TT..T@@TT@@@@@@@@@@@@@@@@@@@@@@@@
@@@@@@@@@@@@@@@@@@@@@@@@@@@@@@@@@@@@@@@@@@@@@@@@@@@@@@@@@@@@@@@@.T.T...........TT....T...T.T@@T.T...@@T..@@@@@@@@@@@@@@@@@@@@@@@
@@@@@@@@@@@@@@@@@@@@@@@@@@@@@@@@@@@@@@@@@@@@@@@@@@@@@@@@@@@@@@@@.....T..T.T....TT......TTTT@@@@T....@..T.@@@@@@@@@@@@@@@@@@@@@@@
@@@@@@@@@@@@@@@@@@@@@@@@@@@@@@@@@@@@@@@@@@@@@@@@@@@@@@@@TTT@@@@@..TT..TT.....TT..T.TT.TT@@@@@@@@TTT..T.T@@@@@@@@@@@@@@@@@@@@@@@@
@@@@@@@@@@@@@@@@@@@@@@@@@@@@@@@@@@@@@@@@@@@@@@@@@@@@@@@@T.T@@@@@TT.TT.TT...T..T.TTT.T..@@@@@@@@@@T.T...@@@@@@@@@@@@@@@@@@@@@@@@@
@@@@@@@@@@@@@@@@@@@@@@@@@@@@@@@@@@@@@@@@@@@@@@@@@@@@@@@@TT.@@@@@TTTTT.T.T.T....T.T..T...@@@@@@@@@T..T.T@@@@@@@@@@@@@@@@@@@@@@@@@
@@@@@@@@@@@@@@@@@@@@@@@@@@@@@@@@@@@@@@@@@@@@@@@@@@@@@@@@...@@@@T...T.T........T....T....T@@@@@@@..T.TT@@@@@@@@@@@@@@@@@@@@@@@@@@
@@@@@@@@@@@@@@@@@@@@@@@@@@@@@@@@@@@@@@@@@@@@@@@@@@@@@@@@...@@@.........T....T.TTT.T.T.TT..@@@@@.TT...T@@@@@@@@@@@@@@@@@@@@@@@@@@
@@@@@@@@@@@@@@@@@@@@@@@@@@@@@@@@@@@@@@@@@@@@@@@@@.T@@@@@...@@..TTTT...TT....TTT..T..TTTT..T@@@@...T..T@@.T@@@@@@@@@@@@@@@@@@@@@@
@@@@@@@@@@@@@@@@@@@@@@@@@@@@@@@@@@@@@@@@@@@@@@@@.....T...T..TT..TT..TTT.T....TT.TT.T.T.TTT..@@T.T@@@@TT.TTT@@@@@@@@@@@@@@@@@@@@@
@@@@@@@@@@@@@@@@@@@@@@@@@@@@@@@@@@@@@@@@@@@@@@@.T..TT.TT.TT..T..TT..T.T......TTT.......T..TT.TT.@@@@T..T.T..@@@@@@@@@@@@@@@@@@@@
@@@@@@@@@@@@@@@@@@@@@@@@@@@@@@@@@@@@@@@@@@@@@@T.T.T@@@@..TTTT..@@@.T.T.TT.T.T..TT.TT.T..........@@@@T..T...TT@@@@@@@@@@@@@@@@@@@
@@@@@@@@@@@@@@@@@@@@@@@@@@@@@@@@@@@@@@@@@@@@@T..TT.@..@@.......@@TT.TT..T......TT.....T..T....T@@@@@..TTT.....@@@@@@@@@@@@@@@@@@
@@@@@@@@@@@@@@@@@@@@@@@@@@@@@@@@@@@@@@@@@@@@..T........@TTTT...T...T.T.T.TTT.TTTTT....TT.TTT..T.@@@@@...T..T.T.@@@@@@@@@@@@@@@@@
@@@@@@@@@@@@@@@@@@@@@@@@@@@@@@@@@@@@@@@@@@T@..T..T....T@T....T..T.TTT...T.TT....T.TT..TT.T..TT.T@@@@@@...TTT..T.@@@@@@@@@@@@@@@@
@@@@@@@@@@@@@@@@@@@@@@@@@@@@@@@@@@@@@@@@@@T..TTT..T@@TT@@T@@....TTTT.@@.T.T...T.......TT.TT.T..TT@@@@@@T.T..TTTT.@@@@@@@@@@@@@@@
@@@@@@@@@@@@@@@@@@@@@@@@@@@@@@@@@@@@@@@@@@@T....@@@@@..T@T@@..T...T..@@.T.TT....T....TTT......T.T.@@@@@@T..TTT..T.@@@@@@@@@@@@@@
@@@@@@@@@@@@@@@@@@@@@@@@@@@@@@@@@@@@@@@@@@@@.TT@@@@@@T..T..@@TT.....@@..TTT...T.....TTTTT.......T..@@@@@@...TTTTT..@@@@@@@@@@@@@
@@@@@@@@@@@@@@@@@@@@@@@@@@@@@@@@@@@@@@@@@@@@@T.T.T@@@T.T.@TT.TTT.TT...T...TTT.T...TT.T.T..TTT..T....@@@@@@TT..T.T.T.@@@@@@@@@@@@
@@@@@@@@@@@@@@@@@@@@@@@@@@@@@@@@@@@@@..@@@@@@..TT.TTT...T@T.TT.@@@@.....TT..TT...TTTTTTTT.TT.T.T...T.@@@@@@.T.T..T.TT@@@@@@@@@@@
@@@@@@@@@@@@@@@@@@@@@@@@@@@@@@@@@@@@..T.@@@@@T..T.T.T.T....T..@@@@@T.T.TTT.T.T........TT.T.T.TT..T.T.T@@@@@@@..T.T...T@@@@@@@@@@
@@@@@@@@@@@@@@@@@@@@@@@@@@@@@@@@@@@..TT..@@@@...T.T......T...TT.@@..T......TT.TT...TT.T.....T.T....T.@@@@@@@@@.......T.@@@@@@@@@
@@@@@@@@@@@@@@@@@@@@@@@@@@@@@@@@@@.T...T..@@.T.T..T..T..T.T.T.TTT.T.T...T..T..TT.T.....TT.T...T.TT.T@@@@@@@@@@@T......T.@@@@@@@@
@@@@@@@@@@@@@@@@@@@@@@@@@@@@@@@@@......T..@@.T.@@@T.........TT.T....TT....T.T..TT....T..T...TTT....@@@@@@@@@@@@@.T....T..@@@@@@@
@@@@@@@@@@@@@@@@@@@@@@@@@@@@@@@@...TT....T@@...@@@@TT....T.TT..TT........TT..TT....T......TT..T.T.@@@@@@@@@@@@@@@.TT.TT.TT@@@@@@
@@@@@@@@@@@@@@@@@@@@@@@@@@@@@@@T.T@@TT...@@..T@@@@@@....T.T.TTTT.T..T..TT.TT.........TT..T..TT..T@@@@@@@@@@@@@@@@@.TTTT.T.T@@@@@
@@@@@@@@@@@@@@@@@@@@@@@@@@@@@@..T.@@.TT.T@@.T.@@@@@@@@T....@@@@TTTT.TT..TT.TTT.T.TT.T....TT.T...@@@@@@@@@@@@@@@@@@@.....T..T@@@@
@@@@@@@@@@@@@@@@@@@@@@@@@@@@@.TTT.@@@.TT.@T..@@@@@@@@@.T.T.@@@@TTT..T.....TT..T.TT......T.TT.T.@@@@@@@@@@@@@@@@@@@@@...T..T..@@@
@@@@@@@@@@@@@@@@@@@@@@@@@@@@...T.T.@@@..T....@@@@@@@@@@....@@@@.T.TT.TT..@@T...T.TTTT..T.T.TT.@@@@@@@@@@@@@@@@@@@@@@@T.T.T.T.@@@
@@@@@@@@@@@@@@@@@@@@@@@@@@@T..TT.TT@@@@.T....@@@@@@@@@@@..T.@@@......T...@@.TT..TTT....TT....@@@@@@@@@@@@@@@@@@@@@@@@.TT..TT@@@@
@@@@@@@@@@@@@@@@@@@@@@@@@@TT..T.....@@@@T...@@T@@@@@@@@@@TTT...TT.TT...T@@.T@@TT..T.@@@TT.TT@@@@@@@@@@@@@@@@@@@@@@@@@T.TT.T@@@@@
@@@@@@@@@@@@@@@@@@@@@@@@@TTTT..T@@..T@@@@T..@TTT..@@@@@@@@T.T..T.T....T.@T.@@@T.T...@@@..T.@@@@@@@@@@@@@@@@@@@@@@@@@...TT.@@@@@@
@@@@@@@@@@@@@@@@@@@@@@@@T...T...@@@T..T@@@.....T.T@@@@@@@@@...TT....T..T..@@@.T.T...T..TTT@@@@@@@@@@@@@@@@@@@@@@@@.T.TT.T@@@@@@@
@@@@@@@@@@@@@@@@@@@@@@@T.@@...T.T@@@..T.@@@TTT.TTT@T.@@@@@@@..T@@...T..TT.@......TT..T.T.@@@@@@@@@@@@@@@@@@@@@@@@@.T..@@@@@@@@@@
@@@@@@@@@@@@@@@@@@@@@....@@T@@@..T@@@..T.@@@....TT.TTT@@@@@@@.T@@.TTT.T..T.T.T....T.....@@@@@@@@@@@@@@@@@@@@@@@@@@.T..@@@@@@@@@@
@@@@@@@@@@@@@@@@@@@@TTT.T@@.@@@@.TT@@@TT..@@.T..T.....@@@@@@@@TTTT.T.TT.....T.TT...T.T.@@@@@@@@@@@@@@@@@@@@@@@@@@@TTT..@@@@@@@@@
@@@@@@@@@@@@@@@@@@@..TTTT.TTT@@@@.T.@@@..T..T.......T.@.@@@@@@@T.T.T.TTT..TTTT...T.T..@@@@@@@@@@@@@@@@@@@@@@@@@@@@T...TT@@@@@@@@
@@@@@@@@@@@@@@@@@@T..T..T.....@@@@.T.@@@.TTTT.TT..T....T.@@@@@@.....T.TTTT.........T.@@@@@@@@@@@@@@@@@@@@@@@@@@@@.....T..@@@@@@@
@@@@@@@@@@@@@@@@@TT.....@@T.T..@@@@.TT@@.T..T..TT.T.T.....@@@@@..TT.T...@T..T......T..@@@@@@@@@@@@@@@@@@@@@@@@@@@@....T..T@@@@@@
@@@@@@@@@@@@@@@@T.......@@@T.TT.@@@@.T.T..T.TTT....TT.T.T.@@@@@T.TTTT.T.@.TT.....T.....@@@@@@@@@@@@@@@@@@@@@@@@@@..T.TT....@@@@@
@@@@@@@@@@@@@@@T.TT.T.TT.@@@TTT.T@@@@.....TTTT.T.T@@@....T.TT@@...@T.....T....TTT.T.TT..@@@@@@@@@@@@@@@@.@@@@@@@.TT...TT...@@@@@
@@@@@@@@@@@@@@.T......T.T.@@@T.TTT@@@TT...TT......@@@@T.TT.TT@T..@@@.TT..TT.....T..T.T..T@@@@@@@@@@@@@@..T.T..T.TTT..TTT.T@@@@@@
@@@@@@@@@@@@@...@@.T.@@....@@@.TT...T.T.T.T..T.....@@@@T.T.T@@...@@@@...T...T.@@.....T..TT@@@@@@@@@@@@T..TT..T..T..TT..TT@@@@@@@
@@@@@@@@@@@@....@@TT.@@@..TT@@@TT...T..T.....T.....T@@@@...T@....@@@@@.......@@@@.T...T...@@@@@@@@@@@@.TT.T....TTTT..T.T@@@@@@@@
@@@@@@@@@@@.T.T.@@T.T.@@TTT..@@@TTT.TT.....T..TT@@...@@@@.TT@TT.@@@@@@@T...T@@@@@@...T....@@@@@@@@@@@.T.TT..TTTT...T.T.@@@@@@@@@
@@@@@@@@@@..T..T..TTTTT@@...TT@@.T...TT..TT...TT@@@.TT@@@..@@.T.@@@@@@@@...@@@@@@@@T...TTT..@T@@@@.@@.T...T.T......TTT@@@@@@@@@@
@@@@@@@@@T.T........TT.@@@TT.T@@TT..TT..T.@@@.T.@@@@..T@@@.TT..@@..@@@@@@T@@@@@@@@@@.@@@@T..T.T.....TT......T..TTT...@@@@@@@@@@@
@@@@@@@@@@T.TTT..@@T.T..@@@.TT.TT...TT....@@@@...@@@T...@@@TT.T@@..T@@@@@@@@@@@@@@@@@@@@@.T.TT.TT.T...T@.....T......@@@@@@@@@@@@
@@@@@@@@@@@TT....@@@T.TT.@@@...T.TT..T.T.T.@@@@TTT@@@..TT@T....@...T.@@@@@@@@@@@@@@@@@@@T..TTT...TTT@@@@@@TTTT.....@@@@@@@@@@@@@
@@@@@@@@@@@@.T...@@@@.TT.T@@..T.TT.T.TTT.T..@@@@@.T@@@T.TT..TT.TT..TTT@@@@@@@@@@@@@@@@@@TTT.....T.@@@@@@@@T...TT..@@@@@@@@@@@@@@
@@@@@@@@@@@@@TT.TT.@@@@TT.@@TT..T......@@@TTTT@@@@..@@@...TTT.T.TTT..@@@@@@@@@@@@@@@@@@@T.T.T....@@@@@@@@@TTT.T.T@@@@@@@@@@@@@@@
@@@@@@@@@@@@@@.TT..T@@@@...T.TTTTTT.TT.@@@@T.T.@@@@.@@@..T...TTT....@@@@@@@@@@@@@@@@@@@@@.T..T.TT@@@@@@@@@.T....@@@@@@@@@@@@@@@@
@@@@@@@@@@@@@@T.TTT.T.@@@..TT..T....@@.T.@@@...T@@@T.@@..TT.T.T....@@@@@@@@@@@@@@@@@@@@@@@.......@@@@@@@@@T.T..@@@@@@@@@@@@@@@@@
@@@@@@@@@@@@@@@.T..T...@@@..T.T.....@@@.T.@@@.T.T@@.T..T....TT..T.@@@@@@@@@@@@@@@@@@@@@@@@@TT.T.T@@@@@@@......@@@@@@@@@@@@@@@@@@
@@@@@@@@@@@@@@@@..TT.T.T@@T.T...T.T.T@@@...@@@T..T..T..TT.T.T.T.T@@@@@@@@@@@@@@@@@@@@@@@@@@@...TTT@@@@@T.....@@@@@@@@@@@@@@@@@@@
@@@@@@@@@@@@@@@@TT.T..T..TTT.T..T@@T..@@@@..@@@TTT....T.....T...@@@@@@@@@@@@@@@@@@@@@@@@@@@@@T....T..T....T.@@@@@@@@@@@@@@@@@@@@
@@@@@@@@@@@@@@@@@.....TTTT.T.TTT.@@...T@@@@.T@@@T..T....TT...TT@@@@@@@@@@@@@@@@@@@@@@@@@@@@@@@.T.....T..T..@@@@@@@@@@@@@@@@@@@@@
@@@@@@@@@@@@@@@@@..T...TT....TT..@@@..T.@@@@..@@.T.TT....T...T@@@@@@@@@@@@@@@@@@@@@@@@@@@@@@@@@....T..TTT.@@@@@@@@@@@@@@@@@@@@@@
@@@@@@@@@@@@@@@@@@.....T...TT..T..@@@TT.T@@@T.T....T.T..T.T..@@@@@@@@@@@@@@@@@@@@@@@@@@@@@@@@@@@.........@@@@@@@@@@@@@@@@@@@@@@@
@@@@@@@@@@@@@@@@@@T..TT....T.T..T.T@@@..T.@@.TT.T...T......T@@@@@@@@@@@@@@@@@@@@@@@@@@@@@@@@@@@@@TT....T@@@@@@@@@@@@@@@@@@@@@@@@
@@@@@@@@@@@@@@@@@@TTTT.T.T..TTT..TT.@@@.T...T..T..T.TTT...T@@@@@@@@@@@@@@@@@@@@@@@@@@@@@@@@@@@@@@@TT...@@@@@@@@@@@@@@@@@@@@@@@@@
@@@@@@@@@@@@@@@@@@.T..TTTTTTTTTT.TT..@@@@...T....T.T......@@@@@@@@@@@@@@@@@@@@@@@@@@@@@@@@@@@@@@@@@...@@@@@@@@@@@@@@@@@@@@@@@@@@
@@@@@@@@@@@@@@@@.TT..TTTT.T..T.TT.TTTT@@@..T.T.....T....T@@@@@@@@@@@@@@@@@@@@@@@@@@@@@@@@@@@@@@@@@@@.@@@@@@@@@@@@@@@@@@@@@@@@@@@
@@@@@@@@@@@@@@@@..TT..........TT...TTTT@@....T..T..TT.TT@@@@@@@@@@@@@@@@@@@@@@@@@@@@@@@@@@@@@@@@@@@@@@@@@@@@@@@@@@@@@@@@@@@@@@@@
@@@@@@@@@@@@@@@TT.TT...TT.T..T.TT.TT..T...T.T....TT..T.@@@@@@@@@@@@@@@@@@@@@@@@@@@@@@@@@@@@@@@@@@@@@@@@@@@@@@@@@@@@@@@@@@@@@@@@@
@@@@@@@@@@@@@@..T.T.T.T..T.TT...T..T...TT....TT..TTT..@@@@@@@@@@@@@@@@@@@@@@@@@@@@@@@@@@@@@@@@@@@@@@@@@@@@@@@@@@@@@@@@@@@@@@@@@@
@@@@@@@@@@@@@@.T.TT....T...T......T.T..TT.TTT.T..T.TT@@@@@@@@@@@@@@@@@@@@@@@@@@@@@@@@@@@@@@@@@@@@@@@@@@@@@@@@@@@@@@@@@@@@@@@@@@@
@@@@@@@@@@@@@....TTT....T......T...T...TT.TT......T.@@@@@@@@@@@@@@@@@@@@@@@@@@@@@@@@@@@@@@@@@@@@@@@@@@@@@@@@@@@@@@@@@@@@@@@@@@@@
@@@@@@@@@@@@@.....TT...TT...TT.@T.TTT..TT...T.TTT..@@@@@@@@@@@@@@@@@@@@@@@@@@@@@@@@@@@@@@@@@@@@@@@@@@@@@@@@@@@@@@@@@@@@@@@@@@@@@
@@@@@@@@@@@@@@@@@@@..TT.TT..T.@@@TTT...TT.TT..T...@@@@@@@@@@@@@@@@@@@@@@@@@@@@@@@@@@@@@@@@@@@@@@@@@@@@@@@@@@@@@@@@@@@@@@@@@@@@@@
@@@@@@@@@@@@@@@@@@@TTT...TTT.@@@@@...T...TTT....T@@@@@@@@@@@@@@@@@@@@@@@@@@@@@@@@@@@@@@@@@@@@@@@@@@@@@@@@@@@@@@@@@@@@@@@@@@@@@@@
@@@@@@@@@@.@@@@@@@.T...TT...@@@@@@@T...........T@@@@@@@@@@@@@@@@@@@@@@@@@@@@@@@@@@@@@@@@@@@@@@@@@@@@@@@@@@@@@@@@@@@@@@@@@@@@@@@@
@@@@...T....T@@@@...T..T..T@@@@@@@@@TTTT..T.T.T@@@@@@@@@@@@@@@@@@@@@@@@@@@@@@@@@@@@@@@@@@@@@@@@@@@@@@@@@@@@@@@@@@@@@@@@@@@@@@@@@
@@@...TTT..TT..T..T...TT.T@@@@@@@@@@@T.TT..T..@@@@@@@@@@@@@@@@@@@@@@@@@@@@@@@@@@@@@@@@@@@@@@@@@@@@@@@@@@@@@@@@@@@@@@@@@@@@@@@@@@
@@.T.......TT......T...T.@@@@@@@@@@@@@T..TT..@@@@@@@@@@@@@@@@@@@@@@@@@@@@@@@@@@@@@@@@@@@@@@@@@@@@@@@@@@@@@@@@@@@@@@@@@@@@@@@@@@@
@..T....T...T..T......T.@@@@@@@@@@@@@@@TTT..@@@@@@@@@@@@@@@@@@@@@@@@@@@@@@@@@@@@@@@@@@@@@@@@@@@@@@@@@@@@@@@@@@@@@@@@@@@@@@@@@@@@
@@T...TTT..TTTT..T....T@@@@@@@@@@@@@@@@@T..@@@@@@@@@@@@@@@@@@@@@@@@@@@@@@@@@@@@@@@@@@@@@@@@@@@@@@@@@@@@@@@@@@@@@@@@@@@@@@@@@@@@@
@@@....T..TTTTT.TTT.TT@@@@@@@@@@@@@@@@@@@.@@@@@@@@@@@@@@@@@@@@@@@@@@@@@@@@@@@@@@@@@@@@@@@@@@@@@@@@@@@@@@@@@@@@@@@@@@@@@@@@@@@@@@
@@@@....T.T..TTTT....@@@@@@@@@@@@@@@@@@@@@@@@@@@@@@@@@@@@@@@@@@@@@@@@@@@@@@@@@@@@@@@@@@@@@@@@@@@@@@@@@@@@@@@@@@@@@@@@@@@@@@@@@@@
@@@@@T....TT...T..TT@@@@@@@@@@@@@@@@@@@@@@@@@@@@@@@@@@@@@@@@@@@@@@@@@@@@@@@@@@@@@@@@@@@@@@@@@@@@@@@@@@@@@@@@@@@@@@@@@@@@@@@@@@@@
@@@@@@T.T.T...T.TTT@@@@@@@@@@@@@@@@@@@@@@@@@@@@@@@@@@@@@@@@@@@@@@@@@@@@@@@@@@@@@@@@@@@@@@@@@@@@@@@@@@@@@@@@@@@@@@@@@@@@@@@@@@@@@
@@@@@@@.T....TT..T@@@@@@@@@@@@@@@@@@@@@@@@@@@@@@@@@@@@@@@@@@@@@@@@@@@@@@@@@@@@@@@@@@@@@@@@@@@@@@@@@@@@@@@@@@@@@@@@@@@@@@@@@@@@@@
@@@@@@@@T.....T..@@@@@@@@@@@@@@@@@@@@@@@@@@@@@@@@@@@@@@@@@@@@@@@@@@@@@@@@@@@@@@@@@@@@@@@@@@@@@@@@@@@@@@@@@@@@@@@@@@@@@@@@@@@@@@@
@@@@@@@@@TT.TT..@@@@@@@@@@@@@@@@@@@@@@@@@@@@@@@@@@@@@@@@@@@@@@@@@@@@@@@@@@@@@@@@@@@@@@@@@@@@@@@@@@@@@@@@@@@@@@@@@@@@@@@@@@@@@@@@
@@@@@@@@@@T..T.@@@@@@@@@@@@@@@@@@@@@@@@@@@@@@@@@@@@@@@@@@@@@@@@@@@@@@@@@@@@@@@@@@@@@@@@@@@@@@@@@@@@@@@@@@@@@@@@@@@@@@@@@@@@@@@@@
@@@@@@@@@@@...@@@@@@@@@@@@@@@@@@@@@@@@@@@@@@@@@@@@@@@@@@@@@@@@@@@@@@@@@@@@@@@@@@@@@@@@@@@@@@@@@@@@@@@@@@@@@@@@@@@@@@@@@@@@@@@@@@
@@@@@@@@@@@@@@@@@@@@@@@@@@@@@@@@@@@@@@@@@@@@@@@@@@@@@@@@@@@@@@@@@@@@@@@@@@@@@@@@@@@@@@@@@@@@@@@@@@@@@@@@@@@@@@@@@@@@@@@@@@@@@@@@
@@@@@@@@@@@@@@@@@@@@@@@@@@@@@@@@@@@@@@@@@@@@@@@@@@@@@@@@@@@@@@@@@@@@@@@@@@@@@@@@@@@@@@@@@@@@@@@@@@@@@@@@@@@@@@@@@@@@@@@@@@@@@@@@
