type octile
height 54
width 52
map
@@@@@@@@@@@@@@@@@@@@@@@@@@@@@@@@@@@@@@@@@@@@@@@@@@@@
@@@@@@@@@@@@@@@@@@@@@@@@@@@@@@@@@@@@@@@@@@@@@@@@@@@@
@@@@@@@@@@@@@@@@@@@@@@@@@@@@@@@@@@@@@@@@@@@@@@@@@@@@
@@@@@@@@@@@@@@@@@@@@@@@@@@@@@@@@@@@@@@@@@@@@@@@@@@@@
@@@@@@@@@@@@@@@@@@@@@@@@@@@@@@@@@@@@@@@@@@@@@@@@@@@@
@@@@@@@@@@@@@@@@@@@@@@@@@@@@@@@@@@@@@@@@@@@@@@@@@@@@
@@@@@@@@@@@@@@@@@@@@@@@@@@@@@@@@@@@@@@@@@@@@@@@@@@@@
@@@@@@@@@@@@@@@@@@@@@@@@@@@@@@@@@@@@@@@@@@@@@@@@@@@@
@@@@@@@@@@@@@@@@@@@@@@@@@@@@@@@@@@@@@@@@@@@@@@@@@@@@
@@@@@@@@@@@@@@@@@@@@@@@@@@@@@@@@@@@@@@@@@@@@@@@@@@@@
@@@@@@@@@@@@@@@@@@@@@@@@@@@@@@@@@@@@@@@@@@@@@@@@@@@@
@@@@@@@@@@@@@@@@@@@@@@@@@@@@@@@@@@@@@@@@@@@@@@@@@@@@
@@@@@@@@@@@@@@@@@@@@@@@@@@@@@@@@@@@@@@@@@@@@@@@@@@@@
@@@@@@@@@@@@@@@@@@@@@@@@@@@@@@@@@@@@@@@@@@@@@@@@@@@@
@@@@@@@@@@@@@@@@@@@@@@@@@@@@@@@@@@@@@@@@@@@@@@@@@@@@
@@@@@@@@@@@@@@@@@@@@@@@@@@@@@@@@@@@@@@@@@@@@@@@@@@@@
@@@@@@@@@@@@@@@@@@@@@@@@@@@@T@@@@..@@@@@@@@@@@@@@@@@
@@@@@@@@@@@@@@@@@@@@@@@@@@@T.T@@T...T@@@@@@@@@@@@@@@
@@@@@@@@@@@@@@@@@@@@@@@@@@.T.TTT..TT..@@@@@@@@@@@@@@
@@@@@@@@@@@@@@@@@@@@@@@@@@T..TT.T...T..@@@@@@@@@@@@@
@@@@@@@@@@@@@@@@@@@@@@@@@T.TTT..@@T.....@@@@@@@@@@@@
@@@@@@@@@@@@@@@@@@@@@@@....T..T@@@@@.....@@@@@@@@@@@
@@@@@@@@@@@@@@@@@@@@@@.....TTTT@@@@@@@..TT@@@@@@@@@@
@@@@@@@@@@@@@@@@@@@@@.TTT..TT.T@@@@@@@...@@@@@@@@@@@
@@@@@@@@@@@@@@@@@@@@@@.T.T.T.TT@@@@TT...@@@@@@@@@@@@
@@@@@@@@@@@@@@@@@@@@@@@TT.T.T.T.@TT....@@@@@@@@@@@@@
@@@@@@@@@@@@@@@@@@@@@@@@T...TT.T.T.....@@@@@@@@@@@@@
@@@@@@@@@@@@@@@@@..@@@@@@.T.T.TT.TTT..T@@@@@@@@@@@@@
@@@@@@@@@@@@@@@@....@@@@@T.T.TT...T.TT..@@@@@@@@@@@@
@@@@@@@@@@@@@@@..TT..@@@@TT..T.T........T@@@@@@@@@@@
@@@@@@@@@@@@@@@@.T.T.@@@.T.T.T....T..T.T.T@@@@@@@@@@
@@@@@@@@@@@@@@@@@......T..T...T.T...T.T..@@@@@@@@@@@
@@@@@@@@@@@@@@@@@@T..T........TT.TT..T..@@@@@@@@@@@@
@@@@@@@@@@@@@@@@@@@.....T.....T.T...TTT@@@@@@@@@@@@@
@@@@@@@@@@@@T@@@@@@T...T.T...T....TT..@@@@@@@@@@@@@@
@@@@@@@@T@@...@@@@@.TT.T.TTT.....T.T.@@@@@@@@@@@@@@@
@@@@@@@...TTTT.@@@TT....T....TT.T.TT@@@@@@@@@@@@@@@@
@@@@@@T....TTT...T..T..T.TTT.TTTTTT@@@@@@@@@@@@@@@@@
@@@@@@T.T...TT.TTTTTT@@.TT.T..T..T@@@@@@@@@@@@@@@@@@
@@@@@@@T...T...T.T..@@@......T...@@@@@@@@@@@@@@@@@@@
@@@@@@@@T..T.......@@T.T....TTTT@@@@@@@@@@@@@@@@@@@@
@@@@@@@@@.T...TT.T@@T.......TT.@@@@@@@@@@@@@@@@@@@@@
@@@@@@@@@@..T....@@...T.T..T..@@@@@@@@@@@@@@@@@@@@@@
@@@@@@@@@@@T.T..@@...T.T.TT..@@@@@@@@@@@@@@@@@@@@@@@
@@@@@@@@@@@@...@@....TT...TT@@@@@@@@@@@@@@@@@@@@@@@@
@@@@@@@@@@@@@.@@......T..T.@@@@@@@@@@@@@@@@@@@@@@@@@
@@@@@@@@@@@@@@@.....T..TTT@@@@@@@@@@@@@@@@@@@@@@@@@@
@@@@@@@@@@@@@@@..TT.T...T@@@@@@@@@@@@@@@@@@@@@@@@@@@
@@@@@@@@@@@@@@@@..TT.T..@@@@@@@@@@@@@@@@@@@@@@@@@@@@
@@@@@@@@@@@@@@@@@T..T.T@@@@@@@@@@@@@@@@@@@@@@@@@@@@@
@@@@@@@@@@@@@@@@@@TTTT@@@@@@@@@@@@@@@@@@@@@@@@@@@@@@
@@@@@@@@@@@@@@@@@@@TT@@@@@@@@@@@@@@@@@@@@@@@@@@@@@@@
@@@@@@@@@@@@@@@@@@@@@@@@@@@@@@@@@@@@@@@@@@@@@@@@@@@@
@@@@@@@@@@@@@@@@@@@@@@@@@@@@@@@@@@@@@@@@@@@@@@@@@@@@
