type octile
height 70
width 56
map
@@@@@@@@@@@@@@@@@@@@@@@@@@@@@@@@@@@@@@@@@@@@@@@@@@@@@@@@
@@@@@@@@@@@@@@@@@@@@@@@@@@@@@@@@@@@@@@@@@@@@@@@@@@@@@@@@
@@@@@@@@@@@@@@@@@@@@@@@@@@@@@@@@@@@@@@@@@@@@@@@@@@@@@@@@
@@@@@@@@@@@@@@@@@@@@@@@@@@@@@@@@@@@@@@@@@@@@@@@@@@@@@@@@
@@@@@@@@@@@@@@@@@@@@@@@@@@@@@@@@@@@@@@@@@@@@@@@@@@@@@@@@
@@@@@@@@@@@@@@@@@@@@@@@@@@@@@@@@@@@@@@@@@@@@@@@@@@@@@@@@
@@@@@@@@@@@@@@@@@@@@@@@@@@@@@@@@@@@@@@@@@@@@@@@@@@@@@@@@
@@@@@@@@@@@@@@@@@@@@@@@@@@@@@@@@@@@@@@@@@@@@@@@@@@@@@@@@
@@@@@@@@@@@@@@@@@@@@@@@@@@@@@@@@@@@@@@@@@@@@@@@@@@@@@@@@
@@@@@@@@@@@@@@@@@@@@@@@@@@@@@@@@@@@@@@@@@@@@@@@@@@@@@@@@
@@@@@@@@@@@@@@@@@@@@@@@@@@@@@@@@@@@@@.@@@@@@@@@@@@@@@@@@
@@@@@@@@@@@@@@@@@@@@@@@@@@@@@@@@@@@@@TT@@@@@@@@@@@@@@@@@
@@@@@@@@@@@@@@@@@@@@@@@@@@@@@@@@@@@@@..T@@@@@@@@@@@@@@@@
@@@@@@@@@@@@@@@@@@@@@@@@@@@@@@@@@@@T.....@@@@@@@@@@@@@@@
@@@@@@@@@@@@@@@@@@@@@@@@@@@@@@@@@@@...TTT.@@@@@@@@@@@@@@
@@@@@@@@@@@@@@@@@@@@@@@@@@@@@@@@@...T...T.@@@@@@@@@@@@@@
@@@@@@@@@@@@@@@@@@@@@@@@@@@@@@@@@T..T....@@@@@@@@@@@@@@@
@@@@@@@@@@@@@@@@@@@@@@@@@@@@@@@@@T..T.T@@@@@@@@@@@@@@@@@
@@@@@@@@@@@@@@@@@@@@@@@@@@@@@@...T.T.T@@@@@@@@@@@@@@@@@@
@@@@@@@@@@@@@@@@@@@@@@@@@@.@@@TTT...@@@@@@@@@@@@@@@@@@@@
@@@@@@@@@@@@@@@@@@@@@@@.TT..@@@.T.T@@@@@@@@@@@@@@@@@@@@@
@@@@@@@@@@@@@@@@@@@@@@.TTTT......@@@@@@@@@@@@@@@@@@@@@@@
@@@@@@@@@@@@@@@@@@@@@@@T..TT.TT..@@@@@@@@@@@@@@@@@@@@@@@
@@@@@@@@@@@@@@@@@@@@@@@@..T...T.T@@@@@@@@@@@@@@@@@@@@@@@
@@@@@@@@@@@@@@@@@@@@@@@@@T.TTTTTT@@@@@@@@@@@@@@@@@@@@@@@
@@@@@@@@@@@@@@@@@@.@@@@@@@.....@@@@@@@@@@@@@@@@@@@@@@@@@
@@@@@@@@@@@@@@@@T..T@@@@@@@TTT@@@@@@@@@@@@@@@@@@@@@@@@@@
@@@@@@@@@@@@@@@@.TT..@@@@@....@@@@@@@@@@@@@@@@@@@@@@@@@@
@@@@@@@@@@@@@@@@..TT.T@@@.....@@@@@@.@@@@@@@@@@@@@@@@@@@
@@@@@@@@@@@@@@@.T.T...TTTT.....@@@@TTT@@@@@@@@@@@@@@@@@@
@@@@@@@@@@@@@@@@.....T..T..TT.@@@@T....@@@@@@@@@@@@@@@@@
@@@@@@@@@@@@@@@@@...T.T..TT.T@@@@..T....@@@@@@@@@@@@@@@@
@@@@@@@@@@@@@@@@@@T.TTT..T..T..@@.TTT...@@@@@@@@@@@@@@@@
@@@@@@@@@@@@@@@@@TT..TT.T.T.T..@@TT...T.@@@@@@@@@@@@@@@@
@@@@@@@@@@@@@@@@.......T@TTTT..T@@..@TT..@@@@@@@@@@@@@@@
@@@@@@@@@@@@.@@..T.TTTT@@@.......@@@@....@@@@@@@@@@@@@@@
@@@@T@@@@@@T.....T.T.T@@@@@.T...TT.TTT...T@@@@@@@@@@@@@@
@@@T.T.T..T.T.T....TT@@@@@@@..T.T..TT.TTT.@@@@@@@@@@@@@@
@@T.T...T.TTT.T..TT.T@@@@@@@TTT...T..TT...@@@@@@@@@@@@@@
@@@...T.T.T.TTT....TT.@@@@@@@.T.T..TTT.T...@@@@@@@@@@@@@
@@@T.T..TT.T.T..T....T.@@@@@@@.@@....TTTT...@@@@@@@@@@@@
@@@@TT.TT.....@@.TT....@@@@@@@@@@.T..TT..T.T..T@@@@@@@@@
@@@@@.T......@@@@......T@@@@@@@@@..T....TTT.T...@@@@@@@@
@@@@@@......@@@@@T..TTTT.@@@@@@@@..T.TTT.TTTT..TT@@@@@@@
@@@@@@@T.TT@@@@.@@.T.T...T@@@@@@@T...@@@@....T.T..@@@@@@
@@@@@@@@T.@@@@..T@..TTT..TT@@@@@T....@@@@@@TT...T...@@@@
@@@@@@@@@@@@@@TTT@@...TTTT.T@@@@..T.@@@@@@@TTT..T.T....@
@@@@@@@@@@@@@@T...@..TTT.T.....T.T.@@@@@@@..T.T..T...T@@
@@@@@@@@@@@@@@@.TT@@TT..T.T..T...TT@@@@@@@.....TTTT..@@@
@@@@@@@@@@@@@@@.T..@@T....TTT.TT.......@@@T.TTTT.T..@@@@
@@@@@@@@@@@@@@@@..T@@@.T.T..TT.T...TT..T..TT.TTT.T.@@@@@
@@@@@@@@@@@@@@@@T.T.@.....TT.T..T.T..T.T...T...TT.@@@@@@
@@@@@@@@@@@@@@@@@...@TT....T.....T......T....T.T.@@@@@@@
@@@@@@@@@@@@@@@@@T..@@T...TT.TT.T.T....T..TTT...@@@@@@@@
@@@@@@@@@@@@@@@@@@TTT....T..T...T....T..T.TT.T.@@@@@@@@@
@@@@@@@@@@@@@@@@@@@T..TT..T.T..TTT...T...T.T..@@@@@@@@@@
@@@@@@@@@@@@@@@@@@..T.T..TTTT..TTTTT...T..T.T@@@@@@@@@@@
@@@@@@@@@@@@@@@@@.T.TTT.....TTT.T....T....T@@@@@@@@@@@@@
@@@@@@@@@@@@@@@@@T............TTTTT...T.TT@@@@@@@@@@@@@@
@@@@@@@@@@@@@@@@@@TTTT......T.TT.T....TTT@@@@@@@@@@@@@@@
@@@@@@@@@@@@@@@@@@@..TT..T.T..TT..T....T@@@@@@@@@@@@@@@@
@@@@@@@@@@@@@@@@@@@@..TT...TT..TT.....T@@@@@@@@@@@@@@@@@
@@@@@@@@@@@@@@@@@@@@@T.........T.TT...@@@@@@@@@@@@@@@@@@
@@@@@@@@@@@@@@@@@@@@@@.T.TT.T.TT...TT@@@@@@@@@@@@@@@@@@@
@@@@@@@@@@@@@@@@@@@@@@@.....TT...TT.@@@@@@@@@@@@@@@@@@@@
@@@@@@@@@@@@@@@@@@@@@@@@....TT.TT.@@@@@@@@@@@@@@@@@@@@@@
@@@@@@@@@@@@@@@@@@@@@@@@@.TT.T..T@@@@@@@@@@@@@@@@@@@@@@@
@@@@@@@@@@@@@@@@@@@@@@@@@@@TT..T@@@@@@@@@@@@@@@@@@@@@@@@
@@@@@@@@@@@@@@@@@@@@@@@@@@@@@@@@@@@@@@@@@@@@@@@@@@@@@@@@
@@@@@@@@@@@@@@@@@@@@@@@@@@@@@@@@@@@@@@@@@@@@@@@@@@@@@@@@
