type octile
height 80
width 52
map
@@@@@@@@@@@@@@@@@@@@@@@@@@@@@@@@@@@@@@@@@@@@@@@@@@@@
@@@@@@@@@@@@@@@@@@@@@@@@@@@@@@@@@@@@@@@@@@@@@@@@@@@@
@@@@@@@@@@@@@@@@@@@@@@@@@@@@@@@@@@@@@@@@@@@@@@@@@@@@
@@@@@@@@@@@@@@@@@@@@@@@@@@@@@@@@@@@@@@@@@@@@@@@@@@@@
@@@@@@@@@@@@@@@@@@@@@@@@@@@@@@@@@@@@@@@@@@@@@@@@@@@@
@@@@@@@@@@@@@@@@@@@@@@@@@@@@@@@@@@@@@@@@@@@@@@@@@@@@
@@@@@@@@@@@@@@@@@@@@@@@@@@@@@@@@@@@@@@@@@@@@@@@@@@@@
@@@@@@@@@@@@@@@@@@@@@@@@@@@@@@@@@@@@@@@@@@@@@@@@@@@@
@@@@@@@@@@@@@@@@@@@@@@@@@@@@@@@@@@@@@@@@@@@@@@@@@@@@
@@@@@@@@@@@@@@@@@@@@@@@@@@@@@@@@@@@@@@@@@@@@@@@@@@@@
@@@@@@@@@@@@@@@@@@@@@@@@@@@@@@@@@@@@@@@@@@@@@@@@@@@@
@@@@@@@@@@@@@@@@@@@@@@@@@@@@@@@@@@@@@@@@@@@@@@@@@@@@
@@@@@@@@@@@@@@@@@@@@@@@@@@@@@@@@@@@@@@@@@@@@@@@@@@@@
@@@@@@@@@@@@@@@@@@@@@@@@@@@@@@@@@@@@@@@@@@@@@@@@@@@@
@@@@@@@@@@@@@@@@@@@@@@@@@@@@@@@@@@@@@@@@@@@@@@@@@@@@
@@@@@@@@@@@@@@@@@@@@@@@@@@@@@@@@@@@@@@@@@@@@@@@@@@@@
@@@@@@@@@@@@@@@@@@@@@@@@@@@@@@@@@@@@@@@@@@@@@@@@@@@@
@@@@@@@@@@@@@@@@@@@@@@@@@@@@@@@@@@@@@@@@@@@@@@@@@@@@
@@@@@@@@@@@@@@@@@@@@@@@@@@@@@@@@@@@@@@@@@@@@@@@@@@@@
@@@@@@@@@@@@@@@@@@@@@@@@@@@@@@@@@@@@@@@@@@@@@@@@@@@@
@@@@@@@@@@@@@@@@@@@@@@@@@@@@@@@@@@@@@@@@@@@@@@@@@@@@
@@@@@@@@@@@@@@@@@@@@@@@@@@@@@@@@@@@@@@@@@@@@@@@@@@@@
@@@@@@@@@@@@@@@@@@@@@@@@@@@@@@@@@@@@@@@@@@@@@@@@@@@@
@@@@@@@@@@@@@@@@@@@@@@@@@@@@@@@@@@@@@@@@@@@@@@@@@@@@
@@@@@@@@@@@@@@@@@@@@@@@@@@@@@@@@@@@@@@@@@@@@@@@@@@@@
@@@@@@@@@@@@@@@@@@@@@@@@@@@@@@@@@@@@@@@@@@@@@@@@@@@@
@@@@@@@@@@@@@@@@@@@@@@@@@@@@@@@@@@@@@@@@@@@@@@@@@@@@
@@@@@@@@@@@@@@@@@@@@@@@@@@@@@@@@@@@@@@@@@@@@@@@@@@@@
@@@@@@@@@@@@@@@@@@@@@@@@@@@@@@@@@@@@@@@@@@@@@@@@@@@@
@@@@@@@@@@@@@@@@@@@@@@@...T.@@@@@@@@@@@@@@@@@@@@@@@@
@@@@@@@@@@@@@@@@@@@....T...T..T..@@@@@@@@@@@@@@@@@@@
@@@@@@@@@@@@@@@@@....T..TT..T..T...@@@@@@@@@@@@@@@@@
@@@@@@@@@@@@@@@...TT.......TT..TTTT.@@@@@@@@@@@@@@@@
@@@@@@@@@@@@@@T.T.T........T.T...TT@@@@@@@@@@@@@@@@@
@@@@@@@@@@@@@@@...TT......T.TT..TTT@@@@@@@@@@@@@@@@@
@@@@@@@@@@@@@@@..TTTT..T...T..TT.TT@@@@@T@@@@@@@@@@@
@@@@@@@@@@@@@@@T..T.TT.....T.T.T....@@.T.@@@@@@@@@@@
@@@@@@@@@@@@@@@...T..T...TTT..TTT....TT...@@@@@@@@@@
@@@@@@@@@@@@@@..T.....T..T...T...T..TTT...T@@@@@@@@@
@@@@@@@@@@@@@.T..TT...T.......T.T.T..TT..T.@@@@@@@@@
@@@@@@@@.@@@TT..T......TTTT....TT........TTT@@@@@@@@
@@@@@@@.T.T..T.....TT....TTT.TT..T..T.TTT.T.@@@@@@@@
@@@@@@@....T.....T..T..TT.TT..T...TTTT.T..T..@@@@@@@
@@@@@@@TT.....TTT..T.TTTT..T.TTT..T.T..TT...T@@@@@@@
@@@@@@T..T.............T.TTT........T..TTTTT.T@@@@@@
@@@@@@TTTTTT.T...T.T...T...TT.TTTTT...TT....TT@@@@@@
@@@@@@TT..TTT.T.T...TT..T..TTT......T..T.T.T.T@@@@@@
@@@@@@.T...T.TT...TTT.T....TT.T..TT.T.T.T.@@@@@@@@@@
@@@@@@T..T...TT.TTT..T.TTTT..T.TTTT..T....@@@@@@@@@@
@@@@@@.T.TT.T...TT.T.T....TT....T..TT.T...@@@@@@@@@@
@@@@@@.T.......TTT......TT.TTT.T.T.T...TT@@@@@@@@@@@
@@@@@@...T.T.TT......T......T.....TT..T.T@@@@@@@@@@@
@@@@@@T......TT..T...TTT.T.....T...TT.T....@@@@@@@@@
@@@@@@@.....TTTTT....TT..TT.TTTT.T..T...T....@@@@@@@
@@@@@@@.T.TTT...TT..T......TT..T..T.T..T.T.TT@@@@@@@
@@@@@@@.....T.....TTT.TT.TT.TT..T...TT...T.T@@@@@@@@
@@@@@@@@.TT..T....T..T.TTTTTTTTTTT...TT..TT.@@@@@@@@
@@@@@@@@TTT@@@@T.T.TT..T.TTT..T..T.T.T.....@@@@@@@@@
@@@@@@@@@TT@@@@T.TTTT.TT....T.T.......T..T.@@@@@@@@@
@@@@@@@@@@T@@@@@TT.TT.....T.TT.TTT.TT..TT.@@@@@@@@@@
@@@@@@@@@@.@@@@@@.T...T..T.T....TTT.TTT..@@@@@@@@@@@
@@@@@@@@@@@@@@T...TTTT.TTT.TT.T.T..T.T..@@@@@@@@@@@@
@@@@@@@@@@@@@TT.T.TT.T...TT.T.@@@@TT...@@@@@@@@@@@@@
@@@@@@@@@@@@@@.T...TT..TT....@@@@@@..T@@@@@@@@@@@@@@
@@@@@@@@@@@@@@@T..T.....T.TTT@@@@@@.T@@@@@@@@@@@@@@@
@@@@@@@@@@@@@@@@@.T.T..T.T....@@@@@@@@@@@@@@@@@@@@@@
@@@@@@@@@@@@@@@@@@@@TT.TTTT...@@@@@@@@@@@@@@@@@@@@@@
@@@@@@@@@@@@@@@@@@@@@@@@....T@@@@@@@@@@@@@@@@@@@@@@@
@@@@@@@@@@@@@@@@@@@@@@@@@@@@@@@@@@@@@@@@@@@@@@@@@@@@
@@@@@@@@@@@@@@@@@@@@@@@@@@@@@@@@@@@@@@@@@@@@@@@@@@@@
@@@@@@@@@@@@@@@@@@@@@@@@@@@@@@@@@@@@@@@@@@@@@@@@@@@@
@@@@@@@@@@@@@@@@@@@@@@@@@@@@@@@@@@@@@@@@@@@@@@@@@@@@
@@@@@@@@@@@@@@@@@@@@@@@@@@@@@@@@@@@@@@@@@@@@@@@@@@@@
@@@@@@@@@@@@@@@@@@@@@@@@@@@@@@@@@@@@@@@@@@@@@@@@@@@@
@@@@@@@@@@@@@@@@@@@@@@@@@@@@@@@@@@@@@@@@@@@@@@@@@@@@
@@@@@@@@@@@@@@@@@@@@@@@@@@@@@@@@@@@@@@@@@@@@@@@@@@@@
@@@@@@@@@@@@@@@@@@@@@@@@@@@@@@@@@@@@@@@@@@@@@@@@@@@@
@@@@@@@@@@@@@@@@@@@@@@@@@@@@@@@@@@@@@@@@@@@@@@@@@@@@
@@@@@@@@@@@@@@@@@@@@@@@@@@@@@@@@@@@@@@@@@@@@@@@@@@@@
@@@@@@@@@@@@@@@@@@@@@@@@@@@@@@@@@@@@@@@@@@@@@@@@@@@@
