type octile
height 59
width 52
map
@@@@@@@@@@@@@@@@@@@@@@@@@@@@@@@@@@@@@@@@@@@@@@@@@@@@
@@@@@@@@@@@@@@@@@@@@@@@@@@@@@@@@@@@@@@@@@@@@@@@@@@@@
@@@@@@@@@@@@@@@@@@@@@@@@@@@@@@@@@@@@@@@@@@@@@@@@@@@@
@@@@@@@@@@@@@@@@@@@@@@@@@@@@@@@@@@@@@@@@@@@@@@@@@@@@
@@@@@@@@@@@@@@@@@@@@@@@@@@@@@@@@.@@@@@@@@@@@@@@@@@@@
@@@@@@@@@@@@@@@@@@@@@@@@@@@@@@@T..@@@@@@@@@@@@@@@@@@
@@@@@@@@@@@@@@@@@@@@@@@@@@@@@@..T.@@@@@@@@@@@@@@@@@@
@@@@@@@@@@@@@@@@@@@@@@@@@@@@@.....@@@@@@@@@@@@@@@@@@
@@@@@@@@@@@@@@@@@@@@@@@@@@@@@.....@@@@@@@@@@@@@@@@@@
@@@@@@@@@@@@@@@@@@@@@@@@@@@@...T.@@@@@@@@@@@@@@@@@@@
@@@@@@@@@@@@@@@@@@@@@@@@@@@T....@@@@@@@@@@@@@@@@@@@@
@@@@@@@@@@@@@@@@@@@@@@@@@@@T...@@@@@@@@@@@@@@@@@@@@@
@@@@@@@@@@@@@@@@@@@@@@@@@@.T.@@@@@@@@@@@@@@@@@@@@@@@
@@@@@@@@@@@@@@@@@@@@@@@T.T.T@@@@@@@@@@@@@@@@@@@@@@@@
@@@@@@@@@@@@@@@@@@@@@@@.TTTT@@@@@@@@@@@@@@@@@@@@@@@@
@@@@@@@@@@@@@@@@@@@@@@@T...@@@@@@@@@@@@@@@@@@@@@@@@@
@@@@@@@@@@@@@@@@@@@@@@@.T.T@@@@@@@@@@@@@@@@@@@@@@@@@
@@@@@@@@@@@@@@@@@@@@@@@....@@@@@@@@@@@@@@@@@@@@@@@@@
@@@@@@@@@@@@@@@@@@@@@@@....@@@@@@@@@@@@@@@@@@@@@@@@@
@@@@@@@@@@@@@@@@T.@@@@@....@@@@@@@@@@@@@@@@@@@@@@@@@
@@@@@@@@@@@@@@@....@@@T....@@@@@@@@@@@@@@@@@@@@@@@@@
@@@@@@@@@@@@@@@TT..T@TT.T...@@@@@@@@@@@@@@@@@@@@@@@@
@@@@@@@@@@@@@@.T.T.T...T..TT@@@@@@@@@@@@@@@@@@@@@@@@
@@@@@@@@@@@@@.TT.T..T.T.T...T..TT.TT@@@@@@@@@@@@@@@@
@@@@@@@@@@@@@TT.....TTT.T.TT....T.TT.@@@@@@@@@@@@@@@
@@@@@@@@@@@@T..........T..@@@@@.T.....TT@@@@@@@@@@@@
@@@@@@@@@@@@.TTTT.....T...@@@@@@T....T..T@@@@@@@@@@@
@@@@@@@@@@@@....@@T...T.......@@@TT...T..T@@@@@@@@@@
@@@@@@@@@@@..TT@@T...T.T.T.T...@@@..T...T..@@@@@@@@@
@@@@@@@@@@.T.T.@@.T.......TTT.TT.@@T..T....@@@@@@@@@
@@@@@@@@T..TTT@@....T..T.T.TT.....@@@TTTT...@@@@@@@@
@@@@@@@@T..T..@@T..T.TTT.T....TTT..@@...T..T@@@@@@@@
@@@@@@@T...T.T@@T..T.TT.T...T....TT.@@T.......@@@@@@
@@@@@@@.TT..T@@.T.T.T...TT..T...TTT..@..T.TTTT@@@@@@
@@@@@@@TTT.T.@@.TT.T.T.T@@@@..T..T.TT@..TTT...@@@@@@
@@@@@@@...T..@@.TTTT.T.@@@@@@.....TT.@@...T...@@@@@@
@@@@@@@...T.T@@@TT.TTT.@@@@@@T.T.TTT.@@.T.T...@@@@@@
@@@@@@@......@@@..T.TT.@@@@@@...TT...@@TT.TTT..@@@@@
@@@@@@@...TTT@@@.TT...T.@@@@...TTT.T.@@.T..T...@@@@@
@@@@@@@....T.@@@......TT..TT.TTT....@@@.TTT.T..T@@@@
@@@@@@@..TTT..@@@...T..T..T.TTT.TT.T@@@TTT......@@@@
@@@@@@@T..T.T.@@@..TT...T.....T....@@@@...T.....@@@@
@@@@@@@.....T.T@@.T...TTTT...T....T@@@.T....T..T@@@@
@@@@@@@T.T..TT.@@@TTT.....TTTT..T.@@@..T.TTTT.TT@@@@
@@@@@@@..T.....T@@@.T.T..TT.TT...@@@....T.T..T..@@@@
@@@@@@@.....T.TT.@@@......T...T.@@@.T....T.TTTT.@@@@
@@@@@@@T....T...T@@@@@.T.....T@@@@..T...TT.T..T@@@@@
@@@@@@@.....T.TT.T@@@@@@@@@@@@@@@..T..TTT.TTTTT@@@@@
@@@@@@@.T..TT.T.TTTT@@@@@@@@@@@@...TTT.T.T...T.@@@@@
@@@@@@@@....TTT.....TT.T.T.TTT......T.TTT..TTT@@@@@@
@@@@@@@@@..T......T.T..T...TTT...T...T.......@@@@@@@
@@@@@@@@@@TT.T...TT..T.TTTT.T.T..T...T....T.@@@@@@@@
@@@@@@@@@@@@.....T.T.T...TTT..T..TT....TT@@@@@@@@@@@
@@@@@@@@@@@@@@@TT.TTT...........T...TT.@@@@@@@@@@@@@
@@@@@@@@@@@@@@@@T....T.......T...TT@@@@@@@@@@@@@@@@@
@@@@@@@@@@@@@@@@@@@T..T.........@@@@@@@@@@@@@@@@@@@@
@@@@@@@@@@@@@@@@@@@@@@@@@@@@@@@@@@@@@@@@@@@@@@@@@@@@
@@@@@@@@@@@@@@@@@@@@@@@@@@@@@@@@@@@@@@@@@@@@@@@@@@@@
@@@@@@@@@@@@@@@@@@@@@@@@@@@@@@@@@@@@@@@@@@@@@@@@@@@@
