type octile
height 54
width 52
map
@@@@@@@@@@@@@@@@@@@@@@@@@@@@@@@@@@@@@@@@@@@@@@@@@@@@
@@@@@@@@@@@@@@@@@@@@@@@@@@@@@@@@@@@@@@@@@@@@@@@@@@@@
@@@@@@@@@@@@@@@@@@@@@@@@@@@@@@@@@@@@@@@@@@@@@@@@@@@@
@@@@@@@@@@@@@@@@@@@@@@@@@@@@@@@@@@@@@@@@@@@@@@@@@@@@
@@@@@@@@@@@@@@@@@@@@@@@@@@@@@@@@@@@@@@@@@@@@@@@@@@@@
@@@@@@@@@@@@@@@@@@@@@@@@@@@@@@@@@@@@@@@@@@@@@@@@@@@@
@@@@@@@@@@@@@@@@@@@@@@@@@@@@@@@@@@@@@@@@@@@@@@@@@@@@
@@@@@@@@@@@@@@@@@@@@@@@@@@@@@@@@@@@@@@@@@@@@@@@@@@@@
@@@@@@@@@@@@@@@@@@@@@@@@@@@@@@@@@@@@@@@@@@@@@@@@@@@@
@@@@@@@@@@@@@@@@@@@@@@@@@@@@@@@@@@@@@@@@@@@@@@@@@@@@
@@@@@@@@@@@@@@@@@@@@@@@@@@@@@@@@@@@@@@@@@@@@@@@@@@@@
@@@@@@@@@@@@@@@@@@@@@@@@@@@@@@@@@@@@@@@@@@@@@@@@@@@@
@@@@@@@@@@@@@@@@@@@@@@@@@@@@@@@@@@@@@@@@@@@@@@@@@@@@
@@@@@@@@@@@@@@@@@@@@@@@@@@@@@@@@@@@@@@@@@@@@@@@@@@@@
@@@@@@@@@@@@@@@@@@@@@@@@@@@@@@@.@@@@@@@@@@@@@@@@@@@@
@@@@@@@@@@@@@@@@@@@@@@@@@@@.T@T.T@@@@@@@@@@@@@@@@@@@
@@@@@@@@@@@@@@@@@@@@@@@@@@@.T...@@@@@@@@@@@@@@@@@@@@
@@@@@@@@@@@@@@@@@@@@@@@@@@@@....@@@.@@@@@@@@@@@@@@@@
@@@@@@@@@@@@@@@@@@@@@@@@@@@@.T..@@....T@@@@@@@@@@@@@
@@@@@@@@@@@@@@@@@@@@@@@@@@...T.TT.T.T..@@@@@@@@@@@@@
@@@@@@@@@@@@@@@@@@@@@@@@@T.T.TTTT....T.@@@@@@@@@@@@@
@@@@@@@@@@@@@@@@@@@@@@@@.TT.......T...T@@.@@@@@@@@@@
@@@@@@@@@@@@@@@@@@@@@@@TTT..T.....T.T..TT.T@@@@@@@@@
@@@@@@@@@@@@@@@@@@@@@@T....T.TTT..TT.TTTT..T@@@@@@@@
@@@@@@@@@@@@@@@@@@@@TT...@@@T..T.T....T..T...@@@@@@@
@@@@@@@@@@..@@@@@@@T...T@@@@@.T.T....T..T.....@@@@@@
@@@@@@@@@T..T@@.TTT.T..@@@@@@@.TTT...T...TT.T.T@@@@@
@@@@@@@@...T.@.TTT..TT@@@@@@@T.TTT.T....T....T@@@@@@
@@@@@@@T.T.TT@@..TT..@@@@@@@T..T..TT.TT....T.@@@@@@@
@@@@@@T....T..@....T@@@@@@@TT...T..T.T.T.TT.@@@@@@@@
@@@@@@@T..T.TT@@..T@@@@@@@..T..T.TT..T..TT.@@@@@@@@@
@@@@@@@...T....@TT@@@@@@@.TTTTT..TTTT.....@@@@@@@@@@
@@@@@@@@T.TT..T@...@@@@.T....T.......TT..@@@@@@@@@@@
@@@@@@@@T.TT...@@.T.@@TTT.T.T.....T.T.T.@@@@@@@@@@@@
@@@@@@@@@...TT.T@...@.....T...TTTTT....@@@@@@@@@@@@@
@@@@@@@@@TTT..TT@.TTTT.TTTT.T.TTT..T.T@@@@@@@@@@@@@@
@@@@@@@@@@TT..T.T..T..TT...T..T...TTT@@@@@@@@@@@@@@@
@@@@@@@@@@..T..T..TT...T.T...T..T.T.@@@@@@@@@@@@@@@@
@@@@@@@@@@@...T.T.T.T.T..T.TTTTTT..@@@@@@@@@@@@@@@@@
@@@@@@@@@@@.T..T.T.T.T....T.TT....@@@@@@@@@@@@@@@@@@
@@@@@@@@@@.T.......TTTT....TT...T@@@@@@@@@@@@@@@@@@@
@@@@@@@@@TTT..T....T..TT....T.TT@@@@@@@@@@@@@@@@@@@@
@@@@@@@@...TT...TT.TT....TT..TT@@@@@@@@@@@@@@@@@@@@@
@@@@@@@@......T...T..TT.T....T@@@@@@@@@@@@@@@@@@@@@@
@@@@@@@@@..T.TT.TT...TT.T...T@@@@@@@@@@@@@@@@@@@@@@@
@@@@@@@@@@...T.....TT.T.T...@@@@@@@@@@@@@@@@@@@@@@@@
@@@@@@@@@@@.....TTTTTTT.T..@@@@@@@@@@@@@@@@@@@@@@@@@
@@@@@@@@@@@@T....T.TTT..TT@@@@@@@@@@@@@@@@@@@@@@@@@@
@@@@@@@@@@@@@T........T..@@@@@@@@@@@@@@@@@@@@@@@@@@@
@@@@@@@@@@@@@@.TT.....T.@@@@@@@@@@@@@@@@@@@@@@@@@@@@
@@@@@@@@@@@@@@@.T..T...@@@@@@@@@@@@@@@@@@@@@@@@@@@@@
@@@@@@@@@@@@@@@@TT..T.@@@@@@@@@@@@@@@@@@@@@@@@@@@@@@
@@@@@@@@@@@@@@@@@T...@@@@@@@@@@@@@@@@@@@@@@@@@@@@@@@
@@@@@@@@@@@@@@@@@@@@@@@@@@@@@@@@@@@@@@@@@@@@@@@@@@@@
