type octile
height 59
width 56
map
@@@@@@@@@@@@@@@@@@@@@@@@@@@@@@@@@@@@@@@@@@@@@@@@@@@@@@@@
@@@@@@@@@@@@@@@@@@@@@@@@@@@@@@@@@@@@@@@@@@@@@@@@@@@@@@@@
@@@@@@@@@@@@@@@@@@@@@@@@@@@@@@@@@@@@@@@@@@@@@@@@@@@@@@@@
@@@@@@@@@@@@@@@@@@@@@@@@@@@@@@@@@@@@@@@@@@@@@@@@@@@@@@@@
@@@@@@@@@@@@@@@@@@@@@@@@@@@@@@@@@@@@@@@@@@@@@@@@@@@@@@@@
@@@@@@@@@@@@@@@@@@@@@@@@@@@@@@@@@@@@@@@@@@@@@@@@@@@@@@@@
@@@@@@@@@@@@@@@@@@@@@@@@@@@@@@@@@@@@@@@@@@@@@@@@@@@@@@@@
@@@@@@@@@@@@@@@@@@@@@@@@@@@@@@@@@@@@@@@@@@@@@@@@@@@@@@@@
@@@@@@@@@@@@@@@@@@@@@@@@@@@@@@@@@@@@@@@@@@@@@@@@@@@@@@@@
@@@@@@@@@@@@@@@@@@@@@@@@@@@@@@@@@@@@@@@@@@@@@@@@@@@@@@@@
@@@@@@@@@@@@@@@@@@@@@@@@@@@@@@@@@@@@@@@@@@@@@@@@@@@@@@@@
@@@@@@@@@@@@@@@@@@@@@@@@@@@@@@@@@@@@@@@@@@@@@@@@@@@@@@@@
@@@@@@@@@@@@@@@@@@@@@@@@@@@@@@@@@@@@@@@@@@@@@@@@@@@@@@@@
@@@@@@@@@@@@@@@@@@@@@@@@@@@@@@@@T@@@@@@@@@@@@@@@@@@@@@@@
@@@@@@@@@@@@@@@@@@@@@@@@@@@@@@@..TTT.@@@@@@@@@@@@@@@@@@@
@@@@@@@@@@@@@@@@@@@@@@@@@@@@@@T...TTT@@@@@@@@@@@@@@@@@@@
@@@@@@@@@@@@@@@@@@@@@@@@@@@@T..TTT@@@@@@@@@@@@@@@@@@@@@@
@@@@@@@@@@@@@@@@@@@@@@@@@@@.T...T@@@@@T@@@@@@@@@@@@@@@@@
@@@@@@@@@@@@@@@@@@@@@@@@@@T.T@@T.@@@@@T.TT@@@@@@@@@@@@@@
@@@@@@@@@@@@@@@@@@@@@@@@@@..@@@..@@@@@.T..T.@@@@@@@@@@@@
@@@@@@@@@@@@@@@@@@@@@@@@@T.@@@@.T@@@@@T.@@..@@@@@@@@@@@@
@@@@@@@@@@@@@@@@@@@@@@@@.T@@@TTT...@@@T.@@@@@@@@@@@@@@@@
@@@@@@@@@@@@@@@@@@@@@@@@..@@@TT..T.T..T.@@@@@@@@@@@@@@@@
@@@@@@@@@@@@@@@@@@@@@TTT.T......TTT......T@@@@@@@@@@@@@@
@@@@@@@@@@@@@@@@@@@@T..@TT.T...TT.T.T..TT..@@@@@@@@@@@@@
@@@@@@@@@@@@@@@@@@@TT.@@@T.TTT....TT..TT...T@@.@@@@@@@@@
@@@@@@@@@@@@@@@@@@@@T@@@@@T..T..T..T...T.T.......@@@@@@@
@@@@@@@@@@@@@@@@@@@@.@@@@@@TTT....TT.TTT.TTT.TT.TTT@@@@@
@@@@@@@@@@@@@@@@@@@T.@@@@@@@.T..TT.T..T....T..T.....@@@@
@@@@@@@@@@@@@@@@@T...@@@@@T.....TT.TTTT....TTTT.TT..@@@@
@@@@@@@@@@@@@@@@@@@T..T@@TTT.TT.T..TTT..T.......TTT@@@@@
@@@@@@@@@@@@@@@@@@@@T...T..T..T.TT.........TTT...T@@@@@@
@@@@@@@@@@@@@@@@@@@@...TT.@..TTT.T..T..T....TT...@@@@@@@
@@@@@@@@@@@@@@@@@@@..TTT.@@@T....TT..TTT..TTT...@@@@@@@@
@@@@@@@@@.@@@T.@@@T..T.@@@@@.TT.T.......TT..T..@@@@@@@@@
@@@@@@@@TT@@@...@....T.@@@@@@TT.TT.TTT..T...T.@@@@@@@@@@
@@@@@@@....@@TT.TT.T...@@@@@...T..TT.T..T.TT.@@@@@@@@@@@
@@@@@...T...@..@@.TT...T.@....T.T..T.TT...T.@@@@@@@@@@@@
@@@@TTTT......@@@@.T..T.TTT.TTT.T.T......T.@@@@@@@@@@@@@
@@@TT..T..T.T.@@@@@T........T.TT.T.T..T.T.@@@@@@@@@@@@@@
@@......T......@@@@...T.......T.TT....TT.@@@@@@@@@@@@@@@
@T.T.T..T..T..T.@@@..T..T..TTT.T.T.T....@@@@@@@@@@@@@@@@
@@..T.TT...TT..T.@..TT.TT.T....T....TTT@@@@@@@@@@@@@@@@@
@@@.....T..T..TT...TTT...TTTT.T...TTT.@@@@@@@@@@@@@@@@@@
@@@@TTTT.....TTTT.T..TT......T...TTT.@@@@@@@@@@@@@@@@@@@
@@@@@..T..T.TTTT.T..T.T..T...TT..TT.@@@@@@@@@@@@@@@@@@@@
@@@@@@T.T.T.TT.....T....T.....T.TT.@@@@@@@@@@@@@@@@@@@@@
@@@@@@@..T..TTTTTT......T.T.....T.@@@@@@@@@@@@@@@@@@@@@@
@@@@@@@@.T.TTTTTT....TT...T..TTT.@@@@@@@@@@@@@@@@@@@@@@@
@@@@@@@@@T...TTT......T....TT...@@@@@@@@@@@@@@@@@@@@@@@@
@@@@@@@@@@TTT...T.TTT..TT.TTT..@@@@@@@@@@@@@@@@@@@@@@@@@
@@@@@@@@@@@.T.......T.T.T.T.T.@@@@@@@@@@@@@@@@@@@@@@@@@@
@@@@@@@@@@@@.....T.T....TT..T@@@@@@@@@@@@@@@@@@@@@@@@@@@
@@@@@@@@@@@@@T.....T....T.T.@@@@@@@@@@@@@@@@@@@@@@@@@@@@
@@@@@@@@@@@@@@....TT.....T.@@@@@@@@@@@@@@@@@@@@@@@@@@@@@
@@@@@@@@@@@@@@@...T.T.T...@@@@@@@@@@@@@@@@@@@@@@@@@@@@@@
@@@@@@@@@@@@@@@@..TTT....@@@@@@@@@@@@@@@@@@@@@@@@@@@@@@@
@@@@@@@@@@@@@@@@@.T..TT.@@@@@@@@@@@@@@@@@@@@@@@@@@@@@@@@
@@@@@@@@@@@@@@@@@@@@@@@@@@@@@@@@@@@@@@@@@@@@@@@@@@@@@@@@
