type octile
height 118
width 120
map
@@@@@@@@@@@@@@@@@@@@@@@@@@@@@@@@@@@@@@@@@@@@@@@@@@@@@@@@@@@@@@@@@@@@@@@@@@@@@@@@@@@@@@@@@@@@@@@@@@@@@@@@@@@@@@@@@@@@@@@@
@@@@@@@@@@@@@@@@@@@@@@@@@@@@@@@@@@@@@@@@@@@@@@@@@@@@@@@@@@@@@@@@@@@@@@@@@@@@@@@@@@@@@@@@@@@@@@@@@@@@@@@@@@@@@@@@@@@@@@@@
@@@@@@@@@@@@@@@@@@@@@@@@@@@@@@@@@@@@@@@@@@@@@@@@@@@@@@@@@@@@@@@@@@@@@@@@@@@@@@@@@@@@@@@@@@@@@@@@@@@@@@@@@@@@@@@@@@@@@@@@
@@@@@@@@@@@@@@@@@@@@@@@@@@@@@@@@@@@@@@@@@@@@@@@@@@@@@@@@@@@@@@@@@@@@@@@@@@@@@@@@@@@@@@@@@@@@@@@@@@@@@@@@@@@@@@@@@@@@@@@@
@@@@@@@@@@@@@@@@@@@@@@@@@@@@@@@@@@@@@@@@@@@@@@@@@@@@@@@@@@@@@@@@@@@@@@@@@@@@@@@@@@@@@@@@@@@@@@@@@@@@@@@@@@@@@@@@@@@@@@@@
@@@@@@@@@@@@@@@@@@@@@@@@@@@@@@@@@@@@@@@@@@@@@@@@@@@@@@@@@@@@@@@@@@@@@@@@@@@@@@@@@@@@@@@@@@@@@@@@@@@@@@@@@@@@@@@@@@@@@@@@
@@@@@@@@@@@@@@@@@@@@@@@@@@@@@@@@@@@@@@@@@@@@@@@@@@@@@@@@@@@@@@@@@@@@@@@@@@@@@@@@@@@@@@@@@@@@@@@@@@@@@@@@@@@@@@@@@@@@@@@@
@@@@@@@@@@@@@@@@@@@@@@@@@@@@@@@@@@@@@@@@@@@@@@@@@@@@@@@@@@@@@@@@@@@@@@@@@@@@@@@@@@@@@@@@@@@@@@@@@@@@@@@@@@@@@@@@@@@@@@@@
@@@@@@@@@@@@@@@@@@@@@@@@@@@@@@@@@@@@@@@@@@@@@@@@@@@@@@@@@@@@@@@@@@@@@@@@@@@@@@@@@@@@@@@@@@@@@@@@@@@@@@@@@@@@@@@@@@@@@@@@
@@@@@@@@@@@@@@@@@@@@@@@@@@@@@@@@@@@@@@@@@@@@@@@@@@@@@@@@@@@@@@@@@@@@@@@@@@@@@@@@@@@@@@@@@@@@@@@@@@@@@@@@@@@@@@@@@@@@@@@@
@@@@@@@@@@@@@@@@@@@@@@@@@@@@@@@@@@@@@@@@@@@@@@@@@@@@@@@@@@@@@@@@@@@@@@@@..@@@@@@@@@@@@@@@@@@@@@@@@@@@@@@@@@@@@@@@@@@@@@@
@@@@@@@@@@@@@@@@@@@@@@@@@@@@@@@@@@@@@@@@@@@@@@@@@@@@@@@@@@@@@@@@@@@@@@@..TTT@@@@@@@@@@@@@@@@@@@@@@@@@@@@@@@@@@@@@@@@@@@@
@@@@@@@@@@@@@@@@@@@@@@@@@@@@@@@@@@@@@@@@@@@@@@@@@@@@@@@@@@@@@@@@@@@@@@.TT.TT.@@@@@@@@@@@@@@@@@@@@@@@@@@@@@@@@@@@@@@@@@@@
@@@@@@@@@@@@@@@@@@@@@@@@@@@@@@@@@@@@@@@@@@@@@@@@@@@@@@@@@@@@@@@@@@@@T.T.......@@@@@@@@@@@@@@@@@@@@@@@@@@@@@@@@@@@@@@@@@@
@@@@@@@@@@@@@@@@@@@@@@@@@@@@@@@@@@@@@@@@@@@@@@@@@@@@@@@@@@@@@@@@@@@.T.T@@@...TT@@@@@@@@@@@@@@@@@@@@@@@@@@@@@@@@@@@@@@@@@
@@@@@@@@@@@@@@@@@@@@@@@@@@@@@@@@@@@@@@@@@@@@@@@@@@@@@@@@@@@@@@@@@@TT.T@@@@@...TT@@@@@@@@@@@@@@@@@@@@@@@@@@@@@@@@@@@@@@@@
@@@@@@@@@@@@@@@@@@@@@@@@@@@@@@@@@@@@@@@@@@@@@@@@@@@@@@@@@@@@@@@@@TT..@@@@@@@.T.TT@@@@@@@@@@@@@@@@@@@@@@@@@@@@@@@@@@@@@@@
@@@@@@@@@@@@@@@@@@@@@@@@@@@@@@@@@@@@@@@@@@@@@@@@@@@@@@@@@@@@@@@@.T..@@@@@@@@@..T.T@@@@@@@@@@@@@@@@@@@@@@@@@@@@@@@@@@@@@@
@@@@@@@@@@@@@@@@@@@@@@@@@@@@@@@@@@@@@@@@@@@@@@@@@@@@@@@@@@@@@@@@T..@@@@@@@@@@@.T..T@@@@@@@@@@@@@@@@@@@@@@@@@@@@@@@@@@@@@
@@@@@@@@@@@@@@@@@@@@@@@@@@@@@@@@@@@@@@@@@@@@@@@@@@@@@@@@@@@@@@@@@.@@@@@@@@@@@@@...TT@@@@@@@@@@@@@@@@@@@@@@@@@@@@@@@@@@@@
@@@@@@@@@@@@@@@@@@@@@@@@@@@@@@@@@@@@@@@@@@@@@@@@@@@@@@@@@@@@@@@@@@@@@@@@..@@@@@@TT...@@@@@@@@@@@@@@@@@@@@@@@@@@@@@@@@@@@
@@@@@@@@@@@@@@@@@@@@@@@@@@@@@@@@@@@@@@@@@@@@@@@@@@@@@@@@@@@@@@@@@@@@@@@@...@@@@@@..TT.@@@@@@@@@@@@@@@@@@@@@@@@@@@@@@@@@@
@@@@@@@@@@@@@@@@@@@@@@@@@@@@@@@@@@@@@@@@@@@@@@@@@@@@@@@@@@@@@@@@@@@@@@.....T@@@@@@T..T.@@@@@@@@@@@@@@@@@@@@@@@@@@@@@@@@@
@@@@@@@@@@@@@@@@@@@@@@@@@@@@@@@@@@@@@@@@@@@@@@@@@@@@@@@@@@@@@@@@@@.T@@...TT.T@@@@@@.TTTT@@@@@@@@@@@@@@@@@@@@@@@@@@@@@@@@
@@@@@@@@@@@@@@@@@@@@@@@@@@@@@@@@@@@@@@@@@@@@@@@@@@@@@@@@@@@@@@@@@@.TT.TTT..TT.@@@@@@.TT.T@@@@@@@@@@@@@@@@@@@@@@@@@@@@@@@
@@@@@@@@@@@@@@@@@@@@@@@@@@@@@@@@@@@@@@@@@@@@@@@@@@@@@@@@@@@@@@@@@@T...T.T.T@...@@@@@@@..TT@@@@@@@@@@@@@@@@@@@@@@@@@@@@@@
@@@@@@@@@@@@@@@@@@@@@@@@@@@@@@@@@@@@@@@@@@@@@@@@@@@@@@@@...T.T@@@@@T..T.T@@@...T@@@@@@...T@@@@@@@@@@@@@@@@@@@@@@@@@@@@@@
@@@@@@@@@@@@@@@@@@@@@@@@@@@@@@@@@@@@@@@@@@@@@@@@@@@@@@@TT..T..T@@@@TT.T@@@@@@T.@@@@@@TTT.@@@@@@@@@@@@@@@@@@@@@@@@@@@@@@@
@@@@@@@@@@@@@@@@@@@@@@@@@@@@@@@@@@@@@@@@@@@@@@@@@@@@@@..T.T@@@T..@@....@@@@@@@T@@@@@@TTT@@@@@@@@@@@@@@@@@@@@@@@@@@@@@@@@
@@@@@@@@@@@@@@@@@@@@@@@@@@@@@@@@@@@@@@@@@@@@@@@@@@@@@.TTT..@@@.@@@@@.TT@@@@@@.T@@@@@.T..@@@@@@@@@@@@@@@@@@@@@@@@@@@@@@@@
@@@@@@@@@@@@@@@@@@@@@@@@@@@@@@@@@@@@@@@@@@@.@@@@@@@@..@@@@T..TT@@@@@..T@@@.@@..@@@@@T..@@@@@@@@@@@@@@@@@@@@@@@@@@@@@@@@@
@@@@@@@@@@@@@@@@@@@@@@@@@@@@@@@@@@@@@@@@@@..T@@@@@@@..@@@@@TT.@@@@@@..TTT.T.T.T@@@@.T..@@@@@@@@@@@@@@@@@@@@@@@@@@@@@@@@@
@@@@@@@@@@@@@@@@@@@@@@@@@@@@@@@@@@@@@@@@@..T.T@@@@@@T.T@@.@.T..@@@@@..TTT..TT..@@@@...@@@@@@@@@@@@@@@@@@@@@@@@@@@@@@@@@@
@@@@@@@@@@@@@@@@@@@@@@@@@@@@@@@@@@@@@@@@T.TT..@@@@@@..TT..T.@@T@@@@@....T..TT.@@@@....@@@@@@@@@@@@@@@@@@@@@@@@@@@@@@@@@@
@@@@@@@@@@@@@@@@@@@@@@@@@@@@@@@@@@@@@@@TTTT..@@@@@@@TTT.@@@.@@..T.@@.T.T..TT.@@@@@...@@@@@@@.TT@@@@@@@@@@@@@@@@@@@@@@@@@
@@@@@@@@@@@@@@@@@@@@@@@@@@@@@@@@@@@@@@.T..TT@@@@@@@@@T.T@@@T.T....@@TT.TTT..T@@@@..TT@@@@@@@.T@@@@@@@@@@@@@@@@@@@@@@@@@@
@@@@@@@@@@@@@@@@@@@@@@@@@@@@@@@@@@@@@.T..TT@@.@@@@@@@..T@@@.TTTT.T@TTTT...T.T.@.@TT.@@@@@@@@.T@@@@@@@@@@@@@@@@@@@@@@@@@@
@@@@@@@@@@@@@@@@@@@@@@@@@@@@@@@@@@@@T.T..T@@..@@@@@@@@TT.T....TTT..T.T.TT.T.TT......@@@@@@@.....@@@@@@@@@@@@@@@@@@@@@@@@
@@@@@@@@@@@@@@@@@@@@@@@@@@@@@@@@@@@T.T.TT.@...@@@@@@@@@.T......@......TTT.....T....@@@@@@@..T.T@@@@@@@@@@@@@@@@@@@@@@@@@
@@@@@@@@@@@@@@@@@@@@@@@@@@@@@@@@@@....T.T.@.T.@T@@@@@@@@@@@@@@@@TTT.TTT...T..TT....@@@@@@..TT.@@@@@@@@@@@@@@@@@@@@@@@@@@
@@@@@@@@@@@@@@@@@@@@@@@@@@@@@@@@@@.T.T...T@@....T@@@@@@@@@@@@@@..TT..TT.T...@@@...@@@@@@.T...@@@@@@@@@@@@@@@@@@@@@@@@@@@
@@@@@@@@@@@@@@@@@@@@@@@@@@@@@@@@@....@@..T.@T...T.@@@@@@..TT..TT.TT.T.....T@@@@@T@@@@@@.T..@@@@@@T.@@@@@@@@@@@@@@@@@@@@@
@@@@@@@@@@@@@@@@@@@@@@@@@@@@@@@..TT.@@@.T.T@@TT..TT@.@@@@.T..T.TT.T.T...T.@@@@@@@@@@@@..TT..@@@@T..T@@@@@@@@@@@@@@@@@@@@
@@@@@@@@@@@@@@@@@@@@@@@@@@@@@@TTTT.@@@@@.TTT@TTT...T..@@@.....T.TT.T.T.TT@@@@@@@@@@.@..T.....@@T...@@@@@@@@@@@@@@@@@@@@@
@@@@@@@@@@@@@@@@@@@@@@@@@@@@@...T.@@@@@@T...@@..T....TT@T.T......T.T..T@@@@@@@@@@@@.....TTT..T@@T.@@@@@@@@@@@@@@@@@@@@@@
@@@@@@@@@@@@@@@@@@@@@@@@@@@@TTTT.@@@@@@@T...T@.TTT...T...T.@@.T....TTT..@@@@@@@@@@@.TTT..TT.T..TT@@@@@@@@@@@@@@@@@@@@@@@
@@@@@@@@@@@@@@@@@@@@@@@@@@..T.TT@@@@@@@@@T.T.@@...T..T...@@@@@...TT.T.T..@@@@@@@@@...T.T....T..@@@@@@@T.@@@@@@T@@@@@@@@@
@@@@@@@@@@@@@@@@@@@@@@@@@....T.@@@@@@@@@@@.T..@.T..T..T.T.@@@@@.T...T.T.T@@@@@@@.T..T.T.T.T.T..@@@@@@..T.@@@@@TT@@@@@@@@
@@@@@@@@@@@@@@@@@@@@@@@@...TT.@@@@@@@@@@.@.T..@.TTTT...TT.@@@@@@T.T.....@@@@@@@T...@T.T.TTT.TTT..T@@TT..@@@@@T..@@@@@@@@
@@@@@@@@@@@@@@@@@@@@@@@T.TT.T@@@@@@@@@@T.@@...@.T....T....@@@@@@@...T..@@@@@T@@...@@@@...T.TT.T.TT.TTTT@@@@@@..T@@@@@@@@
@@@@@@@@@@@@@@@@@@@@@@..T.TT@@@@@@@@@@TTT.@...TT..TTT.TT@@@@@@@@@@T..T@@@@@.T@@.T@@@@@@..T...T..TT.T..@@@@@@...@@@@@@@@@
@@@@@@@@@@@@@@@@@@@@@T.....@@@@@@@@@@.....@@.T..T...T..@@@@@@@@@@@@..@@@@@@..@@@@@@@@@@......TTTTTT.TT@@@@@@T..@@@@@@@@@
@@@@@@@@@@@@@@@@@@@@@T.T..@@@@@@@@@@.T..............TTT@@@@@@@@@@@@@@@@@@@@...@@@@@@@T.T..TTT.T....TTT@@@@@.T.@@@@@@@@@@
@@@@@@@@@@@@@@@@@@@@.T...@@@@@@@@@@T...T..........T..T.T@@@@@@@@@@@@@@@@@@@@..@@@@@@...T@@...T..T.T.TT@@@@@...@@@@@@@@@@
@@@@@@@@@@@@@@@@@@.T.T..@@@@@@@@@@@...T....T.....T.TT....TT@@@@@@@@@@@@@@@@@.T.@@@@..T.@@@@.T..T.T..T@@@@@...@@@@@@@@@@@
@@@@@@@@@@@@@@@@@.TT.TT@@@@@@@@@@@@@.....T......T....T..T.T.@@@@@@@@@@@@@@@@..T@@@@@..@@@@@.T....T.T@@@@@@T.@@@@@@@@@@@@
@@@@@@@@@@@@@@@@...T..@@@@@@@@@@TT@@@T.T........T.T.T.TT..TT.@@@@@@@@@@@@@@@@.T@@@@@@@@@@@@@T...T.TT@@T@...T@@@@@@@@@@@@
@@@@@@@@@@@@@@@T.....@@@@@@@@@@T.T.@@@..T.TT...T.T.T.T........@@@@@@@@@@@@@@@...@@@@@@@@@@@@.@......@T..T..T@@@@@@@@@@@@
@@@@@@@@@@@@@@T..TTT@@@@@@@@@@.....T@@@....T.TTT..T....TT..T....@@@@@@@@@@.@@....@@@@@@@@TT.@@@T..TTTTT.T...@@@@@@@@@@@@
@@@@@@@@@@@@...T..T@@@@@@@@@@....T...@@@.T..T.T....@@.T..T...TT.@@@@@@@@@@..@@...@@@@@@@..T@@@@@T..TT..TT.T.@@@@@@@@@@@@
@@@@@@@@@@@.T.TTT..@@@@@@@@@..T..T...T@@.TT.TTT.TT.@@@T.T..T.....T@@.@@@...T@@....@@@@@T..@@@@@@T.T.T.....T.T@@@@@@@@@@@
@@@@@@@@@@T.T..T.T@@@@@@@@@@.T.TT...T.TT.T..T..TTT.@@@@T.T..TT.TT.T..@@@T.TT@@T..T@@@@..T@@@@@@T....T.....T.@@@@@@@@@@@@
@@@@@@@@@T.TTT.TT.@@@@@@@T@@@...TTT...T.T.T.TT.T.T.T@@@@...T....T.TT..T.TT.TT@@TT.@@@@@@@@@@@@T....TT..T.T.@@@@@@@@@@@@@
@@@@@@@@.....T...T.@@@@@TTT@@@..TTTT..T....T.TTTT...T@@@@.....T...T..T..TTTT..T.T.T@@@@@@@@@@..T.T..TT.T..@@@@@@@@@@@@@@
@@@@@@@@.....T@@T.T@@@@T..TT@@@..T.TTTT.T......T.T..TT@@@T....T...T..T.TT....T.@@...@@@@@@@@T..TTTT.TT...@@@@@@@@@@@@@@@
@@@@@@@TTTTT.@@@T.T.@@.....T.@@@T..T.T.TTTT........T..T...TTTTT.....TT....T..T@@@@...@@@@@@...TT.T..TTT.@@@@@@@@@@@@@@@@
@@@@@@.T.T..@@@@..TT@@T...TT.T@@@T.TT..@@@@@@T........T....T..TT....T......TT@@@@@@.TT@@@@@@TTTT...T...@@@@@@@@@@@@@@@@@
@@@@@@.T..T@@@@@@TT..@.TTT.TT.T@@T.TT.@@@@@@@..TTTT...@@@............TT..TT.@@@@@@@@...@@@@...........@@@@@@@@@@@@@@@@@@
@@@@@@@.T.@@@@@@@@...@T.TT..TT..T.T..@@@@@@@@T........@@@TT...T..TT..T..T..T@@@@@@@@@..@@@TT..TT...T.@@@@@@@@@@@@@@@@@@@
@@@@@@@@T@@@@@@@@@..T@@.T.....TT.....@@@@@@@@T.T..TTTT....TT....TTT...T.T.T@@@@@@@@@@..T.T..T@@.T...@@@@@@@@@@@@@@@@@@@@
@@@@@@@@@@@@@@@@@@@T..@TT.T...TT....T@@@@@@@@T.T....T.......T@@TTTTT.TT.T.T.@@@@@@@@@..T..T.@@@@..T@@@@@@@@@@@@@@@@@@@@@
@@@@@@@@@@@@@@@@TT@T..@@T...T.TT...T...@@T@@@TTT.TT.T.TTT...@@@@@.T.T.T....T.@@@@@@@@@@@..TT.@@@@.@@@@@@@@@@@@@@@@@@@@@@
@@@@@@@@@@@@@@@...@@.T....TTTT.......T....@@@@...TT...TT..@@@@@@@@...TTT..TTTT@@@@@@T@@@T.T.T.@@@@@@@@@@@@@@@@@@@@@@@@@@
@@@@@@@@@@@@@@TT.T@@@..TTT..T.TTT.TT......@@@@TT.TTTTT.T..@@@@@@T.TTTTT..TT..T.@@@@TT.T........@@@@@@@@@@@@@@@@@@@@@@@@@
@@@@@@@@@@@@@TTT.T@@@...T.T....T...T......@@@..T.T.TT..TTT...@@@.TTTTT.........T@@@...TTT..TTT.@@@@@@@@@@@@@@@@@@@@@@@@@
@@@@@@@@@@@@T...TTT..TT...TT.T.@@@T..TT..T..TT....TTT.TT.....@@@T..........TTT.T.@@.T..T......@@@@@@@@@@@@@@@@@@@@@@@@@@
@@@@@@@@@@...TT.T..TTT...TTTT..@@@TT....T.T....T..T.T...TT..T@@@.T..T.T..T..T..TT.TT....TT.T.@@@@@@@@@@@@@@@@@@@@@@@@@@@
@@@@@@@@@@T..T..TT.TT..TTT....@@@..T.T....T......T....TT@@TTT@@@T..T.T.TT..TTT.TT...TTTTT...@@@@@@@@@@@@@@@@@@@@@@@@@@@@
@@@@@@@@@@@T....T.......TTTT.@@@@TTTT......TTTT.TT..T.TT@@@..T....T..TT..TT.....TTT.....TT.@@@@@@@@@@@@@@@@@@@@@@@@@@@@@
@@@@@@@@@@@@TTTT.T.....T..T@@@@@@@@.TT.T..TT......T....@@@@@..T..T.T.T......T...T...TTT..T@@@@@@@@@@@@@@@@@@@@@@@@@@@@@@
@@@@@@@@@@@@@T.T.TT.T...T..@@@@@@@@@...@@@@@T.....T.T.T@@@@@@...T.T@@@TT.TTT...T.T..TT..T@@@@@@@@@@@@@@@@@@@@@@@@@@@@@@@
@@@@@@@@@@@@@@..TT.T....T.T@@@@@@@@@T.@@@@@@@.TTTTTT...@@@@@@..T.T@@@@@.....T.TT..TTT...@@@@@@@@@@@@@@@@@@@@@@@@@@@@@@@@
@@@@@@@@@@@@@@@....T...T...T.T...T...@@@@.@@@@.T...T..T@@@@@T.T..@@@@@@@T..T..T...TT.T.@@@@@@@@@@@@@@@@@@@@@@@@@@@@@@@@@
@@@@@@@@@@@@@@@@.T.TTT.T..TTT..TT.T.@@@@T.T@@@@@.TT..TTT@@@T.TT.@@@@@@@@@..T...T.T....@@@@@@@@@@@@@@@@@@@@@@@@@@@@@@@@@@
@@@@@@@@@@@@@@@@@...TT..TT.TT..T.T.@@@@..T..@@@..T..TT..@@..T..@@@@@@@@@@..T.TT..TTTT@@@@@@@@@@@@@@@@@@@@@@@@@@@@@@@@@@@
@@@@@@@@@@@@@@@@@@.T...TT..T.T....@@@@@@@@T..@..T.T.TT.TT.T...@@@@@@@@@@TTT.T.TT....@@@@@@@@@@@@@@@@@@@@@@@@@@@@@@@@@@@@
@@@@@@@@@@@@@@@@@@@..TT...TT.T.TT@@@@@@@@@@@T..TT@.TT.TTTT..T@@@@@@@@@T.T.@TT......@@@@@@@@@@@@@@@@@@@@@@@@@@@@@@@@@@@@@
@@@@@@@@@@@@@@@@@@@@T.TT..TT.T..@@@@@@@@@@@T....@@@@...T.T..@@@@@@@@@....@@@....T.@@@@@@@@@@@@@@@@@@@@@@@@@@@@@@@@@@@@@@
@@@@@@@@@@@@@@@@@@@@@TT.TT.T.TT@@@@@@@@@@@@T..T.@@@@@.T....@@@@@@@@@T.....@@@...T@@@@@@@@@@@@@@@@@@@@@@@@@@@@@@@@@@@@@@@
@@@@@@@@@@@@@@@@@@@@@@.....TTT@@@@.@@@@@@@@T.T..T@@@@@T..T@@@@@@@@@..T.T...@@@T.@@@@@@@@@@@@@@@@@@@@@@@@@@@@@@@@@@@@@@@@
@@@@@@@@@@@@@@@@@@@@@@@T.T...@@@@TT@@@@@@@@.T..TT.@@@@@T.@@@@@@@@@@...T.TT.T@@@@@@@@@@@@@@@@@@@@@@@@@@@@@@@@@@@@@@@@@@@@
@@@@@@@@@@@@@@@@@@@@@@@@TTT.@@@@T..@@@@@@T..T....TT@@@@@@@@@@@@@@@@TT.T..T...@@@@@@@@@@@@@@@@@@@@@@@@@@@@@@@@@@@@@@@@@@@
@@@@@@@@@@@@@@@@@@@@@@@@@..@@@@...@@@@@@@......TT..@@@@@@@@@@@@@@@TTT..T.....@@@@@@@@@@@@@@@@@@@@@@@@@@@@@@@@@@@@@@@@@@@
@@@@@@@@@@@@@@@@@@@@@@@@@@@@@@..TT.@@@@@..TT.....T@@@.@@@@@@@@@@.....TT...T.@@@@@@@@@@@@@@@@@@@@@@@@@@@@@@@@@@@@@@@@@@@@
@@@@@@@@@@@@@@@@@@@@@@@@@@@@@T.TT..TT.T...T.T....@@@TT.@@@@@@@@@..TT..T.TT.@@@@@@@@@@@@@@@@@@@@@@@@@@@@@@@@@@@@@@@@@@@@@
@@@@@@@@@@@@@@@@@@@@@@@@@@@@TT.T..TT.T.T.TT....T@@@TT..T@@@@@@@T.T..T.....@@@@@@@@@@@@@@@@@@@@@@@@@@@@@@@@@@@@@@@@@@@@@@
@@@@@@@@@@@@@@@@@@@@@@@@@@@@@.T..T...T.T....T.T@@@T.....T@@@@...T...T.TT.@@@@@@@@@@@@@@@@@@@@@@@@@@@@@@@@@@@@@@@@@@@@@@@
@@@@@@@@@@@@@@@@@@@@@@@@@@@@@@.TT..T.T..T..T.T.T@.T..T.T..@@@@T.TTT.TT.T@@@@@@@@@@@@@@@@@@@@@@@@@@@@@@@@@@@@@@@@@@@@@@@@
@@@@@@@@@@@@@@@@@@@@@@@@@@@@@@@@.TTTT....T..@@..TT@@@@@@@T.@@@@.T...T.T@@@@@@@@@@@@@@@@@@@@@@@@@@@@@@@@@@@@@@@@@@@@@@@@@
@@@@@@@@@@@@@@@@@@@@@@@@@@@@@@@@@....TT..T.@@@....@@@@@@@TT.@@@@TT....@@@@@@@@@@@@@@@@@@@@@@@@@@@@@@@@@@@@@@@@@@@@@@@@@@
@@@@@@@@@@@@@@@@@@@@@@@@@@@@@@@@@@TTT.TTT.@@@@T...@@@@@@TTTT.@@@@....@@@@@@@@@@@@@@@@@@@@@@@@@@@@@@@@@@@@@@@@@@@@@@@@@@@
@@@@@@@@@@@@@@@@@@@@@@@@@@@@@@@@@@@T...T.@@@@@.T.@@@@@@@T..TTT@@@@TT@@@@@@@@@@@@@@@@@@@@@@@@@@@@@@@@@@@@@@@@@@@@@@@@@@@@
@@@@@@@@@@@@@@@@@@@@@@@@@@@@@@@@@@@@T...@@@@@@...@@@@@@@T...T.T@@@@@@@@@@@@@@@@@@@@@@@@@@@@@@@@@@@@@@@@@@@@@@@@@@@@@@@@@
@@@@@@@@@@@@@@@@@@@@@@@@@@@@@@@@@@@@@..@@@@@@@.TT@@@@@@@@..T..TT@@@@@@@@@@@@@@@@@@@@@@@@@@@@@@@@@@@@@@@@@@@@@@@@@@@@@@@@
@@@@@@@@@@@@@@@@@@@@@@@@@@@@@@@@@@@@@@@@@@@@@T..T.@@T.@@TTT.TTT..@@@@@@@@@@@@@@@@@@@@@@@@@@@@@@@@@@@@@@@@@@@@@@@@@@@@@@@
@@@@@@@@@@@@@@@@@@@@@@@@@@@@@@@@@@@@@@@@@..T.T...TT..T.T....T...@@@@@@@@@@@@@@@@@@@@@@@@@@@@@@@@@@@@@@@@@@@@@@@@@@@@@@@@
@@@@@@@@@@@@@@@@@@@@@@@@@@@@@@@@@@@@@@@@TT...T..T....TT..T.TTT.@@@@@@@@@@@@@@@@@@@@@@@@@@@@@@@@@@@@@@@@@@@@@@@@@@@@@@@@@
@@@@@@@@@@@@@@@@@@@@@@@@@@@@@@@@@@@@@@@@@T.T.T.....T....TT...T@@@@@@@@@@@@@@@@@@@@@@@@@@@@@@@@@@@@@@@@@@@@@@@@@@@@@@@@@@
@@@@@@@@@@@@@@@@@@@@@@@@@@@@@@@@@@@@@@@@@@TT...T..TT.TT....TT@@@@@@@@@@@@@@@@@@@@@@@@@@@@@@@@@@@@@@@@@@@@@@@@@@@@@@@@@@@
@@@@@@@@@@@@@@@@@@@@@@@@@@@@@@@@@@@@@@@@@@@.T...T.T...TT...T@@@@@@@@@@@@@@@@@@@@@@@@@@@@@@@@@@@@@@@@@@@@@@@@@@@@@@@@@@@@
@@@@@@@@@@@@@@@@@@@@@@@@@@@@@@@@@@@@@@@@@@@@T..TT..T.T..T.T@@@@@@@@@@@@@@@@@@@@@@@@@@@@@@@@@@@@@@@@@@@@@@@@@@@@@@@@@@@@@
@@@@@@@@@@@@@@@@@@@@@@@@@@@@@@@@@@@@@@@@@@@@@.T.T.T....T..@@@@@@@@@@@@@@@@@@@@@@@@@@@@@@@@@@@@@@@@@@@@@@@@@@@@@@@@@@@@@@
@@@@@@@@@@@@@@@@@@@@@@@@@@@@@@@@@@@@@@@@@@@@@@.TT.TTTTTT.@@@@@@@@@@@@@@@@@@@@@@@@@@@@@@@@@@@@@@@@@@@@@@@@@@@@@@@@@@@@@@@
@@@@@@@@@@@@@@@@@@@@@@@@@@@@@@@@@@@@@@@@@@@@@@@..T.TTT.T@@@@@@@@@@@@@@@@@@@@@@@@@@@@@@@@@@@@@@@@@@@@@@@@@@@@@@@@@@@@@@@@
@@@@@@@@@@@@@@@@@@@@@@@@@@@@@@@@@@@@@@@@@@@@@@@@.T..T..@@@@@@@@@@@@@@@@@@@@@@@@@@@@@@@@@@@@@@@@@@@@@@@@@@@@@@@@@@@@@@@@@
@@@@@@@@@@@@@@@@@@@@@@@@@@@@@@@@@@@@@@@@@@@@@@@@@@TT.@@@@@@@@@@@@@@@@@@@@@@@@@@@@@@@@@@@@@@@@@@@@@@@@@@@@@@@@@@@@@@@@@@@
@@@@@@@@@@@@@@@@@@@@@@@@@@@@@@@@@@@@@@@@@@@@@@@@@@@@@@@@@@@@@@@@@@@@@@@@@@@@@@@@@@@@@@@@@@@@@@@@@@@@@@@@@@@@@@@@@@@@@@@@
@@@@@@@@@@@@@@@@@@@@@@@@@@@@@@@@@@@@@@@@@@@@@@@@@@@@@@@@@@@@@@@@@@@@@@@@@@@@@@@@@@@@@@@@@@@@@@@@@@@@@@@@@@@@@@@@@@@@@@@@
