type octile
height 144
width 148
map
@@@@@@@@@@@@@@@@@@@@@@@@@@@@@@@@@@@@@@@@@@@@@@@@@@@@@@@@@@@@@@@@@@@@@@@@@@@@@@@@@@@@@@@@@@@@@@@@@@@@@@@@@@@@@@@@@@@@@@@@@@@@@@@@@@@@@@@@@@@@@@@@@@@@
@@@@@@@@@@@@@@@@@@@@@@@@@@@@@@@@@@@@@@@@@@@@@@@@@@@@@@@@@@@@@@@@@@@@@@@@@@@@@@@@@@@@@@@@@@@@@@@@@@@@@@@@@@@@@@@@@@@@@@@@@@@@@@@@@@@@@@@@@@@@@@@@@@@@
@@@@@@@@@@@@@@@@@@@@@@@@@@@@@@@@@@@@@@@@@@@@@@@@@@@@@@@@@@@@@@@@@@@@@@@@@@@@@@@@@@@@@@@@@@@@@@@@@@@@@@@@@@@@@@@@@@@@@@@@@@@@@@@@@@@@@@@@@@@@@@@@@@@@
@@@@@@@@@@@@@@@@@@@@@@@@@@@@@@@@@@@@@@@@@@@@@@@@@@@@@@@@@@@@@@@@@@@@@@@@@@@@@@@@@@@@@@@@@@@@@@@@@@@@@@@@@@@@@@@@@@@@@@@@@@@@@@@@@@@@@@@@@@@@@@@@@@@@
@@@@@@@@@@@@@@@@@@@@@@@@@@@@@@@@@@@@@@@@@@@@@@@@@@@@@@@@@@@@@@@@@@@@@@@@@@@@@@@@@@@@@@@@@@@@@@@@@@@@@@@@@@@@@@@@@@@@@@@@@@@@@@@@@@@@@@@@@@@@@@@@@@@@
@@@@@@@@@@@@@@@@@@@@@@@@@@@@@@@@@@@@@@@@@@@@@@@@@@@@@@@@@@@@@@@@@@@@@@@@@@@@@@@@@@@@@@@@@@@@@@@@@@@@@@@@@@@@@@@@@@@@@@@@@@@@@@@@@@@@@@@@@@@@@@@@@@@@
@@@@@@@@@@@@@@@@@@@@@@@@@@@@@@@@@@@@@@@@@@@@@@@@@@@@@@@@@@@@@@@@@@@@@@@@@@@@@@@@@@@@@@@@@@@@@@@@@@@@@@@@@@@@@@@@@@@@@@@@@@@@@@@@@@@@@@@@@@@@@@@@@@@@
@@@@@@@@@@@@@@@@@@@@@@@@@@@@@@@@@@@@@@@@@@@@@@@@@@@@@@@@@@@@@@@@@@@@@@@@@@@@@@@@@@@@@@@@@@@@@@@@@@@@@@@@@@@@@@@@@@@@@@@@@@@@@@@@@@@@@@@@@@@@@@@@@@@@
@@@@@@@@@@@@@@@@@@@@@@@@@@@@@@@@@@@@@@@@@@@@@@@@@@@@@@@@@@@@@@@@@@@@@@@@@@@@@@@@@@@@@@@@@@@@@@@@@@@@@@@@@@@@@@@@@@@@@@@@@@@@@@@@@@@@@@@@@@@@@@@@@@@@
@@@@@@@@@@@@@@@@@@@@@@@@@@@@@@@@@@@@@@@@@@@@@@@@@@@@@@@@@@@@@@@@@@@@@@@@@@@@@@@@@@@@@@@@@@@@@@@@@@@@@@@@@@@@@@@@@@@@@@@@@@@@@@@@@@@@@@@@@@@@@@@@@@@@
@@@@@@@@@@@@@@@@@@@@@@@@@@@@@@@@@@@@@@@@@@@@@@@@@@@@@@@@@@@@@@@@@@@@@@@@@@@@@@@@@@@@@@@@@@@@@@@@@@@@@@@@@@@@@@@@@@@@@@@@@@@@@@@@@@@@@@@@@@@@@@@@@@@@
@@@@@@@@@@@@@@@@@@@@@@@@@@@@@@@@@@@@@@@@@@@@@@@@@@@@@@@@@@@@@@@@@@@@@@@@@@@@@@@@@@@@@@@@@@@@@@@@@@@@@@@@@@@@@@@@@@@@@@@@@@@@@@@@@@@@@@@@@@@@@@@@@@@@
@@@@@@@@@@@@@@@@@@@@@@@@@@@@@@@@@@@@@@@@@@@@@@@@@@@@@@@@@@@@@@@@@@@@@@@@@@@@@@@@@@@@@@@@@@@@@@@@@@@@@@@@@@@@@@@@@@@@@@@@@@@@@@@@@@@@@@@@@@@@@@@@@@@@
@@@@@@@@@@@@@@@@@@@@@@@@@@@@@@@@@@@@@@@@@@@@@@@@@@@@@@@@@@@@@@@@@@@@@@@@@@@@@@@@@@@@@@@@@@@@@@@@@@@@@@@@@@@@@@@@@@@@@@@@@@@@@@@@@@@@@@@@@@@@@@@@@@@@
@@@@@@@@@@@@@@@@@@@@@@@@@@@@@@@@@@@@@@@@@@@@@@@@@@@@@@@@@@@@@@@@@@@@@@@@@@@@@@@@@@@@@@@@@@@@@@@@@@@@@@@@@@@@@@@@@@@@@@@@@@@@@@@@@@@@@@@@@@@@@@@@@@@@
@@@@@@@@@@@@@@@@@@@@@@@@@@@@@@@@@@@@@@@@@@@@@@@@@@@@@@@@@@@@@@@@@.@@@@@@@@@@@@@@@@@@@@@@@@@@@@@@@@@@@@@@@@@@@@@@@@@@@@@@@@@@@@@@@@@@@@@@@@@@@@@@@@@@
@@@@@@@@@@@@@@@@@@@@@@@@@@@@@@@@@@@@@@@@@@@@@@@@@@@@@@@@@@@@@@@@T.@@.@@@@@@@@@@@@@@@@@@@@@@@@@@@@@@@@@@@@@@@@@@@@@@@@@@@@@@@@@@@@@@@@@@@@@@@@@@@@@@@
@@@@@@@@@@@@@@@@@@@@@@@@@@@@@@@@@@@@@@@@@@@@@@@@@@@@@@@@@@@@@@@@TT@@T@@@@@@@@@@@@@@@@@@@@@@@@@@@@@@@@@@@@@@@@@@@@@@@@@@@@@@@@@@@@@@@@@@@@@@@@@@@@@@@
@@@@@@@@@@@@@@@@@@@@@@@@@@@@@@@@@@@@@@@@@@@@@@@@@@@@@@@@@@@@@@@@..T..@@@@@@@@@@@@@@@@@@@@@@@@@@@@@@@@@@@@@@@@@@@@@@@@@@@@@@@@@@@@@@@@@@@@@@@@@@@@@@@
@@@@@@@@@@@@@@@@@@@@@@@@@@@@@@@@@@@@@@@@@@@@@@@@@@@@@@@@@@@@@@@@.T..T@@@@@@@@@@@@@@@@@@@@@@@@@@@@@@@@@@@@@@@@@@@@@@@@@@@@@@@@@@@@@@@@@@@@@@@@@@@@@@@
@@@@@@@@@@@@@@@@@@@@@@@@@@@@@@@@@@@@@@@@@@@@@@@@@@@@@@@@@@@@@@@...TT.T@@@@@@@@@@@@@@@@@@@@@@@@@@@@@@@@@@@@@@@@@@@@@@@@@@@@@@@@@@@@@@@@@@@@@@@@@@@@@@
@@@@@@@@@@@@@@@@@@@@@@@@@@@@@@@@@@@@@@@@@@@@@@@@@@@@@@@@@@@@@@@@..T..T.@@@@@@@@@@@@@@@@@@@@@@@@@@@@@@@@@@@@@@@@@@@@@@@@@@@@@@@@@@@@@@@@@@@@@@@@@@@@@
@@@@@@@@@@@@@@@@@@@@@@@@@@@@@@@@@@@@@@@@@@@@@@@@@@@@@@@@@@@@.T@@T.TTTT.T@@@@@@@@@@@@@@@@@@@@@@@@@@@@@@@@@@@@@@@@@@@@@@@@@@@@@@@@@@@@@@@@@@@@@@@@@@@@
@@@@@@@@@@@@@@@@@@@@@@@@@@@@@@@@@@@@@@@@@@@@@@@@@@@@@@@@@@@TT..TT.T....T.@@@@@@@@@@@@@@@@@@@@@@@@@@@@@@@@@@@@@@@@@@@@@@@@@@@@@@@@@@@@@@@@@@@@@@@@@@@
@@@@@@@@@@@@@@@@@@@@@@@@@@@@@@@@@@@@@@@@@@@@@@@@@@@@@@@@@@..T.T....T..TT.T@@@@@@@@@@@@@@@@@@@@@@@@@@@@@@@@@@@@@@@@@@@@@@@@@@@@@@@@@@@@@@@@@@@@@@@@@@
@@@@@@@@@@@@@@@@@@@@@@@@@@@@@@@@@@@@@@@@@@@@@@@@@@@@@@@@@...T..T..TT.....@@@@@@@@@@@@@@@@@@@@@@@@@@@@@@@@@@@@@@@@@@@@@@@@@@@@@@@@@@@@@@@@@@@@@@@@@@@
@@@@@@@@@@@@@@@@@@@@@@@@@@@@@@@@@@@@@@@@@@@@@@@@@@@@@@@@@TTT...TT...TTT.@@@@@@@@@@@@@@@@@@@@@@@@@@@@@@@@@@@@@@@@@@@@@@@@@@@@@@@@@@@@@@@@@@@@@@@@@@@@
@@@@@@@@@@@@@@@@@@@@@@@@@@@@@@@@@@@@@@@@@@@@@@@@@@@@@@.T..T....TT.TT...@@@@@@@@@@@@@@@@@@@@@@@@@@@@@@@@@@@@@@@@@@@@@@@@@@@@@@@@@@@@@@@@@@@@@@@@@@@@@
@@@@@@@@@@@@@@@@@@@@@@@@@@@@@@@@@@@@@@@@@@@@@@@@@@@@@@.TT...@@.TT..T.T@@@@@@@@@@@@@@@@@@@@@@@@@@@@@@@@@@@@@@@@@@@@@@@@@@@@@@@@@@@@@@@@@@@@@@@@@@@@@@
@@@@@@@@@@@@@@@@@@@@@@@@@@@@@@@@@@@@@@@@@@@@@@@@@@@@@T..T.T@@@@..T.T.@@@@@@@@@@@@@@@@@@@@@@@@@@@@@@@@@@@@@@@@@@@@@@@@@@@@@@@@@@@@@@@@@@@@@@@@@@@@@@@
@@@@@@@@@@@@@@@@@@@@@@@@@@@@@@@@@@@@@@@@@@@@@@@@@@@@T...T.@@@@@TTT..@@@@@@T@@@@@@@T@@@@@@@@@@@@@@@@@@@@@@@@@@@@@@@@@@@@@@@@@@@@@@@@@@@@@@@@@@@@@@@@@
@@@@@@@@@@@@@@@@@@@@@@@@@@@@@@@@@@@@@@@@@@@@@@@@@@@T.TTT.T@@@@....T@@@@@@@.@@@@@@.TT@@@@@@@@@@@@@@@@@@@@@@@@@@@@@@@@@@@@@@@@@@@@@@@@@@@@@@@@@@@@@@@@
@@@@@@@@@@@@@@@@@@@@@@@@@@@@@@@@@@@@@@@@@@@@@@@@@@..T.T...@@@TT..T.@@@@@@TT@@@@@@T..@@@@@@@@@@@@@@@@@@@@@@@@@@@@@@@@@@@@@@@@@@@@@@@@@@@@@@@@@@@@@@@@
@@@@@@@@@@@@@@@@@@@@@@@@@@@@@@@@@@@@@@@@@@@@@@@@@T..T.T...T@TT.TT.@@@@@@.T.@@@@@.TTT@@@@@@@@@@@@@@@@@@@@@@@@@@@@@@@@@@@@@@@@@@@@@@@@@@@@@@@@@@@@@@@@
@@@@@@@@@@@@@@@@@@@@@@@@@@@@@@@@@@@@@@@@@@@@@@@.T....TT.T....T..T@@@@@@.TTT.T.@@...T..@@@@@@@@@@@@@@@@@@@@@@@@@@@@@@@@@@@@@@@@@@@@@@@@@@@@@@@@@@@@@@
@@@@@@@@@@@@@@@@@@@@@@@@@@@@@@@@@@@@@@@@@@@@@@@.TT...T.T..TT....T@@@@@.T..T..TTT...T..@@@@@@@@@@@@@@@@@@@@@@@@@@@@@@@@@@@@@@@@@@@@@@@@@@@@@@@@@@@@@@
@@@@@@@@@@@@@@@@@@@@@@@@@@@@@@@@@@@@@@@@@@@.@@@..T.T....TT..T...T@@@@@@...T...T.T...T.T@@@@@@@@@@@@@@@@@@@@@@@@@@@@@@@@@@@@@@@@@@@@@@@@@@@@@@@@@@@@@
@@@@@@@@@@@@@@@@@@@@@@@@@@@@@@@@@@@@@@@@@@@..TT..TT.....T.TTTTT.T@@@@@@@..T...T..TTTTT.TTT@@@@@@@@@@@@@@@@@@@@@@@@@@@@@@@@@@@@@@@@@@@@@@@@@@@@@@@@@@
@@@@@@@@@@@@@@@@@@@@@@@@@@@@@@@@@@@@@@@@@@T.T.T....T.....TTTT..T..@@@@@@TTT........T.T...T@@@@@@@@@@@@@@@@@@@@@@@@@@@@@@@@@@@@@@@@@@@@@@@@@@@@@@@@@@
@@@@@@@@@@@@@@@@@@@@@@@@@@@@@@@@@@@@@@@@..TTT..T...T...TT.TT.T.TT.T.@@@@@..TT.T..TTTT....@@@@@@@@@@@@@@@@@@@@@@@@@@@@@@@@@@@@@@@@@@@@@@@@@@@@@@@@@@@
@@@@@@@@@@@@@@@@@@@@@@@@@@@@@@@@@@@@@@@.T.T.TTTT..T.TT....TT.T.TT....@@@@@..TT..TTTT...T@@@@@@@@@@@@@@@@@@@@@@@@@@@@@@@@@@@@@@@@@@@@@@@@@@@@@@@@@@@@
@@@@@@@@@@@@@@@@@@@@@@@@@@@@@@@@@@@@@@TTT.T............T..T.T..T.....@@@@@TT.TT.T.T...T@@@@@@@@@@@@@@@@@@@@@@@@@@@@@@@@@@@@@@@@@@@@@@@@@@@@@@@@@@@@@
@@@@@@@@@@@@@@@@@@@@@@@@@@@@@@@@@@@@@.......TT..TT.TT.T.TTTT..T..TTTT..@@@......T.T.T.@@@@@@@@..@@@@@@@@@@@@@@@@@@@@@@@@@@@@@@@@@@@@@@@@@@@@@@@@@@@@
@@@@@@@@@@@@@@@@@@@@@@@@@@@@@@@@@@@@T..T..TTT.T....T..TT...@@.T..T.T.TT.@T...@@@.....@@@@@@@@..T.@@@@@@@@@@@@@@@@@@@@@@@@@@@@@@@@@@@@@@@@@@@@@@@@@@@
@@@@@@@@@@@@@@@@@@@@@@@@@@@@@@@@@@@...............T.....T.@@@@T...TT.T.T....@@@@@...@@@@@@@@@..T.T@@@@@@@@@@@@@@@@@@@@@@@@@@@@@@@@@@@@@@@@@@@@@@@@@@
@@@@@@@@@@@@@@@@@@@@@@@@@@@@@@@@@@....T.TTTT.TT..T....TT.@@@@@@T......TT.T.@@@@@@@.@@@@@@@@@@@@..T.@@@@@@@@@@@@@@@@@@@@@@@@@@@@@@@@@@@@@@@@@@@@@@@@@
@@@@@@@@@@@@@@@@@@@@@@@@@@@@@@@@@..T...TTTT.TTTTT..TTTTT.@@@@@@..T...T.T..T@@@@@@@@@@@@@@@@@@@@T....@@@@@@@@@@@@@@@@@@@@@@@@@@@@@@@@@@@@@@@@@@@@@@@@
@@@@@@@@@@@@@@@@@@@@@@@@@@@@@@@@T..TT...@@.TTTT....T....@@@@@@@@.TTT..T..T..@@@@@@@@@@@@@@@@@@.T...T.@@@@@@@@@@@@@@@@@@@@@@@@@@@@@@@@@@@@@@@@@@@@@@@
@@@@@@@@@@@@@@@@@@@@@@@@@@@@@@@TT..TTT.@@@@.....T..TT.T.@@@@@@@@@..T...T.TT.T@@@@@@@@@@@@@@@@@.TTTT.TT@@@@@@@@@@@@@@@@@@@@@@@@@@@@@@@@@@@@@@@@@@@@@@
@@@@@@@@@@@@@@@@@@@@@@@@@@@@@@....TT..@@@@@T.T.T.T..T..@@@@@@@@@@@T..TT...T...@@@@@@@@@@.T@@@@......T.@@@@@@@@@@@@@@@@@@@@@@@@@@@@@@@@@@@@@@@@@@@@@@
@@@@@@@@@@@@@@@@@@@@@@@@@@@@@.T.T.TT.@@@@@...T.T.....@@@@@@@@@@@@@@T..T.....TT.@@@@@@@@.T...@@T..T..T.@@@@@@@@@@@@@@@@@@@@@@@@@@@@@@@@@@@@@@@@@@@@@@
@@@@@@@@@@@@@@@@@@@@@@@@@@@@T........T@@@..T.TT....TT@@@@@@@@@@@@@@@.T.....T.T.T@@@@@@.......T.T.TTT...@@@@@@@@@@@@@@@@@@@@@@@@@@@@@@@@@@@@@@@@@@@@@
@@@@@@@@@@@@@@@@@@@@@@@@@@@......T..TTT@T.....T.TT....@@T@@@@@@@@@@@.TTTT.TT...T.@@@@@@T....T.T......TTT@@@@@@@@@@@@@@@@@@@@@@@@@@@@@@@@@@@@@@@@@@@@
@@@@@@@@@@@@@@@@@@@@@@@@@@@...T....TTTT.T..TT..TTTT..T...@@@@@@@@@@@@@..T..T..T..T@@@@@@..T.TT.T.T....T.TTT@@@@@@@@@@@@@@@@@@@@@@@@@@@@@@@@@@@@@@@@@
@@@@@@@@@@@@@@@@@@@@@@@@@@@..T.....T......T....T..TT.....@@@@@@@@@@@@@@T..T.T.T....@@@@@@..T..TT.T...TT..T.T@@@@@@@@@@@@@@@@@@@@@@@@@@@@@@@@@@@@@@@@
@@@@@@@@@@@@@@@@@@@@@@@@@.TT.T..T......TT.T.....T.T......@@TT@@@@@@@@@@.....T...TT..@@@@@@..T.T..TT.........@@@@@@@@@@@@@@@@@@@@@@@@@@@@@@@@@@@@@@@@
@@@@@@@@@@@@@@@@@@@@@@@@@.T.T.T..T.T....T.T.....T....TT...T.@@@@@@@@@@@@..TT.TTT..T..@@@@@@..TT..T.T...T...@@@@@@@@@@@@@@@@@@@@@@@@@@@@@@@@@@@@@@@@@
@@@@@@@@@@@@@@@@@@@@@@@@@@.T...TT..T........T.T.T...T.TT.T..@@@@@@@@@@@@@@.T..TTTT...T@@@@@TTT.T.T.TTTTTT.@@@@@@@@@@@@@@@@@@@@@@@@@@@@@@@@@@@@@@@@@@
@@@@@@@@@@@@@@@@@@@@@@T@@.T.TTTT....T..T.T...TT.T....T.T.T..T@@T@@@@@@@@@@@...TT..TTTT.T@@@T.T.........T.@@@@@@@@@@@@@@@@@@@@@@@@@@@@@@@@@@@@@@@@@@@
@@@@@@@@@@@@@@@@@@@@@.TTT..T.TT...T.TT..TT...T.T.TTT..TTT..T....@@@@@@@@@@@@TTT.T..T......T...@.TTT.T.T.@@@@@@@@@@@@@@@@@@@@@@@@@@@@@@@@@@@@@@@@@@@@
@@@@@@@@@@@@@@@@@@@@@..TT....TTT..TTT.T.@@@.T..T..TT.TT.TT.T.T.@@@@@@@@@@@@@@T.T...T...TT....@@@.T...T.@@@@@@@@@@@@@@@@@@@@@@@@@@@@@@@@@@@@@@@@@@@@@
@@@@@@@@@@@@@@@@@@@@@T.T..T.T...TTT.T.@@@@@.....T..........T.T..@@@T@@@@@@@@@.TT..T.TT..TT..@@@@@....@@@@@@@@@@@@@@@@@@@@@@@@@@@@@@@@@@@@@@@@@@@@@@@
@@@@@@@@@@@@@@@@@@@@@T....T......TTT.T@@@@@.T..T...T.TT..T..TTTT@@T.@@@@@@@@@@..T.T...TT.TTT@@@@@@T.@@@@@@@@.@@@@@@@.@@@@@@@@@@@@@@@@@@@@@@@@@@@@@@@
@@@@@@@@@@@@@@@@@.TT...........T....T@@@@@@@@@TTTT...TTT.T..TT.T.T.@@@@@@@@@@@T.....T....T...@@@@@@@@@@@@@@..@@@@@@.T.@@@@@@@@@@@@@@@@@@@@@@@@@@@@@@
@@@@@@@@@@@@@@@@@T.T.T.T.TT...T..TTT@@@@@@@@@@..TT..T.T.T.T.T....TT@@@@T@@@@@..T@@@TT.T.T..T.T@@@@@@@@@@@@..T.@@@@.TT..@@@@@@@@@@@@@@@@@@@@@@@@@@@@@
@@@@@@@@@@@@@@@TTTT..@TTT..T.TTT...T@@@@@@@@@@TTT...TT...........TT.@@..@@@@..T@@@@@.T..TT..T.T@@@@@@@@@@..T..@@..T....@@@@@@@@@@@@@@@@@@@@@@@@@@@@@
@@@@@@@@@@@@@@..T...@@@....T.T...T.T@@@@@@@@@@@T@@...T.T.TTT.T.T.......@@@@@T.@@@@@@@.T..T......@@@@@@@@..TT..TT..T...T@@@@@@@@@@@@@@@@@@@@@@@@@@@@@
@@@@@@@@@@@@@.T....@@@@...T.T...TT.T@@@@@@@@@@@@@@@...T.T..TT.T........@@@@.T.@@@@@@@T.T..TTTT.T.@@@@@@T.T..TT.T.TT.T...@@@@@@@@@@@@@@@@@@@@@@@@@@@@
@@@@@@@@@@@@..TT..@@@@T...TTT.T.T....@@@@@@@@@@@@@T...T.TT..T.TT..T....T@@T...@@@@@@@@.....T...TT.@@@@@@TTT...T..T.TTT...@T@@@@@@@@@@@@@@@@@@@@@@@@@
@@@@@@@@@@@...T..T@@@.......T.T...TT..@@@@@@@@@@@@..@@TT.T.....T.....TTTT..T...@@@@@@@@...T..T.T.T.@@@@@@T..TTT.T.........T.@@@@@@@@@@@@@@@@@@@@@@@@
@@@@@@@@@@TTT.T...T.TT..TT.T....TTTTT.T@@@@@@@@@@@@@@@TTT...TT...T...T..TT.T@@..T@@@@@@@TT...T...T.T@@@@@@.T...T..T.TT...TTTT@@@@@@@@@@@@@@@@@@@@@@@
@@@@@@@@@..TT..TTT...T..T@@.TT.TTT......@@@@@@@@@@@@@.TT..TTTT...T.T...T.T.@@@@T.T@@@@@@@.....TT..T.T@@@@@..TT..T...T.TT......@@@@@@@@@@@@@@@@@@@@@@
@@@@@@@@.TTT....TTT...T.@@@@.............@@@@@@@@@@@@..@T....T.TT..TT.TT..@@@@@@..T@@@@@@@T..TTTTT....@@@@@T...T...T.T..T.T.T.@@@@@@@@@@@@@@@@@@@@@@
@@@@@@@...TT...TTT.....@@@@@@....TT.T...T.@@@@@@@@@@@@.@@.T.TTT...TTT..T.@@@..@@@T.T@@@@@@@@.T.TTT..T.T@@@@@TT..T.....T.T....@@@@@@@@@@@@@@@@@@@@@@@
@@@@@@@.T.....T..T.TTT@@@@@@@@T.TT..TTTT.T.@@@@@@@@@@@@@@.T.T.....T...T.@@@...TT@@T..@@@@@@@@TT.TT.T.TTT@@@@.TT.T.T..T...T..@@@@@@@@@@@@@@@@@@@@@@@@
@@@@@@.TTT.TT...TT..T@@@@@@@@@@T....T......T@@@@@@@@@@@@....TTT.TT.....@@@....T..@@.T.@@@@@@@@..T..T...T.........T...TTT..T@@@@@@T.@@@@@@@@@@@@@@@@@
@@@@@@@...T.TT.TT.T.@@@@@@@@@@@@T.TTT....T...@@@@@@@@@@@@TT@.T.TT.T...@@@TT.T.TT.T@@T..@@@@@@@@TTT...T.T....T.@@.T....T....@@@@@T.TT@@@@@@@@@@@@@@@@
@@@@@@@@.TTT.......@@@@@@@@@@@@@@...T.TT.T....@@@@@@@@@@@@@@@.....TT.@@@T.TT..T.TTT@@..T@@@@@@@.....TT...T.T.@@@@@.TT.T..T@@@@@T....T@@@@@@@@@@@@@@@
@@@@@@@@@@T.TT.T..@@@@@@@@@@@@@@@..TT.T...TT.T@@@@@@@@@@@@@@T.T.T..@@@@T.T..TT..TTTT@@TTT@@@@@@T.TT.T.T.T...T@@@@@@T.TT..@@@@@...TT.@@@@@@@@@@@@@@@@
@@@@@@@@@@@...T..@@@@@@@@@@@@@@@@@.TT...TTTTT.T.@@@@@@@@@@@@.T..TT@@@@T.T.....T..T..@@@...@@@@@..T...T.....T..@@@@@@TT..@@@@@TTT.T@@@@@@@@@@@@@@@@@@
@@@@@@@@@@@@TT.T@@@@@@@@@.@@@@@@@@.TTTT..T.TTT...@@@@@@@@@@T.TTTT@@@@T....T.T@@@.....@@@.T@@@@@T...T..T.T...T..@@@@@@...@@@@.TTT.@@@@@@@@@@@@@@@@@@@
@@@@@@@@@@@@@T.@@@@@@@@@TTT..@@......TTT...TT.....@@@@@@@@....T..@@@@..T...T.@@@.....@@@T.T.@...T.@@.TT.T.TT....@@@@@@@@@@@T...T.@@@@@@T@@@@@@@@@@@@
@@@@@@@@@@@@@@@@@@@@@.@@T.T...T......@@..T...T....T@@@@@@...T....@@@@@.TTTT.T.@@@TTTT.@@TTT....T.@@@@TT.TTTTT....@@@@@@@@@..TT..@@@@@@@.@@@@@@@@@@@@
@@@@@@@@@@@@@@@@@@@@T.T..TTTT......T@@@@..TT..T.T.TT@@@@@..T.TTTT@@@@@@T.TTT.TT@@..TT.@@.TT.....@@@@@@.T....TT.T..@@@@@@@...T.T.@@@@@@.TT@@@@@@@@@@@
@@@@@@@@@@@@@@@@@@@T.T...T..T....T..@@@@@.TT..TTTT...@@@...@@..TT.@@@@@@TTT..T@@@..T..T..T...TT@@@@@@@@.....T..T...@@@@@@T..TTTT..@@@@..T.@@@@@@@@@@
@@@@@@@@@@@@@@@@@@@.........T.TTTT.T@@@@@@...TT.TTTT.TT.TT@@@@@..T.@@@@@@....@@@@@...T.T.T.T.TT@@@@@@@@@T.T.T...T.T.@@@@@@.....T....T......T.@@@@@@@
@@@@@@@@@@@@@@@@@@@T..TT.T...T..T.TT.@@@@@@.TT..T.TTTT.TT@@@@@@@T...@@@@@@@@@@@@@@TTTT...TT...@@@@@@@@@@@..TTT.....T.@@@@@@.TTT.T.....T.T.T.TT@@@@@@
@@@@@@@@@@@@@@@@@@@@...TTT...@@@T....T@@@@@@TT....TT...TT@@@@@@@@..T.@@@@@@@@.T@@@@.....TTT..@@@@@@@@@@@@@T.....TTTT.T@@@@@@..T.TT..T........T.@@@@@
@@@@@@@@@@@@@@@@@@@@@TT..TTT@@@@.T.T..@@@@@@@T.T.....TT.T@@@@@@@@@TTT.@@@@@@.T.T@@@TT.TT.T.T@@@@@@@@@@@@@@@TTT....T.T..@@@@@@....TTTT.TTTT.TTT.T@@@@
@@@@@@@@@@@@@@@@@@@@@@.....@@@@@@TT.T.@@@@@@@@..T.T.....T.@@@@@@@@@.T.T@@@@.T.T..TT..T.....T.@@@@@@@@@@@@@@@T..T...T..T.@@@@@..T....T.....TT.T.@@@@@
@@@@@@@@@@@@@@@@@@@@@@@..T@@@@@@@TTT.@@@@@@@@@@....TT.T.T..T@@@@@@@@..TT@@@TTT..T...T.T.T...T.T.@@@@@@@@@@@@@.T...T..T.TT@@@@TTTT....T.T.TTTT@@@@@@@
@@@@@@@@@@@@@@@@@@@@@@@@.@@@@@@@@.T@@@@@@@@@@@@@....TTT......@@@@@@@@.T.T@@@..TT...TTT.TT.T.T..T@@@@T@@@@@@@@@T.T..T.T.TT.@@@....T.T....TT@.@@@@@@@@
@@@@@@@@@@@@@@@@@@@@@@@@@@@@@@@@@@@@@@@@@@@@@@@@@......TT.T...@@@@@@@@..T.@@@..TT.TTT.TT..T..TT.@@@...@@@@@@@@@.T..T....TTT...T@@@.TT.TT.@@@@@@@@@@@
@@@@@@@@@@@@@@@@@@@@@@@@@@@@@@@@@@@@@@@@@@@@@@@@@@T.TTT.TT..T..@@@@@@@@.T.T@@T.....T.TT..TTT....TT..TT@@@@@@@@@@...T..T..T.....@@@@..T.T@@@@@@@@@@@@
@@@@@@@@@@@@@@@@@@@@@@@@@@@@@@@@@@@@@@@@@@@@@@@@@@@T..T.TTTTTT..@@@@@@@@...T..T..TT..TTT..T.T.T...T..@@@@@@@@@@@@T..T....TTTT.T@@@@@.T.@@@@@@@@@@@@@
@@@@@@@@@@@@@@@@@@@@@@@@@@@@@@@@@@@@@@@@@@@..@@@@@@.TTTTT....TT.T@@@@@@@@.T.TTTTT..TT..TT.....TT.T..@@@@@T@@@@@@@@...TTT..T....T@@@@@T@@@@@@@@@@@@@@
@@@@@@@@@@@@@@@@@@@@@@@@@@@@@@@@@@@@@T.@@@.TTT@@@@.T.TT.....T..TT.@@@@@@@@TTTT.T.TTTT..T.......T....T@@@..@@@@@@@@@TTTTT....TT.T.@@@@@@@@@@@@@@@@@@@
@@@@@@@@@@@@@@@@@@@@@@@@@@@@@@@@@@@.T..T...T.TT@@T..@@......T...T..@@@@@@@@.TT..@@TT..T.TTT......T....@..@@@@@@@@@@@T.T.TT..T..T.T@@@@@@@@@@@@@@@@@@
@@@@@@@@@@@@@@@@@@@@@@@@@@@@@@@@@@TTT......T..T.TT..@@@...TTT...T..T@@@@@@@...@@@TTTT.T.TTT......T.....T@@@@@@@@@@@@@TT....T.T.T...@@@@@@@@@@@@@@@@@
@@@@@@@@@@@@@@@@@@@@@@@@@@@@@@@@@....T.T..TTTTT.....@@@@T.T.TT....T.T@@@@@T..@@@@.T@..T......T.TT....T..@@@@@T@@@@@@@...TT....TTT...@@@@@@@@@@@@@@@@
@@@@@@@@@@@@@@@@@@@@@@@@@@@@@@@@@...T.....T.T..TT...@@@@@....T...T.T.T@@@T..@@@@@@@@@.T..TTT..T.TT.T.T..T@@@.T@@@@@@@.T.....T..T...@@@@@@@@@@@@@@@@@
@@@@@@@@@@@@@@@@@@@@@@@@@@@@@@@@@@T..T...TT@.....T..@@@@@@........T.T..@...@@@@@@@@@@@T.TTTT..T..T..T.T.....TT@@@@@@T........TTT.T@@@@@@@@@@@@@@@@@@
@@@@@@@@@@@@@@@@@@@@@@@@@@@@@@@@@@@.T.TT.T@@@@.T...TT@@@@@@@..TT...T..T...@@@@@@@@@@@TTT.T..TT...@@T.TTTTT..@@@@@..T.TT.TTT.T.TTT@@@@@@@@@@@@@@@@@@@
@@@@@@@@@@@@@@@@@@@@@@@@@@@@@@@@@@@@TTT.T@@@@@@..TTTTT@@@@@@@TTT..TTTTTTT.@@@@@@@@@@@.T........T@@@.T..T.TT.@@@@.T.T.T...T...TT.@@@@@@@@@@@@@@@@@@@@
@@@@@@@@@@@@@@@@@@@@@@@@@@@@@@@@@@@@@TTT.@@@@@@@T....TT@@@@@@@.TT...TT....@@@@@@@@@@@@..T@.....@@@@T....TTT..@@.TT...TTTTT.....@@@@@@@@@@@@@@@@@@@@@
@@@@@@@@@@@@@@@@@@@@@@@@@@@@@@@@@@@@@@.T.@@@@@@@.TT.....@@@@@@@@.T.T.T.TTT.@@@@@@@@@@@@.@@@..TT.@@TT.....TT...T...T.TTTTT.....@@@@@@@@@@@@@@@@@@@@@@
@@@@@@@@@@@@@@@@@@@@@@@@@@@@@@@@@@@@@@@TT.@@@...T..T.T..@@@@@@@@@....TT.TT.T@@@@@@@@@@@@@@..T..T..T....T....T.T.TTTTT..TTTTT.@@@@@@@@@@@@@@@@@@@@@@@
@@@@@@@@@@@@@@@@@@@@@@@@@@@@@@@@@@@@@@@@..T......T..T..@@@@@@@@@@T.TT.TT.....@@@@@@@@@@@@..T...T..T......@.......TTT..TTT...@@@@@@@@@@@@@@@@@@@@@@@@
@@@@@@@@@@@@@@@@@@@@@@@@@@@@@@@@@@@@@@@@@.T.....TTTTTT@@@@@@@@@@@@T....TTT....@@@@@@@@@@@@..T@TTTT.T.TT.@@T.......TT..T.T.T@@@@@@@@@@@@@@@@@@@@@@@@@
@@@@@@@@@@@@@@@@@@@@@@@@@@@@@@@@@@@@@@@@@@.T....T..T@@@@@@@@@@@@@@@..T....T...T@@@@@@@@@@@@@@@@.TTT.T..@@@.T.TTTT..T.TTTT.@@@@@@@@@@@@@@@@@@@@@@@@@@
@@@@@@@@@@@@@@@@@@@@@@@@@@@@@@@@@@@@@@@@@@@@.T.TT.T@@@@@@@@@@@@@@@@TT...TTTT.TT.@@@@@@@@@@@@@@...TTT.T@@@..T.....T.....T.@@@@@@@@@@@@@@@@@@@@@@@@@@@
@@@@@@@@@@@@@@@@@@@@@@@@@@@@@@@@@@@@@@@@@@@@@T.TTT@@@@@@@@@@@.@@@@@@.T.T....T....@@@@@@@@@@@@@T.T..T..@@.T......TTTT...T@@@@@@@@@@@@@@@@@@@@@@@@@@@@
@@@@@@@@@@@@@@@@@@@@@@@@@@@@@@@@@@@@@@@@@@@@@@...@@@@@@@@@@@.T.@@@@T.TTT.T.T.T.T.TT@@@@@@@@@@@@...T..T.T.TTT.TT.T...TT.@@@@@@@@@@@@@@@@@@@@@@@@@@@@@
@@@@@@@@@@@@@@@@@@@@@@@@@@@@@@@@@@@@@@@@@@@@@@@.@@@@@@@@@@TTTT.TT....T.@T....T.T....@@@@@@@@@@@@@@....TT....T......T.@@@@@@@@@@@@@@@@@@@@@@@@@@@@@@@
@@@@@@@@@@@@@@@@@@@@@@@@@@@@@@@@@@@@@@@@@@@@@@@@@@@@@@@@@..TT.T..TT..T@@@.....TT...T.@@@@@@@@@@@@@@....T...TTT.T....@@@@@@@@@@@@@@@@@@@@@@@@@@@@@@@@
@@@@@@@@@@@@@@@@@@@@@@@@@@@@@@@@@@@@@@@@@@@@@@@@@@@@@@.TT...T.T..TTT.@@@@@....T..TT...@@@@@@@@@@@@@T.........T...T.@@@@@@@@@@@@@@@@@@@@@@@@@@@@@@@@@
@@@@@@@@@@@@@@@@@@@@@@@@@@@@@@@@@@@@@@@@@@@@@@@@@@@@@TTT.TT.T..T...TT.@@@@@.TTT.T...T.T@@@@@@@@@@@@..T.T.........T@@@@@@@@@@@@@@@@@@@@@@@@@@@@@@@@@@
@@@@@@@@@@@@@@@@@@@@@@@@@@@@@@@@@@@@@@@@@@@@@@@@@@@@TT..T......T...T...@@@@@.......T.T.T@@@@@@@@@.T..TT.T..T.T..T@@@@@@@@@@@@@@@@@@@@@@@@@@@@@@@@@@@
@@@@@@@@@@@@@@@@@@@@@@@@@@@@@@@@@@@@@@@@@@@@@@@@@@@@@.TT.TT.T.@T.TT.T.T@@@@@@..TTTT..T..T@@@@@@@TTT.T......TT..T@@@@@@@@@@@@@@@@@@@@@@@@@@@@@@@@@@@@
@@@@@@@@@@@@@@@@@@@@@@@@@@@@@@@@@@@@@@@@@@@@@@@@@@@@@@.T.T..@@@@...T.T.T@@@@@@@T.T.....TT.@@@@@@TT.....TT...TT.@@@@@@@@@@@@@@@@@@@@@@@@@@@@@@@@@@@@@
@@@@@@@@@@@@@@@@@@@@@@@@@@@@@@@@@@@@@@@@@@@@@@@@@@@@@@@..T..@@@@@@.T.T..T@@@@@@@...TT.....T@@@@@T.T..T.T..T..@@@@@@@@@@@@@@@@@@@@@@@@@@@@@@@@@@@@@@@
@@@@@@@@@@@@@@@@@@@@@@@@@@@@@@@@@@@@@@@@@@@@@@@@@@@@@@@@T.T.@@@@@@..TTT..T@@@@@@@....T.T..T.@@@.TT......T.T.@@@@@@@@@@@@@@@@@@@@@@@@@@@@@@@@@@@@@@@@
@@@@@@@@@@@@@@@@@@@@@@@@@@@@@@@@@@@@@@@@@@@@@@@@@@@@@@@@@@T.@@@@@...T.T..@@@@@@@@@.T...T...T..T...T.....TT.@@@@@@@@@@@@@@@@@@@@@@@@@@@@@@@@@@@@@@@@@
@@@@@@@@@@@@@@@@@@@@@@@@@@@@@@@@@@@@@@@@@@@@@@@@@@@@@@@@@@@..@@@..TT...T@@@@@@@@@@@..TTTT..T......T.T.TT.T@@@@@@@@@@@@@@@@@@@@@@@@@@@@@@@@@@@@@@@@@@
@@@@@@@@@@@@@@@@@@@@@@@@@@@@@@@@@@@@@@@@@@@@@@@@@@@@@@@@@@@@...T.TT.T.@@@@@@@@@@@@@@.....TTT..TTT.T.T...T@@@@@@@@@@@@@@@@@@@@@@@@@@@@@@@@@@@@@@@@@@@
@@@@@@@@@@@@@@@@@@@@@@@@@@@@@@@@@@@@@@@@@@@@@@@@@@@@@@@@@@@@T.TTT..T.@@@@@@@@@@@@@@@TT..T.....T..TTT...T@@@@@@@@@@@@@@@@@@@@@@@@@@@@@@@@@@@@@@@@@@@@
@@@@@@@@@@@@@@@@@@@@@@@@@@@@@@@@@@@@@@@@@@@@@@@@@@@@@@@@@@@@@@.TT.T.@@@@@@@@@@@@@@@@@.TTT.T..T....TTTT.@@@@@@@@@@@@@@@@@@@@@@@@@@@@@@@@@@@@@@@@@@@@@
@@@@@@@@@@@@@@@@@@@@@@@@@@@@@@@@@@@@@@@@@@@@@@@@@@@@@@@@@@@@@@@.TTT@@@@@@@@@@@@@@@@@@T.TT.T........T.T@@@@@@@@@@@@@@@@@@@@@@@@@@@@@@@@@@@@@@@@@@@@@@
@@@@@@@@@@@@@@@@@@@@@@@@@@@@@@@@@@@@@@@@@@@@@@@@@@@@@@@@@@@@@@@@T.@@@@@@@T@@@@@@@@@@@...TT.T...T.TT.T@@@@@@@@@@@@@@@@@@@@@@@@@@@@@@@@@@@@@@@@@@@@@@@
@@@@@@@@@@@@@@@@@@@@@@@@@@@@@@@@@@@@@@@@@@@@@@@@@@@@@@@@@@@@@@@@@@@@@@@@...@@@@.@@@@@.T.@@@.T.T.TT..@@@@@@@@@@@@@@@@@@@@@@@@@@@@@@@@@@@@@@@@@@@@@@@@
@@@@@@@@@@@@@@@@@@@@@@@@@@@@@@@@@@@@@@@@@@@@@@@@@@@@@@@@@@@@@@@@@@@@@@@.T..T@@T..T..T..@@@@..TT..TT@@@@@@@@@@@@@@@@@@@@@@@@@@@@@@@@@@@@@@@@@@@@@@@@@
@@@@@@@@@@@@@@@@@@@@@@@@@@@@@@@@@@@@@@@@@@@@@@@@@@@@@@@@@@@@@@@@@@@@@@@T..TT..TT..TT.T.@@@@@......@@@@@@@@@@@@@@@@@@@@@@@@@@@@@@@@@@@@@@@@@@@@@@@@@@
@@@@@@@@@@@@@@@@@@@@@@@@@@@@@@@@@@@@@@@@@@@@@@@@@@@@@@@@@@@@@@@@@@@@@TT...T...TT..TTTTT@@@@@@T..T@@@@@@@@@@@@@@@@@@@@@@@@@@@@@@@@@@@@@@@@@@@@@@@@@@@
@@@@@@@@@@@@@@@@@@@@@@@@@@@@@@@@@@@@@@@@@@@@@@@@@@@@@@@@@@@@@@@@@@@@@T....TT..........T@@@@@@@@T@@@@@@@@@@@@@@@@@@@@@@@@@@@@@@@@@@@@@@@@@@@@@@@@@@@@
@@@@@@@@@@@@@@@@@@@@@@@@@@@@@@@@@@@@@@@@@@@@@@@@@@@@@@@@@@@@@@@@@@@@@@....TT........TTTT@@@@@@@@@@@@@@@@@@@@@@@@@@@@@@@@@@@@@@@@@@@@@@@@@@@@@@@@@@@@
@@@@@@@@@@@@@@@@@@@@@@@@@@@@@@@@@@@@@@@@@@@@@@@@@@@@@@@@@@@@@@@@@@@@@@@T....T..TT.TTTT...@@@@@@@@@@@@@@@@@@@@@@@@@@@@@@@@@@@@@@@@@@@@@@@@@@@@@@@@@@@
@@@@@@@@@@@@@@@@@@@@@@@@@@@@@@@@@@@@@@@@@@@@@@@@@@@@@@@@@@@@@@@@@@@@@@@@TT......T..TT...T.@@@@@@@@@@@@@@@@@@@@@@@@@@@@@@@@@@@@@@@@@@@@@@@@@@@@@@@@@@
@@@@@@@@@@@@@@@@@@@@@@@@@@@@@@@@@@@@@@@@@@@@@@@@@@@@@@@@@@@@@@@@@@@@@@@@@.TT.TT.@@@@..T....@@@@@@@@@@@@@@@@@@@@@@@@@@@@@@@@@@@@@@@@@@@@@@@@@@@@@@@@@
@@@@@@@@@@@@@@@@@@@@@@@@@@@@@@@@@@@@@@@@@@@@@@@@@@@@@@@@@@@@@@@@@@@@@@@@@@@T.TTT@@@@..T...@@@@@@@@@@@@@@@@@@@@@@@@@@@@@@@@@@@@@@@@@@@@@@@@@@@@@@@@@@
@@@@@@@@@@@@@@@@@@@@@@@@@@@@@@@@@@@@@@@@@@@@@@@@@@@@@@@@@@@@@@@@@@@@@@@@@@@@..T.@@@@@....@@@@@@@@@@@@@@@@@@@@@@@@@@@@@@@@@@@@@@@@@@@@@@@@@@@@@@@@@@@
@@@@@@@@@@@@@@@@@@@@@@@@@@@@@@@@@@@@@@@@@@@@@@@@@@@@@@@@@@@@@@@@@@@@@@@@@@@@@.T@@@@@@@.T@@@@@@@@@@@@@@@@@@@@@@@@@@@@@@@@@@@@@@@@@@@@@@@@@@@@@@@@@@@@
@@@@@@@@@@@@@@@@@@@@@@@@@@@@@@@@@@@@@@@@@@@@@@@@@@@@@@@@@@@@@@@@@@@@@@@@@@@@@@@@@@@@@@T@@@@@@@@@@@@@@@@@@@@@@@@@@@@@@@@@@@@@@@@@@@@@@@@@@@@@@@@@@@@@
@@@@@@@@@@@@@@@@@@@@@@@@@@@@@@@@@@@@@@@@@@@@@@@@@@@@@@@@@@@@@@@@@@@@@@@@@@@@@@@@@@@@@@@@@@@@@@@@@@@@@@@@@@@@@@@@@@@@@@@@@@@@@@@@@@@@@@@@@@@@@@@@@@@@
@@@@@@@@@@@@@@@@@@@@@@@@@@@@@@@@@@@@@@@@@@@@@@@@@@@@@@@@@@@@@@@@@@@@@@@@@@@@@@@@@@@@@@@@@@@@@@@@@@@@@@@@@@@@@@@@@@@@@@@@@@@@@@@@@@@@@@@@@@@@@@@@@@@@
