type octile
height 86
width 80
map
@@@@@@@@@@@@@@@@@@@@@@@@@@@@@@@@@@@@@@@@@@@@@@@@@@@@@@@@@@@@@@@@@@@@@@@@@@@@@@@@
@@@@@@@@@@@@@@@@@@@@@@@@@@@@@@@@@@@@@@@@@@@@@@@@@@@@@@@@@@@@@@@@@@@@@@@@@@@@@@@@
@@@@@@@@@@@@@@@@@@@@@@@@@@@@@@@@@@@@@@@@@@@@@@@@@@@@@@@@@@@@@@@@@@@@@@@@@@@@@@@@
@@@@@@@@@@@@@@@@@@@@@@@@@@@@@@@@@@@@@@@@@@@@@@@@@@@@@@@@@@@@@@@@@@@@@@@@@@@@@@@@
@@@@@@@@@@@@@@@@@@@@@@@@@@@@@@@@@@@@@@@@@@@@@@@@@@@@@@@@@@@@@@@@@@@@@@@@@@@@@@@@
@@@@@@@@@@@@@@@@@@@@@@@@@@@@@@@@@@@@@@@@@@@@@@@@@@@@@@@@@@@@@@@@@@@@@@@@@@@@@@@@
@@@@@@@@@@@@@@@@@@@@@@@@@@@@@@@@@@@@@@@@@@@@@@@@@@@@@@@@@@@@@@@@@@@@@@@@@@@@@@@@
@@@@@@@@@@@@@@@@@@@@@@@@@@@@@@@@@@@@@@@@@@@@@@@@@@@@@@@@@@@@@@@@@@@@@@@@@@@@@@@@
@@@@@@@@@@@@@@@@@@@@@@@@@@@@@@@@@@@@@@@@@@@@@@@@@@@@@@@@@@@@@@@@@@@@@@@@@@@@@@@@
@@@@@@@@@@@@@@@@@@@@@@@@@@@@@@@@@@@@@@@@@@@@@@@@@@@@@@@@@@@@@@@@@@@@@@@@@@@@@@@@
@@@@@@@@@@@@@@@@@@@@@@@@@@@@@@@@@@@@@@@@@@@@@@@@@@@@@@@@@@@@@@@@@@@@@@@@@@@@@@@@
@@@@@@@@@@@@@@@@@@@@@@@@@@@@@@@@@@@@@@@@@@@@@@@@@@@@@@@@@@@@@@@@@@@@@@@@@@@@@@@@
@@@@@@@@@@@@@@@@@@@@@@@@@@@@@@@@@@@@@@@@@@@@@@@@@@@@@@@@@@@@@@@@@@@@@@@@@@@@@@@@
@@@@@@@@@@@@@@@@@@@@@@@@@@@@@@@@@@@@@@@@@@@@@@@@@@@@@@@@@@@@@@@@@@@@@@@@@@@@@@@@
@@@@@@@@@@@@@@@@@@@@@@@@@@@@@@@@@@@@@@@@@@@@@@@@@@@@@@@@@@@@@@@@@@@@@@@@@@@@@@@@
@@@@@@@@@@@@@@@@@@@@@@@@@@@@@@@@@@@@@@@@@@@@@@@@@@@@@@@@@@@@.@@@@@@@@@@@@@@@@@@@
@@@@@@@@@@@@@@@@@@@@@@@@@@@@@@@@@@@@@@@@@@@@@@@@@@@@@@@@@@@@T.@@@@@@@@@@@@@@@@@@
@@@@@@@@@@@@@@@@@@@@@@@@@@@@@@@@@@@@@@@@@@@@@@@@@@@@@@@@@@@T.T@@@@@@@@@@@@@@@@@@
@@@@@@@@@@@@@@@@@@@@@@@@@@@@@@@@@@@@@@T.@@@@@@@@@@@@@@@@@@..T@@@@@@@@@@@@@@@@@@@
@@@@@@@@@@@@@@@@@@@@@@@@@@@@@@@@@@@...T.T....TT....TTT@@@T.TT@@@@@@@@@@@@@@@@@@@
@@@@@@@@@@@@@@@@@@@@@@@@@@@@@@@@@@T..T.T...TT......TT..T@TTT@@@@@@@@@@@@@@@@@@@@
@@@@@@@@@@@@@@@@@@@@@@@@@@..T..T@@T....T..TTT..T..T.TTT@@..T@@@@@@@@@@@@@@@@@@@@
@@@@@@@@@@@@@@@@@@@@@@@@.TT.............TT...TT......T.@TTT.@@T@@@@@@@@@@@@@@@@@
@@@@@@@@@@@@@@@@@@@@@@TTT.T....TTT..T..T.T.T..TTT.T....@..T.@TT@@@@@@@@@@@@@@@@@
@@@@@@@@@@@@@@@@@@@@@..TT.....T.....T.............T.TT@@..T@@.T@@@@@@@@@@@@@@@@@
@@@@@@@@@@@@@@@@@.@@@..T....TTT.T..T.TT.T.TTT..T...TT.@TT..@@.T@@@@@@@@@@@@@@@@@
@@@@@@@@@@@@@@.@@..@@TT.....TTTT..T..T.....TTTT..T....@.T.T@@..T@@@@@@@@@@@@@@@@
@@@@@@@@@@@@@@...TT..T..TT..T.....T.T..TT...TTTT..T..@@.T.@@@T.T.@@@@@@@@@@@@@@@
@@@@@@@@@@@@@T.T.T...T.TT.TT..T......TT....T.T...TT.T@.T..@@@.T..T@@@@@@@@@@@@@@
@@@@@@@@@@@@@.....TTT..T...T.........TTTT.T..T.....@@@TT.T@@T.TT.T.@@@@@@@@@@@@@
@@@@@@@@@@@@..T..TT.T..T......T..TT.....T..T.TTT..T@@@.TT@@@TT...TT.@@@@@@@@@@@@
@@@@@@@@@@@@TT..T.TTTTT...T..TT.T..T.TT.TT.T.T...T@@@...T@@.T.T....T.@@@@@@@@@@@
@@@@@@@@@@@.T.....TT.TTT..T...TT.T.T..T..TTT...T.T.T.TT..@@TT..T...T..@@@@@@@@@@
@@@@@@@@@@TT...TT..T..T...T..TTT.TT.T.T....T.....TT.TTTT@@@.T.TTTT.T.TT@@@@@@@@@
@@@@@@@@@..TTTT...T..TT...T.T.T...TTT...T..T....T..T..T@@@@@.TT.T....T.@@@@@@@@@
@@@@@@@@@TT.....TT.T...T.....TTTT.T.....T..TT..T...TT.....T.T........TT@@@@@@@@@
@@@@@@@@@TTTT..T..T...T......T.T.TTTTTTTTT.....T..T.T.T.TT......T..T...@@@@@@@@@
@@@@@@@@@@...T....T..T.....T..TT.TTTTT..T.T..TTTTT....T...TT.T..TTT..T..@@@@@@@@
@@@@@.@@@@.TT.....TTTT.T...T.TTT..TT.T.......TTTTTTT...T..T.TTT...T..TT.@@@@@@@@
@@@@@TTT.T.T.T.T..T..T.T...TTTT.T....TT...TTT...TT...TTT..T.......T..T.T.@@@@@@@
@@@@@.T...T...T.TTT.....T..T.T.TT......TTT.TTT...TT.TTT..T..T..TT..T.TTTT@@@@@@@
@@@@@.T..TTT.TT.T......TTT.......TT....TTT..TT.T.......TTTT....TT.T.TT...T@@@@@@
@@@@@T..TTT.T.TT....TTTT.T..T....T..@@@@@@@.TT..T.T.T.T...T.TTTTTTT...TTT..@@@@@
@@@@@.T........T..TT...T..T..TTT..@@@@@@@@@@.TT.....T.T.T...T.TT.TT.TT...TT@@@@@
@@@@@T........T.T.T.....T.....TTT.@@@@@@@@@@T..T.TT.T..T....T..T.T..TTT...TT@@@@
@@@@@.TTT.TT.T.......T.TTT....TT.@@@@@..@@@@....@@.TT.T.TT.........T.......T.@@@
@@@@@T.T.T.TTT....T.T.T.TTTT.T...@@@....@@@T.T.@@@T..T..TT..TT..T.TTT.TTT..TT@@@
@@@@@T..T.....T.....TTT.T.T.TT.T..TTT.T......T@@@@..TT.T...T.T..T........T..T@@@
@@@@@....TT..T..T...T....T.T.@@.T..T..T...T.T@@@@@@T..T..TTT..TT.T.TTT..T.TT.@@@
@@@@@.T.T...T.TT..T.T.....@@.@@@..T..T...T...@@@@@@..TT...T..T.T.T.T...TT.TT.@@@
@@@@@.TTT....TTT..TT..T..T@@@@@@@...T.TT..T..@@@@@@TT.TTT.T...TTT...T.TTT.TT.@@@
@@@@@.....T........TT.T....T@@@@@TT..........T@@@@@@.T...TT......T..T....T.T.@@@
@@@@@....T..T..T...T...TT..T@@@@@TT.T.T..TT.....@@@@.T...TT......T.T.....T..T@@@
@@@@@.TT..T..TTT..T.T.T..T..@@@@..T.....TTT.T..T.@@@..TTTT..TTT.......TT..T..@@@
@@@@@..TT.T....T.T...T.T....@@@@T..T..TTT.TTT.T.@@@@T.TT..TTT..........TTTT.T@@@
@@@@@T.T......TT.........T..@@@TT.T.TT...T..TT.@@@@@T...T..T........TTT...TT.@@@
@@@@@.T.......T...TT...T.TTT@@@T.T.T....T.T..T@@@@@TT.T....T...TTT..T........@@@
@@@@@.T.T.TTT....T.....TT.T.@@@@@T.T....T..T...@@@@TT....T..T.T......TT.T..T.@@@
@@@@@....TT...T..T.T.T.T..T..@@@@.TT.TTTT.T.....@@@.T.......T........T..TTTTT@@@
@@@@@...T.T...T.TT....TTTTT.T@@@@@@.T..T.T...T...TT.T.TT.TTT..........T.T..TT@@@
@@@@@T.T...T..T..T......TT...T@@@@.TT..T.TT.T.@T.TT.TT.T..T..T...T.TTTT.T..TT@@@
@@@@@.TTTT.....TTTT.TT.T..T.TT.T..TT.TT..T..@@@....TTT...T.TT.TT....T..TT..T.@@@
@@@@@TTTTT..TT.TT.T.T...T.T........T.T@@@@@@@@@@@TT.TT...T.TTTT.T....TTTTT.T.@@@
@@@@@...T....TT.T.TT..T.TT......T....@@@@@@@@@@@@T...TTT.TT.T.TT.......TT.T..@@@
@@@@@.T....T....T..T....T........TT@@@@@@@@@@@TTT.TT..T.......TT...T...TT....@@@
@@@@@.T.T..T...TTT.T....T..TTTT..T.@@@@@@@@@@T.TT.T..T..T..TT.TTT.T..TT.TT.TT@@@
@@@@@TT..TTT..T.TT...T.TTT.TTT....TT...TT..TT.TT.TT.TTT.......T......TT....T.@@@
@@@@@...TT....T.T...TT......TTTTTTTTTT.TT..TTTT.......T.T..TTTTT..T...T..TTTT@@@
@@@@@TT..T..T.TTTT.T..T.T.........T.T....T..TT..TTT..TTTTTT...T..TT...TTTT.T.@@@
@@@@@.TTT...T....T.TT..TTT..T.T.T.TT....TTTTTT..T....T.TT.TT..TT..T.T.....T.@@@@
@@@@@T....T.....T...TT...T.TT.T......TT...T..T...T.T..TTT.TT..T.TT..T..T..TT@@@@
@@@@@@.......T.......T....TT.TT.T....T.TT.T.T..TTT........T.........T..T.TT@@@@@
@@@@@@.T..T.TT..TT.TT.TT....T.TTTTTT....T..TT..TT.TTT.TT..T..T.T.TTTTT...TT@@@@@
@@@@@@@.T.T.T.T....TT...T.TTTT.T...TTT....TT..T..TT..T.T..T......TTT...T.T@@@@@@
@@@@@@@@.T....TT....TT...T..T..T......T..........T..TT..TT.......T...T..@@@@@@@@
@@@@@@@@@TT....T.T..TT.TT.TTT.TTTTTT.TT..TT......TTTTTTT.TTT..TT..T....@@@@@@@@@
@@@@@@@@@@@...T........T..T.T.TT.T.T.T.......T...T.TT....T........T..@@@@@@@@@@@
@@@@@@@@@@@@@@.T.TT.T...........TT...T.....TT.TTT...TT..........T..@@@@@@@@@@@@@
@@@@@@@@@@@@@@@@TT.......TT....T...T..........T..T..T.TTT.T..T.TT@@@@@@@@@@@@@@@
@@@@@@@@@@@@@@@@@@@..T.TT...T...T....TT.TTTTTTT.T.TT.......T.TT@@@@@@@@@@@@@@@@@
@@@@@@@@@@@@@@@@@@@@@.T..TT.T..T.T.T...T..TTT..TTT..TT....T.@@@@@@@@@@@@@@@@@@@@
@@@@@@@@@@@@@@@@@@@@@@@@.....T...TTT......T.T..T.TTTT.....@@@@@@@@@@@@@@@@@@@@@@
@@@@@@@@@@@@@@@@@@@@@@@@@@.T....TT....TT.....TT....TTT.T@@@@@@@@@@@@@@@@@@@@@@@@
@@@@@@@@@@@@@@@@@@@@@@@@@@@@T...T..T..TT...T.....T...T@@@@@@@@@@@@@@@@@@@@@@@@@@
@@@@@@@@@@@@@@@@@@@@@@@@@@@@@@@@@@@@@@@@@@@@@@@@@@@@@@@@@@@@@@@@@@@@@@@@@@@@@@@@
@@@@@@@@@@@@@@@@@@@@@@@@@@@@@@@@@@@@@@@@@@@@@@@@@@@@@@@@@@@@@@@@@@@@@@@@@@@@@@@@
