type octile
height 112
width 100
map
@@@@@@@@@@@@@@@@@@@@@@@@@@@@@@@@@@@@@@@@@@@@@@@@@@@@@@@@@@@@@@@@@@@@@@@@@@@@@@@@@@@@@@@@@@@@@@@@@@@@
@@@@@@@@@@@@@@@@@@@@@@@@@@@@@@@@@@@@@@@@@@@@@@@@@@@@@@@@@@@@@@@@@@@@@@@@@@@@@@@@@@@@@@@@@@@@@@@@@@@@
@@@@@@@@@@@@@@@@@@@@@@@@@@@@@@@@@@@@@@@@@@@@@@@@@@@@@@@@@@@@@@@@@@@@@@@@@@@@@@@@@@@@@@@@@@@@@@@@@@@@
@T..T.@@@@@@@@@@@@@@@@@@@@@@@@@@@@@@@@@@@@@@@@@@@@@@@@@@@@@@@@@@@@@@@@@@@@@@@@@@@@@@@@@@@@@@@@@@@@@@
@..T.T@@@@@@@@@@@@@@@@@@@@@@@@@@@@@@@@@@@@@@@@@@@@@@@@@@@@@@@@@@@@@@@@@@@@@@@@@@@@@@@@@@@@@@@@@@@@@@
@.T...@@@@@@@@@@@@@@@@@@@@@@@@@@@@@@@@@@@@@@@@@@@@@@@@@@@@@@@@@@@@@@@@@@@@@@@@@@@@@@@@@@@@@@@@@@@@@@
@TTT.T@@@@@@@@@@@@@@@@@@@@@@@@@@@@@@@@@@@@@@@@@@@@@@@@@@@@@@@@@@@@@@@@@@@@@@@@@@@@@@@@@@@@@@@@@@@@@@
@...TT@@@@@@@@@@@@@@@@@@@@@@@@@@@@@@@@@@@@@@@@@@@@@@@@@@@@@@@@@@@@@@@@@@@@@@@@@@@@@@@@@@@@@@@@@@@@@@
@@@@@@@@@@@@@@@@@@@@@@@@@@@@@@@@@@@@@@@@@@@@@@@@@@@@@@@@@@@@@@@@@@@@@@@@@@@@@@@@@@@@@@@@@@@@@@@@@@@@
@@@@@@@@@@@@@@@@@@@@@@@@@@@@@@@@@@@@@@@@@@@@@@@@@@@@@@@@@@@@@@@@@@@@@@@@@@@@@@@@@@@@@@@@@@@@@@@@@@@@
@@@@@@@@@@@@@@@@@@@@@@@@@@@@@@@@@@@@@@@@@@@@@@@@@@@@@@@@@@@@@@@@@@@@@@@@@@@@@@@@@@@@@@@@@@@@@@@@@@@@
@@@@@@@@@@@@@@@@@@@@@@@@@@@@@@@@@@@@@@@@@@@@@@@@@@@@@@@@@@@@@@@@@@@@@@@@@@@@@@@@@@@@@@@@@@@@@@@@@@@@
@@@@@@@@@@@@@@@@@@@@@@@@@@@@@@@@@@@@@@@@@@@@@@@@@@@@@@@@@@@@@@@@@@@@@@@@@@@@@@@@@@@@@@@@@@@@@@@@@@@@
@@@@@@@@@@@@@@@@@@@@@@@@@@@@@@@@@@@@@@@@@@@@@@@@@@@@@@@@@@@@@@@@@@@@@@@@@@@@@@@@@@@@@@@@@@@@@@@@@@@@
@@@@@@@@@@@@@@@@@@@@@@@@@@@@@@@@@@@@@@@@@@@@@@@@@@@@@@@@@@@@@@@@@@@@@@@@@@@@@@@@@@@@@@@@@@@@@@@@@@@@
@@@@@@@@@@@@@@@@@@@@@@@@@@@@@@@@@@@@@@@@@@@@@@@@@@@@@@@@@@@@@@@@@@@@@@@@@@@@@@@@@@@@@@@@@@@@@@@@@@@@
@@@@@@@@@@@@@@@@@@@@@@@@@@@@@@@@@@@@@@@@@@@@@@@@@@@@@@@@@@@@@@@@@@@@@@@@@@@@@@@@@@@@@@@@@@@@@@@@@@@@
@@@@@@@@@@@@@@@@@@@@@@@@@@@@@@@@@@@@@@@@@@@@@@@@@@@@@@@@@@@@@@@@@@@@@@@@@@@@@@@@@@@@@@@@@@@@@@@@@@@@
@@@@@@@@@@@@@@@@@@@@@@@@@@@@@@@@@@@@@@@@@@@@@@@@@@@@@@@@@@@@@@@@@@@@@@@@@@@@@@@@@@@@@@@@@@@@@@@@@@@@
@@@@@@@@@@@@@@@@@@@@@@@@@@@@@@@@@@@@@@@@@@@@@@@@@@@@@@@@@@@@@@@@@@@@@@@@@@@@@@@@@@@@@@@@@@@@@@@@@@@@
@@@@@@@@@@@@@@@@@@@@@@@@@@@@@@@@@@@@@@@@@@@@@@@@@@@@@@@@@@@@@@@@@@@@@@@@@@@@@@@@@@@@@@@@@@@@@@@@@@@@
@@@@@@@@@@@@@@@@@@@@@@@@@@@@@@@@@@@@@@@@@@@@@@@@@@@@@@@@@@@@@@@@@@@@@@@@@@@@@@@@@@@@@@@@@@@@@@@@@@@@
@@@@@@@@@@@@@@@@@@@@@@@@@@@@@@@@@@@@@@@@@@@@@@@@@@@@@@@@@@@@@@@@@@@@@@@@@@@@@@@@@@@@@@@@@@@@@@@@@@@@
@@@@@@@@@@@@@@@@@@@@@@@@@@@@@@@@@@@@@@@@@@@@@@@@@@@@@@@@@@@@@@@@@@@@@@@@@@@@@@@@@@@@@@@@@@@@@@@@@@@@
@@@@@@@@@@@@@@@@@@@@@@@@@@@@@@@@@@@@@@@@@@@@@@@@@@@@@@@@@@@@@@@@@@@@@@@@@@@@@@@@@@@@@@@@@@@@@@@@@@@@
@@@@@@@@@@@@@@@@@@@@@@@@@@@@@@@@@@@@@@@@@@@@@@@@@@@@@@@@@@@@@@@@@@@@@@@@@@@@@@@@@@@@@@@@@@@@@@@@@@@@
@@@@@@@@@@@@@@@@@@@@@@@@@@@@@@@@@@@@@@@@@@T@@@@@@@@@@@@@@@@@@@@@@@@@@@@@@@@@@@@@@@@@@@@@@@@@@@@@@@@@
@@@@@@@@@@@@@@@@@@@@@@@@@@@@@@@@@@@@T.@@@.T.@@@@@@@@@@@@@@@@@@@@@@@@@@@@@@@@@@@@@@@@@@@@@@@@@@@@@@@@
@@@@@@@@@@@@@@@@@@@@@@@@@@@@@@@@@@@TTT.T.T..T@@@@@@@@@@@@@@@@@@@@@@@@@@@@@@@@@@@@@@@@@@@@@@@@@@@@@@@
@@@@@@@@@@@@@@@@@@@@@@@@@@@@@@@@@@....TT.....T@@@@@@@@@@@@@@@@@@@@@@@@@@@@@@@@@@@@@@@@@@@@@@@@@@@@@@
@@@@@@@@@@@@@@@@@@@@@@@@@@@@@@@@@.TT....TTTTTT....T.@@@@@@@@@@@@@@@@@@@@@@@@@@@@@@@@@@@@@@@@@@@@@@@@
@@@@@@@@@@@@@@@@@@@@@@@@@@@@@@@@T..TT...TTTT...TTTT..@@@@@@@@@@@@@@@@@@@@@@@@@@@@@@@@@@@@@@@@@@@@@@@
@@@@@@@@@@@@@@@@@@@@@@@@@@@@@@@@@.T..T..T.TTT.TT.T....@@@@@@@@@@@@@@@@TT..TT@@@@@@@@@@@@@@@@@@@@@@@@
@@@@@@@@@@@@@@@@@@@@@@@@@@@@@@@@@..........TT........T.@@@@@@@@@@@@@@.....TT.@@@@@@@@@@@@@@@@@@@@@@@
@@@@@@@@@@@@@@@@@@@@@@@@@@@@@@@@...T..TTT@@@T.TTT.TT.T.@@@@@@@@@@@@T.TTT.@@@..@@@@@@@@@@@@@@@@@@@@@@
@@@@@@@@@@@@@@@@@@@@@@@@@@@@@@@.....@@.T.@@@...T.T..T.T@@@@@@@@@@@.TT...@@@@TT.@@@@@@@@@@@@@@@@@@@@@
@@@@@@@@@@@@@@@@@@@@@@@@@@..@@.T.T.T@@@@@@@@....T.....@@@@@@@@@@@T.T.T..@@@@T.T.@@@@@@@@@@@@@@@@@@@@
@@@@@@@@@@@@@@@@@@@@@@@@@@.....T....@@T@@@@..T.TTT....T@@@@@@@@@.T....T.@@@..T.T@@@@@@@@@@@@@@@@@@@@
@@@@@@@@@@@@@@@@@@@@@@@@@..TT..TT....T.@@@@..T..TT.T....@@@@@@@@@T...T..T...T...@@@@@@@@@@@@@@@@@@@@
@@@@@@@@@@@@@@@@@@@@@@@@T.T.T.@@@..TTT..@@@.T.T.........T.T.T@@@@.TTTT..T@@@..TT@@@@@@@@@@@@@@@@@@@@
@@@@@@@@@@@@@@@@@@@@@@@.T..T.@@@@@....T..@@..T..T..T..TTT.TTT@@@......T.@@@@@T.T@@@@@@@@@@@@@@@@@@@@
@@@@@@@@@@@@@@@@@@@@@@@.T.T.@@@@@@@.TT..T.@@@.T.TT.TT.TT..T..TT....TT.T.@@@@@.TT@@@@@@@@@@@@@@@@@@@@
@@@@@@@@@@@@@@@@@@@@@@@...T@@@@@@@@T..T...@@@....TTT..TTTTT...T.T...TT..@@@@@T.@@@@@@@@@@@@@@@@@@@@@
@@@@@@@@@@@@@@@@@@@@@@@...@@@@@@@@@..TTTTT............T..T...T...T.T...T.@@@..@@@@@@@@@@@@@@@@@@@@@@
@@@@@@@@@@@@@@@@@@@@@@...@@@@@@@@@@.....T..T.TT.TT.T....TTT...TT.T..TT.T...TT@@@@@@@@@@@@@@@@@@@@@@@
@@@@@@@@@@@@@@@@@@@@@TT.@@@@@@@@@@..T...T...T..T..T....T.TTT...TT..T.T.T.TT.@@@@@@@@@@@@@@@@@@@@@@@@
@@@@@@@@@@@@@@@@@@@@T..@@@@@@@@@@@T..TT..T..TT.TT.TT..T.T.T...T..T.TTT.....@@@@@@@@@@@@@@@@@@@@@@@@@
@@@@@@@@@@@@@@@@.T.....@@@@@@@@@@@.T....TT...TT..T.@@@@T.TT.T.....TTTT.T..@@@@@@@@@@@@@@@@@@@@@@@@@@
@@@@@@@@@@@@@@@..T...T..@@@@@@@@@@@T.T....T..T..T.@@@@@@T.T........T.TT..@@@@@@@@@@@@@@@@@@@@@@@@@@@
@@@@@@@@@@@@@.T.T.TT...TT@@@@@@@@@...T....TT.T..T@@@@@@@.TT....T.T.TT...@@@@@@@@@@@@@@@@@@@@@@@@@@@@
@@@@@@@@@@@@T...TT@@@.....@@@..@@..TT.TT.@@TTT..@@@.T@@.T.TTT.......TTT.T@@@@@@@@@@@@@@@@@@@@@@@@@@@
@@@@@@@@@@@@@TTTTT@@@T.....@TTT..T..T...@@@T...@@@.T...T..TT.TTT.T...T.TT.@@@@@@@@@@@@@@@@@@@@@@@@@@
@@@@@@@@@@@@@.TT...@@....T...TT.T.....T@@@..T.@@@TTTTT.T...TT..TT.T.TTT.T..@@@@@@@@@@@@@@@@@@@@@@@@@
@@@@@@@@@@@@@..TT..@@.......T.TT...T.TT@@..T.@@@.TT.T.TT.TTT......T.T.T...@@@@@@@@@@@@@@@@@@@@@@@@@@
@@@@@@@@@@@@..T.TTT@@..TT.....T..TTT.@.@TTTT@@@..TT.TT..TT.T.TT.TT.T.TT.T.@@@@@@@@@@@@@@@@@@@@@@@@@@
@@@@@@@.@@@T.....TT@@@@T...T.TTT.T.T@@..TT.@@@..T....T...T.T.T..........T.@@@@@@@@@@@@@@@@@@@@@@@@@@
@@@@@@T..@TT....T..@@@@@T.TT.T...TT@@@....@@..TT..TTTT....T..TT..@....TTT..@@@@@@@@@@@@@@@@@@@@@@@@@
@@@@@T.T.T.....TT...@@@@TTTT.....T@@@.TT.@@.........TT..........@@.TTTT.T..T@@@@@@@@@@@@@@@@@@@@@@@@
@@@@@@.T....TT.TTT@@@@@@@@@.T..TT@@@.TT.@@T.TT..T..T.......T.TT@@@@T...T..TTTT..TT@@@@@@@@@@@@@@@@@@
@@@@@@@....TTT.TTT@@@...@@@...T..@@..T.@@.TT.T...T..TT.........@@@....T..TT..T.T..T@@@@@@@@@@@@@@@@@
@@@@@@@@T.T.T.....T..T....T.T..T..T..T@@.TT.....T.T...T..T..T.T.@@T.T.T...T....T....@@@@@@@@@@@@@@@@
@@@@@@@@@T..TT.TTT.T......TTTTT...T.T@@T.......T..T..TT........@@TT..T.T..TT..T..T..@@@@@@@@@@@@@@@@
@@@@@@@@@@....TTT....T..T.....T.TTTT@@T...T...T..T.T.T..T.TT..@@TT.T.TT.T.....T.TTT.@@@@@@@@@@@@@@@@
@@@@@@@@@@@T.T.T....TT.TTT...TT.T..@@....TT.TT....TTTTT..TT..@@T...TTT.TT.....TT.T..@@@@@@@@@@@@@@@@
@@@@@@@@@@@@...TTT.T.T.TT.T..T.TTT@@...TT.T..T....T..TTTTT..@@...T.@.TT...T.T.TTT.T.@@@@@@@@@@@@@@@@
@@@@@@@@@@@@@T......T..T.T.T.....@@.T.T...T.TT...TT.T.....T@@.....@@@.T..TTT..TT.TT.T@@@@@@@@@@@@@@@
@@@@@@@@@@@@@@T.T...T..TT.TT....@@..T..T.T....T.T..TT.T.TT@@.T.TT@@@@@TTTT.T.....T.TT.@@@.@@@@@@@@@@
@@@@@@@@@@@@@@@..TTTTT.......T.T@.....T....T.TTT......T.T@@T.TT.@@@@@..T...T.T..TT........T@@@@@@@@@
@@@@@@@@@@@@@@@@TT..T..TTTT..TT@@@T.......T.......T..T..@@.TTTT@@@@@...@T..T..T.TTT..T...T@@@@@@@@@@
@@@@@@@@@@@@@@@@@....TT.TT.T..TT.T......TT.TT.T.T....T.@@.....@@@@@T.T@@@T...TT..T.T..TT.@@@@@@@@@@@
@@@@@@@@@@@@@@@@@T.T.T..TTT.TTT..T.....TTT.T.T.TT.TT.T@@....TTT@@@...@@@@@..T..T..TTT.T.@@@@@@@@@@@@
@@@@@@@@@@@@@@@@@@.T.........TT.T.T.T..TT......T.T...@@..T.@@@..@...@@@@@@@...T...T.T.T@@@@@@@@@@@@@
@@@@@@@@@@@@@@@@@@@...T.T..T....TTT...T..........T..@@.T.T@@@@@T...@@@@@@@@@..TTTTTT..@@@@@@@@@@@@@@
@@@@@@@@@@@@@@@@@@@@TTT..TTTTT.TTTT.TT.T.T.......T.@@T.T..@@@@T.....@@@@@@@.TT.TT..TT@@@@@@@@@@@@@@@
@@@@@@@@@@@@@@@@@@@@@TTT.T..TT.T....T.TTT.T.TT...T@@.TT..@@@@TT.T..TT@@@@@......T.T.@@@@@@@@@@@@@@@@
@@@@@@@@@@@@@@@@@@@@..T.TT.T...T.....T..........T@@T.TT.@@@@....@.T.TT@@@....T.T.T.@@@@@@@@@@@@@@@@@
@@@@@@@@@@@@@@@@@@@TT.T...T........T...T..T...T.@@..TT.@@@@..TT@@@T....TT.TT....T.@@@@@@@@@@@@@@@@@@
@@@@@@@@@@@@@@@@@@TT..TTTT....T...T.T....TTTT.T@@.....TT@@....@@@@@T....TTTTT.T..@@@@@@@@@@@@@@@@@@@
@@@@@@@@@@@@@@@@@..T.....TTTTT.T.T....TT...@T.@@T..TT@@.T..T.@@@@@@@..TTT.....TT@@@@@@@@@@@@@@@@@@@@
@@@@@@@@@@@@@@@@@..TTT.T...TT.T...TT...T.T@@@@@..TT.@@@@T...@@@@@@@@@..T..T.TT@@@@@@@@@@@@@@@@@@@@@@
@@@@@@@@@@@@@@@@@....T.....T..T........T.TT..T.T.T.@@@@....T@@@@@@@@...T....T@@@@@@@@@@@@@@@@@@@@@@@
@@@@@@@@@@@@@@@@@@.TT...TT.TT.T.T.TT..TT......TT.T@@@@T......@@@@@@T.TT.T...@@@@@@@@@@@@@@@@@@@@@@@@
@@@@@@@@@@@@@@@@@@@.TT..T...T.T...T......TT..TT..@@@@...@@.TT.@@@@TT.T.TTT.@@@@@@@@@@@@@@@@@@@@@@@@@
@@@@@@@@@@@@@@@@@@@@.T....T.T..T..TTTT...TT.....@@@@T..@@@@....T....T.T...@@@@@@@@@@@@@@@@@@@@@@@@@@
@@@@@@@@@@@@@@@@@@@@@T.T..T......T.T.TT.T.....T..@@.T.@@@@@@TTT..TTT.T.T.@@@@@@@@@@@@@@@@@@@@@@@@@@@
@@@@@@@@@@@@@@@@@@@@@@.T.T....T.....T....T....T..T...@@@@@@@@T..TT..T.T.@@@@@@@@@@@@@@@@@@@@@@@@@@@@
@@@@@@@@@@@@@@@@@@@@@@@.T...T......T....T.....TTT..T@@@@@@@@@..T....TT.@@@@@@@@@@@@@@@@@@@@@@@@@@@@@
@@@@@@@@@@@@@@@@@@@@@@@@..TT.T....T..TTT..T......TT.T@@@@@@@..TTTTT.TT@@@@@@@@@@@@@@@@@@@@@@@@@@@@@@
@@@@@@@@@@@@@@@@@@@@@@@@@..TTT..T@@@...TT.T..TTT..T.TT@@@@@T...T..T..@@@@@@@@@@@@@@@@@@@@@@@@@@@@@@@
@@@@@@@@@@@@@@@@@@@@@@@@@@.....T@@@@@T.......T..T.T..TT@@@.TT..TT..T@@@@@@@@@@@@@@@@@@@@@@@@@@@@@@@@
@@@@@@@@@@@@@@@@@@@@@@@@@@@.T..@@@@@@@@TT.....T..TTT.......T..T.T..@@@@@@@@@@@@@@@@@@@@@@@@@@@@@@@@@
@@@@@@@@@@@@@@@@@@@@@@@@@@@@@@@@@@@@@@@@.T..TT.T..T......TTTTTT..T@@@@@@@@@@@@@@@@@@@@@@@@@@@@@@@@@@
@@@@@@@@@@@@@@@@@@@@@@@@@@@@@@@@@@@@@@@@@.TTT...............TT.T.@@@@@@@@@@@@@@@@@@@@@@@@@@@@@@@@@@@
@@@@@@@@@@@@@@@@@@@@@@@@@@@@@@@@@@@@@@@@@@T.TT...T.T..TTTT....T.@@@@@@@@@@@@@@@@@@@@@@@@@@@@@@@@@@@@
@@@@@@@@@@@@@@@@@@@@@@@@@@@@@@@@@@@@@@@@@@@.T..T..T.TTT.TTTT..T@@@@@@@@@@@@@@@@@@@@@@@@@@@@@@@@@@@@@
@@@@@@@@@@@@@@@@@@@@@@@@@@@@@@@@@@@@@@@@@@@@..T.T..TT..TT..TTT@@@@@@@@@@@@@@@@@@@@@@@@@@@@@@@@@@@@@@
@@@@@@@@@@@@@@@@@@@@@@@@@@@@@@@@@@@@@@@@@@@@@..TTT..T.T.TT.TT@@@@@@@@@@@@@@@@@@@@@@@@@@@@@@@@@@@@@@@
@@@@@@@@@@@@@@@@@@@@@@@@@@@@@@@@@@@@@@@@@@@@@@@T...T...T....@@@@@@@@@@@@@@@@@@@@@@@@@@@@@@@@@@@@@@@@
@@@@@@@@@@@@@@@@@@@@@@@@@@@@@@@@@@@@@@@@@@@@@@@@T.T..T....T@@@@@@@@@@@@@@@@@@@@@@@@@@@@@@@@@@@@@@@@@
@@@@@@@@@@@@@@@@@@@@@@@@@@@@@@@@@@@@@@@@@@@@@@@@@....TT...@@@@@@@@@@@@@@@@@@@@@@@@@@@@@@@@@@@@@@@@@@
@@@@@@@@@@@@@@@@@@@@@@@@@@@@@@@@@@@@@@@@@@@@@@@@@@T.T...T@@@@@@@@@@@@@@@@@@@@@@@@@@@@@@@@@@@@@@@@@@@
@@@@@@@@@@@@@@@@@@@@@@@@@@@@@@@@@@@@@@@@@@@@@@@@@@@TT..T@@@@@@@@@@@@@@@@@@@@@@@@@@@@@@@@@@@@@@@@@@@@
@@@@@@@@@@@@@@@@@@@@@@@@@@@@@@@@@@@@@@@@@@@@@@@@@@@@..T@@@@@@@@@@@@@@@@@@@@@@@@@@@@@@@@@@@@@@@@@@@@@
@@@@@@@@@@@@@@@@@@@@@@@@@@@@@@@@@@@@@@@@@@@@@@@@@@@@@@@@@@@@@@@@@@@@@@@@@@@@@@@@@@@@@@@@@@@@@@@@@@@@
@@@@@@@@@@@@@@@@@@@@@@@@@@@@@@@@@@@@@@@@@@@@@@@@@@@@@@@@@@@@@@@@@@@@@@@@@@@@@@@@@@@@@@@@@@@@@@@@@@@@
@@@@@@@@@@@@@@@@@@@@@@@@@@@@@@@@@@@@@@@@@@@@@@@@@@@@@@@@@@@@@@@@@@@@@@@@@@@@@@@@@@@@@@@@@@@@@@@@@@@@
@@@@@@@@@@@@@@@@@@@@@@@@@@@@@@@@@@@@@@@@@@@@@@@@@@@@@@@@@@@@@@@@@@@@@@@@@@@@@@@@@@@@@@@@@@@@@@@@@@@@
@@@@@@@@@@@@@@@@@@@@@@@@@@@@@@@@@@@@@@@@@@@@@@@@@@@@@@@@@@@@@@@@@@@@@@@@@@@@@@@@@@@@@@@@@@@@@@@@@@@@
@@@@@@@@@@@@@@@@@@@@@@@@@@@@@@@@@@@@@@@@@@@@@@@@@@@@@@@@@@@@@@@@@@@@@@@@@@@@@@@@@@@@@@@@@@@@@@@@@@@@
@@@@@@@@@@@@@@@@@@@@@@@@@@@@@@@@@@@@@@@@@@@@@@@@@@@@@@@@@@@@@@@@@@@@@@@@@@@@@@@@@@@@@@@@@@@@@@@@@@@@
@@@@@@@@@@@@@@@@@@@@@@@@@@@@@@@@@@@@@@@@@@@@@@@@@@@@@@@@@@@@@@@@@@@@@@@@@@@@@@@@@@@@@@@@@@@@@@@@@@@@
@@@@@@@@@@@@@@@@@@@@@@@@@@@@@@@@@@@@@@@@@@@@@@@@@@@@@@@@@@@@@@@@@@@@@@@@@@@@@@@@@@@@@@@@@@@@@@@@@@@@
