type octile
height 64
width 60
map
@@@@@@@@@@@@@@@@@@@@@@@@@@@@@@@@@@@@@@@@@@@@@@@@@@@@@@@@@@@@
@@@@@@@@@@@@@@@@@@@@@@@@@@@@@@@@@@@@@@@@@@@@@@@@@@@@@@@@@@@@
@@@@@@@@@@@@@@@@@@@@@@@@@@@@@@@@@@@@@@@@@@@@@@@@@@@@@@@@@@@@
@@@@@@@@@@@@@@@@@@@@@@@@@@@@@@@@@@@@@@@@@@@@@@@@@@@@@@@@@@@@
@@@@@@@@@@@@@@@@@@@@@@@@@@@@@@@@@@@@@@@@@@@@@@@@@@@@@@@@@@@@
@@@@@@@@@@@@@@@@@@@@@@@@@@@@@@@@@@@@@@@@@@@@@@@@@@@@@@@@@@@@
@@@@@@@@@@@@@@@@@@@@@@@@@@@@@@@@@@@@@@@@@@@@@@@@@@@@@@@@@@@@
@@@@@@@@@@@@@@@@@@@@@@@@@@@@@@@@@@@@@@@@@@@@@@@@@@@@@@@@@@@@
@@@@@@@@@@@@@@@@@@@@@@@@@@@@@@@@@@@@@@@@@@@@@@@@@@@@@@@@@@@@
@@@@@@@@@@@@@@@@@@@@@@@@@@@@@@@@@@@@@@@@@@@@@@@@@@@@@@@@@@@@
@@@@@@@@@@@@@@@@@@@@@@@@@@@@@@@@@@@@@@@@@@@@@@@@@@@@@@@@@@@@
@@@@@@@@@@@@@@@@@@@@@@@@@@@@@@@@@@@@@@@@@@@@@@@@@@@@@@@@@@@@
@@@@@@@@@@@@@@@@@@@@@@@@@@@@@@@@@@@@@@@@@@@@@@@@@@@@@@@@@@@@
@@@@@@@@@@@@@@@@@@@@@@@@@@@@@@@@@@@@@@@@@@@@@@@@@@@@@@@@@@@@
@@@@@@@@@@@@@@@@@@@@@@@@@@@@@@@@@@@@@@@@@@@@@@@@@@@@.TT@@@@@
@@@@@@@@@@@@@@@@@@@@@@@@@@@@@@@@@@@@@@@@@@@@@@@@@@TT.T@@@@@@
@@@@@@@@@@@@@@@@@@@@@@@@@@@@@@@@@@@@@@@@@@@@@@@@.T.T..@@@@@@
@@@@@@@@@@@@@@@@@@@@@@@@@@@@@@@@@@@@@@@@@@@@@@@.....T..@@@@@
@@@@@@@@@@@@@@@@@@@@@@@@@@@@@@@@@@@@@@@@@@@@@@...T.TT..@@@@@
@@@@@@@@@@@@@@@@@@@@@@@@@@@@@@@@@@@@@@@@@@@@@@.T.TT..T.@@@@@
@@@@@@@@@@@@@@@@@@@@@@@@@@@@@@@@@@@@@@@@@@@@.TTT...TTTT@@@@@
@@@@@@@@@@@@@@@@@@@@@@@@@@@@@@@@@@@@@@@@@@..T..TT..TT@@@@@@@
@@@@@@@@@@@@@@@@@@@@@@@@@@@@@@@@@@@@@@@@@T.TTTTT....T@@@@@@@
@@@@@@@@@@@@@@@@@@@@@@@@@@@@@@@@@@@@@@@@.....T.TTT.T.@@@@@@@
@@@@@@@@@@@@@@@@@@@@@@@@@@@@@@@@@@@@@@@..T..T...TTT..@@@@@@@
@@@@@@@@@@@@@@@@@@@@@@@@@@@@@@@@@@@@@@..TTT...T...TT.@@@@@@@
@@@@@@@@@@@@@@@@@@@@@@@@@@@@@@@@@@@@..TT.T...T.T....T@@@@@@@
@@@@@@@@@@@@@@@@@@@@@@@@@@@@@@@@@@T..T.TT..TTT.T...TT@@@@@@@
@@@@@@@@@@@@@@@@@@@@@@@@@@@@@@@@T..T...T.TTT.TT.T...@@@@@@@@
@@@@@@@@@@@@@@@@@@@@@@@@@@@@@@T...TTT..TT.....T...T..@@@@@@@
@@@@@@@@@@@@@@@@@@@@@@@@@@@@TTTT.T.TT.TT..TTTT..TTT.@@@@@@@@
@@@@@@@@@@@@@@@@@@@@@@@@@....T....TT...TTT..TT...T..@@@@@@@@
@@@@@@@@@@@@@@@@@@@@@@@.....TT.TTTTT..TT..TTT.T...TT@@@@@@@@
@@@@@@@@@@@@@@@@@@@@@TT.....TT......T...........T.TTT@@@@@@@
@@@@@@@@@@@@@@@@@@@..TTTT.....T........T...TTTT...TT.@@@@@@@
@@@@@@@@@@@@@@@@@@@...TTTT..T.....TT@@@@T.TT...TTT.TT@@@@@@@
@@@@@@@@@@@@@@@@@@@@.T....TTT...T.T@@@@@@T....T.TTT..@@@@@@@
@@@@@@@@@@@@@@@@@@@@@...TT....T..T.@@@@@@....TTT.T.T@@@@@@@@
@@@@@@@@@@@@@@@@@@@@@@@@@....T...T.@@@@@@.......T.TT@@@@@@@@
@@@@@@@@@@@@@@@@@@@@@@@@@@T..T..TT.@@@@@@.T..T..T..@@@@@@@@@
@@@@@@@@@@@@@@@@@@@@@@@@@@@T.T...T.T@@@@T.TT..T.TT.@@@@@@@@@
@@@@@@@@@@@@@@@@@@@@@@@@@@@@TTT..T........TTT...T..@@@@@@@@@
@@@@@@@@@@@@@@@@@@@@@@@@@@@@@@T.....TT.T.TT........@@@@@@@@@
@@@@@@@@@@@@@@@@@@@@@@@@@@@@@@T.TT....T.T...T..T.T.@@@@@@@@@
@@@@@@@@@@@@@@@@@@@@@@@@@@@@@T.....T....TT.......TT@@@@@@@@@
@@@@@@@@@@@@@@@@@@@@@@@@@@@@@TTT.TT.T...........T.@@@@@@@@@@
@@@@@@@@@@@@@@@@@@@@@@@@@@@@T...T..T..T..T......T.T@@@@@@@@@
@@@@@@@@@@@@@@@@@@@@@@@@@@@@.....T....T.@.....T....@@@@@@@@@
@@@@@@@@@@@@@@@@@@@@@@@@@@@@@T..T.TT..T@@@...T..TT.@@@@@@@@@
@@@@@@@@@@@@@@@@@@@@@@@@@@@@@@@...T...@@@@.@@....TT@@@@@@@@@
@@@@@@@@@@@@@@@@@@@@@@@@@@@@@@@@@T.T..@@@@@@@..TT.T@@@@@@@@@
@@@@@@@@@@@@@@@@@@@@@@@@@@@@@@@@@@@T.@@@@@@@@@T....@@@@@@@@@
@@@@@@@@@@@@@@@@@@@@@@@@@@@@@@@@@@@@@@@@@@@@@@@@.TT@@@@@@@@@
@@@@@@@@@@@@@@@@@@@@@@@@@@@@@@@@@@@@@@@@@@@@@@@@@@@@@@@@@@@@
@@@@@@@@@@@@@@@@@@@@@@@@@@@@@@@@@@@@@@@@@@@@@@@@@@@@@@@@@@@@
@@@@@@@@@@@@@@@@@@@@@@@@@@@@@@@@@@@@@@@@@@@@@@@@@@@@@@@@@@@@
@@@@@@@@@@@@@@@@@@@@@@@@@@@@@@@@@@@@@@@@@@@@@@@@@@@@@@@@@@@@
@@@@@@@@@@@@@@@@@@@@@@@@@@@@@@@@@@@@@@@@@@@@@@@@@@@@@@@@@@@@
@@@@@@@@@@@@@@@@@@@@@@@@@@@@@@@@@@@@@@@@@@@@@@@@@@@@@@@@@@@@
@@@@@@@@@@@@@@@@@@@@@@@@@@@@@@@@@@@@@@@@@@@@@@@@@@@@@@@@@@@@
@@@@@@@@@@@@@@@@@@@@@@@@@@@@@@@@@@@@@@@@@@@@@@@@@@@@@@@@@@@@
@@@@@@@@@@@@@@@@@@@@@@@@@@@@@@@@@@@@@@@@@@@@@@@@@@@@@@@@@@@@
@@@@@@@@@@@@@@@@@@@@@@@@@@@@@@@@@@@@@@@@@@@@@@@@@@@@@@@@@@@@
@@@@@@@@@@@@@@@@@@@@@@@@@@@@@@@@@@@@@@@@@@@@@@@@@@@@@@@@@@@@
