type octile
height 64
width 60
map
@@@@@@@@@@@@@@@@@@@@@@@@@@@@@@@@@@@@@@@@@@@@@@@@@@@@@@@@@@@@
@@@@@@@@@@@@@@@@@@@@@@@@@@@@@@@@@@@@@@@@@@@@@@@@@@@@@@@@@@@@
@@@@@@@@@@@@@@@@@@@@@@@@@@@@@@@@@@@@@@@@@@@@@@@@@@@@@@@@@@@@
@@@@@@@@@@@@@@@@@@@@@@@@@@@@@@@@@@@@@@@@@@@@@@@@@@@@@@@@@@@@
@@@@@@@@@@@@@@@@@@@@@@@@@@@@@@@@@@@@@@@@@@@@@@@@@@@@@@@@@@@@
@@@@@@@@@@@@@@@@@@@@@@@@@@@@@@@@@@@@@@@@@@@@@@@@@@@@@@@@@@@@
@@@@@@@@@@@@@@@@@@@@@@@@@@@@@@@@@@@@@@@@@@@@@@@@@@@@@@@@@@@@
@@@@@@@@@@@@@@@@@@@@@@@@@@@@@@@@@@@@@@@@@@@@@@@@@@@@@@@@@@@@
@@@@@@@@@@@@@@@@@@@@@@@@@@@@@@@@@@@@@@@@@@@@@@@@@@@@@@@@@@@@
@@@@@@@@@@@@@@@@@@@@@@@@@@@@@@@@@@@@@@@@@@@@@@@@@@@@@@@@@@@@
@@@@@@@@@@@@@@@@@@@@@@@@@@@@@@@@@@@@@@@@@@@@@@@@@@@@@@@@@@@@
@@@@@@@@@@@@@@@@@@@@@@@@@@@@@@@@@@@@@@@@@@@@@@@@@@@@@@@@@@@@
@@@@@@@@@@@@@@@@@@@@@@@@@@@@@@@@@@@@@@@@@@@@@@@@@@@@@@@@@@@@
@@@@@@@@@@@@@@@@@@@@@@@@@@@T.TT@@@@@@@@@@@@@@@@@@@@@@@@@@@@@
@@@@@@@@@@@@@@@@@@@@@@@@@@T..TT..T@@@@@@@@@@@@@@@@@@@@@@@@@@
@@@@@@@@@@@@@@@@@@@@@@@@@@....TT...@@@@@@@@@@@@@@@@@@@@@@@@@
@@@@@@@@@@@@@@@@@@@@@@@@@@..TT..TTTT.@@@@@@@@@@@@@@@@@@@@@@@
@@@@@@@@@@@@@@@@@@@@@@@@@@.TT..TT.TT..T@@@@@@@@@@@@@@@@@@@@@
@@@@@@@@@@@@@@@@@@@@@@@@@@..TTTT.T.T...T@@@@@@@@@@@@@@@@@@@@
@@@@@@@@@@@@@@@@@@@@@@@@@@T.....T.TT.T...@@@@@@@@@@@@@@@@@@@
@@@@@@@@@@@@@@@@@@@@@@@@@@...TT.T.TT....T@@@T@@@@@@@@@@@@@@@
@@@@@@@@@@@@@@@@@@@@@@@@@T..T..T......T..T.T.T@@@@@@@@@@@@@@
@@@@@@@@@@@@@@@@@@@@@@@@@TTTTTT....TTTTT.T..T.@@@@@@@@@@@@@@
@@@@@@@@@@@@@@@T.T..@@@@@....TTT...T.TTT.T@.T..@@@@@@@@@@@@@
@@@@@@@@@@@@@@..T.T.T@@@T..TTT...TT.@@@T.T@@T..@@@@@@@@@@@@@
@@@@@@@@@@@@@@@..T........T@@@@..TT@@@@..T@@TTT@@@@@@@@@@@@@
@@@@@@@@@@@@@@@.T....T.....@@@@TT@@@@@@TT@@@...@@@@@@@@@@@@@
@@@@@@@@@@@@@@@TTT....T.TT.@@@@@@@@@@@T..@@@...@@@@@@@@@@@@@
@@@@@@@@@@@@@@@..T..TT@@@@@@@@@@@@@@@@@@@@@...T@@@@@@@@@@@@@
@@@@@@@@@@@@@@@T....TT@@@@@@@@@@@@@@@@@@@@..T.T@@@@@@@@@@@@@
@@@@@@@@@@@@@TTTTT....@@@@@@@@@@@@@@@@@@@@TTT@@@@T.TT@@@@@@@
@@@@@@@@@@@@@.T.T....@@@@@@@@@@@@@@@@@@@@@T..@@@..TTT.@@@@@@
@@@@@@@@@@@@@..T.....T@@@@@@@@@@@@@@@@@@@@@.TT@@.T.T.T@@@@@@
@@@@@@@@@@@@@..TT.T..T.@@@@@@@@@@@@@@@@.TT@@T.@@TT..TT@@@@@@
@@@@@@@@@@@@@..T.....T@@@@@@@@@@@@@@@@@T..@@.TT.T...T.@@@@@@
@@@@@@@@@@@@@@T.TT...@@@@@@@.@@@@@@@@@@TTT@@@.T...TTTT@@@@@@
@@@@@@@@@@@@@@@.T...@@@@@@@.TT@@@@@@@@@TT..T.T...T..TT@@@@@@
@@@@@@@@@@@@@@@@....@@@@@@@T.T.@@@@@@@@T...T....TTT..T@@@@@@
@@@@@@@@@@@@@@@@@TT@@@@@@@TTT.TT@@@@@@T..T...T.TT.....@@@@@@
@@@@@@@@@@@@@@@@@@@@@@@@@@T.@@@..@@T..T.TT.TTT..T.....@@@@@@
@@@@@@@@@@@@@@@@@@@@@@@@@TT@@@@@T@@T...TTTT....T......@@@@@@
@@@@@@@@@@@@@@@@@@@@@@@@@TT@@@@@TT...TTT....T..TTTT...@@@@@@
@@@@@@@@@@@@@@@@@@@@@@@@...@@@@T.......T.T..TT....TT.@@@@@@@
@@@@@@@@@@@@@@@@@@@@@@@@.TT@@@@........T...TTT.T....@@@@@@@@
@@@@@@@@..T.@TTT@@@@@@@@T....TTT.....T.TT..T.T....T.@@@@@@@@
@@@@@@@@.....T..T@@@@@@@@.T.T.T.TT.......TTTTT.TT..@@@@@@@@@
@@@@@@@@TT.T..T.....@@@@T....T.......T.T...T..TT..@@@@@@@@@@
@@@@@@@@TT.T.......T@@..T.T.T........TTTTT.T..T.TT@@@@@@@@@@
@@@@@@@@@...TTTT..T...T...TTTTT.......T.....T.T.T@@@@@@@@@@@
@@@@@@@@@@.T..T.TTTT.TT.TT......T..T.TT..T...T.T.@@@@@@@@@@@
@@@@@@@@@@@..T....T.........T.TT.T..TT...TTTTT.T@@@@@@@@@@@@
@@@@@@@@@@@@T...TT..TTT..TT.TT.....TT..TTT.TT.T@@@@@@@@@@@@@
@@@@@@@@@@@@@.....T...T.TT.TT.TT.T..TT.T...T.T.@@@@@@@@@@@@@
@@@@@@@@@@@@@@TT.TT.T....T......TTT.TT.T...T..@@@@@@@@@@@@@@
@@@@@@@@@@@@@@@T.T..T.T.TT.T..T...T.....T.T.T@@@@@@@@@@@@@@@
@@@@@@@@@@@@@@@@@TT.TT..T....T.....TTT...TT.T@@@@@@@@@@@@@@@
@@@@@@@@@@@@@@@@@@@...T..T.T........T..T.T.T@@@@@@@@@@@@@@@@
@@@@@@@@@@@@@@@@@@@@@TT................T....@@@@@@@@@@@@@@@@
@@@@@@@@@@@@@@@@@@@@@@@@........T......T...@@@@@@@@@@@@@@@@@
@@@@@@@@@@@@@@@@@@@@@@@@@@T....T.TT.TTTT.T@@@@@@@@@@@@@@@@@@
@@@@@@@@@@@@@@@@@@@@@@@@@@@@@@TT.....TT..@@@@@@@@@@@@@@@@@@@
@@@@@@@@@@@@@@@@@@@@@@@@@@@@@@@@@..TT...T@@@@@@@@@@@@@@@@@@@
@@@@@@@@@@@@@@@@@@@@@@@@@@@@@@@@@@@@@@@@@@@@@@@@@@@@@@@@@@@@
@@@@@@@@@@@@@@@@@@@@@@@@@@@@@@@@@@@@@@@@@@@@@@@@@@@@@@@@@@@@
