type octile
height 54
width 56
map
@@@@@@@@@@@@@@@@@@@@@@@@@@@@@@@@@@@@@@@@@@@@@@@@@@@@@@@@
@@@@@@@@@@@@@@@@@@@@@@@@@@@@@@@@@@@@@@@@@@@@@@@@@@@@@@@@
@@@@@@@@@@@@@@@@@@@@@@@@@@@@@@@@@@@@@@@@@@@@@@@@@@@@@@@@
@@@@@@@@@@@@@@@@@@@@@@@@@@@@@@@@@@@@@@@@@@@@@@@@@@@@@@@@
@@@@@@@@@@@@@@@@@@@@@@@@@@@@@@@@@@@@@@@@@@@@@@@@@@@@@@@@
@@@@@@@@@@@@@@@@@@@@@@@@@@@@@@@@@@@@@@@@@@@@@@@@@@@@@@@@
@@@@@@@@@@@@@@@@@@@@@@@@@@@@@@@@@@@@@@@@@@@@@@@@@@@@@@@@
@@@@@@@@@@@@@@@@@@@@@@@@@@@@@@@@@@@@@@@@@@@@@@@@@@@@@@@@
@@@@@@@@@@@@@@@@@@@@@@@@@@@@@@@@@@@@@@@@@@@@@@@@@@@@@@@@
@@@@@@@@@@@@@@@@@@@@@@@@@@@@@@@@@@@@@@@@@@@@@@@@@@@@@@@@
@@@@@@@@@@@@@@@@@@@@@@@@@@@@@@@@@@@@@@@@@@@@@@@@@@@@@@@@
@@@@@@@@@@@@@@@@@@@@@@@@@@@@@@@@@@@@@@@@@@@@@@@@@@@@@@@@
@@@@@@@@@@@@@@@@@@@@@@@@@@@@@@@@@@@@@@@@@@@@@@@@@@@@@@@@
@@@@@@@@@@@@@@@@@@@@@@@@@@@@@@@@@@@@@@@@@@@@@@@@@@@@@@@@
@@@@@@@@@@@@@@@@@@@@@@@@@@.@@@@@@@@@@@@@@@@@@@@@@@@@@@@@
@@@@@@@@@@@@@@@@@@@@@@@@@TT@@@@@@@@@@@@@@@@@@@@@@@@@@@@@
@@@@@@@@@@@@@@@@@@@@@@@@@T..@T@@@@@@@@@@@@@@@@@@@@@@@@@@
@@@@@@@@@@@@@@@@@@@@@@@@.T.....T@@@@@@@@@@@@@@@@@@@@@@@@
@@@@@@@@@@@@@@@@@@@@@@@..TT..T.T.@@@@@@@@@@@@@@@@@@@@@@@
@@@@@@@@@@@@@@@@@@@@@@...TTTT.TT@@@@@@@@@@@@@@@@@@@@@@@@
@@@@@@@@@@@@@@@@@@@@@@.T...TT.T.@@@@@@@@@@@@@@@@@@@@@@@@
@@@@@@@@@@@@@@@@@@@@@....T.......@@@@@@@@@@@@@@@@@@@@@@@
@@@@@@@@@@@@@@@@@@@@T.@@.TT......@@@@@@@@@@@@@@@@@@@@@@@
@@@@@@@@@@@@@@@@@@@@T@@@.TT..T..@@@@@@@@@@@@@@@@@@@@@@@@
@@@@@@@@@@@@@@@@@@@T.T....TT.TTTT@TT@@@@@@@@@@@@@@@@@@@@
@@@@@@@@@@@@@@@@@@..T..T..TTT..T.TT.T.@@@@@@@@@@@@@@@@@@
@@@@@@@@@@@@@@@@@....T..T..T...TT..T.T.@@T@@@@@@@@@@@@@@
@@@@@@@@@@@@@@@@@....TT.T.TT....T...TT.@@TT@@@.@@@@@@@@@
@@@@@@@@@@@@@@@@.T..TT.....T....TTT....@@...@.TT@@@@@@@@
@@@@@@@@@@@@@@@@@@.TT.....T.TT......T..@@.....TT.T@@@@@@
@@@@@@@@@@@@@@@.@@T..T.........@...TT..TTT....TT.T@@@@@@
@@@@@@@@@@@@@@TT@@T..T........@@@T.T.T....T.T.T...@@@@@@
@@@@@@@@@@@@@..T.T.T..TTT.TTTTTT@@@T...TTTTTT....T@@@@@@
@@@@@@@@@@@@.TT.T.T.T..TT.TTT.T..@@TT..T..T......@@@@@@@
@@@@@@@@@@@@..T.T....T...TT..TTT..TTTT..T....T.T@@@@@@@@
@@@@@@@@@@@....TTT..T.TT..TTT..T.T.TT.T.TT..@@.T@@@@@@@@
@@@@@@@@@@.T..T.T....TTT...TT.TTT.TT.T...T.T@@@@@@@@@@@@
@@@@@@@@@.T@@TT.........TTT..T...T...TT...TTT@@@@@@@@@@@
@@@@@@@@@.@@@......TTTT.TT...TT...T...T.T....@@@@@@@@@@@
@@@@@@@@T.@@..T..T.TT..TTT..T..T...TT...T..T.@@@@@@@@@@@
@@@@@@@T.T......T.TT.....TT.T..T....T.T..T.T.@@@@@@@@@@@
@@@@@@....T.T..T.T...T........T.T.T..T..T...@@@@@@@@@@@@
@@@@@@@@.TT..T.T.T.TTT.....T...TT.......T..@@@@@@@@@@@@@
@@@@@@@@@TT.T.TT.TT.T...TT.T.T..T.....T@@..@@@@@@@@@@@@@
@@@@@@@@@@@...T..TTT..TT..TTTT.T.T.....@@@@@@@@@@@@@@@@@
@@@@@@@@@@@@T....T....TTTT..T.T...T.....@@@@@@@@@@@@@@@@
@@@@@@@@@@@@@@....T.TT..T.TT..T.T.T....T@@@@@@@@@@@@@@@@
@@@@@@@@@@@@@@@T.T.TT.T.TTT..TTTTTTTTT.T@@@@@@@@@@@@@@@@
@@@@@@@@@@@@@@@@..TT...TT.T.T..T.TT....@@@@@@@@@@@@@@@@@
@@@@@@@@@@@@@@@@@@..T.T.T.TTTT.TTT....T@@@@@@@@@@@@@@@@@
@@@@@@@@@@@@@@@@@@@..TT..T....T.T..TTT@@@@@@@@@@@@@@@@@@
@@@@@@@@@@@@@@@@@@@@@.T....T..TT.@@..@@@@@@@@@@@@@@@@@@@
@@@@@@@@@@@@@@@@@@@@@@@...T....T.@@@@@@@@@@@@@@@@@@@@@@@
@@@@@@@@@@@@@@@@@@@@@@@@@@@@@@@@@@@@@@@@@@@@@@@@@@@@@@@@
