type octile
height 86
width 100
map
@@@@@@@@@@@@@@@@@@@@@@@@@@@@@@@@@@@@@@@@@@@@@@@@@@@@@@@@@@@@@@@@@@@@@@@@@@@@@@@@@@@@@@@@@@@@@@@@@@@@
@@@@@@@@@@@@@@@@@@@@@@@@@@@@@@@@@@@@@@@@@@@@@@@@@@@@@@@@@@@@@@@@@@@@@@@@@@@@@@@@@@@@@@@@@@@@@@@@@@@@
@@@@@@@@@@@@@@@@@@@@@@@@@@@@@@@@@@@@@@@@@@@@@@@@@@@@@@@@@@@@@@@@@@@@@@@@@@@@@@@@@@@@@@@@@@@@@@@@@@@@
@@@@@@@@@@@@@@@@@@@@@@@@@@@@@@@@@@@@@@@@@@@@@@@@@@@@@@@@@@@@@@@@@@@@@@@@@@@@@@@@@@@@@@@@@@@@@@@@@@@@
@@@@@@@@@@@@@@@@@@@@@@@@@@@@@@@@@@@@@@@@@@@@@@@@@@@@@@@@@@@@@@@@@@@@@@@@@@@@@@@@@@@@@@@@@@@@@@@@@@@@
@@@@@@@@@@@@@@@@@@@@@@@@@@@@@@@@@@@@@@@@@@@@@@@@@@@@@@@@@@@@@@@@@@@@@@@@@@@@@@@@@@@@@@@@@@@@@@@@@@@@
@@@@@@@@@@@@@@@@@@@@@@@@@@@@@@@@@@@@@@@@@@@@@@@@@@@@@@@@@@@@@@@@@@@@@@@@@@@@@@@@@@@@@@@@@@@@@@@@@@@@
@@@@@@@@@@@@@@@@@@@@@@@@@@@@@@@@@@@@@@@@@@@@@@@@@@@@@@@@@@@@@@@@@@@@@@@@@@@@@@@@@@@@@@@@@@@@@@@@@@@@
@@@@@@@@@@@@@@@@@@@@@@@@@@@@@@@@@@@@@@@@@@@@@@@@.T.@@@@@@@@@@@@@@@@@@@@@@@@@@@@@@@@@@@@@@@@@@@@@@@@@
@@@@@@@@@@@@@@@@@@@@@@@@@@@@@@@@@@@@@@@@@@@@@@@@..T@TTT.@@@@@@@@@@@@@@@@@@@@.TT..@@@@@@@@@@@@@@@@@@@
@@@@@@@@@@@@@@@@@@@@@@@@@@@@@@@@@@@@@@@@@@@@@@@@T..@.TTT..@@@@@@@@@@@@@@@@@T..TT..@@@@@@@@@@@@@@@@@@
@@@@@@@@@@@@@@@@@@@@@@@@@@@@@@@@@@@@@@@T.@@@@@@@TTT@@@@@.T@@@@@@@@@@@@@@@@.....T..@@@@@@@@@@@@@@@@@@
@@@@@@@@@@@@@@@@@@@@@@@@@@@@@@@@@@@@@.TT@@@@@@@@...@@@@@TTT..@@@@@@@@@@@@.T@@.T..@@@@@@@@@@@@@@@@@@@
@@@@@@@@@@@@@@@@@@@@@@@@@@@@@@@@@@@@....@@@@@@@@T.T@...T.TT..@@@@@@@@@@@T..@@@T..T@@@@@@@@@@@@@@@@@@
@@@@@@@@@@@@@@@@@@@@@@@@@@@@@@@...T.TT.......TT....@@.TT.T.TT@@@@@@@@@@..@T.@@@T.TT@@@@@@@@@@@@@@@@@
@@@@@@@@@@@@@@@@@@@@@@@@@@@@@@@...TTTT.TT..TT.TTT...@@@@TT.TT.@@@@@@@@@T.@@.T@@@T.T.@@@.@@@@@@@@@@@@
@@@@@@@@@@@@@@@@@@@@@@@@@@@@@@@...T...T..T.@@@@@TTTT.T..T.T.T..@@@@@@@@@.T@@.T..TTT.T.T...@@@@@@@@@@
@@@@@@@@@@@@@@@@@@@@@@@@@@@@@@@.T.TTTT...T.@@@@@......T.TT..T.TT@@@@@@@@@.T@@@...@@...T...@@@@@@@@@@
@@@@@@@@@@@@@@@@@@@@@@@@@@@@@@@..T.....T.T.@@@@@.T.T.T.TT.......T@@@@@@@@@.T.TT.T@@@...TT.@@@@@@@@@@
@@@@@@@@@@@@@@@@@@@@@@@@@@@@@@@....T..@@@@@@@@@@......TTT.T..@TT..@@@@@@@@@@T..@TT@@@T.TT@@@@@@@@@@@
@@@@@@@@@@@@@@@@@@@@@@@@@@@@@@@..T.@@@@@@@@@@@@@.T...T.T...TT@@TTT.@@@@@@@TT.T.@@T.@@..T@@@@@@@@@@@@
@@@@@@@@@@@@@@@@@@@@@@@@@@@@@@@@@@@@@@@@@@@@@@@@.TT..T..TT.TT@@@....@@@@@@..TTT.@@TTT.T@@@@@@@@@@@@@
@@@@@@@@@@@@@@@@@@@@@@@@@@@@@@@@@@@@@@@@@@@@@@@@@@@@@@@@@@@@@@@@@....@@@@@....T.T@@..T@@@@@@@@@@@@@@
@@@@@@@@@@@@@@@@@@@@@@@@@@@@@@@@@@@@@@@@@@@@@@@@@@@@@@@@@@@@@@@@@@.T..@@@@...@.T.TTT.@@@@@@@@@@@@@@@
@@@@@@@@@@@@T@@T@@@@@@@@@@@@@@@@@@@@@@@@@@@@@@@@@@@@@@@@@@@@@@@@@@@....@@T.T@@@...T@@@@@@@@@@@@@@@@@
@@@@@TT@@@@...TT...@@@@@@@@@@@@@@@@@@@@@@@@@@@@@@@@@@@@@@@@@@@@@@@@@..T.TTT@@@@@@T@@@@@@@@@@@@@@@@@@
@@@@@.TT...T..TTT..T.@@@@@@@@@@@@@@@@@@@@@@@@@@@@@@@@@@@@@@@@@@@@@@@@....TT@@@@@@@@@@@@@@@@@@@@@@@@@
@@@@T...T......@@..T..@@@@@@@@@@@@@@@@@@@@@@@@@@@@@@@@@@@@@@@@@@@@@@@@T.T..@@@@@@@@@@@@@@@@@T@@@@@@@
@@@@..T.@@@....@@@..T.@@@@@@@@@@@@@@@@@@@@@@@@@@@@@@@@@@@@@@@@@@@@@@@@@TT...@@@@@@@@@@@@@@..T.@@@@@@
@@@T.TTTTT...T@@@@.T.@@@@@@@@@@@@@@@@@@@@@@@@@@@@@@@@@@@@@@@@@@@@@@@@@@@.TTT.@@@@@@@@@@@T..T.@@@@@@@
@@@...T.TTT...@@@T...@@@@@@@@@@@@@@@@@@@@T...T@@@@@@@@@T@@@@@@@@@@@@@@@@@.....@@@@@@@@.TT.T@@@@@@@@@
@@T.T.....T.T@@@@..T.@@@@@@@@@@@@@@@@@@TTT....T.@@@@@@@..@@@@@@@@@@@@@@@@@..T..@@@@@.T...@@@@@@@@@@@
@@@..TT....TT@@@@T.T@@@@@@@@@@@@@@@@@TT.....T.TTT..@@@@@T.T@@@@@@@@@@@@@@@@T.TT.@@@T..T@@@@@@@@@@@@@
@@@@@..T......@@T...@@@@@@@@@@@@@@@T..@@@....T.T...@@@@@.T.T@@@@@@@@@@@@@@@@TTT..T..T.@@@@@@@@@@@@@@
@@@@@@@@TTT..TTT...@@@@@@@@@@@@@@@T...@@@@@@@T...T.@@@@@T..T.@@@@@@@@@@@@@@@@....TT.@@@@@@@@@@@@@@@@
@@@@@@@@.T.@@@@@TT.@@@@@@@@@@@@@@T.T.TT..T@@@@..TT@@@@@@...T..@@@@@@@@@@@@@@@@@TT...@@@@@@@@@@@@@@@@
@@@@@@@@TT@@@@@@@@@@@@@@@@@@@@@@@.TTTTTT.....@@@TT@@@@@..T.TT.T@@@@@@@@@@@@@@@@...TT@@@@@@@@@@@@@@@@
@@@@@@TT..@@@@@@@@@@@@@@@@@@@@@@@@..@@.T.T..T..@T.@@@@@.......TT@@@@@@@@@@@@@@@T.T..@@@@@@@@@@@@@@@@
@@@@@@TTTT@@@@@@@@@@@@@@@@@@@@@@@@..@@@@@.TTT.TT.@@@@@..T..TT....@@T@@@@@@@@@@@.T...@@@@@@@@@@@@@@@@
@@@@@@.T..T@@@@@@@@@@@@@@@@@@@@@@T.TT.@@@@@@T...T@@@@@T.@@@@@..TT.T.@@@@@@@@@@@....@@@@@@@@@@@@@T.@@
@@@@@@....T@@@@@@@@@@@@@@@@@@@@@@T.@@.TT.@@@@@..@@T.T..@@@@@@@.T@@...@@@@@@@@@@.TT.@@@@@@@@@@@@..T.@
@@@@@@TTT..@@@@@@@@@@@@@@@@@@@@@.TT@@@@@.TT.@@..@..TT.TT.T@@..T@@@@TT@@@@@@@@@@@@T.@@@@@@@@@@@@..T.@
@@@@@@T.T.T@@@@@@@@@@@@@@@@@@@..TT.T@@@@@@@.TT.@@....T..T...TT@@@@@.TT@@@@@@@@@TTT..@@@@@@@@@@@....@
@@@@@@T..TT@@@@@@@@@@@@@@@@@@.T.T...T.T@@@@T..T@@.TT....TT...@@@@@@.T.@@@@@@@@@..TT.@@@@@@@@@@T...T@
@@@@@@.T..T@@@@@@@@@@@@@@@@@@T..T.TTTT.TT..T.T.TT.T......T.T.T@@@@@..T@@@@@@@@@@@@T..T.T@@@@......T@
@@@@@@.....@@@@@@@@@@@@@@@@@@.T.@@@..T.T...TTTTTT..TT.T..T....@@@@T..T@@@@@@@@@@@@T.....@@@@.....TT@
@@@@@@TT.T.@@@@@@@@@@@@@@@@@@..T@@@@@@.T...........T@@@@@@@TT..T....T.@@@@@@@@@@@@...T..@@@@T.TT...@
@@@@@@.TT...@@@@@@@@@@@@@@@@@.T.@@TT@@@@@..T.@T...@@@@@@@@@@TT.TT@...T@@@@@@@@@@@@...T..@@@@.T.T...@
@@@@@@.TT.T.@@@@@@@@@@@@@@@@@T..T..TT.@@@@@.@@...@@@@@@@@@@@@T.@@@@@@.@@@@@@@@@@@@.TT..T......TT...@
@@@@@@.T.T..@@@@@@@@@@@@@@@@@...T.TT..T.@@..@....@.T@@@@@..@@@@@@@@@.T@@@@@@@@@@@@.T..T..T...T.T.TT@
@@@@@@T..TT.@@@@@@@@@@@@@@@@@@...T.......T..@TT..@..@@@@@..@@@@@@@@T..@@@@@@@@@@@@...T......T.TTT.@@
@@@@@@T..T..@@@@@@@@@@@@@@@@@@@...T..T..TT.@@..T.@..@@@@...@@@@@@@@..T@@@@@@@@@T........TT..T.TT.T@@
@@@@@@@.TTTT@@@@@@@@@@@@@@@@@@@@@@.TT...TTT@TT.T..T...TT..@@@@@@@....@@@@@@@@@@T.T.T.TT....T.T....@@
@@@@@@@TTT...@@@@@@@@@@@@@@@@@@@@@@@@@....@@.......TT....@@@T...TT.T.@@@@@@@@@T..T@@@@@T.TT...TT.@@@
@@@@@@@.TT..T@@@@@@@@@@@@@@@@@@@@@@@@@@@T.@T..T...T....@@@@TT..TTT...@@@@@@@@@..T@@@@@@@@@...T.T.@@@
@@@@@@@....TT@@@@@@@@@@@@@@@@@@@@@@@@@@@@@@T.T.T..T.....TT.TT...T.T.@@@@@@@@@TT.@@@@@@@@@@@@T...T@@@
@@@@@@@..T...@@@@@@@@@@@@@@@@@@@@@@@@@@@@@.T...T.TTT.......TT...T..T@@@@@@@@..T.@@@@@@@@@@@@@@..@@@@
@@@@@@@@...TT@@@@@@@@@@@@@@@@@@@@@@@@@@@@@T...T.....T.T...T..T.T.TTT.@@@@@@@T.T.@@@@@@@@@@@@@@@@@@@@
@@@@@@@@.TTT..@@@@@@@@@@@@@@@@@@@@@@@@@@@.TT....TT...TT...T......@T.TT@@@@@@T...@@@@@@@@@@@@@@@@@@@@
@@@@@@@@.TT....@@@@@@@@@@@@@@@@@@@@@@@@@@@@@@T....T..TT.TTTT...T@@@.T..@@@@TT.TT@@@@@@@@@@@@@@@@@@@@
@@@@@@@@TT..T.T@@@@@@@@@@@@@@@@@@@@@@@@@@@@@@@@@.TT..T.T.TTTTTT@@@@@.TT..@@..TT..@@@@@@@@@@@@@@@@@@@
@@@@@@@@@.......@@@@@@@@@@@@@@@@@@@@@@@@@@@@@@@@@@T..T..TTT..@@@@@@@@.T..T.TT@@@@@@..T@@@@@@@@@@@@@@
@@@@@@@@@.TTT....@@@@@@@@@@@@@@@@@@@@@@@@@@@@@@@@@..T..T@TT.@@@@@@@@@@@T.TTT.@@@@@.....@@@@@@@@@@@@@
@@@@@@@@@@TTT..T.T@@@@@@@@@@@@@@@@@@@@@@@@@@@@@@@@@@@@@@@.T@@@@@@@@@@@@@@TT.TT...T.T..@@@@@@@@@@@@@@
@@@@@@@@@@@....T..T@@@@@@@@@@@@@@@@@@@@@@@@@@@@@@@@@@@@@@TT.@@@@@@@@@@@@@@@@@TT....T.@@@@@@@@@@@@@@@
@@@@@@@@@@@@TT.T.TT.@@@@@@@@@@@@@@@@@@@@@@@@@@@@@@@@@@@@@@TT.@@@@@@@@@@@@@@@@@@TT...@@@@@@@@@@@@@@@@
@@@@@@@@@@@@T.T...T.T@@@@@@@@@@@@@@@@@@@@@@@@@@@@@@@@@@@@@T.T.@@@@@@@@@@@@@@@@@@@.T@@@@@@@@@@@@@@@@@
@@@@@@@@@@@@@.T.T.T....@@@@.@@@@@@@@@@@@@@@@@@@@@@@@@@@@@@..TT@@@@@@@@@@@@@@@@@@@@@@@@@@@@@@@@@@@@@@
@@@@@@@@@@@@@@...T.T.T...@@TTT.T.@@@@@@@@@@@@@@@@@@@@@@@@@T.T.@@@@@@@@@@@@@@@@@@@@@@@@@@@@@@@@@@@@@@
@@@@@@@@@@@@@@@T.......TT.TTTT......@@@@@@@@@@@@@@@@@@@@@@.T.T@@@@@@@@@@@@@@@@@@@@@@@@@@@@@@@@@@@@@@
@@@@@@@@@@@@@@@@..T.TT.T....T.TT.......T@@TT@@@@@@@@@@@@@@T..T@@@@@@@@@@@@@@@@@@@@@@@@@@@@@@@@@@@@@@
@@@@@@@@@@@@@@@@@.T.TT......TT.TT...TT..TT..@@@@@@@@@@@@@@T...@@@@@@@@@@@@@@@@@@@@@@@@@@@@@@@@@@@@@@
@@@@@@@@@@@@@@@@@@@...T..T.TTTT@@@.T.T.T.T..@@@@@@@@@@@@@.....@@@@@@@@@@@@@@@@@@@@@@@@@@@@@@@@@@@@@@
@@@@@@@@@@@@@@@@@@@@T.TT..T.@@@@@@T.....TT..@@@@@@@@@@@@T....@@@@@@@@@@@@@@@@@@@@@@@@@@@@@@@@@@@@@@@
@@@@@@@@@@@@@@@@@@@@@..TT....@@@@@@.TT.TT.TT@@@@@@@@@@.TTT..@@@@@@@@@@@@@@@@@@@@@@@@@@@@@@@@@@@@@@@@
@@@@@@@@@@@@@@@@@@@@@@T....TTT@@@@@@@@....T...TT.T.T...T...@@@@@@@@@@@@@@@@@@@@@@@@@@@@@@@@@@@@@@@@@
@@@@@@@@@@@@@@@@@@@@@@@T.TT@TT..@@@@@@..@..T.T.....TT....@@@@@@@@@@@@@@@@@@@@@@@@@@@@@@@@@@@@@@@@@@@
@@@@@@@@@@@@@@@@@@@@@@@TT.@@@.T@@@@@@@.@@@..TTT..T...@@@@@@@@@@@@@@@@@@@@@@@@@@@@@@@@@@@@@@@@@@@@@@@
@@@@@@@@@@@@@@@@@@@T.@.T.T@@.T@@@@@@@@.@@@@.T..T..@@@@@@@@@@@@@@@@@@@@@@@@@@@@@@@@@@@@@@@@@@@@@@@@@@
@@@@@@@@@@@@@@@@@@..T.....T@@@@@@@@@@@@@@@T..@@@@@@@@@@@@@@@@@@@@@@@@@@@@@@@@@@@@@@@@@@@@@@@@@@@@@@@
@@@@@@@@@@@@@@@@@.T....T...T...@@@@@@@@@@@...@@@@@@@@@@@@@@@@@@@@@@@@@@@@@@@@@@@@@@@@@@@@@@@@@@@@@@@
@@@@@@@@@@@@@@@@@@@....T...TTT...T.@@@@@@T...@@@@@@@@@@@@@@@@@@@@@@@@@@@@@@@@@@@@@@@@@@@@@@@@@@@@@@@
@@@@@@@@@@@@@@@@@@@@@@TTTTTT.........@@@@..T.@@@@@@@@@@@@@@@@@@@@@@@@@@@@@@@@@@@@@@@@@@@@@@@@@@@@@@@
@@@@@@@@@@@@@@@@@@@@@@@@@TT...TTT.T...T.@TT..@@@@@@@@@@@@@@@@@@@@@@@@@@@@@@@@@@@@@@@@@@@@@@@@@@@@@@@
@@@@@@@@@@@@@@@@@@@@@@@@@@@@@T....TT...T.T.TT@@@@@@@@@@@@@@@@@@@@@@@@@@@@@@@@@@@@@@@@@@@@@@@@@@@@@@@
@@@@@@@@@@@@@@@@@@@@@@@@@@@@@@@@@@@@@@@@@@@@@@@@@@@@@@@@@@@@@@@@@@@@@@@@@@@@@@@@@@@@@@@@@@@@@@@@@@@@
