type octile
height 70
width 64
map
@@@@@@@@@@@@@@@@@@@@@@@@@@@@@@@@@@@@@@@@@@@@@@@@@@@@@@@@@@@@@@@@
@@@@@@@@@@@@@@@@@@@@@@@@@@@@@@@@@@@@@@@@@@@@@@@@@@@@@@@@@@@@@@@@
@@@@@@@@@@@@@@@@@@@@@@@@@@@@@@@@@@@@@@@@@@@@@@@@@@@@@@@@@@@@@@@@
@@@@@@@@@@@@@@@@@@@@@@@@@@@@@@@@@@@@@@@@@@@@@@@@@@@@@@@@@@@@@@@@
@@@@@@@@@@@@@@@@@@@@@@@@@@@@@@@@@@@@@@@@@@@@@@@@@@@@@@@@@@@@@@@@
@@@@@@@@@@@@@@@@@@@@@@@@@@@@@@@@@@@@@@@@@@@@@@@@@@@@@@@@@@@@@@@@
@@@@@@@@@@@@@@@@@@@@@@@@@@@@@@@@@@@@@@@@@@@@@@@@@@@@@@@@@@@@@@@@
@@@@@@@@@@@@@@@@@@@@@@@@@@@@@@@@@@@@@@@@@@@@@@@@@@@@@@@@@@@@@@@@
@@@@@@@@@@@@@@@@@@@@@@@@@@@@@@@@@@@@@@@@@@@@@@@@@@@@@@@@@@@@@@@@
@@@@@@@@@@@@@@@@@@@@@@@@@@@@@@@@@@@@@@@@@@@@@@@@@@@@@@@@@@@@@@@@
@@@@@@@@@@@@@@@@@@@@@@@@@@@@@@@@@@@@@@@@@@@@@@@@@@@@@@@@@@@@@@@@
@@@@@@@@@@@@@@@@@@@@@@@@@@@@@@@@@@@@@@@@@@@@@@@@@@@@@@@@@@@@@@@@
@@@@@@@@@@@@@@@@@@@@@@@@@@@@@@@@@@@...@@@@@@@@@@@@@@@@@@@@@@@@@@
@@@@@@@@@@@@@@@@@@@@@@@@@@@@@@@@@@.T..T@@@@@@@@@@@@@@@@@@@@@@@@@
@@@@@@@@@@@@@@@@@@@@@@@@@@@@@@@@@.TT@@.T@@@@@@@@@@@@@@@@@@@@@@@@
@@@@@@@@@@@@@@@@@@@@@@@@@@@@@@@@@T.@@@.T.@@@@@@@@@@@@@@@@@@@@@@@
@@@@@@@@@@@@@@@@@@@@@@@@@@@@@@@@@@T.@@TTTT@@@@@@@@@@@@@@@@@@@@@@
@@@@@@@@@@@@@@@@@@@@@@@@@@@@@@@@@@@T..T...T@@@@@@@@@@@@@@@@@@@@@
@@@@@@@@@@@@@@@@@@@@@@@@@@@@@@@@@@@@.T.TTTTT@@@@@@@@@@@@@@@@@@@@
@@@@@@@@@@@@@@@@@@@@@@@@@@@@@@@@@@@@@..TTT...@@@@@@@@@@@@@@@@@@@
@@@@@@@@@@@@@@@@@@@@@@@@@@@@@@@@@@@@@...TTT...@@@@@@@@@@@@@@@@@@
@@@@@@@@@@@@@@@@@@@@@@@@@@@..@@@@@@.TTT.TT.T..T@@@@@@@@@@@@@@@@@
@@@@@@@@@@@@@@@@@@@@@@@@@@@..@@@@@..TTTTTT...T..@@@@@@@@@@@@@@@@
@@@@@@@@@@@@@@@@@@@@@@@@@@@@.T..TTT..T.T....T....@@@@@@@@@@@@@@@
@@@@@@@@@@@@@@@@@@@@@@@@@@@@@T.T..TT.T.....@@T..TT@@@@@@@@@@@@@@
@@@@@@@@@@@@@@@@@@@@@@@@@@@@@@T.....TTTT..@@@@.....@@@@@@@@@@@@@
@@@@@@@@@@@@@@@@@@@@@@@@@@@@@@TT.TT.TT.T.T.@@@T.T...@@@@@@@@@@@@
@@@@@@@@@@@@@@@@@@@@@@@@@@@@@..T...T....TT.@..TTT...T.@@@@@@@@@@
@@@@@@@@@@@@@@@@@@@@@@@@@@@@..T.T..T.TT.T.T.T..T.T.TT..@@@@@@@@@
@@@@@@@@@@@@@@@@@@@@@@@@@@@...@T.T....T...T........T...@@@@@@@@@
@@@@@@@@@@@@@@@@@@@@@@@.T..T.@@@...TT.T...T......T.TTTT@@@@@@@@@
@@@@@@@@@@@@@@@@@@@@@@@@TTT..@@..T..TTTTT.TT.T....TTT.TTT.@@@@@@
@@@@@@@@@@@@@@@@@@@@@@@@.T..TTTT.@@TT...TT.T....T.@...TTTTT@@@@@
@@@@@@@@@@@@@@..@@@@@@@..TT..TT.@@@@......T.T....@@@TTT.TTTT@@@@
@@@@@@@@@@@@TT..@@@@@@......TT..@@@.......T..T..@@@@@T.TT....@@@
@@@@@@@@@@@...T.@@@@.T...T......@@@TTT..TTT...T@@@@@@@T.T...@@@@
@@@@@@@@@@T.TTT..TT....TT.T.T.TT@@...TTTT.T...@@@@@@@@@.T..@@@@@
@@@@@@@@@.T....T....T.....TT..T..TT..@...T...TT@@@@@@@@@T.@@@@@@
@@@@@@@@..T....TT.T...T..T.T....T...@@@...T......@@@@@@@@@@@@@@@
@@@@@@@..TTT..T.T.T.T.T......TT.....@@TT...T..T.T@@@@@@@@@@@@@@@
@@@@@@TT.T..@.TT..TT...TT.T..TTT....T..T..T@@....T@@@@@@@@@@@@@@
@@@@@.T..T..@@T..T...T..TT.T...T...T.....T@@@@.T...@@@@@@@@@@@@@
@@@@.TT.....@@@..T....T.TTT..T....T...TT.@@@@@@.TT..@@@@@@@@@@@@
@@@TT.TTT...@@@@...TT.T...T..TTT..T.TT..@@@@@@@@T...@@@@@@@@@@@@
@@.T.TT.@.T..@@@@T.TTTT....TT..T...TTT.@@@@@@@@@@..@@@@@@@@@@@@@
@@..TT.@@....@@@T..TT...TT..T....TTTT...@@@@@@@@@@@@@@@@@@@@@@@@
@@@.TT..@@TT.@@...T..T....T.T..T.T..T.T..T@@@@@@@@@@@@@@@@@@@@@@
@@@@TT.TT@..@@.TTT...@@.TT........@@....T.@@@@@@@@@@@@@@@@@@@@@@
@@@@@...T@@@@....T..@@@@..T.TT.T.@@@@TT.TTT@@@@@@@@@@@@@@@@@@@@@
@@@@@@T....@TT.....T.@@...T.....@@@@@@TTT.T.@@@@@@@@@@@@@@@@@@@@
@@@@@@@.T.T.T.TTT....TT..T....T@@@@@@@@..T..T@@@@@@@@@@@@@@@@@@@
@@@@@@@@TTT..T..TTTTTT.....@@@@@@@@@@@@@T..T@@@@@@@@@@@@@@@@@@@@
@@@@@@@@@.TT.T..TT..T...@@@@@@@@@@@@@@@@@..@@@@@@@@@@@@@@@@@@@@@
@@@@@@@@@@T..TT.T..T....TTT.@@@@@@@@@@@@@.@@@@@@@@@@@@@@@@@@@@@@
@@@@@@@@@@@.TT.TTT...T.....@@@@@@@@@@@@@@@@@@@@@@@@@@@@@@@@@@@@@
@@@@@@@@@@@@..T..........T@@@@@@@@@@@@@@@@@@@@@@@@@@@@@@@@@@@@@@
@@@@@@@@@@@@@.TTTTT...T.T.@@@@@@@@@@@@@@@@@@@@@@@@@@@@@@@@@@@@@@
@@@@@@@@@@@@@@T....TT.T..@@@@@@@@@@@@@@@@@@@@@@@@@@@@@@@@@@@@@@@
@@@@@@@@@@@@@@@.T...T.TT@@@@@@@@@@@@@@@@@@@@@@@@@@@@@@@@@@@@@@@@
@@@@@@@@@@@@@@@@@@@@@@@@@@@@@@@@@@@@@@@@@@@@@@@@@@@@@@@@@@@@@@@@
@@@@@@@@@@@@@@@@@@@@@@@@@@@@@@@@@@@@@@@@@@@@@@@@@@@@@@@@@@@@@@@@
@@@@@@@@@@@@@@@@@@@@@@@@@@@@@@@@@@@@@@@@@@@@@@@@@@@@@@@@@@@@@@@@
@@@@@@@@@@@@@@@@@@@@@@@@@@@@@@@@@@@@@@@@@@@@@@@@@@@@@@@@@@@@@@@@
@@@@@@@@@@@@@@@@@@@@@@@@@@@@@@@@@@@@@@@@@@@@@@@@@@@@@@@@@@@@@@@@
@@@@@@@@@@@@@@@@@@@@@@@@@@@@@@@@@@@@@@@@@@@@@@@@@@@@@@@@@@@@@@@@
@@@@@@@@@@@@@@@@@@@@@@@@@@@@@@@@@@@@@@@@@@@@@@@@@@@@@@@@@@@@@@@@
@@@@@@@@@@@@@@@@@@@@@@@@@@@@@@@@@@@@@@@@@@@@@@@@@@@@@@@@@@@@@@@@
@@@@@@@@@@@@@@@@@@@@@@@@@@@@@@@@@@@@@@@@@@@@@@@@@@@@@@@@@@@@@@@@
@@@@@@@@@@@@@@@@@@@@@@@@@@@@@@@@@@@@@@@@@@@@@@@@@@@@@@@@@@@@@@@@
@@@@@@@@@@@@@@@@@@@@@@@@@@@@@@@@@@@@@@@@@@@@@@@@@@@@@@@@@@@@@@@@
