type octile
height 80
width 80
map
@@@@@@@@@@@@@@@@@@@@@@@@@@@@@@@@@@@@@@@@@@@@@@@@@@@@@@@@@@@@@@@@@@@@@@@@@@@@@@@@
@@@@@@@@@@@@@@@@@@@@@@@@@@@@@@@@@@@@@@@@@@@@@@@@@@@@@@@@@@@@@@@@@@@@@@@@@@@@@@@@
@@@@@@@@@@@@@@@@@@@@@@@@@@@@@@@@@@@@@@@@@@@@@@@@@@@@@@@@@@@@@@@@@@@@@@@@@@@@@@@@
@@@@@@@@@@@@@@@@@@@@@@@@@@@@@@@@@@@@@@@@@@@@@@@@@@@@@@@@@@@@@@@@@@@@@@@@@@@@@@@@
@@@@@@@@@@@@@@@@@@@@@@@@@@@@@@@@@@@@@@@@@@@@@@@@@@@@@@@@@@@@@@@@@@@@@@@@@@@@@@@@
@@@@@@@@@@@@@@@@@@@@@@@@@@@@@@@@@@@@@@@@@@@@@@@@@@@@@@@@@@@@@@@@@@@@@@@@@@@@@@@@
@@@@@@@@@@@@@@@@@@@@@@@@@@@@@@@@@@@@@@@@@@@@@@@@@@@@@@@@@@@@@@@@@@@@@@@@@@@@@@@@
@@@@@@@@@@@@@@@@@@@@@@@@@@@@@@@@@@@@@@@@@@@@@@@@@@@@@@@@@@@@@@@@@@@@@@@@@@@@@@@@
@@@@@@@@@@@@@@@@@@@@@@@@@@@@@@@@@@@@@@@@@@@@@@@@@@@@@@@@@@@@@@@@@@@@@@@@@@@@@@@@
@@@@@@@@@@@@@@@@@@@@@@@@@@@@@@@@@@@@@@@@@@@@@@@@@@@@@@@@@@@@@@@@@@@@@@@@@@@@@@@@
@@@@@@@@@@@@@@@@@@@@@@@@@@@@@@@@@@@@@@@@@@@@@@@@@@@@@@@@@@@@@@@@@@@@@@@@@@@@@@@@
@@@@@@@@@@@@@@@@@@@@@@@@@@@@@@@@@@@@@@@@@@@@@@@@@@@@@@@@@@@@@@@@@@@@@@@@@@@@@@@@
@@@@@@@@@@@@@@@@@@@@@@@@@@@@@@@@@@@@@@@@@@@@@@@@@@@@@@@@@@@@@@@@@@@@@@@@@@@@@@@@
@@@@@@@@@@@@@@@@@@@@@@@@@@@@@@@@@@@@@@@@@@@@@@@@@@@@@@@@@@@@@@@@@@@@@@@@@@@@@@@@
@@@@@@@@@@@@@@@@@@@@@@@@@@@@@@@@@@@@@@@@@@@@@@@@@@@@@@@@@@@@@@@@@@@@@@@@@@@@@@@@
@@@@@@@@@@@@@@@@@@@@@@@@@@@@@@@@@@@@@@@@@@@@@@@@@@@@@@@@@@@@@@@@@@@@@@@@@@@@@@@@
@@@@@@@@@@@@@@@@@@@@@@@@@@@@@@@@@@@@@@@@@@@@@@@@@@@@@@@@@@@@@@@@@@@@@@@@@@@@@@@@
@@@@@@@@@@@@@@@@@@@@@@@@@@@@@@@@@@@@@@@@@@@@@@@@@@@@@@@@@@@@@@@@@@@@@@@@@@@@@@@@
@@@@@@@@@@@@@@@@@@@@@@@@@@@@@@@@@@@@@@@.@@@@@@@@@@@@@@@@@@@@@@@@@@@@@@@@@@@@@@@@
@@@@@@@@@@@@@@@@@@@@@@@@@@@@@@@@@@@@@@@.@@@@@@@@@@@@@@@@@@@@@@@@@@@@@@@@@@@@@@@@
@@@@@@@@@@@@@@@@@@@@@@@@@@@@@@@@@@@@@@.T.T@@@@@@@@@@@@@@@@@@@@@@@@@@@@@@@@@@@@@@
@@@@@@@@@@@@@@@@@@@@@@@@@@@@@@@@@@@@@@....@@@@@@@@@@@.@@@@@@@@@@@@@@@@@@@@@@@@@@
@@@@@@@@@@@@@@@@@@@@@@@@@@@@@@@@@@@@@@T..T@@@@@@@@@TT..@@@@@@@@@@@@@@@@@@@@@@@@@
@@@@@@@@@@@@@@@@@@@@@@@@@@@@@@@@@@@@@@T.T.@@@@@@@@@T.T.@@@@@@@@@@@@@@@@@@@@@@@@@
@@@@@@@@@@@@@@@@@@@@@@@@@@@@@@@@@@@@@@@....@@@@@@@....@@@@@@@@@@@@@@@@@@@@@@@@@@
@@@@@@@@@@@@@@@@@@@@@@@@@@@@@@@@@@@@@@T.TT....@@@T...@@@@@@@@@@@@@@@@@@@@@@@@@@@
@@@@@@@@@@@@@@@@@@@@@@@@@@@@@@@@@@@@@..TT...T..T....@@@@@@@@@@@@@@@@@@@@@@@@@@@@
@@@@@@@@@@@@@@@@@@@@@@@@@@@@@@@@@@@@@T.T...TT.T..T.@@@@@@@@@@@@@@@@@@@@@@@@@@@@@
@@@@@@@@@@@@@@@@@@@@@@@@@@@@@@@@@........T..T......@@@@@@@@@@@@@@@@@@@@@@@@@@@@@
@@@@@@@@@@@@@@@@@@@@@@@@@@@@.@@TTT..TTTTT.T.......@@@@@@@@@@@@@T.@@@@@@@@@@@@@@@
@@@@@@@@@@@@@@@@@@@@@@@@@@@@.@@T.TT.......T.T..T..@@@@@@@@@@@@@TTT@@@@@@@@@@@@@@
@@@@@@@@@@@@@@@@@@@@@@@@@@@@T.@...T..TT..T...T..T..@@@@@@@@@@@.TT@@@@@@@@@@@@@@@
@@@@@@@@@@@@@@@@@@@@@@@@@@@@.T@@T...TT..T..TTT....T@@@@@@@@@@@TTT@@@@@@@@@@@@@@@
@@@@@@@@@@@@@@@@@@@@@@@@@@@@@T@@T...TT.TT......TT.T.@@@@@@@@@...@@@@@@@@@@@@@@@@
@@@@@@@@@@@@@@@@@@@@@@@@@@@@@.@@T...T....T.......T.T@@@@@@@@...@@@@@@@@@@@@@@@@@
@@@@@@@@@@@@@@@@@@@@@@@@@@@T.T@@.TT.....T..T.T........@@@@@....@@@@@@@@@@@@@@@@@
@@@@@@@@@@@@@@@@@@@@@@...@@..TTT.T.T.TT.T..T..TTTT.TT.....TT.T.@@@@@@@@@@@@@@@@@
@@@@@@@@@@@@@@@@@@@@@.....@T.TT.TT...T..T...T...T....TT.T....T..@@@@@@@@@@@@@@@@
@@@@@@@@@@@@@@@@@@@@@.T..T.T.T.TT...T.T.TTTTT.TT.T.TT.TTT..T@@@@@@@@@@@@@@@@@@@@
@@@@@@@@@@@@@@@@@@@@@TT.....T.TT....T...TT..T...TTT.T.TT.TT@@@@@@@@@@@@@@@@@@@@@
@@@@@@@@@@@@@@@@@@@@@@T.....TT...TTTT...TTT.....TTTT..T.T.@@@@@@@@@@@@@@@@@@@@@@
@@@@@@@@@@@@@@@@@@@@@@@T.....T..TTTT.T..TT.TTT.TTT.T.T....@@@@@@@@@@@@@@@@@@@@@@
@@@@@@@@@@@@@@@@@@@@@@@........T..T.T.TTTT.T.T.T.T...T.T.@@@@@@@@@@@@@@@@@@@@@@@
@@@@@@@@@@@@@@@@@@@@@@@@.T.....T.TTTT..T.TT..TT..T..TT..T@@@@@@@@@@TT@@@@@@@@@@@
@@@@@@@@@@@@@@@@@@@@@@@@@.TTT.....T..TTT..TTT..TTT...T..T@@@@@@@@@@T.@@@@@@@@@@@
@@@@@@@@@@@@@@@@@@@@@@@@@.T.T..TT...TTT..T.T.T.T...TT.T.T.@@@@@@@@@...@@@@@@@@@@
@@@@@@@@@@@@@@@@@@@@@@@@@.T..TTT.TT.TTT..TTT....T..TTTT.T..@@@@@@@....@@@@@@@@@@
@@@@@@@@@@@@@@@@@@@@@@@@@T..TT..T.TT..T.TTT.T.......T...TT...@@@...TTT@@@@@@@@@@
@@@@@@@@@@@@@@@@@@@@@@@@T...T.TT...T......T.T...T.T.TT...T.T.T..T.T.TT@@@@@@@@@@
@@@@@@@@@@@@@@@@@@@@@@@.TT..T...T.TT....TTTT.T..TTT.TTTTTTT..T......TT@@@@@@@@@@
@@@@@@@@@@@@@@@@@@@@@....T...T.T.TTTT..T..TT....T..T...T..T...T.......@@@@@@@@@@
@@@@@@@@@@@@@@@@@@@@.T.T...T..T.T..T......T.T.T.......T@@@@T.T..TT.TT@@@@@@@@@@@
@@@@@@@@@@@@@@@@@@@@T....T....TT..TT..T.T..T.TTT...T..@@@@@@TT.......@@@@@@@@@@@
@@@@@@@@@@@@@@@@@@@T.T.T....TT..T..T..TTT.TT..T.......@@@@@@.T.T...T.@@@@@@@@@@@
@@@@@@@@@@@@@@@.@@..TT.T.T.T..T.....T.TTT....T.T.T.T..@@@@@@T..T.TTT@@@@@@@@@@@@
@@@@@@@@@@@@@@@T@@TT....T.....TTTT.T.TT.TT.T..TTTT..T.@@@@@@.TT..T.T@@@@@@@@@@@@
@@@@@@@@@@@@@@@T@@T.....TTT.T.TT.T....T.T..T.......T.T.@@@@@...T...@@@@@@@@@@@@@
@@@@@@@@@@@@@@.T.@....T...TTT.....TT.TT.....T...T.T...T.....T.TT...@@@@@@@@@@@@@
@@@@@@@@@@@@@T.....T....T.........TTTTT..TTT@@@@.....T..T.TT..T..T@@@@@@@@@@@@@@
@@@@@@@@@@@@@T..T.T.T...T.....TT..T...T..T.@@@@@@.....T...T...TT.@@@@@@@@@@@@@@@
@@@@@@@@@@@@@.T..TTT.TTT..T...TTT.TTTTT...@@@@@@@@T.TTT..T.TT...@@@@@@@@@@@@@@@@
@@@@@@@@@@@@@@T...T...TTT.T.T..TT.TT.T...T@@@@@@@@TT.....TT....@@@@@@@@@@@@@@@@@
@@@@@@@@@@@@@@....T......T.T....T.TTT.TTT.@@@@@@@@..T...T.TT..@@@@@@@@@@@@@@@@@@
@@@@@@@@@@@@@@.TT..T..T....T.T.T..T....T@@@@@@@@@...TT..TTTTT@@@@@@@@@@@@@@@@@@@
@@@@@@@@@@@@@T.T...T..TT.T..TT.TT.....@@@@@@@@@@......T.T.TT@@@@@@@@@@@@@@@@@@@@
@@@@@@@@@@@@@..T..T.T..TT.T..T.TT.T.T@@@@@@@@@@.T..TT.....@@@@@@@@@@@@@@@@@@@@@@
@@@@@@@@@@@@..T..T.T.T...TT.TTT..TT..@@@@@@@@@.T...TT...@@@@@@@@@@@@@@@@@@@@@@@@
@@@@@@@@@@@@TTT..T.T.........T.T.T..T@@@@@@@T.TT.T.T.T@@@@@@@@@@@@@@@@@@@@@@@@@@
@@@@@@@@@@@@..T.T...T..T..T..TTTTTT...@@@@T.T..TTT.@@@@@@@@@@@@@@@@@@@@@@@@@@@@@
@@@@@@@@@@@@.TT.TTT...T.TTT..TTT.TTT....T.T....T.@@@@@@@@@@@@@@@@@@@@@@@@@@@@@@@
@@@@@@@@@@@@T.......T.TT..T...TT........TTT..T.T@@@@@@@@@@@@@@@@@@@@@@@@@@@@@@@@
@@@@@@@@@@@@.TT....T.T...T..T.T.T...TTT.....TT@@@@@@@@@@@@@@@@@@@@@@@@@@@@@@@@@@
@@@@@@@@@@@@@T.T..TT.......T...T.TT...T.T...T@@@@@@@@@@@@@@@@@@@@@@@@@@@@@@@@@@@
@@@@@@@@@@@@@@T...T..TT.T..TTT..TT.T...T.TTT@@@@@@@@@@@@@@@@@@@@@@@@@@@@@@@@@@@@
@@@@@@@@@@@@@@@..TTT.TTT..........T....T..@@@@@@@@@@@@@@@@@@@@@@@@@@@@@@@@@@@@@@
@@@@@@@@@@@@@@@@@......T.T...T.T...TTT.TT@@@@@@@@@@@@@@@@@@@@@@@@@@@@@@@@@@@@@@@
@@@@@@@@@@@@@@@@@@.T......T............T@@@@@@@@@@@@@@@@@@@@@@@@@@@@@@@@@@@@@@@@
@@@@@@@@@@@@@@@@@@@TT.T...T.TT.TT...T.@@@@@@@@@@@@@@@@@@@@@@@@@@@@@@@@@@@@@@@@@@
@@@@@@@@@@@@@@@@@@@@@@..T.T...TT.....@@@@@@@@@@@@@@@@@@@@@@@@@@@@@@@@@@@@@@@@@@@
@@@@@@@@@@@@@@@@@@@@@@@@@@@@@@@@@@@@@@@@@@@@@@@@@@@@@@@@@@@@@@@@@@@@@@@@@@@@@@@@
