type octile
height 86
width 80
map
@@@@@@@@@@@@@@@@@@@@@@@@@@@@@@@@@@@@@@@@@@@@@@@@@@@@@@@@@@@@@@@@@@@@@@@@@@@@@@@@
@@@@@@@@@@@@@@@@@@@@@@@@@@@@@@@@@@@@@@@@@@@@@@@@@@@@@@@@@@@@@@@@@@@@@@@@@@@@@@@@
@@@@@@@@@@@@@@@@@@@@@@@@@@@@@@@@@@@@@@@@@@@@@@@@@@@@@@@@@@@@@@@@@@@@@@@@@@@@@@@@
@@@@@@@@@@@@@@@@@@@@@@@@@@@@@@@@@@@@@@@@@@@@@@@@@@@@@@@@@@@@@@@@@@@@@@@@@@@@@@@@
@@@@@@@@@@@@@@@@@@@@@@@@@@@@@@@@@@@@@@@@@@@@@@@@@@@@@@@@@@@@@@@@@@@@@@@@@@@@@@@@
@@@@@@@@@@@@@@@@@@@@@@@@@@@@@@@@@@@@@@@@@@@@@@@@@@@@@@@@@@@@@@@@@@@@@@@@@@@@@@@@
@@@@@@@@@@@@@@@@@@@@@@@@@@@@@@@@@@@@@@@@@@@@@@@@@@@@@@@@@@@@@@@@@@@@@@@@@@@@@@@@
@@@@@@@@@@@@@@@@@@@@@@@@@@@@@@@@@@@@@@@@@@@@@@@@@@@@@@@@@@@@@@@@@@@@@@@@@@@@@@@@
@@@@@@@@@@@@@@@@@@@@@@@@@@@@@@@@@@@@@@@@@@@@@@@@@@@@@@@@@@@@@@@@@@@@@@@@@@@@@@@@
@@@@@@@@@@@@@@@@@@@@@@@@@@@@@@@@@@@@@@@@@@@@@@@@@@@@@@@@@@@@@@@@@@@@@@@@@@@@@@@@
@@@@@@@@@@@@@@@@@@@@@@@@@@@@@@@@@@@@@@@@@@@@@@@@@@@@@@@@@@@@@@@@@@@@@@@@@@@@@@@@
@@@@@@@@@@@@@@@@@@@@@@@@@@@@@@@@@@@@@@@@@@@@@@@@@@@@@@@@@@@@@@@@@@@@@@@@@@@@@@@@
@@@@@@@@@@@@@@@@@@@@@@@@@@@@@@@@@@@@@@@@@@@@@@@@@@@@@@@@@@@@@@@@@@@@@@@@@@@@@@@@
@@@@@@@@@@@@@@@@@@@@@@@@@T.@@@@@.T@@@@@@@@@@@@@@@@@@@@@@@@@@@@@@@@@@@@@@@@@@@@@@
@@@@@@@@@@@@@@@@@@@@@@@@TTT@@....T@@@@@@@@@@@@@@@@@@@@@@@@@@@@@@@@@@@@@@@@@@@@@@
@@@@@@@@@@@@@@@@@@@@@@@..TT@@..T....@@@@@@@@@@@@@@@@@@@@@@@@@@@@@@@@@@@@@@@@@@@@
@@@@@@@@@@@@@@@@@@@@@@.T..T@@@TTTTT.@@@@@@@@@@@@@@@@@@@@@@@@@@@@@@@@@@@@@@@@@@@@
@@@@@@@@@@@@@@@@@@@@@@@@@@TTT.....T..TTT@@@@@@@@@@@@@@@@@@@@@@@@@@@@@@@@@@@@@@@@
@@@@@@@@@@@@@@@@@@@@@@@..@T.TT.T....T...@@@@@@@@@@@@@@@@@@@@@@@@@@@@@@@@@@@@@@@@
@@@@@@@@@@@@@@@@@@@@@@@..TT@.T..T..@TT.T.@@@@@@@@@@@@@@@@@@@@@@@@@@@@@@@@@@@@@@@
@@@@@@@@@@@@@@@@@@@@@@.T..@@@.T..T.@@@@T.T@@@@@@@@@@@@@@@@@@@@@@@@@@@@@@@@@@@@@@
@@@@@@@@@@@@@@@@@@@@@.TTT..TTT.TTT..@@@@T..@@@@@@@@@@@@@@@@@@@@@@@@@@@@@@@@@@@@@
@@@@@@@@@@@@@@@@@@@@...TT@@@T.T.TT.T@@@@@T.T@@@@@@@@@@@@@@@@@@@@@@@@@@@@@@@@@@@@
@@@@@@@@@@@@@@@@@@@.......@....T.T.T.@@@@@T...@@@@@@@@@@@@@@@@@@@@@@@@@@@@@@@@@@
@@@@@@@@@@@@@@@@@@T.T.TT.@@@T.T.T.....@@@@@T.TTT@@@@@@@@@@@@@@@@@@@@@@@@@@@@@@@@
@@@@@@@@@@@@@.@@@TTT.@@..T@..T....T..T..@@@@T....@@@@@@@@@@@@@@@@@@@@@@@@@@@@@@@
@@@@@@@@@@@@...TTTT.T..T..TT...T@@T.....@@@@@.T.T@@@@@@@@@@@@@@@@@@@@@@@@@@@@@@@
@@@@@@@@@@@T......TT...T..TT.TT@@@@.TTTTT@@@@..T..@@@@@@@@@@@@@@@@@@@@@@@@@@@@@@
@@@@@@@@@@.T.......T......T..T@@@@@@T...T.@T.TTT@@@@@@@@@@@@@@@@@@@@@@@@@@@@@@@@
@@@@@@@@@@@@...T@@.@.T.T.TT.T@@@@@@@T.T.TTT...T.@@@@@@@@@@@@@@@@@@@@@@@@@@@@@@@@
@@@@@@@@@@@@@..T@@@@.T.....T@@@@@@@TTTT.TT.T..T..@@@@@@@@@@@@@@@@@@@@@@@@@@@@@@@
@@@@@@@@@@@@.T.TT.T..T.....@@@@@@@..T..T.T.T...TTT@@@@@@@@@@@@@@@@@@@@@@@@@@@@@@
@@@@@@@@@@@@TTT.TT.TT.....@@@@@@@@@T..T....TT....@@@@@@@@@@@@@@@@@@@@@@@@@@@@@@@
@@@@@@@@@@@...T.........T@@@@@@@@@@....T..TTT...@@@@@@@@@@@@@@@@@@@@@@@@@@@@@@@@
@@@@@@@@@@.....T.T.....T@@@@@@@@@@.T.T...TT.T....@@@@@@@@@@@@@@@@@@@@@@@@@@@@@@@
@@@@@@@@@@.TT....@T....@@@@@@@@@@..T.T.@.T...T...@@@@@@@@@@@@@@@@@@@@@@@@@@@@@@@
@@@@@@@@@T.TTTT.@@.....@@@@@@@@TT..T.T@@@.T.@@...@@@@@@@@@@@@@@@@@@@@@@@@@@@@@@@
@@@@@@@@@.T..T.@@...TT..@@@@@@@.....T@@@@@@@@@@T..@@@@@@@@@@@@@@@@@@@@@@@@@@@@@@
@@@@@@@@......@@@...TTTTTT@@@@TT..TTT@@@@@@@@@@T.T@@@@@@@@@@@@@@@@@@@@@@@@@@@@@@
@@@@@@@@TTTTT@@@.T.....TTT.TTT..T....@@@@@@@@@@@TT@@@@@T@@@@@@@@@@@@@@@@@@@@@@@@
@@@@@@@@T..T@@@.T.T.T.@T.TT.T.T...T..@@@@@@@@@@@TTT@.T@T.@@@@@@@@@@@@@@@@@@@@@@@
@@@@@@@@...@@@@....TT@@T..TTT.T..T.T.@@@@@@@@@@@@.T@@.@TTT@@@@@@@@@@@@@@@@@@@@@@
@@@@@@@@@T@@@.TT..T..@@.TT.T....T@@@@@@@@@@@@@@@@.TT@TT.T...@@@@@@@@@@@@@@@@@@@@
@@@@@@@@@@@@..TT.T..@@@@...T.T.TT@@@@@@@@@@@@@@@@...@@TT..TTT@@@@@@@@@@@@@@@@@@@
@@@@@@@@@@@...T.T..@@@@@......TTT@@@@@@@@@@@@@@.@@...@.T.TT...@@@@@@@@@@@@@@@@@@
@@@@@@@@@@@@..T..T@@@.T....T...TT@@@@@@@@@@@@@TT.@...@.T@@T..T@@@@@@@@@@@@@@@@@@
@@@@@@@@@@@@@.T..@@@TTT.TT..TT...@@@@@@@@@@@T..TT@@.T...@@....@@@@@@@@@@@@@@@@@@
@@@@@@@@@@@@@@.T@@@@....T.TTT.T.@@@@@@@@@@@..T@@T@@.T.TT..T..@@@@.@@@@@@@@@@@@@@
@@@@@@@@@@@@@@@@@@@....TT..T.TT.@@@@@@@@@@T..@@@TT@@TTT....@@@...T.@@@@@@@@@@@@@
@@@@@@@@@@@@@@@@@@.TT.T.TT.@.T.T.@@@@@@@@.T..@@@@.@@..T.T.@@....TT..@@@@@@@@@@@@
@@@@@@@@@@@@@@@@@.TTTT....@@@@@..@@@@@@@TT.T.T@@@.@TTTTT...T.TT.....@@@@@@@@@@@@
@@@@@@@@@@@@@@@@@@TT.T..TT@@@@@...@@@@@.....TT.@@..TTTTT.T.T.TT.TTT@@@@@@@@@@@@@
@@@@@@@@@@@@@@@@@@@TT.T.T.@@@@@@..@@@@TT.TT.TT@@@@@.....T.TTTTT@..@@@@@@@@@@@@@@
@@@@@@@@@@@@@@@@@@@@T.T.T@@@@@@@TT.@TTT.TT...@@@@@@.TT.TT.T..TT@T@@@@@@@@@@@@@@@
@@@@@@@@@@@@@@@@@@@@@TT.@@@@@@@@@.T@@..T@@T.@@@@@@@.T..T.T.TT.T@@@@@@@@@@@@@@@@@
@@@@@@@@@@@@@@@@@@@@@@.@@@@@@@@@@T.T@.T@@@@@@@@@@TT.TT........T@@T@@@@@@@@@@@@@@
@@@@@@@@@@@@@@@@@@@@@@@@@@@@@@@@@@TT@@.@@@@@@@@@@TTTT.T.T.....T..T.@@@@@T@@@@@@@
@@@@@@@@@@@@@@@@@@@@@@@@@@@@@@@@@@.TT@TT@@@@@@T......TT.TTTTT......T@@@..T@@@@@@
@@@@@@@@@@@@@@@@@@@@@@@@@@@@@@@@@@@..@@T...@...T...TT.@@TTTT.....T.TTTT.TTT@@@@@
@@@@@@@@@@@@@@@@@@@@@@@@@@@@@@@.T@@...@.TTT..T..T.T..@@@@.T..T...TTT...TTTT.@@@@
@@@@@@@@@@@@@@@@@@@@@@@@@@@@@@T.T.@@TTT..T.T....T..T@@@@@@@..TTTTTTTTTTT...T@@@@
@@@@@@@@@@@@@@@@@@@@@@@@@@@@...TT@@@...T.T..TT..T..T@@@@@@@TTT..TT......TT.@@@@@
@@@@@@@@@@@@@@@@@@@@@@@@@@@T.....@@@@......@@TT..TT.T@@@@@@TTT..T.TT..T.T.@@@@@@
@@@@@@@@@@@@@@@@@@@@@@@@@@T.T..T.T@..TTT.@@@@@TT..TT..@@@T@TT.T....TTTTT.@@@@@@@
@@@@@@@@@@@@@@@@@@@@@@@@@@@.T..TT....TT..@@@@@@T..T..T@@@T@TT.T.TTT.T..T@@@@@@@@
@@@@@@@@@@@@@@@@@@@@@@@@@@@@.T...T.TT...TT@@@@@@T.T..T..T...TTT....TT..@@@@@@@@@
@@@@@@@@@@@@@@@@@@@@@@@@@@@@@.......T..TTT.@@@@@@..TT....T.T.TT...T...@@@@@@@@@@
@@@@@@@@@@@@@@@@@@@@@@@@@@@@@@T..TT..T.TT...@@@@@@.T.T..T.....TT.TT..@@@@@@@@@@@
@@@@@@@@@@@@@@@@@@@@@@@@@@@@@@@............TTT@@@@@T@@.T.T....T..TT.@@@@@@@@@@@@
@@@@@@@@@@@@@@@@@@@@@@@@@@@@@@@@.TTT.T.T..T.T.@@@@@@@@T..T.TT.T.T.T@@@@@@@@@@@@@
@@@@@@@@@@@@@@@@@@@@@@@@@@@@@@@@@..T..T.T.T.....@@@@@@.T.T.T.....T@@@@@@@@@@@@@@
@@@@@@@@@@@@@@@@@@@@@@@@@@@@@@@@@@T.TT@...T.......@@@...TT...TT.T@@@@@@@@@@@@@@@
@@@@@@@@@@@@@@@@@@@@@@@@@@@@@@@@@@@T.@@.TT...TT.T.T@..T..TTT....@@@@@@@@@@@@@@@@
@@@@@@@@@@@@@@@@@@@@@@@@@@@@@@@@@@@@.@@@@.TT.T..T....TT..TT....@@@@@@@@@@@@@@@@@
@@@@@@@@@@@@@@@@@@@@@@@@@@@@@@@@@@@@@@@@@...T....T...T.TTT..TT@@@@@@@@@@@@@@@@@@
@@@@@@@@@@@@@@@@@@@@@@@@@@@@@@@@@@@@@@@@@@T.T..TT.....T....T.@@@@@@@@@@@@@@@@@@@
@@@@@@@@@@@@@@@@@@@@@@@@@@@@@@@@@@@@@@@@@@@T.T....T.T...T...@@@@@@@@@@@@@@@@@@@@
@@@@@@@@@@@@@@@@@@@@@@@@@@@@@@@@@@@@@@@@@@@@....@...T.T.TTT@@@@@@@@@@@@@@@@@@@@@
@@@@@@@@@@@@@@@@@@@@@@@@@@@@@@@@@@@@@@@@@@@..T.@@TTTT..T.T@@@@@@@@@@@@@@@@@@@@@@
@@@@@@@@@@@@@@@@@@@@@@@@@@@@@@@@@@@@@@@@@@@....@@.T.TTT.T@@@@@@@@@@@@@@@@@@@@@@@
@@@@@@@@@@@@@@@@@@@@@@@@@@@@@@@@@@@@@@@@@@@....@TTT...TT@@@@@@@@@@@@@@@@@@@@@@@@
@@@@@@@@@@@@@@@@@@@@@@@@@@@@@@@@@@@@@@@@@@@@...T....T..@@@@@@@@@@@@@@@@@@@@@@@@@
@@@@@@@@@@@@@@@@@@@@@@@@@@@@@@@@@@@@@@@@@@@@@.T...T...@@@@@@@@@@@@@@@@@@@@@@@@@@
@@@@@@@@@@@@@@@@@@@@@@@@@@@@@@@@@@@@@@@@@@@@@@..T....@@@@@@@@@@@@@@@@@@@@@@@@@@@
@@@@@@@@@@@@@@@@@@@@@@@@@@@@@@@@@@@@@@@@@@@@@@@T..T.@@@@@@@@@@@@@@@@@@@@@@@@@@@@
@@@@@@@@@@@@@@@@@@@@@@@@@@@@@@@@@@@@@@@@@@@@@@@@@@@@@@@@@@@@@@@@@@@@@@@@@@@@@@@@
