type octile
height 91
width 104
map
@@@@@@@@@@@@@@@@@@@@@@@@@@@@@@@@@@@@@@@@@@@@@@@@@@@@@@@@@@@@@@@@@@@@@@@@@@@@@@@@@@@@@@@@@@@@@@@@@@@@@@@@
@@@@@@@@@@@@@@@@@@@@@@@@@@@@@@@@@@@@@@@@@@@@@@@@@@@@@@@@@@@@@@@@@@@@@@@@@@@@@@@@@@@@@@@@@@@@@@@@@@@@@@@@
@@@@@@@@@@@@@@@@@@@@@@@@@@@@@@@@@@@@@@@@@@@@@@@@@@@@@@@@@@@@@@@@@@@@@@@@@@@@@@@@@@@@@@@@@@@@@@@@@@@@@@@@
@@@@@@@@@@@@@@@@@@@@@@@@@@@@@@@@@@@@@@@@@@@@@@@@@@@@@@@@@@@@@@@@@@@@@@@@@@@@@@@@@@@@@@@@@@@@@@@@@@@@@@@@
@@@@@@@@@@@@@@@@@@@@@@@@@@@@@@@@@@@@@@@@@@@@@@@@@@@@@@@@@@@@@@@@@@@@@@@@@@@@@@@@@@@@@@@@@@@@@@@@@@@@@@@@
@@@@@@@@@@@@@@@@@@@@@@@@@@@@@@@@@@@@@@@@@@@@@@@@@@@@@@@@@@@@@@@@@@@@@@@@@@@@@@@@@@@@@@@@@@@@@@@@@@@@@@@@
@@@@@@@@@@@@@@@@@@@@@@@@@@@@@@@@@@@@@@@@@@@@@@@@@@@@@@@@@@@@@@@@@@@@@@@@@@@@@@@@@@@@@@@@@@@@@@@@@@@@@@@@
@@@@@@@@@@@@@@@@@@@@@@@@@@@@@@@@@@@@@@@@@@@@@@@@@@@@@@@@@@@@@@@@@@@@@@@@@@@@@@@@@@@@@@@@@@@@@@@@@@@@@@@@
@@@@@@@@@@@@@@@@@@@@@@@@@@@@@@@@@@@@@@@@@@@@@@@@@@@@@@@@@@@@@@@@@@@@@@@@@@@@@@@@@@@@@@@@@@@@@@@@@@@@@@@@
@@@@@@@@@@@@@@@@@@@@@@@@@@@@@@@@@@@@@@@@@@@@@@@@@@@@@@@@@@@@@@@@@@@@@@@@@@@@@@@@@@@@@@@@@@@@@@@@@@@@@@@@
@@@@@@@@@@@@@@@@@@@@@@@@@@@@@@@@@@@@@@@@@@@@@@@@@@@@@@@@@@@@@@@@@@@@@@@@@@@@@@@@@@@@@@@@@@@@@@@@@@@@@@@@
@@@@@@@@@@@@@@@@@@@@@@@@@@@@@@@@@@@@@@@@@@@@@@@@@@@@@@@@@@@@@@@@@@@@@@@@@@@@@@@@@@@@@@@@@@@@@@@@@@@@@@@@
@@@@@@@@@@@@@@@@@@@@@@@@@@@@@@@@@@@@@@@@@@@@@@@@@@@@@@@@@@@@@@@@@@@@@@@@@@@@@@@@@@@@@@@@@@@@@@@@@@@@@@@@
@@@@@@@@@@@@@@@@@@@@@@@@@@@@@@@@@@@@@@@@@@@@@@@@@@@@@@@@@@@@@@@@@@@@@@@@@@@@@@@@@@@@@@@@@@@@@@@@@@@@@@@@
@@@@@@@@@@@@@@@@@@@@@@@@@@@@@@@@@@@@@@@@@@@@@@@@@@@@@@@@@@@@@@@@@@@@@@@@@@@@@@@@@@@@@@@@@@@@@@@@@@@@@@@@
@@@@@@@@@@@@@@@@@@@@@@@@@@@@@@@@@@@@@@@@@@@@@@@@@@@@@@@@@@@@@@@@@@@@@@@@@@@@@@@@@@@@@@@@@@@@@@@@@@@@@@@@
@@@@@@@@@@@@@@@@@@@@@@@@@@@@@@@@@@@@@@@@@@@@@@@@@@@@@@@@@@@@@@@@@@@@@@@@@@@@@@@@@@@@@@@@@@@@@@@@@@@@@@@@
@@@@@@@@@@@@@@@@@@@@@@@@@@@@@@@@@@@@@@@@@@@@@@@@@@@@@@@@@@@@@@@@@@@@@@@@@@@@@@@@@@@@@@@@@@@@@@@@@@@@@@@@
@@@@@@@@@@@@@@@@@@@@@@@@@@@@@@@@@@@@@@@@@@@@@@@@@@@@@@@@@@@@@@@@@@@@@@@@@@@@@@@@@@@@@@@@@@@@@@@@@@@@@@@@
@@@@@@@@@@@@@@@@@@@@@@@@@@@@@@@@@@@@@@@@@@@@@@@@@@@@@@@@@@@@@@@@@@@@@@@@@@@@@@@@@@@@@@@@@@@@@@@@@@@@@@@@
@@@@@@@@@@@@@@@@@@@@@@@@@@@@@@@@@@@@@@@@@@@@@@@@@@@@@@@@@@@@@@@@@@@@@@@@@@@@@@@@@@@@@@@@@@@@@@@@@@@@@@@@
@@@@@@@@@@@@@@@@@@@@@@@@@@@@@@@@@@@@@@@@@@@@@@@@@@@@@@@@@@@@@@@@@@@@@@@@@@@@@@@@@@@@@@@@@@@@@@@@@@@@@@@@
@@@@@@@@@@@@@@@@@@@@@@@@@@@@@@@@@@@@@.@@@@@@@@@@@@@@@@@@@@@@@@@@@@@@@@@@@@@@@@@@@@@@@@@@@@@@@@@@@@@@@@@@
@@@@@@@@@@@@@@@@@@@@@@@@@@@@@@@@@..@...@@@@@@@@@@@@@@@@@@@@@@@@@@@@@@@@@@@@@@@@@@@@@@@@@@@@@@@@@@@@@@@@@
@@@@@@@@@@@@@@@@@@@@@@@@@@@@@@@@........@@@@@@@@@@@@@@@@@@@@@@@@@@@@@@@@@@@@@@@@@@@@@@@@@@@@@@@@@@@@@@@@
@@@@@@@@@@@@@@@@@@@@@@@@@@@@@@@..T.......@@@@@@@@@@@@@@@@@@@@@@@@@@@@@@@@@@@@@@@@@@@@@@@@@@@@@@@@@@@@@@@
@@@@@@@@@@@@T@@@@@@@@@@@@@@@@@............@@@@@@@@@@@@@@@@@@@@@@@@@@@@@@@@@@@@@@@@@@@..T@@@@@@@@@@@@@@@@
@@@@@@@@@@@..@@@@@@@@@@@@@@@@@@............@.@@@@@@@@@@@@@@@@@@@@@@@@@@@@@@@@@@@@..@@.T.@@@@@@@@@@@@@@@@
@@@@@@@@@@....@@@@@@@@@@@@@@.@@@.............@@@@@@@@@@@@@@@@@@@@@@@@@@@@@@@@@@@....@..@@@@@@@@@@@@@@@@@
@@@@@@@@@......@@@@@@@@@@@@T..T@@..T.........@@@@@@@@@@@@@@@@@@@@@@@@@@@@@@@@@.........@@@@@@@@@@@@@@@@@
@@@@@@@@@@.....@@@@@@@@@@.......@@............@@@@@@@@@@@@@@@@@@@@@@@@@@@@@@@.....T....@@@@@@@@@@@@@@@@@
@@@@@@@@@@......@@@@@@@@.........@@............@@@@@@@@@@@@@@@@@@@@@@@@@@@@@...........@@@@@@@@@@@@@@@@@
@@@@@@@@@@@..T..@@@@@@@@@.T.......@@............@@@@@@@@@@@@@@@@@@@@@@@@@@@@@.....T..@@@@@@@@@@@@@@@@@@@
@@@@@@@@@@@@....@@@@@@..@@.........@...........@@..@@@@@@@@@@@@@@@@@@@@@@@@@@@@.....@@@@@@@@@@@@@@@@@@@@
@@@@@@@@@@@@.....@@@@....@@.T.................@@...@@@@@@@@@@@@@@@@@@@@@@...T.@@..T.@@@@@@@@@@@@@@@@@@@@
@@@@@@@@@@@@@....@@.......@@.................@@..T.@@@@@@@@@@@@@@@@@@.@@.......@@...@@@@@@@@@@@@@@@@@@@@
@@@@@@@@@@@@@@...T@@.......@@.T....T........@@.T...@@@@@@@@@@@@@@@@@@TT.............@@@@@@@@@@@@@@@@@@@@
@@@@@@@@@@@@@@....@@@.......@@.............@@.......@@@@@@@@@@@@@@@@................@@@@@@@@@@@@@@@@@@@@
@@@@@@@@@@@@@@@..T@@@@.......@@....TTT....@@........@@.@@@@@@@@@@@@@..............@@@@@@@@@@@@@@@@@@@@@@
@@@@@@@@@@@@@@@....@@@@.......@.........T@@............@@@@@@@@@@@@@...............@@@@@@@@@@@@@@@@@@@@@
@@@@@@@@@@@@@@@@...@@@@@................@@......T...T..@@@@@@@@@@@@@@...........T...@@@@@@@@@@@@@@@@@@@@
@@@@@@@@@@@@@@@@.T..@@@@@............T..@...............@@@@@@@@@@@@@@............T..@@@@@@@@@@@@@@@@@@@
@@@@@@@@@@@@@T.......@@@@@....T.........@.T.@..........@@@@@@@@@@@@@@@@@..............@@@@@@@@@@@@@@@@@@
@@@@@@@@@@@@....T....@@@@@.............@@..@@@........@@@@@@@@@@@@@@@@@@@.....T.......T@@@@@@@@@@@@@@@@@
@@@@@@@@@@@.....T.....@@@@@...........T@...@@@@......@@@@@@@@@@@@@@@@@@@@@..............@@@@@@@@@@@@@@@@
@@@@@@@@@@...............@@...........@@..T@@@@@....@@@@@@@@@@@@@@@@@@@@@@@@.............@@@@@@@@@@@@@@@
@@@@@@@@@..................T..........@....@@@@@@..@@@@@@@@@@@@@@@@@@@@@@@@@@.............@@@@@@@@@@@@@@
@@@@@@@@.................T...........@@...@@@@@@@@@@@@@@@@.@@@@@@@@@@@@@@@@@@@@........T.T.@@@@@@@@@@@@@
@@@@@@@@......T......................@...@@@@@@@@@@@@@@@@..@@@@@@@.@@@@@@@@@@@@@@...........@@@@@@@@@@@@
@@@@@@@@@............................@...@@@@@@@@@@@@@.@....@@@@@..@@@@@@@@@@@@@.............@@@@@@@@@@@
@@@@@@@@@@...............T..........T...@@@@@@@@@@@@.T.....@@@@@@...@@@@@@@.@@@...T............@@@@@@@@@
@@@@@@@@@@@.............................@@@@@@@@@@@........@@@@@@.....@@@@...@................@@@@@@@@@@
@@@@@@@@@@@@.......T.......TT..........@@@@@@@@@.@@...@@@..............@@@.......T.....T.....@@@@@@@@@@@
@@@@@@@@@@@@@...T.....................@@@@@@@@@.......@@@@.............T.....TT..T@..T......@@@@@@@@@@@@
@@@@@@@@@@@@@@....T...T..............@@@@@@.@@....T..@@@@@.......................@@@......@@@@@@@@@@@@@@
@@@@@@@@@@@@@@@........................@@@T........@@@@@@@............TT........T@@@@....@@@@@@@@@@@@@@@
@@@@@@@@@@@@@@@@...T..............................@@@@@@@..........@..............@@@@..@@@@@@@@@@@@@@@@
@@@@@@@@@@@@@@@@@..........T......@@@...T......T.@@@@@@@..........@@@......T.......@@@@@@@@@@@@@@@@@@@@@
@@@@@@@@@@@@@@@@@@...............@@@@...T........@@.@@....@@....@@@@@@..............@@@@@@@@@@@@@@@@@@@@
@@@@@@@@@@@@@@@@@@@.............@@@@T...........@@@......@@@@...@@@@@@@..............@@@@@@@@@@@@@@@@@@@
@@@@@@@@@@@@@@@@@@@@...........@@@@@@...........@@......@@@@@@....@@@@@..T..........@@@@@@@@@@@@@@@@@@@@
@@@@@@@@@@@@@@@@@@@@@.........@@@@@@@@......T..........@@@@@@@.....@@@@............@@@@@@@@@@@@@@@@@@@@@
@@@@@@@@@@@@@@@@@@@@@@.......@@@@@@@@@................@@@@@@@............T........@@@@@@@@@@@@@@@@@@@@@@
@@@@@@@@@@@@@@@@@@@@@@@..T..@@@@@@@@@@@..............@@@@@@@T.....TT.............@@@@@@@@@@@@@@@@@@@@@@@
@@@@@@@@@@@@@@@@@@@@@@@@...@@@.@@@@@@@@....@..T.....@@@@@@@.T...................@@@@@@@@@@@@@@@@@@@@@@@@
@@@@@@@@@@@@@@@@@@@@@@@@@.@@@.T.@@@.@@@..T@@@.T....@@@@@@@.........T..........T@@@@@@@@@@@@@@@@@@@@@@@@@
@@@@@@@@@@@@@@@@@@@@@@@@@@@@.............@@.......@@@@@@@.....................@@@@@@@@@@@@@@@@@@@@@@@@@@
@@@@@@@@@@@@@@@@@@@@@@@@@@@.............@@T.......@@@@@@...T..........T......@@@@@@@@@@@@@@@@@@@@@@@@@@@
@@@@@@@@@@@@@@@@@@@@@@@@@@@@...........@@..........@@@@.......T.............@@@@@@@@@@@@@@@@@@@@@@@@@@@@
@@@@@@@@@@@@@@@@@@@@@@@@@@@@@.........@@.....@......@@...............T.....@@@@@@@@@@@@@@@@@@@@@@@@@@@@@
@@@@@@@@@@@@@@@@@@@@@@@@@@@@@@@..T...@@.T...@@@.....T....T.....T..........@@@@@@@@@@@@@@@@@@@@@@@@@@@@@@
@@@@@@@@@@@@@@@@@@@@@@@@@@@@@@@@....@@..T..@@..........T.................@@@@@@@@@@@@@@@@@@@@@@@@@@@@@@@
@@@@@@@@@@@@@@@@@@@@@@@@@@@@@@@@@.@@@.....@@.........T..................@@@@@@@@@@@@@@@@@@@@@@@@@@@@@@@@
@@@@@@@@@@@@@@@@@@@@@@@@@@@@@@@@@@@@..TT.@@.............T..............@@@@@@@@@@@@@@@@@@@@@@@@@@@@@@@@@
@@@@@@@@@@@@@@@@@@@@@@@@@@@@@@@@@@@.....@@......@@....................@@@@@@@@@@@@@@@@@@@@@@@@@@@@@@@@@@
@@@@@@@@@@@@@@@@@@@@@@@@@@@@@@@@@@@@...@@.....@@@@@@.............T...@@@@@@@@@@@@@@@@@@@@@@@@@@@@@@@@@@@
@@@@@@@@@@@@@@@@@@@@@@@@@@@@@@@@@@@@@.@@...T.@@@@@@@@.............T.@@@@@@@@@@@@@@@@@@@@@@@@@@@@@@@@@@@@
@@@@@@@@@@@@@@@@@@@@@@@@@@@@@@@@@@@@@@@.......@@@@@@@..............@@@@@@@@@@@@@@@@@@@@@@@@@@@@@@@@@@@@@
@@@@@@@@@@@@@@@@@@@@@@@@@@@@@@@@@@@@@@@.....T.@@@@@@..............@@@@@@@@@@@@@@@@@@@@@@@@@@@@@@@@@@@@@@
@@@@@@@@@@@@@@@@@@@@@@@@@@@@@@@@@@@@@@@@......T@@@@..........T...@@@@@@@@@@@@@@@@@@@@@@@@@@@@@@@@@@@@@@@
@@@@@@@@@@@@@@@@@@@@@@@@@@@@@@@@@@@@@@@@@.......T@....T.........@@@@@@@@@@@@@@@@@@@@@@@@@@@@@@@@@@@@@@@@
@@@@@@@@@@@@@@@@@@@@@@@@@@@@@@@@@@@@@@@@@@.....................@@@@@@@@@@@@@@@@@@@@@@@@@@@@@@@@@@@@@@@@@
@@@@@@@@@@@@@@@@@@@@@@@@@@@@@@@@@@@@@@@@@@@.................T.@@@@@@@@@@@@@@@@@@@@@@@@@@@@@@@@@@@@@@@@@@
@@@@@@@@@@@@@@@@@@@@@@@@@@@@@@@@@@@@@@@@@@@@.........T.......@@@@@@@@@@@@@@@@@@@@@@@@@@@@@@@@@@@@@@@@@@@
@@@@@@@@@@@@@@@@@@@@@@@@@@@@@@@@@@@@@@@@@@@@@......T.......T@@@@@@@@@@@@@@@@@@@@@@@@@@@@@@@@@@@@@@@@@@@@
@@@@@@@@@@@@@@@@@@@@@@@@@@@@@@@@@@@@@@@@@@@@@@.........T..@@@@@@@@@@@@@@@@@@@@@@@@@@@@@@@@@@@@@@@@@@@@@@
@@@@@@@@@@@@@@@@@@@@@@@@@@@@@@@@@@@@@@@@@@@@@@@..........@@@@@@@@@@@@@@@@@@@@@@@@@@@@@@@@@@@@@@@@@@@@@@@
@@@@@@@@@@@@@@@@@@@@@@@@@@@@@@@@@@@@@@@@@@@@@@@@........@@@@@@@@@@@@@@@@@@@@@@@@@@@@@@@@@@@@@@@@@@@@@@@@
@@@@@@@@@@@@@@@@@@@@@@@@@@@@@@@@@@@@@@@@@@@@@@@@@......@@@@@@@@@@@@@@@@@@@@@@@@@@@@@@@@@@@@@@@@@@@@@@@@@
@@@@@@@@@@@@@@@@@@@@@@@@@@@@@@@@@@@@@@@@@@@@@@@@@@@@@@@@@@@@@@@@@@@@@@@@@@@@@@@@@@@@@@@@@@@@@@@@@@@@@@@@
@@@@@@@@@@@@@@@@@@@@@@@@@@@@@@@@@@@@@@@@@@@@@@@@@@@@@@@@@@@@@@@@@@@@@@@@@@@@@@@@@@@@@@@@@@@@@@@@@@@@@@@@
