type octile
height 54
width 56
map
@@@@@@@@@@@@@@@@@@@@@@@@@@@@@@@@@@@@@@@@@@@@@@@@@@@@@@@@
@@@@@@@@@@@@@@@@@@@@@@@@@@@@@@@@@@@@@@@@@@@@@@@@@@@@@@@@
@@@@@@@@@@@@@@@@@@@@@@@@@@@@@@@@@@@@@@@@@@@@@@@@@@@@@@@@
@@@@@@@@@@@@@@@@@@@@@@@@@@@@@@@@@@@@@@@@@@@@@@@@@@@@@@@@
@@@@@@@@@@@@@@@@@@@@@@@@@@@@@@@@@@@@@@@@@@@@@@@@@@@@@@@@
@@@@@@@@@@@@@@@@@@@@@@@@@@@@@@@@@@@@@@@@@@@@@@@@@@@@@@@@
@@@@@@@@@@@@@@@@@@@@@@@@@@@@@@@@@@@@@@@@@@@@@@@@@@@@@@@@
@@@@@@@@@@@@@@@@@@@@@@@@@@@@@@@@@@@@@@@@@@@@@@@@@@@@@@@@
@@@@@@@@@@@@@@@@@@@@@@@@@@@@@@@@@@@@@@@@@@@@@@@@@@@@@@@@
@@@@@@@@@@@@@@@@@@@@@@@@@@@@@@@@@@@@@@@@@@@@@@@@@@@@@@@@
@@@@@@@@@@@@@@@@@@@@@..@@@@@@@@@@@@@@@@@@@@@@@@@@@@@@@@@
@@@@@@@@@@@@@@@@@@@@....@@@@@@@@@@@@@@@@@@@@@@@@@@@@@@@@
@@@@@@@@@@@@@@@@@@@......@@@@@@@@@@@@@@@.@@@@@@@@@@@@@@@
@@@@@@@@@@@@@@@@@@........@@@@@@@@@@@@@..T@@@@@@@@@@@@@@
@@@@@@@@@@@@@@@@@......TT..@@@@@@@@@@@.....@@@@@@@@@@@@@
@@@@@@@@@@@@@@@@....@@......@@@@@@@@@@.....@@@@@@@@@@@@@
@@@@@@@@@@@@@@@.T..@@@.......@@@@@@@@......@@@@@@@@@@@@@
@@@@@@@@@@@@@@..T.@@@@........@@@@@@......T@@@@@@@@@@@@@
@@@@@@@@@@@@@.....@@@..........@@@@........@@@@@@@@@@@@@
@@@@@@@@@@@@.TT....@.T..........@@......@@@@@@@@@@@@@@@@
@@@@@@@@@@.......................T.....@@@@@@@@@@@@@@@@@
@@@@@@@@@..............................@@@@@@@@@@@@@@@@@
@@@@@@@@.................@@@@...........@@....@@@@@@@@@@
@@@@@@@@@................@@@@@.............T.@@@@@@@@@@@
@@@@@@@@@@TT..........T.@@@@@@@.............@@@@@@@@@@@@
@@@@@@@@@@@.............@@@@@@@@...........@@@@@@@@@@@@@
@@@@@@@@@@@@@....@......@@@@@@@@@........@@@@@@@@@@@@@@@
@@@@@@@@@@@@@@@..@@......@@@@@@@@@.T....@@@@@@@@@@@@@@@@
@@@@@@@@@@@@@@@...@@......@@@@@@@@@....@@@@@@@@@@@@@@@@@
@@@@@@@@@@@@@@@@..@@@T..T..@@@@@@@@.....@@@@@@@@@@@@@@@@
@@@@@@@@@@@@@@@@..@@@@......@@@@@@.......@@@@@@@@@@@@@@@
@@@@@@@@@@@@@@@@@.@@@@@......@@@@.........@@@@@@@@@@@@@@
@@@@@@@@@@@@@@@@@@@@@@@@.....@@@........T..@@@@@@@@@@@@@
@@@@@@@@@@@@@@@@@@@@@@@@....................@@@@@@@@@@@@
@@@@@@@@@@@@@@@@@@@@@@@@..................T..@@@@@@@@@@@
@@@@@@@@@@@@@@@.@@@@@@@@......................@@@@@@@@@@
@@@@@@@@@@@@..................................@@@@@@@@@@
@@@@@@@@@@........................T..@......T@@@@@@@@@@@
@@@@@@@@............................@@@.....@@@@@@@@@@@@
@@@@@@@....@@.......................@@@@...@@@@@@@@@@@@@
@@@@@@....@@.......T............T...T@@@@.@@@@@@@@@@@@@@
@@@@@@...................@............@@@@@@@@@@@@@@@@@@
@@@@@@.....T............@@@............@@@@@@@@@@@@@@@@@
@@@@@@.............T...@@@@@...........@@@@@@@@@@@@@@@@@
@@@@@@@............T..@@@@@@@.........@@@@@@@@@@@@@@@@@@
@@@@@@@@.............@@@@@@@@@.......@@@@@@@@@@@@@@@@@@@
@@@@@@@@@..T........@@@@@@@@@@@@....@@@@@@@@@@@@@@@@@@@@
@@@@@@@@@@.........@@@@@@@@@@@@@@.@@@@@@@@@@@@@@@@@@@@@@
@@@@@@@@@@@.......@@@@@@@@@@@@@@@@@@@@@@@@@@@@@@@@@@@@@@
@@@@@@@@@@@@....@@@@@@@@@@@@@@@@@@@@@@@@@@@@@@@@@@@@@@@@
@@@@@@@@@@@@@@.@@@@@@@@@@@@@@@@@@@@@@@@@@@@@@@@@@@@@@@@@
@@@@@@@@@@@@@@@@@@@@@@@@@@@@@@@@@@@@@@@@@@@@@@@@@@@@@@@@
@@@@@@@@@@@@@@@@@@@@@@@@@@@@@@@@@@@@@@@@@@@@@@@@@@@@@@@@
@@@@@@@@@@@@@@@@@@@@@@@@@@@@@@@@@@@@@@@@@@@@@@@@@@@@@@@@
