type octile
height 102
width 92
map
@@@@@@@@@@@@@@@@@@@@@@@@@@@@@@@@@@@@@@@@@@@@@@@@@@@@@@@@@@@@@@@@@@@@@@@@@@@@@@@@@@@@@@@@@@@@
@@@@@@@@@@@@@@@@@@@@@@@@@@@@@@@@@@@@@@@@@@@@@@@@@@@@@@@@@@@@@@@@@@@@@@@@@@@@@@@@@@@@@@@@@@@@
@@@@@@@@@@@@@@@@@@@@@@@@@@@@@@@@@@@@@@@@@@@@@@@@@@@@@@@@@@@@@@@@@@@@@@@@@@@@@@@@@@@@@@@@@@@@
@@@@@@@@@@@@@@@@@@@@@@@@@@@@@@@@@@@@@@@@@@@@@@@@@@@@@@@@@@@@@@@@@@@@@@@@@@@@@@@@@@@@@@@@@@@@
@@@@@@@@@@@@@@@@@@@@@@@@@@@@@@@@@@@@@@@@@@@@@@@@@@@@@@@@@@@@@@@@@@@@@@@@@@@@@@@@@@@@@@@@@@@@
@@@@@@@@@@@@@@@@@@@@@@@@@@@@@@@@@@@@@@@@@@@@@@@@@@@@@@@@@@@@@@@@@@@@@@@@@@@@@@@@@@@@@@@@@@@@
@@@@@@@@@@@@@@@@@@@@@@@@@@@@@@@@@@@@@@@@@@@@@@@@@@@@@@@@@@@@@@@@@@@@@@@@@@@@@@@@@@@@@@@@@@@@
@@@@@@@@@@@@@@@@@@@@@@@@@@@@@@@@@@@@@@@@@@@@@@@@@@@@@@@@@@@@@@@@@@@@@@@@@@@@@@@@@@@@@@@@@@@@
@@@@@@@@@@@@@@@@@@@@@@@@@@@@@@@@@@@@@@@@@@@@@@@@@@@@@@@@@@@@@@@@@@@@@@@@@@@@@@@@@@@@@@@@@@@@
@@@@@@@@@@@@@@@@@@@@@@@@@@@@@@@@@@@@@@@@@@@@@@@@@@@@@@@@@@@@@@@@@@@@@@@@@@@@@@@@@@@@@@@@@@@@
@@@@@@@@@@@@@@@@@@@@@@@@@@@@@@@@@@@@@@@@@@@@@@@@@@@@@@@@@@@@@@@@@@@@@@@@@@@@@@@@@@@@@@@@@@@@
@@@@@@@@@@@@@@@@@@@@@@@@@@@@@@@@@@@@@@@@@@@@@@@@@@@@@@@@@@@@@@@@@@@@@@@@@@@@@@@@@@@@@@@@@@@@
@@@@@@@@@@@@@@@@@@@@@@@@@@@@@@@@@@@@@@@@@@@@@@@@@@@@@@@@@@@@@@@@@@@@@@@@@@@@@@@@@@@@@@@@@@@@
@@@@@@@@@@@@@@@@@@@@@@@@@@@@@@@@@@@@@@@@@@@@@@@@@@@@@@@@@@@@@@@@@@@@@@@@@@@@@@@@@@@@@@@@@@@@
@@@@@@@@@@@@@@@@@@@@@@@@@@@@@@@@@@@@@@@@@@@@@@@@@@@@@@@@@@@@@@@@@@@@@@@@@@@@@@@@@@@@@@@@@@@@
@@@@@@@@@@@@@@@@@@@@@@@@@@@@@@@@@@@@@@@@@@@@@@@@@@@@@@@@@@@@@@@@@@@@@@@@@@@@@@@@@@@@@@@@@@@@
@@@@@@@@@@@@@@@@@@@@@@@@@@@@@@@@@@@@@@@@@@@@@@@@@@@@@@@@@@@@@@@@@@@@@@@@@@@@@@@@@@@@@@@@@@@@
@@@@@@@@@@@@@@@@@@@@@@@@@@@@@@@@@@@@@@@@@@@@@@@@@@@@@@@@@@@@@@@@@@@@@@@@@@@@@@@@@@@@@@@@@@@@
@@@@@@@@@@@@@@@@@@@@@@@@@@@@@@@@@@@@@@@@@@@@@@@@@@@@@@@@@@@@@@@@@@@@@@@@@@@@@@@@@@@@@@@@@@@@
@@@@@@@@@@@@@@@@@@@@@@@@@@@@@@@@@@@@@@...................@@@@@@@@@@@@@@@@@@@@@@@@@@@@@@@@@@@
@@@@@@@@@@@@@@@@@@@@@@@@@@@@@@@@@..T................T......@@@@@@@@@@@@@@@@@@@@@@@@@@@@@@@@@
@@@@@@@@@@@@@@@@@@@@@@@@@@@@@T...............T............T@@@@@@@@@@@@@@@@@@@@@@@@@@@@@@@@@
@@@@@@@@@@@@@@@@@@@@@@@@@@@......TT........................@@@@@@@@@@@@@@@@@@@@@@@@@@@@@@@@@
@@@@@@@@@@@@@@@@@@@@@@@@@..................................@@@@@@@@@@@@@@@@@@@@@@@@@@@@@@@@@
@@@@@@@@@@@@@@@@@@@@@@@.........................T..........@@@@@@@@@@@@@@@@@@@@@@@@@@@@@@@@@
@@@@@@@@@@@@@@@@@@@@@.........T..........T..............T..@@@@@@@@@@@@@@@@@@@@@@@@@@@@@@@@@
@@@@@@@@@@@@@@@@@@@@.................T.T..................T@@@@@@@@@@@@@@@@@@@@@@@@@@@@@@@@@
@@@@@@@@@@@@@@@@@@@.....................TT.................@@@@@@@@@@@@@@@@@@@@@@@@@@@@@@@@@
@@@@@@@@..@@@@@@@...T.T.T.T..............@@.T.....@@.....T.@@@@@@@@@@@@@@@@@@@@@@@@@@@@@@@@@
@@@@@@@@...@@@@@........................@@@@.....@@@@....T.@@@@@@@@@@@@@@@@@@@@@@@@@@@@@@@@@
@@@@@@@....@@@@T................@@.T...................T...@@@@@..@@@@@@@@@@@@@@@@@...@@@@@@
@@@@@@@.....@@............T....@@@@....@@@@@@@@@@@@@@....T.@@@@@...@@@@@@@@@@@@@@@.....@@@@@
@@@@@@..........................@@@@@@@@@@@@@@@@@@@@@@@@@..@@@@@...@@@@@@@@@@@@@@......@@@@@
@@@@@@..................@@......@@@@@@@@@@@@@@@@@@@@@@@@@@@@@@@@....@@@@@@@@@@@@.......@@@@@
@@@@@@..................@@@..@@@@@@@@@@@@@@@@@@@@@@@@@@@@@@@@@@@....@@@@@@@@@@@.T......@@@@@
@@@@@................TT@@@@@@@@@@@@@@@@@@@@@@@@@@@@@@@@@@@@@@@@@T...@@@@@@@@@@.........@@@@@
@@@@@....................@@@@@@@@@@@@@@@@@@@@@@@@@@@@@@@@@@@@@@..T..@@@@@@@@@...........@@@@
@@@@..T.T......T.......@@@@@@@@@@@@@@@@@@@@@@@@@@@@@@@@@@@@@@@......@@@@@@@@............@@@@
@@@@........T.........@@@@@@@@@@@@@@@@@@@@@@@@@@@@@@@@@@@@@@@.......@@@@@@@@...........T@@@@
@@@@.T..T...T....@@@@@@@@@@@@@@@@@@@@@@@@@@@@@@@@@@@@@@@@@@@........@@@@@@@@..T.......T..@@@
@@@@........T....@@@@@@@@@@@@@@@@@@@@@@@@@@@@@@@@@@@@@@@@@@........@@@@@@@@@...........T.@@@
@@@....T.........@@@@@@@@@@@@@@@@@@@@@@@@@@@@@@@@@@@@@@@@@.........@@@@@@@@@.............@@@
@@@..............T.T@@@@@@@@@@@@@@@@@@@@@@@@@@@@@@@@@@@@@@.....T..@@@@@@@@@@..........T..@@@
@@@.........TT.......@@@@@@@@@@@@@@@@@@@@@@@@@@@@@@@@@@@@........@@@@@@@@@...............@@@
@@@....................@@@@@@@@@@@@@@@@@@@@@@@@@@@@@@@@@........@@@@@@@@@@@..............@@@
@@@...........T..........@@@@@@@@@@@@@@@@@@@@@@@@@@@@@@....T....@@@@@@@@@@@@.......T.....@@@
@@@........................@@@@@@@@@@@@@@@@@@@@@@@@@@@.........@@@@@@@@@@@@@@.@@.........@@@
@@@.........@@@@............@@@@@@@@@@@@@@@@@@@@@@@@@.........@@@@@@@@@@@@@@@@@@.........@@@
@@@........@@@@@@.............@@@@@@@@@@@@@@@@@@@@@@@........@@@@@@@@@@@@@@@@@@@@........@@@
@@@T.........@@@@@@...T.........@@@@@@@@@@@@@@@@@@@@.........@@@@@@@@@@@@@@@@@@@@........@@@
@@@..........@@@@@@@............T@@@@@@@@@@@@@@@@@@.........@@@@@@@@@@@@@@@@@@@..........@@@
@@@..........@@@@@@@@@.......T....@@@@@@@@@@@@@@@@.........@@@@@@@@@@@@@@@@@@@@.......T..@@@
@@@.........@@@@@@@@@@@..........T..@@@@@@.........T......@@@@@@@@@@@@@@@@@@@@@@.........@@@
@@@.........@@@@@@@@@@@@@............@@.........T.........@@@@@@@@@@@@@@@@@@@@@@.........@@@
@@@.........@@@@@@@@@@@@@@................T..............@@@@@@@@@@@@@@@@@@@@@@@@........@@@
@@@..T.....@@@@@@@@@@@@@@@@@....T.......................T@@@@@@@@@@@@@@@@@@@@@@@@........@@@
@@@........@@@@@@@@@@@@@@@@@@T..T.......T.T.T.....T......@@@@@@@@@@@@@@@@@@@@@@@@@.......@@@
@@@..T...T.@@@@@@@@@@@@@@@@@@@@............T..............@@@@@@@@@@@@@@@@@@@@@@@@.T.....@@@
@@@........@@@@@@@@@@@@@@@@@@@@@...............T..........@@@@@@@@@@@@@@@@@@@@@@@@.......@@@
@@@....T...@@@@@@@@@@@@@@@@@@@@@@...........@@@@...........@@@@@@@@@@@@@@@@@@@@@@@.......@@@
@@@.........@@@@@@@@@@@@@@@@@@@@@.......T.@@@@@@@@.........@@@@@@@@@@@@@@@@@@@@@@@...TT..@@@
@@@.........@@@@@@@@@@@@@@@@@@@@@........@@@@@@@@@@........@@@@@@@@@@@@@@@@@@@@@@@.......@@@
@@@.........@@@@@@@@@@@@@@@@@@@@@T......@@@@@@@@@@@........@@@@@@@@@@@@@@@@@@@@@@@.......@@@
@@@.........@@@@@@@@@@@@@@@@@@@@@.......@@@@@@@@@@@........@@@@@@@@@@@@@@@@@@@@@@@T..T...@@@
@@@.........@@@@@@@@@@@@@@@@@@@@@.......@@@@@@@@@@@........@@@@@@@@@@@@@@@@@@@@@@@....T..@@@
@@@..........@@@@@@@@@@@@@@@@@@@@.......@@@@@@@@@@@........@@@@@@@@@@@@@@@@@@@@@@@.......@@@
@@@..........@@@@@@@@@@@@@@@@@@@@........@@@@@@@@@@.T......@@@@@@@@@@@@@@@@@@@@@@@.......@@@
@@@T.........@@@@@@@@@@@@@@@@@@@@........@@@@@@@@@.........@@@@@@@@@@@@@@@@@@@@@@........@@@
@@@........T..@@@@@@@@@@@@@@@@@@@@....T...@@@@@@@.......T..@@@@@@@@@@@@@@@@@@@@@@........@@@
@@@............@@@@@@@@@@@@@@@@@@@.........@@@@@.............@@@@@@@@@@@@@@@@@@@@........@@@
@@@............@@@@@@@@@@@@@@@@@@@@.......T......T............@@@@@@@@@@@@@@@@@@@........@@@
@@@.............@@@@@@@@@@@@@@@@@@@..............T..............@@@@@@@@@@@@@@@@.T.......@@@
@@@.............@@@@@@@@@@@@@@@@@@.......T....T...................@@@@@@@@@@@@@..........@@@
@@@..............@@@@@@@@@@@@@@@@@...................@@.............@@@@@@@@@@...........@@@
@@@.T....T......T.@@@@@@@@@@@@@@@@.................@@@@@...........T.@@@@@@@@@T..........@@@
@@@...............@@@@@@@@@@@@@@@.........@@....@@@@@@@@@@.............@@@@@@....T.......@@@
@@@................@@@@@@@@@@@@@.T.......@@@@@@@@@@@@@@@@@@..............@@@T..T.........@@@
@@@.................@@@@@@@@@@@@........@@@@@@@@@@@@@@@@@@@@@...T...........T............@@@
@@@.........T.T.....@@@@@@@@@@@..T..TT.@@@@@@@@@@@@@@@@@@@@@@@..........T................@@@
@@@...T..............@@@@@@@@@.........@@@@@@@@@@@@@@@@@@@@@@@@.....T...........T........@@@
@@@...........T.......@@@@@@@@T.......@@@@@@@@@@@@@@@@@@@@@@@@@@................T........@@@
@@@@..T...............@@@@@@.........@@@@@@@@@@@@@@@@@@@@@@@@@@@@..............T.......TT@@@
@@@@@@..TT......T.......@@..........@@@@@@@@@@@@@@@@@@@@@@@@@@@@@@......................@@@@
@@@@@@....T........................@@@@@@@@@@@@@@@@@@@@@@@@@@@@@@@.....................@@@@@
@@@@@@@T..............T...........@@@@@@@@@@@@@@@@@@@@@@@@@@@@@@@.............T.......@@@@@@
@@@@@@@@@..T.....................@@@@@@@@@@@@@@@@@@@@@@@@@@@@@@@@....................@@@@@@@
@@@@@@@@@@..T.............T.....@@@@@@@@@@@@@@@@@@@@@@@@@@@@@@@@....................@@@@@@@@
@@@@@@@@@@@@......................@@@@@@@@@@@@@@@@@@@@@@@@@@@@@......T............@@@@@@@@@@
@@@@@@@@@@@@@@.....T.....T...T.....@@@@@@@@@@@@@@@@@@@@@@@@T...T.................@@@@@@@@@@@
@@@@@@@@@@@@@@@.............T.........T...@@@@@@@@@@@@@@@......................@@@@@@@@@@@@@
@@@@@@@@@@@@@@@@@@.T...T...........TT.................T................T......@@@@@@@@@@@@@@
@@@@@@@@@@@@@@@@@@@.............T..........................................@@@@@@@@@@@@@@@@@
@@@@@@@@@@@@@@@@@@@@......TTT......................T...........T.......@@@@@@@@@@@@@@@@@@@@@
@@@@@@@@@@@@@@@@@@@@@@....T..........................T.......T......@@@@@@@@@@@@@@@@@@@@@@@@
@@@@@@@@@@@@@@@@@@@@@@@...................T.........T...T..........@@@@@@@@@@@@@@@@@@@@@@@@@
@@@@@@@@@@@@@@@@@@@@@@@@@@@............TT......................@@@@@@@@@@@@@@@@@@@@@@@@@@@@@
@@@@@@@@@@@@@@@@@@@@@@@@@@@@@@.........................T....@@@@@@@@@@@@@@@@@@@@@@@@@@@@@@@@
@@@@@@@@@@@@@@@@@@@@@@@@@@@@@@@@..T..................T....@@@@@@@@@@@@@@@@@@@@@@@@@@@@@@@@@@
@@@@@@@@@@@@@@@@@@@@@@@@@@@@@@@@@@@@...T................@@@@@@@@@@@@@@@@@@@@@@@@@@@@@@@@@@@@
@@@@@@@@@@@@@@@@@@@@@@@@@@@@@@@@@@@@@@@@@@@@@@@@@@@@@@@@@@@@@@@@@@@@@@@@@@@@@@@@@@@@@@@@@@@@
@@@@@@@@@@@@@@@@@@@@@@@@@@@@@@@@@@@@@@@@@@@@@@@@@@@@@@@@@@@@@@@@@@@@@@@@@@@@@@@@@@@@@@@@@@@@
@@@@@@@@@@@@@@@@@@@@@@@@@@@@@@@@@@@@@@@@@@@@@@@@@@@@@@@@@@@@@@@@@@@@@@@@@@@@@@@@@@@@@@@@@@@@
