type octile
height 54
width 60
map
@@@@@@@@@@@@@@@@@@@@@@@@@@@@@@@@@@@@@@@@@@@@@@@@@@@@@@@@@@@@
@@@@@@@@@@@@@@@@@@@@@@@@@@@@@@@@@@@@@@@@@@@@@@@@@@@@@@@@@@@@
@@@@@@@@@@@@@@@@@@@@@@@@@@@@@@@@@@@@@@@@@@@@@@@@@@@@@@@@@@@@
@@@@@@@@@@@@@@@@@@@@@@@@@@@@@@@@@@@@@@@@@@@@@@@@@@@@@@@@@@@@
@@@@@@@@@@@@@@@@@@@@@@@@@@@@@@@@@@@@@@@@@@@@@@@@@@@@@@@@@@@@
@@@@@@@@@@@@@@@@@@@@@@@@@@@@@@@@@@@@@@@@@@@@@@@@@@@@@@@@@@@@
@@@@@@@@@@@@@@@@@@@@@@@@@@@@@@@@@@@@@@@@@@@@@@@@@@@@@@@@@@@@
@@@@@@@@@@@@@@@@@@@@@@@@@@@@@@@@@@@@@@@@@@@@@@@@@@@@@@@@@@@@
@@@@@@@@@@@@@@@@@@@@@@@@@@@@@@@@@@@@@@@@@@@@@@@@@@@@@@@@@@@@
@@@@@@@@@@@@@@@@@@@@@@.................@@@@@@@@@@@@@@@@@@@@@
@@@@@@@@@@@@@@@@@@@.......................@@@@@@@@@@@@@@@@@@
@@@@@@@@@@@@@@@@@T..........T...............@@@@@@@@@@@@@@@@
@@@@@@@@@@@@@@@...............................@@@@@@@@@@@@@@
@@@@@@@@@@@@@...............................T..@@@@@@@@@@@@@
@@@@@@@@@@@@..........T.........................@@@@@@@@@@@@
@@@@@@@@@@@...............@@@@...................@@@@@@@@@@@
@@@@@@@@@@......@@........@@@@@@@.................@@@@@@@@@@
@@@@@@@@@......@@@..T.@......@@@@..................@@@@@@@@@
@@@@@@@@..T...@@@.....@T............................@@@@@@@@
@@@@@@@......@@@..................@@.....@.T...T.....@@@@@@@
@@@@@@......@@@......T...........@@@@....@...........@@@@@@@
@@@@@@..T....@.....................@@@@...............@@@@@@
@@@@@...............................@@@@.........@....@@@@@@
@@@@@............................T...@...T......@@@....@@@@@
@@@@...........T.................T.......@.......@@@....@@@@
@@@@......................@@..T.........@@@@@.....@@@.@.@@@@
@@@@.........T..T........@@@@@@.T......@@@@@@@.....@@@@.@@@@
@@@@.T....TT......T.......@@@@@@...........@@......@@@@@@@@@
@@@@...................TT...@@......................@@@@@@@@
@@@@.......@@.T...T............T....................@@@@@@@@
@@@@........@........................................@@@@@@@
@@@@................T.@@@.............................@@@@@@
@@@@.@@.........@@...@@@@@.....@T.......................@@@@
@@@@@@@@..T....@@@@....@@@@@..@@........................@@@@
@@@@@@@@@......@@@@......@@@.......T...........T@.......@@@@
@@@@.@@@......@@@@@.......@......T..T...........@@.....T@@@@
@@@@..@@........@.@@...............................T....@@@@
@@@@......................T...........@@.......T........@@@@
@@@@.................................@@@.........@@.....@@@@
@@@@.....T...........T...............@@@@.......@@@@.T..@@@@
@@@@@...............................@@@@........@@@@....@@@@
@@@@@................................T.@...T...@@@@@....@@@@
@@@@@@..T..@@..............................T.....@@@@...@@@@
@@@@@@....@@@@....T.....................T..T............@@@@
@@@@@@@..@@@@@@........................................@@@@@
@@@@@@@....@@@@........T.............T.TT.............@@@@@@
@@@@@@@@....@@............TT................@@@@.T....@@@@@@
@@@@@@@@....................................@@@@....T@@@@@@@
@@@@@@@@@.........@..........T.............@@@@@....@@@@@@@@
@@@@@@@@@.........@@.............@@.....T..........@@@@@@@@@
@@@@@@@@@@......................@@@@........T.....@@@@@@@@@@
@@@@@@@@@@@@.......T............@@@@....@@.......@@@@@@@@@@@
@@@@@@@@@@@@@@..................@@@@@......T..T@@@@@@@@@@@@@
@@@@@@@@@@@@@@@@@@@@@@@@@@@@@@@@@@@@@@@@@@@@@@@@@@@@@@@@@@@@
