type octile
height 96
width 100
map
@@@@@@@@@@@@@@@@@@@@@@@@@@@@@@@@@@@@@@@@@@@@@@@@@@@@@@@@@@@@@@@@@@@@@@@@@@@@@@@@@@@@@@@@@@@@@@@@@@@@
@@@@@@@@@@@@@@@@@@@@@@@@@@@@@@@@@@@@@@@@@@@@@@@@@@@@@@@@@@@@@@@@@@@@@@@@@@@@@@@@@@@@@@@@@@@@@@@@@@@@
@@@@@@@@@@@@@@@@@@@@@@@@@@@@@@@@@@@@@@@@@@@@@@@@@@@@@@@@@@@@@@@@@@@@@@@@@@@@@@@@@@@@@@@@@@@@@@@@@@@@
@@@@@@@@@@@@@@@@@@@@@@@@@@@@@@@@@@@@@@@@@@@@@@@@@@@@@@@@@@@@@@@@@@@@@@@@@@@@@@@@@@@@@@@@@@@@@@@@@@@@
@@@@@@@@@@@@@@@@@@@@@@@@@@@@@@@@@@@@@@@@@@@@@@@@@@@@@@@@@@@@@@@@@@@@@@@@@@@@@@@@@@@@@@@@@@@@@@@@@@@@
@@@@@@@@@@@@@@@@@@@@@@@@@@@@@@@@@@@@@@@@@@@@@@@@@@@@@@@@@@@@@@@@@@@@@@@@@@@@@@@@@@@@@@@@@@@@@@@@@@@@
@@@@@@@@@@@@@@@@@@@@@@@@@@@@@@@@@@@@@@@@@@@@@@@@@@@@@@@@@@@@@@@@@@@@@@@@@@@@@@@@@@@@@@@@@@@@@@@@@@@@
@@@@@@@@@@@@@@@@@@@@@@@@@@@@@@@@@@@@@@@@@@@@@@@@@@@@@@@@@@@@@@@@@@@@@@@@@@@@@@@@@@@@@@@@@@@@@@@@@@@@
@@@@@@@@@@@@@@@@@@@@@@@@@@@@@@@@@@@@@@@@@@@@@@@@@@@@@@@@@@@@@@@@@@@@@@@@@@@@@@@@@@@@@@@@@@@@@@@@@@@@
@@@@@@@@@@@@@@@@@@@@@@@@@@@@@@@@@@@@@@@@@@@@@@@@@@@@@@@@@@@@@@@@@@@@@@@@@@@@@@@@@@@@@@@@@@@@@@@@@@@@
@@@@@@@@@@@@@@@@@@@@@@@@@@@@@@@@@@@@@@@@@@@@@@@@@@@@@@@@@@@@@@@@@@@@@@@@@@@@@@@@@@@@@@@@@@@@@@@@@@@@
@@@@@@@@@@@@@@@@@@@@@@@@@@@@@@@@@@@@@@@@@@@@@@@@@@@@@@@@@@@@@@@@@@@@@@@@@@@@@@@@@@@@@@@@@@@@@@@@@@@@
@@@@@@@@@@@@@@@@@@@@@@@@@@@@@@@@@@@@@@@@@@@@@@@@@@@@@@@@@@@@@@@@@@@@@@@@@@@@@@@@@@@@@@@@@@@@@@@@@@@@
@@@@@@@@@@@@@@@@@@@@@@@@@@@@@@@@@@@@@@@@@@@@@@@@@@@@@@TT@@@@@@@@@@@@@@@@@@@@@@@@@@@@@@@@@@@@@@@@@@@@
@@@@@@@@@@@@@@@@@@@@@@@@@@@@@@@@@@@@@@@@@@@@@@@@@@@@.TT.T@@@@@@@@@@@@@@@@@@@@@@@@@@@@@@@@@@@@@@@@@@@
@@@@@@@@@@@@@@@@@@@@@@@@@@@@@@@@@@@@@@@@@@@@@@@@@@@T...T.@@@@@@@@@@@@@@@@@@@@@@@@@@@@@@@@@@@@@@@@@@@
@@@@@@@@@@@@@@@@@@@@@@@@@@@@@@@@@@@@@@@@@@@@@@@@@TT..T.T@@@@@@@@@@@@@@@@@@@@@@@@@@@@@@@@@@@@@@@@@@@@
@@@@@@@@@@@@@@@@@@@@@@@@@@@@@@@@@@@@@@@@@@@@@@@@@T...T@@@@@@@@@@@@@@@@@@@@@@@@@@@@@@@@@@@@@@@@@@@@@@
@@@@@@@@@@@@@@@@@@@@@@@@@@@@@@@@@@@@@@@@@@@@@@@@@@TTTT@@@@@@@@@@@@@@@@@@@@@@@@@@@@@@@@@@@@@@@@@@@@@@
@@@@@@@@@@@@@@@@@@@@@@@@@@@@@@@@@@@@@@@@@@@@@@@@@T.T.T.@@@@@@@@@@@@@@@@@@@@@@@@@@@@@@@@@@@@@@@@@@@@@
@@@@@@@@@@@@@@@@@@@@@@@@@@@@@@@@@@@@@@@@@@@@@@@@@T.TT.TT@@@@@@@@@@@@@@@@@@@@@@@@@@@@@@@@@@@@@@@@@@@@
@@@@@@@@@@@@@@@@@@@@@@@@@@@@@@@@@@@@@@@@@@@@@@@@.......T@@@@@T..@@@@@@@@@@@@@@@@@@@@@@@@@@@@@@@@@@@@
@@@@@@@@@@@@@@@@@@@@@@@@@@@@@@@@@@@@@@@@@@@@@@@TT.@T.TT@@@@..TTTT@@@@@@@@@@@@@@@@@@@@@@@@@@@@@@@@@@@
@@@@@@@@@@@@@@@@@@@@@@@@@@@@@@@@@@@@@@@@@T@@T@TT.T@@@T@@@@..T.T..@@@@@@@@@@@@@@@@@@@@@@@@@@@@@@@@@@@
@@@@@@@@@@@@@@@@@@@@@@@@@@@@@@@@@@@@@@@@TTT.TT.T..@@@@@@@T..T.TT@@@@@@@@@@@@@@@@@@@@@@@@@@@@@@@@@@@@
@@@@@@@@@@@@@@@@@@@@@@@@@@@@@@@@@@@@@@@T....T..T.T.@@@@@T...T.@@@@@@@@@@@@@@@@@@@@@@@@@@@@@@@@@@@@@@
@@@@@@@@@@@@@@@@@@@@@@@@@@@@@@@@@@@@@@TTT...TTT.T..T.@@@@..TT.@@@@@@@@@@@@@@@@@@@@@@@@@@@@@@@@@@@@@@
@@@@@@@@@@@@@@@@@@@@@@@@@@@@@@@@@@@@@....TT..T..TTTTT.@@@@TT.TT@@@@@@@@@@@@@@@@@@@@@@@@@@@@@@@@@@@@@
@@@@@@@@@@@@@@@@@@@@@@@@@@@@@@@@@@@@....TT.T..T.T.T.T.@@@@T.T..T@@@@@@@@@@@@@@@@@@@@@@@@@@@@@@@@@@@@
@@@@@@@@@@@@@@@@@@@@@@@@@@@@@@@@@@@..TTTT..TTTTTT..TTT@@@TTT.TTT.@@@@@@@@@@@@@@@@@@@@@@@@@@@@@@@@@@@
@@@@@@@@@@@@@@@@@@@@@@@@@@@@@@@@@@TT..TT.T.TT..TTT.TT..T...T@T...@@@@@@.@@@@@@@@@@@@@@@@@@@@@@@@@@@@
@@@@@@@@@@@@@@@@@@@@@@@@@@@@@@@@@.T.TTT.T...TT..T.@TT.TTTTT@@@TT@@@@@@@.TT@@@@@@@@@@@@@@@@@@@@@@@@@@
@@@@@@@@@@@@@@@@@@@@@@@@@@@@@@@@TTTTT....TTTT.T..@@@.T.T.T@@@@@@@@@.T.TT.@@@@@@@@@@@@@@@@@@@@@@@@@@@
@@@@@@@@@@@@@@@@@@@@@@@@@@@@@@.TT.TTT.....TT...T@@@@@....TTT@@@@@@T.T.T@@@@@@@@@@@@@@@@@@@@@@@@@@@@@
@@@@@@@@@@@@@@@@@@@@@@@@@@@@@@T....TT@@T....TT.T@@@@@@T.T..T@@@@@.TTTT.@@@@@@@@@@@@@@@@@@@@@@@@@@@@@
@@@@@@@@@@@@@@@@@@@@@@@@@@@@@@T..TT.@@@@TT.TT.TT@@@@@.....TT.@@@@.TT.T.T@@@@@@@@@@@@@@@@@@@@@@@@@@@@
@@@@@@@@@@@@@@@@@@@@@@@@@@@@@@.TT.T@@@@@@TTTT..T.@@@TT.TTT...@@@@@@TTTTT.@@@@@@@@@@@@@@@@@@@@@@@@@@@
@@@@@@@@@@@@@@@@@@@@@@@@@@@@....TT.@@@@@@..T..T...TT....TT...T.@@@@T..T.TT@@@@@@@@@@@@@@@@@@@@@@@@@@
@@@@@@@@@@@@@@@@@@@@@@@@@T@@....T..T@@@@TT.....T.....TT.T@@T.T..@@T.T@T..T@@@@@@.@@@@@@@@@@@@@@@@@@@
@@@@@@@@@@@@@@@@@@@@@@@@TTT........T.@@.T..T.T.TT.T.TT..@@@@TTTTT..T@@@..@@@@@@@TT.@@@@@@@@@@@@@@@@@
@@@@@@@@@@@@@@@@@@@@@@@@TT.TT.........TT..T...T....TT.T@@@@@@T.TT..@@@@@@@@@@@TTT.@@@@@@@@@@@@@@@@@@
@@@@@@@@@@@@@@@@@@@@@@@@.T..TT@....T..T..T.T..TTTT..TTT@@@@@.TT....T@@@@@@@@T.T..@@@@@@@@@@@@@@@@@@@
@@@@@@@@@@@@@@@@@@@@@@@T..TTT@@@TT.T..T....TTT...TT...TT@@@@..T.TT..@@@@@@@.TT..@@@@@@@@@@@@@@@@@@@@
@@@@@@@@@@@@@@@@@@@@..TT.T..@@@@@@.T.TT.TTT.TTTT..T.TT.T@@@TT.TT.T..@@@@@@.TTTT.@@@@@@@@@@@@@@@@@@@@
@@@@@@@@@@@@@@@@@@@@.TTT..T.@@@@@@TTT...TTT...T...T...T.TT..TTT.@T.T@@@@@@@.T.TT@@@@@@@@@@@@@@@@@@@@
@@@@@@@@@@@@@@@@@@@@@...T..@@@@@@TTTTT.TT.T.TT..TTTT.T.TT..TT..@@@T.T...T@@@.T..T@@@@@@@@@@@@@@@@@@@
@@@@@@@@@@@@@@@@@@@@@@..T.TT@@@@.TTT..T.T.T..TT.T..T....TT.TTT@@@@@..T..T.@TTTTTTT@@@@@@@@.@@@@@@@@@
@@@@@@@@@@@@@@@@@@@@@@TTT..T..@@..T.T..TT...T.T.TTT..TTT.T....@@@@@@TTTTT...T@..@@@@@@@@@T.T@@@@@@@@
@@@@@@@@@@@@@@@@@@@@@@.TT.T....T.....T.T...TT.TT...TTT.TT....T@@@@@@T..T..TT@@@@@@@@@TT@T..@@@@@@@@@
@@@@@@@@@@@@@@@@@@@@@@@.TT...TT..T..TT..T.....T..TT.TT..TT.....@@@@...TT.T..T@@@@@@@T.T.T.@@@@@@@@@@
@@@@@@@@@@@@@@@..TTT.@..TTTT.TT.T..TTT.TTTTT......T..TTTTTT.T.TT@@TT..T...T.TT.@@@TTT.TT.@@@@@@@@@@@
@@@@@@@@@@@@@@T.TTT..T......T.TT.T.....TTT.....T..TT.TT...TT..TTT..TT..T@.T...@@@@.T.T.T.@@@@@@@@@@@
@@@@@@@@@@@@@@@...T..TT.TTTT..T.TTT....T.T....T.TTT....T.T....TT...TT.T@@@...@@@T@@TTT.TT.T@@@@@@@@@
@@@@@@@@@@.T@@@T....T.TT.T.@@..T..T...T...TTTT.T.TT....TT..TT..TT...T@@@@@@..TT.T.@@@..T.TTT@@@@@@@@
@@@@@@@@@TT.@@.T@TT..T...T@@@@.T.T.T.T.....T.TTT.....TT...TT..TT...T@@@@@@@.T.T.T.@@@....T..@@@@@@@@
@@@@@@@@TTTT.T.@@@@.TT...@@@@@@T..T.TTTTTTTT.TT..T...TTTT..TT..T...TT@@@@@@..TTT.@@@T.@@T.T@@@@@@@@@
@@@@@@@....TT.T@@@@@....@@@@@@@...T.TT.T....T.TT....T.TT.TTT...TT....T@@@@TTT..T.TTTTT@@@.@@@@@@@@@@
@@@@@@T.T......T@@@@@..T.@@@@@TTT..TTT.TTT.T.TTT.T..TT...TTT.....TT.T.T.@...TTTTT..T..@@@@@@@@@@@@@@
@@@@TTT...TTTTT.@@@@@@..T.@@@TTT...TT....T.T....T..TTT...TT.T....TTTT...T.T...TTTT.....@@@@@@@@@@@@@
@@@@T.TTT.T.TT.@@@@@@@@.T..@TT.TT..T...T....T...T...TT..T..T.T......T.T.T.T.T....TTT.TT@@@@@@@@@@@@@
@@@@@T.TTTT..T.@@@@@@@@T.T..TT...@@@TTT......T....TTT.TT...TTTT.T.TT.T..T.TTT..TTTTT..@@@@@@@@@@@@@@
@@@@@@TTT.TT..T.@@@@@@@@@TT.T...@@@@@T.TT.TT.T...TT.T...T..TT..TT.TT.TT....T.T.T..T.T@@@@@@@@@@@@@@@
@@@@@@@.TTTT..TT.@@.T@@@@..T..T@@@@@@@TT..T..T..T....T.T.T...T..T..T.TTT....TTT.T..T@@@@@@@@@@@@@@@@
@@@@@@@@T.TTT.T..T.T@@@@@@@T.T..@@@@@@.TTTTTT.TT.TT....TT.T..TTTT.T.T@@.TTT.TTTT...@@@@@@@@@@@@@@@@@
@@@@@@@@@@T.T..T..T@@@@@@@@@.T.T.@@@@TTTTT.T..TT.T.T..T.TT.TT..T..T.@@@@..T.T.T..T@@@@@@@@@@@@@@@@@@
@@@@@@@@@@@T.TT.TT@@@@@@@@@@@T...T@@TT.T..TTTT..T...T.TT..TTTT...TT@@@@@@TTTTT.TT@@@@@@@@@@@@@@@@@@@
@@@@@@@@@@@@TTT..T@@@@@@@@@@@@..TT..TTT..@.T.TTTTT.T..T..T..T....TT@@@@@@T.T..@@@@@@@@@@@@@@@@@@@@@@
@@@@@@@@@@@@@TT.T.@@@@@@@@@@@@@.T.T.TT.T@@@TT.....TT..TT...T.T.T.T@@@@@@T....@@@@@@@@@@@@@@@@@@@@@@@
@@@@@@@@@@@@@@T.TT.@@@@@@@@@@@@@..TTT.T@@@@@T.TTT..T...T..TT.T..T.T@@@@@..T..@@@@@@@@@@@@@@@@@@@@@@@
@@@@@@@@@@@@@@@TT.TT@@@@@@@@@@@@@TTTT.@@@@@@@...T.T.T...T.T.TT.@.T..@@@T.TTT@@@@@@@@@@@@@@@@@@@@@@@@
@@@@@@@@@@@@@@@@T.TTT@@@@@@@@@@@@@TTTT.@@@@@@....T.TT...T.....@@@.T.T@.T.TT@@@@@@@@@@@@@@@@@@@@@@@@@
@@@@@@@@@@@@@@@@@T....@@@@@@@@@@@@@TTTT.@@@@.T.TTT.T....TTT..@@@@@T....TT.@@@@@@@@@@@@@@@@@@@@@@@@@@
@@@@@@@@@@@@@@@@@@TTTT.@@@@@@@@@@@@@T.TTT@@...T.T.T.TT...TTT@@@@@@@T.TT.T@@@@@@@@@@@@@@@@@@@@@@@@@@@
@@@@@@@@@@@@@@@@@@..T.@@@@@@@@@@@@@@@.TT.....T..T...TT...T.@@@@@@@@@.T.T@@@@..@@@@@@@@@@@@@@@@@@@@@@
@@@@@@@@@@@@@@@@@@@TT@@@@@@@@@@@T@@@@@T..T.TT..@@@.T...TT.T@@@@T@@@@@.TTT@@T.T.@@@@@@@@@@@@@@@@@@@@@
@@@@@@@@@@@@@@@@@@@@@@@@@@@@@@@..T@@@@@T...T..@@@@@.TT...T..@@@..@@@@TT@...T..T.@@@@@@@@@@@@@@@@@@@@
@@@@@@@@@@@@@@@@@@@@@@@@@@@@@@TTT..@@@@@..T..T@@@@@@.T.TTTT..@...@@@@@@@....T...T@@@@@@@@@@@@@@@@@@@
@@@@@@@@@@@@@@@@@@@@@@@@@@@@@T...TT.@@@@@...T..@@@@@TT.TT..T@@T.@@@@@@@@TT..@@.T.@@@@@@@@@@@@@@@@@@@
@@@@@@@@@@@@@@@@@@@@@@@@@@@@T.T...T.@@@@@@..TT.T@@@..TT...TT@TTT@@@@@@@T.TT@@@@.@@@@@@@@@@@@@@@@@@@@
@@@@@@@@@@@@@@@@@@@@@@@@@@@@.TTTTTTT.@@@@@@....TT@TT.T.TTTT@@TT@@@@@@@TT.T@@@@@@@@@@@@@@@@@@@@@@@@@@
@@@@@@@@@@@@@@@@@@@@@@@@@@@T.T.TT.TT.T@@@@@@T....T.TT.T.TT.@T.T@@@@@@@TTT@@@@@@@@@@@@@@@@@@@@@@@@@@@
@@@@@@@@@@@@@@@@@@@@@@@@@T.TT@TTTTT..TT@@@@@@.T....T...T..T@..@@@@@@@@@T.@@@@@@@@@@@@@@@@@@@@@@@@@@@
@@@@@@@@@@@@@@@@@@@@@@@@....@@@.TT.T.TT.@@@@@@@.T...T..TTT...T@@@@@@@@@@.@@@@@@@@@@@@@@@@@@@@@@@@@@@
@@@@@@@@@@@@@@@@@@@@@@@T.T...@@@.TT.TTT..@@@@@@@.TTT.T.T..TTTT@@@@@@@@@@@@@@@@@@@@@@@@@@@@@@@@@@@@@@
@@@@@@@@@@@@@@@@@@@@@@TTT.T..T@@@..TTT..T.@@@@@@@.T...T.T.T.T@@@@@@@@@@@@@@@@@@@@@@@@@@@@@@@@@@@@@@@
@@@@@@@@@@@@@@@@@@@@@......TT@@@@@T.....TT.@@@@@@@T.TTTT.TTT@@@@@@@@@@@@@@@@@@@@@@@@@@@@@@@@@@@@@@@@
@@@@@@@@@@@@@@@@@@@@TT......@@@@@@@T...TTT.T@@@@@@TT.@@.TTT@@@@@@@@@@@@@@@@@@@@@@@@@@@@@@@@@@@@@@@@@
@@@@@@@@@@@@@@@@@@@TTTTT...@@@@@@@@@TT...T.TT@@@@..T@@.TTT@@@@@@@@@@@@@@@@@@@@@@@@@@@@@@@@@@@@@@@@@@
@@@@@@@@@@@@@@@@@@@@TT...T@@@@@@@@@@@..TT....T.T.TT@@@..T@@@@@@@@@@@@@@@@@@@@@@@@@@@@@@@@@@@@@@@@@@@
@@@@@@@@@@@@@@@@@@@@@T..T@@@@@@@@@@@@@.T.TTTTTT...@@@@@T@@@@@@@@@@@@@@@@@@@@@@@@@@@@@@@@@@@@@@@@@@@@
@@@@@@@@@@@@@@@@@@@@@@..@@@@@@@@@@@@@@@TTT......T..@@@@@@@@@@@@@@@@@@@@@@@@@@@@@@@@@@@@@@@@@@@@@@@@@
@@@@@@@@@@@@@@@@@@@@@@@@@@@@@@@@@@@@@@@@T...TT......@@@@@@@@@@@@@@@@@@@@@@@@@@@@@@@@@@@@@@@@@@@@@@@@
@@@@@@@@@@@@@@@@@@@@@@@@@@@@@@@@@@@@@@@@@.T...T..TTT@@@@@@@@@@@@@@@@@@@@@@@@@@@@@@@@@@@@@@@@@@@@@@@@
@@@@@@@@@@@@@@@@@@@@@@@@@@@@@@@@@@@@@@@@@@T.T.T..T.@@@@@@@@@@@@@@@@@@@@@@@@@@@@@@@@@@@@@@@@@@@@@@@@@
@@@@@@@@@@@@@@@@@@@@@@@@@@@@@@@@@@@@@@@@@@@TT.T.TT@@@@@@@@@@@@@@@@@@@@@@@@@@@@@@@@@@@@@@@@@@@@@@@@@@
@@@@@@@@@@@@@@@@@@@@@@@@@@@@@@@@@@@@@@@@@@@@@@@@@@@@@@@@@@@@@@@@@@@@@@@@@@@@@@@@@@@@@@@@@@@@@@@@@@@@
