type octile
height 54
width 52
map
@@@@@@@@@@@@@@@@@@@@@@@@@@@@@@@@@@@@@@@@@@@@@@@@@@@@
@@@@@@@@@@@@@@@@@@@@@@@@@@@@@@@@@@@@@@@@@@@@@@@@@@@@
@@@@@@@@@@@@@@@@@@@@@@@@@@@@@@@@@@@@@@@@@@@@@@@@@@@@
@@@@@@@@@@@@@@@@@@@@@@@@@@@@@@@@@@@@@@@@@@@@@@@@@@@@
@@@@@@@@@@@@@@@@@@@@@@@@@@@@@@@@@@@@@@@@@@@@@@@@@@@@
@@@@@@@@@@@@@@@@@@@@@@@@@@@@@@@@@@@@@@@@@@@@@@@@@@@@
@@@@@@@@@@@@@@@@@@@@@@@@@@@@@@@@@@@@@@@@@@@@@@@@@@@@
@@@@@@@@@@@@@@@@@@@@@@@@@@@@@@@@@@@@@@@@@@@@@@@@@@@@
@@@@@@@@@@@@@@@@@@@@@@@@@@@@@@@@@@@@@@@@@@@@@@@@@@@@
@@@@@@@@@@@@@@@@@@@@@@@@@@@@@@@@@@@@@@@@@@@@@@@@@@@@
@@@@@@@@@@@@@@@@@@@@@@@@@@@@@@@@@@@@@@@@@@@@@@@@@@@@
@@@@@@@@@@@@@@@@@@@@@@@@@@@@@@@@@@@@@@@@@@@@@@@@@@@@
@@@@@@@@@@@@@@@@@@@@@@@@@@@@@@@@@@@@@@@@@@@@@@@@@@@@
@@@@@@@@@@@@@@@@@@@@@@@@@@@@@@@@@@@@@@@@@@@@@@@@@@@@
@@@@@@@@@@@@@@@@@@@@@@@@@@@@@@@@@@@@@@@@@@@@@@@@@@@@
@@@@@@@@@@@@@@@@@@@@@@@@@@@@@@@@@@@@@@@@@@@@@@@@@@@@
@@@@@@@@@@@@@@@@@@@@@@@@@@@@T@@@@T.@@@@@@@@@@@@@@@@@
@@@@@@@@@@@@@@@@@@@@@@@@@@@T.T@@TT.TT@@@@@@@@@@@@@@@
@@@@@@@@@@@@@@@@@@@@@@@@@@TT..TT.T....@@@@@@@@@@@@@@
@@@@@@@@@@@@@@@@@@@@@@@@@@T...TTT..TT.T@@@@@@@@@@@@@
@@@@@@@@@@@@@@@@@@@@@@@@@TTT...T@@..T.TT@@@@@@@@@@@@
@@@@@@@@@@@@@@@@@@@@@@@T.TT..T.@@@@@.TT.T@@@@@@@@@@@
@@@@@@@@@@@@@@@@@@@@@@.TT..T.TT@@@@@@@T..T@@@@@@@@@@
@@@@@@@@@@@@@@@@@@@@@T...TTT..T@@@@@@@TT.@@@@@@@@@@@
@@@@@@@@@@@@@@@@@@@@@@.T.TTT..T@@@@TT...@@@@@@@@@@@@
@@@@@@@@@@@@@@@@@@@@@@@T.....T..@.T..TT@@@@@@@@@@@@@
@@@@@@@@@@@@@@@@@@@@@@@@.TT..T..TT.TT..@@@@@@@@@@@@@
@@@@@@@@@@@@@@@@@TT@@@@@@...T......T...@@@@@@@@@@@@@
@@@@@@@@@@@@@@@@.TTT@@@@@.TTTTTT.TTTTT..@@@@@@@@@@@@
@@@@@@@@@@@@@@@TT..TT@@@@T.T.TTT.T..T.TT.@@@@@@@@@@@
@@@@@@@@@@@@@@@@TTTT.@@@TT.TT..T...TT.TTTT@@@@@@@@@@
@@@@@@@@@@@@@@@@@.T..T.TTT.T..TTT.T....TT@@@@@@@@@@@
@@@@@@@@@@@@@@@@@@T.T.TT..TT.T.T..T.T.TT@@@@@@@@@@@@
@@@@@@@@@@@@@@@@@@@T.T.TT..T.T.T.TTTTT.@@@@@@@@@@@@@
@@@@@@@@@@@@.@@@@@@........T.T..T.T...@@@@@@@@@@@@@@
@@@@@@@@.@@T..@@@@@T.TTT....TTT..TTTT@@@@@@@@@@@@@@@
@@@@@@@.T.TTT.T@@@..TTTTTTTTTT..TTTT@@@@@@@@@@@@@@@@
@@@@@@..TTT...TTTT.T.TTT..T.T.T.TT.@@@@@@@@@@@@@@@@@
@@@@@@.TT.T.TT..T...T@@TT.T.TTTT.T@@@@@@@@@@@@@@@@@@
@@@@@@@.TT.......T.T@@@T....TTTT.@@@@@@@@@@@@@@@@@@@
@@@@@@@@.T.TTTTTTT.@@.T...TTT...@@@@@@@@@@@@@@@@@@@@
@@@@@@@@@.TT.TTT..@@.TTTTTTTTTT@@@@@@@@@@@@@@@@@@@@@
@@@@@@@@@@T..T..T@@T...T.TT.TT@@@@@@@@@@@@@@@@@@@@@@
@@@@@@@@@@@T...T@@T.T.TTTT...@@@@@@@@@@@@@@@@@@@@@@@
@@@@@@@@@@@@.TT@@.TT..TTTTT.@@@@@@@@@@@@@@@@@@@@@@@@
@@@@@@@@@@@@@T@@...T..TT..T@@@@@@@@@@@@@@@@@@@@@@@@@
@@@@@@@@@@@@@@@T.TT.....TT@@@@@@@@@@@@@@@@@@@@@@@@@@
@@@@@@@@@@@@@@@.TTTTTTT.T@@@@@@@@@@@@@@@@@@@@@@@@@@@
@@@@@@@@@@@@@@@@..T.TT.T@@@@@@@@@@@@@@@@@@@@@@@@@@@@
@@@@@@@@@@@@@@@@@TTTTTT@@@@@@@@@@@@@@@@@@@@@@@@@@@@@
@@@@@@@@@@@@@@@@@@TT.T@@@@@@@@@@@@@@@@@@@@@@@@@@@@@@
@@@@@@@@@@@@@@@@@@@.T@@@@@@@@@@@@@@@@@@@@@@@@@@@@@@@
@@@@@@@@@@@@@@@@@@@@@@@@@@@@@@@@@@@@@@@@@@@@@@@@@@@@
@@@@@@@@@@@@@@@@@@@@@@@@@@@@@@@@@@@@@@@@@@@@@@@@@@@@
