type octile
height 70
width 64
map
@@@@@@@@@@@@@@@@@@@@@@@@@@@@@@@@@@@@@@@@@@@@@@@@@@@@@@@@@@@@@@@@
@@@@@@@@@@@@@@@@@@@@@@@@@@@@@@@@@@@@@@@@@@@@@@@@@@@@@@@@@@@@@@@@
@@@@@@@@@@@@@@@@@@@@@@@@@@@@@@@@@@@@@@@@@@@@@@@@@@@@@@@@@@@@@@@@
@@@@@@@@@@@@@@@@@@@@@@@@@@@@@@@@@@@@@@@@@@@@@@@@@@@@@@@@@@@@@@@@
@@@@@@@@@@@@@@@@@@@@@@@@@@@@@@@@@@@@@@@@@@@@@@@@@@@@@@@@@@@@@@@@
@@@@@@@@@@@@@@@@@@@@@@@@@@@@@@@@@@@@@@@@@@@@@@@@@@@@@@@@@@@@@@@@
@@@@@@@@@@@@@@@@@@@@@@@@@@@@@@@@@@@@@@@@@@@@@@@@@@@@@@@@@@@@@@@@
@@@@@@@@@@@@@@@@@@@@@@@@@@@@@@@@@@@@@@@@@@@@@@@@@@@@@@@@@@@@@@@@
@@@@@@@@@@@@@@@@@@@@@@@@@@@@@@@@@@@@@@@@@@@@@@@@@@@@@@@@@@@@@@@@
@@@@@@@@@@@@@@@@@@@@@@@@@@@@@@@@@@@@@@@@@@@@@@@@@@@@@@@@@@@@@@@@
@@@@@@@@@@@@@@@@@@@@@@@@@@@@@@@@@@@@@@@@@@@@@@@@@@@@@@@@@@@@@@@@
@@@@@@@@@@@@@@@@@@@@@@@@@@@@@@@@@@@@@@@@@@@@@@@@@@@@@@@@@@@@@@@@
@@@@@@@@@@@@@@@@@@@@@@@@@@@@@@@@@@@@@@@@@@@@@@@@@@@@@@@@@@@@@@@@
@@@@@@@@@@@@@@@@@@@@@@@@@@@@@@@@@@@@@@@@@@@@@@@@@@@@@@@@@@@@@@@@
@@@@@@@@@@@@@@@@@@@@@@@@@@@@@@@@@@@@@@@@@@@@@@@@@@@@@@@@@@@@@@@@
@@@@@@@@@@@@@@@@@@@@@@@@@@@@@@@@@.@@@@@@@@@@@@@@@@@@@@@@@@@@@@@@
@@@@@@@@@@@@@@@@@@@@@@@@@@@@@@@@T..@@@@@@@@@@@@@@@@@@@@@@@@@@@@@
@@@@@@@@@@@@@@@@@@@@@@@@@@@@@@@@@..T@@@@@@T.@@@@@@@@@@@@@@@@@@@@
@@@@@@@@@@@@@@@@@@@@@@@@@@@@@@@@@@..T@@@@T.T.@@@@@@@@@@@@@@@@@@@
@@@@@@@@@@@@@@@@@@@@@@@@@@@@@@@@@@@TT.@@..T.T@@@@@@@@@@@@@@@@@@@
@@@@@@@@@@@@@@@@@@@@@@@@@@@@T@@T.@@@.T.T...TT@@@@@@@@@@@@@@@@@@@
@@@@@@@@@@@@@@@@@@@@@@@@@@@@TT@TT@@@@TTT.T...TTT@@@@@@@@@@@@@@@@
@@@@@@@@@@@@@@@@@@@@@@@@@@@@TTTTTT.TT..T.TT.T.T.T@@@@@@@@@@@@@@@
@@@@@@@@@@@@@@@@@@@@@@@@@@@@@T..T..T......TTTTT..T@@@@@@@@@@@@@@
@@@@@@@@@@@@@@@@@@@@@@@@@@@@@@..TT....TT.T..T.T..T.@@@@@@@@@@@@@
@@@@@@@@@@@@@@@@@@@@@@@@@@@@@@@T.T...TT...T.TTTT.T.@@@@@@@@@@@@@
@@@@@@@@@@@@@@@@@@@@@@@@@@@@@@@@.T..TTTTT..TTT....T@@@@@@@@@@@@@
@@@@@@@@@@@@@@@@@@@@@@@.T@@@@@@T.T...TTTT...TTT.TTTT.T.@@@@@@@@@
@@@@@@@@@@@@@@@@@@@@@@@@T.@@@@T..TT.TTTT..T......T...T..@@@@@@@@
@@@@@@@@@@@@@@@@@@@@@@@@@.T@@.T..T..T...T@T..T..TTT....@@@@@@@@@
@@@@@@@@@@@@@@@@@@@@@@@@@@.TTT..TTT...T.@@@T..TT.TTTTT@@@@@@@@@@
@@@@@@@@@@@@@@@@@@@@@@@@@@@T..T.T.T..TTT@@@T...T..T..@@@@@@@@@@@
@@@@@@@@@@@@@@@@@@@@@@@@@@.TTTT.T.TTTT.T@@@TT..T.TT.@@@@@@@@@@@@
@@@@@@@@@@@@@@@@@T@@@@@@@T.T.TT.TTTTT.T....TT..T..@T.@@@@@@@@@@@
@@@@@@@@@@@@@@@@.T@@@@T@T..T.T.T....T.TTT.TTT...T@@@T.@@@@@@@@@@
@@@@@@@@@@@@T@@.TT.@@@TTT.TT.TT..T.T.T.TTTT..T...@@@@.T@@@@@@@@@
@@@@@@@@@@@..@@TTT.TTT...TTTT..T.TTTT..TT.T.T.TT@@@@@@.T@@@@@@@@
@@@@@@@@@@.TTTTTTT.TTT....T..T.T.TT.TTT..TT.TT.....@@@@T.@@@@@@@
@@@@@@@@@TT.TT.T...TT..TT.TTTT....TT.....T.TTT.T...@@@@@T@@@@@@@
@@@@@@@@TTTT.T.T..TTTT..TT...TTTTT..TT.TT...@....T.@@@@@@@@@@@@@
@@@@@@@..T...@...T..T.T...TT@TTTTTTTT...T..@@@TTTT.T@@@@@@@@@@@@
@@@@@@T.T.T.@@@....T.....T.@@@TTT...TT.TT.@@@@@T..TT.@@@@@@@@@@@
@@@@@.TTT...@@@@T.TTTTT..T.@@@...T.T.TT.T@@@@@@@.T.TT@@@@@@@@@@@
@@@@.T..T....@@@@TTTTT.T..T@@@T...TT..T.T@@@@@@@@...T@@@@@@@@@@@
@@@.T..T.TT.T@@@@@@@.T.....T.T....T..T.T..@@@@@@@@.T@@@@@@@@@@@@
@@@T.T..TT.TT.@@@@@@......T.TT...TTTT.@@.T.@@@@@@@@@@@@@@@@@@@@@
@@@@T.TT@.TTT.@@@@@@..TTTT...T.TTTT..@@@@...@@@@@@@@@@@@@@@@@@@@
@@@@@T.@@@.T.T@@@@.T..TTTT..TTTTTTT@@@@@@@T.T@@@@@@@@@@@@@@@@@@@
@@@@@@T.T@@T.@@@@.T.....T.T.T.T.TT@@@@@@@@@.T@@@@@@@@@@@@@@@@@@@
@@@@@@@..@@@@@@@..TT..T..TTTT.TTT@@@@@@@@@@@@@@@@@@@@@@@@@@@@@@@
@@@@@@@@...@@@@T.T..T......TTTT..@@@@@@@@@@@@@@@@@@@@@@@@@@@@@@@
@@@@@@@@@TT@@@.TT...T.@@..T.TTT.T..@@@@@@@@@@@@@@@@@@@@@@@@@@@@@
@@@@@@@@@@..T.TTT...T.@@@@@@....T..@@@@@@@@@@@@@@@@@@@@@@@@@@@@@
@@@@@@@@@@@T...T...T.T@@@@@@.T...T.T.@@@@@@@@@@@@@@@@@@@@@@@@@@@
@@@@@@@@@@@@..TT.TTTTT@@@@@@TTTTTTTTTT@@@@@@@@@@@@@@@@@@@@@@@@@@
@@@@@@@@@@@@@T.......@@@@@@@......TTTTT@@@@@@@@@@@@@@@@@@@@@@@@@
@@@@@@@@@@@@@@T..TT@@@@@@@@.T.TT.TT.T..@@@@@@@@@@@@@@@@@@@@@@@@@
@@@@@@@@@@@@@@@TT.T@@@T.TT.TTTTT..TTT..@@@@@@@@@@@@@@@@@@@@@@@@@
@@@@@@@@@@@@@@@@..TT.TTTT..T.T....TTT.@@@@@@@@@@@@@@@@@@@@@@@@@@
@@@@@@@@@@@@@@@@@TT.TTT..TTTTT....T.T@@@@@@@@@@@@@@@@@@@@@@@@@@@
@@@@@@@@@@@@@@@@@@.T.TT.....T.TTTT..@@@@@@@@@@@@@@@@@@@@@@@@@@@@
@@@@@@@@@@@@@@@@@@@T....TTT..T.TTTT@@@@@@@@@@@@@@@@@@@@@@@@@@@@@
@@@@@@@@@@@@@@@@@@@@.T..T..TT.T.TT@@@@@@@@@@@@@@@@@@@@@@@@@@@@@@
@@@@@@@@@@@@@@@@@@@@@..TTT.T..TTT@@@@@@@@@@@@@@@@@@@@@@@@@@@@@@@
@@@@@@@@@@@@@@@@@@@@@@TTTTTT..TT@@@@@@@@@@@@@@@@@@@@@@@@@@@@@@@@
@@@@@@@@@@@@@@@@@@@@@@@TT..T..T@@@@@@@@@@@@@@@@@@@@@@@@@@@@@@@@@
@@@@@@@@@@@@@@@@@@@@@@@@.TTT.T@@@@@@@@@@@@@@@@@@@@@@@@@@@@@@@@@@
@@@@@@@@@@@@@@@@@@@@@@@@@T..T@@@@@@@@@@@@@@@@@@@@@@@@@@@@@@@@@@@
@@@@@@@@@@@@@@@@@@@@@@@@@@TT@@@@@@@@@@@@@@@@@@@@@@@@@@@@@@@@@@@@
@@@@@@@@@@@@@@@@@@@@@@@@@@@@@@@@@@@@@@@@@@@@@@@@@@@@@@@@@@@@@@@@
