type octile
height 54
width 52
map
@@@@@@@@@@@@@@@@@@@@@@@@@@@@@@@@@@@@@@@@@@@@@@@@@@@@
@@@@@@@@@@@@@@@@@@@@@@@@@@@@@@@@@@@@@@@@@@@@@@@@@@@@
@@@@@@@@@@@@@@@@@@@@@@@@@@@@@@@@@@@@@@@@@@@@@@@@@@@@
@@@@@@@@@@@@@@@@@@@@@@@@@@@@@@@@@@@@@@@@@@@@@@@@@@@@
@@@@@@@@@@@@@@@@@@@@@@@@@@@@@@@@@@@@@@@@@@@@@@@@@@@@
@@@@@@@@@@@@@@@@@@@@@@@@@@@@@@@@@@@@@@@@@@@@@@@@@@@@
@@@@@@@@@@@@@@@@@@@@@@@@@@@@@@@@@@@@@@@@@@@@@@@@@@@@
@@@@@@@@@@@@@@@@@@@@@@@@@@@@@@@@@@@@@@@@@@@@@@@@@@@@
@@@@@@@@@@@@@@@@@@@@@@@@@@@@@@@@@@@@@@@@@@@@@@@@@@@@
@@@@@@@@@@@@@@@@@@@@@@@@@@@@@@@@@@@@@@@@@@@@@@@@@@@@
@@@@@@@@@@@@@@@@@@@@@@@@@@@@@@@@@@@@@@@@@@@@@@@@@@@@
@@@@@@@@@@@@@@@@@@@@@@@@@@@@@@@.@@@@@@@@@@@@@@@@@@@@
@@@@@@@@@@@@@@@@@@@@@@@@@@@@@@@.T@@@@@@@@@@@@@@@@@@@
@@@@@@@@@@@@@@@@@@@@@@@@@@@@@@@TT.@@@@@@@@@@@@@@@@@@
@@@@@@@@@@@@@@@@@@@@@@@@@@@@@@@@.TT@@@@@@@@@@@@@@@@@
@@@@@@@@@@@@@@@@@@@@@@@@@@@T@@@T.T.@@@@@@@@@@@@@@@@@
@@@@@@@@@@@@@@@@@@@@@@@@@@TTTTTT.T@@@@@@@@@@@@@@@@@@
@@@@@@@@@@@@@@@@@@@@@@@@@T.T.TTTT@@@@@@@@@@@@@@@@@@@
@@@@@@@@@@@@@@@@@@@@@@@@.T.T.T..@@@@@@@@@@@@@@@@@@@@
@@@@@@@@@@@@@@@@@@@@@@@T....T.T@@@@@@@@@@@@@@@@@@@@@
@@@@@@@@@@@@@@@@@@@@@@..T...T.@@@@@@@@T@T@@@@@@@@@@@
@@@@@@@@@@@@@@@@@@@@@@T....TT.@@@@@@@T..T.@@@@@@@@@@
@@@@@@@@@@@@@@@@@@@@@@TTT.TTTTT@@@@@T...TTT@@@@@@@@@
@@@@@@@@@@@@@@@@@@@@T...T.T...T.@@@.....TTTT@@@@@@@@
@@@@@@@@@@@@@@@@@@@..TT.T.T.T..T..TTTTTTT.TT.@@@@@@@
@@@@@@@@@@@@@@@@@@T......TT.TTTT..T.TTTTT.T.T@@@@@@@
@@@@@@@@@@@@@@@@.TT.T.TT@@@TT..TT....TTTTTTT@@@@@@@@
@@@@@@@@@@@@@@@...TT.T..@@@@@TTT...TTT...T.@@@@@@@@@
@@@@@@@@@@@@@@..TT.TTTTT.@@@@@TT.TTT.TTTTT@@@@@@@@@@
@@@@@@@@@@@@@T.TT.T@T..T.T.@@@.TT.TTTTT..@@@@@@@@@@@
@@@@@@@@@@@T.T.TT@@@@T@@@@.@@..TTTTT.TT.@@@@@@@@@@@@
@@@@@@@@@@T..T.T.T@@@@@@@@..T.TT.TT.TTT@@@@@@@@@@@@@
@@@@@@@@@@@@T..TTT@@@@@@@@....TT.T..TT@@@@@@@@@@@@@@
@@@@@@@@@@@@@.T..TT@@@@@@TT.TTT......@@@@@@@@@@@@@@@
@@@@@@@@@@@@@@TT...T@@@@@@T...TT....@@@@@@@@@@@@@@@@
@@@@@@@@@@@@@@.TTT.T.@@@@@TT...TTT.@@@@@@@@@@@@@@@@@
@@@@@@@@@@@@@.TTT.TT.T@@@.T.T.T..T@@@@@@@@@@@@@@@@@@
@@@@@@@.TTT........T...T.TTT....T@@@@@@@@@@@@@@@@@@@
@@@@@@@@T..T...TT.T.TT..TTT.TTT.@@@@@@@@@@@@@@@@@@@@
@@@@@@@@@T.TTT..T...T..T..T....@@@@@@@@@@@@@@@@@@@@@
@@@@@@@@@@.T.T.T.TTT..T..TT.TT@@@@@@@@@@@@@@@@@@@@@@
@@@@@@@@@@@..T.TT....TT....TT@@@@@@@@@@@@@@@@@@@@@@@
@@@@@@@@@@@@TTTTT.T.T.T.TT.T@@@@@@@@@@@@@@@@@@@@@@@@
@@@@@@@@@@@@@....TTTTTTTT..@@@@@@@@@@@@@@@@@@@@@@@@@
@@@@@@@@@@@@@@.TTTTT.TT.T.@@@@@@@@@@@@@@@@@@@@@@@@@@
@@@@@@@@@@@@@@@.T........@@@@@@@@@@@@@@@@@@@@@@@@@@@
@@@@@@@@@@@@@@@@.T..T.TT@@@@@@@@@@@@@@@@@@@@@@@@@@@@
@@@@@@@@@@@@@@@@@.TT..T@@@@@@@@@@@@@@@@@@@@@@@@@@@@@
@@@@@@@@@@@@@@@@@@..TT@@@@@@@@@@@@@@@@@@@@@@@@@@@@@@
@@@@@@@@@@@@@@@@@@@.T@@@@@@@@@@@@@@@@@@@@@@@@@@@@@@@
@@@@@@@@@@@@@@@@@@@@@@@@@@@@@@@@@@@@@@@@@@@@@@@@@@@@
@@@@@@@@@@@@@@@@@@@@@@@@@@@@@@@@@@@@@@@@@@@@@@@@@@@@
@@@@@@@@@@@@@@@@@@@@@@@@@@@@@@@@@@@@@@@@@@@@@@@@@@@@
@@@@@@@@@@@@@@@@@@@@@@@@@@@@@@@@@@@@@@@@@@@@@@@@@@@@
