type octile
height 160
width 160
map
@@@@@@@@@@@@@@@@@@@@@@@@@@@@@@@@@@@@@@@@@@@@@@@@@@@@@@@@@@@@@@@@@@@@@@@@@@@@@@@@@@@@@@@@@@@@@@@@@@@@@@@@@@@@@@@@@@@@@@@@@@@@@@@@@@@@@@@@@@@@@@@@@@@@@@@@@@@@@@@@
@@@@@@@@@@@@@@@@@@@@@@@@@@@@@@@@@@@@@@@@@@@@@@@@@@@@@@@@@@@@@@@@@@@@@@@@@@@@@@@@@@@@@@@@@@@@@@@@@@@@@@@@@@@@@@@@@@@@@@@@@@@@@@@@@@@@@@@@@@@@@@@@@@@@@@@@@@@@@@@@
@@@@@@@@@@@@@@@@@@@@@@@@@@@@@@@@@@@@@@@@@@@@@@@@@@@@@@@@@@@@@@@@@@@@@@@@@@@@@@@@@@@@@@@@@@@@@@@@@@@@@@@@@@@@@@@@@@@@@@@@@@@@@@@@@@@@@@@@@@@@@@@@@@@@@@@@@@@@@@@@
@@@@@@@@@@@@@@@@@@@@@@@@@@@@@@@@@@@@@@@@@@@@@@@@@@@@@@@@@@@@@@@@@@@@@@@@@@@@@@@@@@@@@@@@@@@@@@@@@@@@@@@@@@@@@@@@@@@@@@@@@@@@@@@@@@@@@@@@@@@@@@@@@@@@@@@@@@@@@@@@
@@@@@@@@@@@@@@@@@@@@@@@@@@@@@@@@@@@@@@@@@@@@@@@@@@@@@@@@@@@@@@@@@@@@@@@@@@@@@@@@@@@@@@@@@@@@@@@@@@@@@@@@@@@@@@@@@@@@@@@@@@@@@@@@@@@@@@@@@@@@@@@@@@@@@@@@@@@@@@@@
@@@@@@@@@@@@@@@@@@@@@@@@@@@@@@@@@@@@@@@@@@@@@@@@@@@@@@@@@@@@@@@@@@@@@@@@@@@@@@@@@@@@@@@@@@@@@@@@@@@@@@@@@@@@@@@@@@@@@@@@@@@@@@@@@@@@@@@@@@@@@@@@@@@@@@@@@@@@@@@@
@@@@@@@@@@@@@@@@@@@@@@@@@@@@@@@@@@@@@@@@@@@@@@@@@@@@@@@@@@@@@@@@@@@@@@@@@@@@@@@@@@@@@@@@@@@@@@@@@@@@@@@@@@@@@@@@@@@@@@@@@@@@@@@@@@@@@@@@@@@@@@@@@@@@@@@@@@@@@@@@
@@@@@@@@@@@@@@@@@@@@@@@@@@@@@@@@@@@@@@@@@@@@@@@@@@@@@@@@@@@@@@@@@@@@@@@@@@@@@@@@@@@@@@@@@@@@@@@@@@@@@@@@@@@@@@@@@@@@@@@@@@@@@@@@@@@@@@@@@@@@@@@@@@@@@@@@@@@@@@@@
@@@@@@@@@@@@@@@@@@@@@@@@@@@@@@@@@@@@@@@@@@@@@@@@@@@@@@@@@@@@@@@@@@@@@@@@@@@@@@@@@@@@@@@@@@@@@@@@@@@@@@@@@@@@@@@@@@@@@@@@@@@@@@@@@@@@@@@@@@@@@@@@@@@@@@@@@@@@@@@@
@@@@@@@@@@@@@@@@@@@@@@@@@@@@@@@@@@@@@@@@@@@@@@@@@@@@@@@@@@@@@@@@@@@@@@@@@@@@@@@@@@@@@@@@@@@@@@@@@@@@@@@@@@@@@@@@@@@@@@@@@@@@@@@@@@@@@@@@@@@@@@@@@@@@@@@@@@@@@@@@
@@@@@@@@@@@@@@@@@@@@@@@@@@@@@@@@@@@@@@@@@@@@@@@@@@@@@@@@@@@@@@@@@@@@@@@@@@@@@@@@@@@@@@@@@@@@@@@@@@@@@@@@@@@@@@@@@@@@@@@@@@@@@@@@@@@@@@@@@@@@@@@@@@@@@@@@@@@@@@@@
@@@@@@@@@@@@@@@@@@@@@@@@@@@@@@@@@@@@@@@@@@@@@@@@@@@@@@@@@@@@@@@@@@@@@@@@@@@@@@@@@@@@@@@@@@@@@@@@@@@@@@@@@@@@@@@@@@@@@@@@@@@@@@@@@@@@@@@@@@@@@@@@@@@@@@@@@@@@@@@@
@@@@@@@@@@@@@@@@@@@@@@@@@@@@@@@@@@@@@@@@@@@@@@@@@@@@@@@@@@@@@@@@@@@@@@@@@@@@@@@@@@@@@@@@@@@@@@@@@@@@@@@@@@@@@@@@@@@@@@@@@@@@@@@@@@@@@@@@@@@@@@@@@@@@@@@@@@@@@@@@
@@@@@@@@@@@@@@@@@@@@@@@@@@@@@@@@@@@@@@@@@@@@@@@@@@@@@@@@@@@@@@@@@@@@@@@@@@@@@@@@@@@@@@@@@@@@@@@@@@@@@@@@@@@@@@@@@@@@@@@@@@@@@@@@@@@@@@@@@@@@@@@@@@@@@@@@@@@@@@@@
@@@@@@@@@@@@@@@@@@@@@@@@@@@@@@@@@@@@@@@@@@@@@@@@@@@@@@@@@@@@@@@@@@@@@@@@@@@@@@@@@@@@@@@@@@@@@@@@@@@@@@@@@@@@@@@@@@@@@@@@@@@@@@@@@@@@@@@@@@@@@@@@@@@@@@@@@@@@@@@@
@@@@@@@@@@@@@@@@@@@@@@@@@@@@@@@@@@@@@@@@@@@@@@@@@@@@@@@@@@@@@@@@@@@@@@@@@@@@@@@@@@@@@@@@@@@@@@@@@@@@@@@@@@@@@@@@@@@@@@@@@@@@@@@@@@@@@@@@@@@@@@@@@@@@@@@@@@@@@@@@
@@@@@@@@@@@@@@@@@@@@@@@@@@@@@@@@@@@@@@@@@@@@@@@@@@@@@@@@@@@@@@@@@@@@@@@@@@@@@@@@@@@@@@@@@@@@@@@@@@@@@@@@@@@@@@@@@@@@@@@@@@@@@@@@@@@@@@@@@@@@@@@@@@@@@@@@@@@@@@@@
@@@@@@@@@@@@@@@@@@@@@@@@@@@@@@@@@@@@@@@@@@@@@@@@@@@@@@@@@@@@@@@@@@@@@@@@@@@@@@@@@@@@@@@@@@@@@@@@@.@@.@@@@@@@@@@@@@@@@@@@@@@@@@@@@@@@@@@@@@@@@@@@@@@@@@@@@@@@@@@@
@@@@@@@@@@@@@@@@@@@@@@@@@@@@@@@@@@@@@@@@@@@@@@@@@@@@@@@@@@@@@@@@@@@@@@@@@@@@@@@@@@@@@@@@@@@@@@@@@.TTT@@@@@@@@@@@@@@@@@@@@@@@@@@@@@@@@@@@@@@@@@@@@@@@@@@@@@@@@@@@
@@@@@@@@@@@@@@@@@@@@@@@@@@@@@@@@@@@@@@@@@@@@@@@@@@@@@@@@@@@@@@@@@@@@@@@@@@@@@@@@@@@@@@@@@@@@@@@@.T.T..@@@@@@@@@@@@@@@@@@@@@@@@@@@@@@@@@@@@@@@@@@@@@@@@@@@@@@@@@@
@@@@@@@@@@@@@@@@@@@@@@@@@@@@@@@@@@@@@@@@@@@@@@@@@@@@@@@@@@@@@@@@@@@@@@@@@@@@@@@@@@@@@@@@@@@@@@@T...TTTT@@@@@@@@@@@@@@@@@@@@@@@@@@@@@@@@@@@@@@@@@@@@@@@@@@@@@@@@@
@@@@@@@@@@@@@@@@@@@@@@@@@@@@@@@@@@@@@@@@@@@@@@@@@@@@@@@@@@@@@@@@@@@@@@@@@@@@@@@@@@@@@@@@@@@@@@.TT..TT...@@@@@@@@@@@@@@@@@@@@@@@@@@@@@@@@@@@@@@@@@@@@@@@@@@@@@@@@
@@@@@@@@@@@@@@@@@@@@@@@@@@@@@@@@@@@@@@@@@@@@@@@@@@@@@@@@@@@@@@@@@@@@@@@@@@@@@@@@@@@@@@@@@@@@TT...T.....T.@@@@@@@@@@@@@@@@@@@@@@@@@@@@@@@@@@@@@@@@@@@@@@@@@@@@@@@
@@@@@@@@@@@@@@@@@@@@@@@@@@@@@@@@@@@@@@@@@@@@@@@@@@@@@@@@@@@@@@@@@@@@@@@@@@@@@@@@@@@@@@@@@@@.TT.T...T.T..TT@@@@@@@@@@@@@@@@@@@@@@@@@@@@@@@@@@@@@@@@@@@@@@@@@@@@@@
@@@@@@@@@@@@@@@@@@@@@@@@@@@@@@@@@@@@@@@@@@@@@@@@@@@@@@@@@@@@@@@@@@@@@@@@@@@@@@@@@@@@@@@@@@TT.T.T@@@@@TTT.TT@@@@@@@@@@@@@@@@@@@@@@@@@@@@@@@@@@@@@@@@@@@@@@@@@@@@@
@@@@@@@@@@@@@@@@@@@@@@@@@@@@@@@@@@@@@@@@@@@@@@@@@@@@@@@@@@@@@@@@@@@@@@@@@@@@@@@@@@@@@@@@.TT.T...@@@@@@@@T.T.@@@@@@@@@@@@@@@@@@@@@@@@@@@@@@@@@@@@@@@@@@@@@@@@@@@@
@@@@@@@@@@@@@@@@@@@@@@@@@@@@@@@@@@@@@@@@@@@@@@@@@@@@@@@@@@@@@@@@@@@@@@@@@@@@@@@@@@@@@@@@.TT.....@@@@@@@@.T..T@@@@@@@@@@@@@@@@@@@@@@@@@@@@@@@@@@@@@@@@@@@@@@@@@@@
@@@@@@@@@@@@@@@@@@@@@@@@@@@@@@@@@@@@@@@@@@@@@@@@@@@@@@@@@@@@@@@.@@@@@@@@@@@@@@@@@@@@@@@.TTT...T@@@@@@@@@T.T...@@@@@@@@@@@@@@@@@@@@@@@@@@@@@@@@@@@@@@@@@@@@@@@@@@
@@@@@@@@@@@@@@@@@@@@@@@@@@@@@@@@@@@@@@@@@@@@@@@@@@@@@@@@@@@@@@.T.@@@@@@@@@@@@@@@@@@@@@TTT...T..@@@@@@@@@.TTT...@@@@@@@@@@@@@@@@@@@@@@@@@@@@@@@@@@@@@@@@@@@@@@@@@
@@@@@@@@@@@@@@@@@@@@@@@@@@@@@@@@@@@@@@@@@@@@@@@@@@@@@@@@@@@@@@T...@@@@@@@@@@@@@@@@@@@.TT...T...@@@@@@@@@..TT..TT@@@@@@@@@@@@@@@@@@@@@@@@@@@@@@@@@@@@@@@@@@@@@@@@
@@@@@@@@@@@@@@@@@@@@@@@@@@@@@@@@@@@@@@@@@@@@@@@@@@@@@@@@@@@@@TT...@@@@@@@@@@@@@@@@@.TTT.TT.TT.TTT...TTT.TTTT.TT.T@@@@@@@@@@@@@@@@@@@@@@@@@@@@@@@@@@@@@@@@@@@@@@@
@@@@@@@@@@@@@@@@@@@@@@@@@@@@@@@@@@@@@@@@@@@@@@@@@@@@@@@@@@@@@TTT.@@@@@@@@@@@@@@@@@@@@.TTT..T...TTTT....T..T.TT.T.T@@@@@@@@@@@@@@@@@@@@@@@@@@@@@@@@@@@@@@@@@@@@@@
@@@@@@@@@@@@@@@@@@@@@@@@@@@@@@@@@@@@@@@@@@@@@@@@@@@@@@@@@@@@TT.TT@@@@@@@@@@@@@@@@@@@@@..TT.TTT..TT...TT.T.TT.TT...T@@@@@@@@@@@@@@@@@@@@@@@@@@@@@@@@@@@@@@@@@@@@@
@@@@@@@@@@@@@@@@@@@@@@@@@@@@@@@@@@@@@@@@@@@@@@@@@@@@@@@@@@@@.T..@@@@@@@@@@@@@@@@@@@@@@.....T....T....T.TT.TTTTT...T@@@@@@@@@@@@@@@@@@@@@@@@@@@@@@@@@@@@@@@@@@@@@
@@@@@@@@@@@@@@@@@@@@@@@@@@@@@@@@@@@@@@@@@@@@@@@@@@@@@@@@@@@@T.TT@@@@@@@@@@@@@@@@@@@@@@..T.T..T.@..TT...TTT..T..TT.@@@@@@@@@@@@@@@@@@@@@@@@@@@@@@@@@@@@@@@@@@@@@@
@@@@@@@@@@@@@@@@@@@@@@@@@@@@@@@@@@@@@@@@@@@@@@@@@@@@@@@@@@@...T.@@@@@@@@@@@@@@.@@@@.TTTTT.T....@@@@T.T...T..TTT.T@@@@@@@@@@@@@@@@@@@@@@@@@@@@@@@@@@@@@@@@@@@@@@@
@@@@@@@@@@@@@@@@@@@@@@@@@@@@@@@@@@@@@@@@@@@@@@@@@@@@@@@@@@@TT.T@@@@@@@@@@@@@@.TT..TT...T.T..T.@@@@@@@..TTTT.T...@@@@@@@@T...@@@@@@@@@@@@@@@@@@@@@@@@@@@@@@@@@@@@
@@@@@@@@@@@@@@@@@@@@@@@@@@@@@@@@@@@@@@@@@@@@@@@@@@@@@@@@@@...T@@@@@@@@.T@@@@TTTT.....T.TT.T.T.@@@@@@@@@...TTT..@@@@@@@T.T..T.@@@@@@@@@@@@@@@@@@@@@@@@@@@@@@@@@@@
@@@@@@@@@@@@@@@@@@@@@@@@@@@@@@@@@@@@@@@@@@@@@@@@@@@@@@@@@@T..T@@@@@@@TTTT@@.T.TT..T.TTT.TTTTT@@@@@@@@@@T.T.TTT@@@@@@@....T..@@@@@@@@@@@@@@@@@@@@@@@@@@@@@@@@@@@@
@@@@@@@@@@@@@@@@@@@@@@@@@@@@@@@@@@@@@@@@@@@@@@@@@@@@@@@@@@T..@@@@@@@@@T..T.T.T.TT..T.TT..T.TT@@@@@@@@@@TTT.T.@@@@@@@.T.TT.T@@@@@@@@@@@@@@@@@@@@@@@@@@@@@@@@@@@@@
@@@@@@@@@@@@@@@@@@@@@@@@@@@@@@@@@@@@@@@@@@@@@@@@@@@@@@@@@T.T.@@@@@@@@@@T.T.T..T..........TT.T...@@@@@@TT....@@@@@@@...T....T@@@@@@@@@@@@@@@@@@@@@@@@@@@@@@@@@@@@
@@@@@@@@@@@@@@@@@@@@@@@@@@@@@@@@@@@@@@@@@@@@@@@@@@@@@@@@.TT...@@@@@@@@@@.T..T.T...T.T.T.T..T.TT.T.T.@@.....@@@@@@@@@TT..T..TT@@@@@@@@@@@@@@@@@@@@@@@@@@@@@@@@@@@
@@@@@@@@@@@@@@@@@@@@@@@@@@@@@@@@@@@@@@@@@@@@@@@@@@@@@@@.T.T.T..@@@@@@@@@@.T.T.TT.TT..TTT.T@@.TT...TTT..TT.@@@@@@@@@@.TTT.T..T.@@@@@@@@@@@@@@@@@@@@@@@@@@@@@@@@@@
@@@@@@@@@@@@@@@@@@@@@@@@@@@@@@@@@@@@@@@@@@@@@@@@@@@@@@..T.TT..T.@@@T@@@@@@....TTTTTT.T.T.@@@@TT.T....TTTT@@@@@@@@@@..TTT.TTT.T.@@@@@@@@@@@@@@@@@@@@@@@@@@@@@@@@@
@@@@@@@@@@@@@@@@@@@@@@@@@@@@@@@@@@@@@@@@@@@@@@@@@@@@@.TTT.TT.TTTT@...@@@@@@T.T..TT..TTTT@@@@@@T..TT...TT@@@@@@.@@@...TT.TT..T..T@@@.T@@@@@@@@@@@@@@@@@@@@@@@@@@@
@@@@@@@@@@@@@@@@@@@@@@@@@@@@@@@@@@@@@@@@@@@@@@@@@@@@@@T.T..TTTT.T@@..T@@@@@@.TTTTTT.TTT@@@@@@@.T..TT...@@@@@@TT.@.T.T.TT..T.T..T.TT...@@@@@@@@@@@@@@@@@@@@@@@@@@
@@@@@@@@@@@@@@@@@@@@@@@@@@@@@@@@@@@@@@@@@@@@@@@@@@@@@@@TTTT...T.TT@...T@@@@@......T.TT.@@@@@@@@.T.T.TT@@@@@@@@.TT.T.T...TT.TTTT.TT...@@@@@@@@@@@@@@@@@@@@@@@@@@@
@@@@@@@@@@@@@@@@@@@@@@@@@@@@@@@@@@@@@@@@@@@@@@@@@@@@@@@@TT..T.T.T.@@T...@@@@T.T.TT.T.T.@@@@@@@@TTT.T@@@@@@@@@@@T.T.T..T@@@TT.T.T.TT.T.TT@@@@@@@@@@@@@@@@@@@@@@@@
@@@@@@@@@@@@@@@@@@@@@@@@@@@@@@@@@@@@@@@@@@@@@@@@@@@@@@@@@.T...TT.TT@..TT@@@@T.TT.TT.TTT.@@@@@@@TTTT@@@@@@@@@@@@T...TTT@@@@@TTTT.T.TTTTTT@@@@@@@@@@@@@@@@@@@@@@@@
@@@@@@@@@@@@@@@@@@@@@@@@@@@@@@@@@@@@@@@@@@@@@@@@@@@@@@@@@@.T.TT.TTT@@TT.@@@...@@.T.T.TT.TTT@@@@.TT@@@@@@@.T@@@T..T@@.@@@@@T.T.TTT.T...T@@@@@@@@@@@@@@@@@@@@@@@@@
@@@@@@@@@@@@@@@@@@@@@@@@@@@@@@@@@@@@@@@@@@@@@@@@@@@@@@@@@@@T....TT.T@..T..T...@@@.T..T..T.T@@@@..@@@@@@@@....T.TTT@@@@@@@@@.T.TTTTTTT.@@@@@@@@@@@@@@@@@@@@@@@@@@
@@@@@@@@@@@@@@@@@@@@@@@@@@@@@@@@@@@@@@@@@@@@@.T@@@@@@@@@@@@TT.T..TTT@@.TT..T.@@@@@T....TT.T..TT.@@@@@@@@@@.......T@@@@@@@.TT.T..T.T..@@@@@@@@@@@@@@@@@@@@@@@@@@@
@@@@@@@@@@@@@@@@@@@@@@@@@@@@@@@@@@@@@@@@@@@@T.TT@@@@@@@@@@@@.T.TTTT.T@TTTT..@@@@@@@@.T.TTTTTTT.@@@@@@@@@@.TT.T.@@T@@@@@@.T.TT...T.T.@@@@@@@@@@@@@@@@@@@@@@@@@@@@
@@@@@@@@@@@@@@@@@@@@@@@@@@@@@@@@@@@@@@@@@@@T..TT.@@@@@@@@@@@.TTTT....@@.TTT.@@@@@@@@@TT.T...TT@@@@@@@@@@.T.T..T@@@@@@@@@@...TT.T.T.@@@@@@@T@@@@@@@@@@@@@@@@@@@@@
@@@@@@@@@@@@@@@@@@@@@@@@@@@@@@@@@@@@@@@@@@T.TT....@@@@@@@@@@T.TTTTT...@TTT....T@@@@@@@T...T.T@@@@@@@T.@TTTTTTT.@@@@@@@@@@..T.TT.TT@@@@@@@@.T@@@@@@@@@@@@@@@@@@@@
@@@@@@@@@@@@@@@@@@@@@@@@@@@@@@@@@@TT@@@@@..........@@@@@@@@@@...T.....@@@@TTTTT@@@@@@@@T..TT@@@@@@@.T.T..T.TT.T@@@@@@TT.......TTT@@@@@@@@@T..@@@@@@@@@@@@@@@@@@@
@@@@@@@@@@@@@@@@@@@@@@@@@@@@@@@@@@@T..T...TTT.TT.T.T@@@@@@@@@..T....TTTT@TTT.TT@@@@@@@@@..T@@@@@@@TT.TT....TT.@@@@@@@T.TT.T..T..@@@@@@@@@@TT..@@@@@@@@@@@@@@@@@@
@@@@@@@@@@@@@@@@@@@@@@@@@@@@@@@@@@@@@TTT..T..T..TTTTT@@@@@@@@@..T.....TTTT..T.T..@@@@@@@@@@@@@@@@.T.T.....T..T@@@@@@@T..T.TTT.T@@@@@@@@@@.TT.TT@@@@@@@@@@@@@@@@@
@@@@@@@@@@@@@@@@@@@@@@@@@@@@@@@@@@@@@@@@..T.TT.TTT.TT@@@@@@@@@T...TTT...T.TT...T@@@@@@@@@@@@@@@@@.T.T.TT.....@@@@@.T...T.TT...@@@@@@@@@@@T..TTTT.T@@@@@@@@@@@@@@
@@@@@@@@@@@@@@@@@@@@@@@@@@@@@@@@@@@@@@@@@@.TTTTTT..T.T@@@@@@@@@..TTT.TT.T.TT..T.T@@@@@@@@@@@@@@@@T...TT.TTT..@@@@TT..TT...T..@@@@@@@@@@...TTTT.T..@@@@@@@@@@@@@@
@@@@@@@@@@@@@@@@@@@@@@@@@@@@@@@@@@@@@@@@@@@T..TTT....T@@@@@@@@@@..T.TT....T.T.T.TT@@@@@@@@@@@@@@..TTTT...T.T.TT....TTTT..TT.@@@@@@@@@@T.T..TT.....@@@@@@@@@@@@@@
@@@@@@@@@@@@@@@@@@@@@@@@@@@@@@@@@@@@@@@@@@@@T.TT......T@@@@@@@@@...T.T.TTTT...T.TT.T@@@@@@@@@TT.TTTTTTT.T.T...TT...T....T.T@@@@@@@@@@TT.T..T..T.TT.@@.@@@@@@@@@@
@@@@@@@@@@@@@@@@@@@@@@@@@@@@@@@@@@@@@@@@@@@@T.TT.T.TT.T@@@@@@@@@....T......TTT.T.TT..@.@@@@@@@TT...TT.T.TTT.T.T.TT...T.T.T@@@@@.@@@@.TT..T.@@.T.TTTTTT@@@@@@@@@@
@@@@@@@@@@@@@@@@@@@@@@@@@@@@@@@@@@@@@@@@@@@@@..TTT..TTT@@@@@@@.T.TT..TT.T.T.T.T.TTT@TT.@@@@@@@@T..T.TTT.T..TT..TT.TTT..TT@@@@@@TT.T.T....@@@@@TT..T.TT@@@@@@@@@@
@@@@@@@@@@@@@@@@@@@@@@@@@@@@@@@@@@@@@@@@@@@@@T.T.TT.TT..@@@@@...TT..TTTT..T..TT.TT.@@TT.@@@@@@@@.TTT..TT.TT.T.....T.TT.T@@@@@@@.T...T.@@TT@@@@@..T...@@@@@@@@@@@
@@@@@@@@@@@@@@@@@@@@@@@@@@@@@@@@@@@@@@@@@@@@@@..TT..T.T.@@@@.TT.T.TTTT..TTT.T.TT.TTT.TTTT@@@@@@@@.TTTTTTTT..T.T.TTT..TT@@@@@@@@.T.T.T@@@@TTT@@@@T...T@@@@@@@@@@@
@@@@@@@@@@@@@@@@@@@@@@@@@@@@@@@@@@@@@@@@@@@@@@TTT.TT.T.TT@@T.TTT...TT...TTT..T.T......T.T.@@@@@@@@T.TTT.T..TTT.TTTT..T@@@@@@@@@..TT...@@@@@.T@@@......@@@@@@@@@@
@@@@@@@@@@@@@@@@@@@@@@@@@@@@@@@@@@@@@@@@@@@@@@@..TTTT....@TTT.TT..TT.TT..TTT.TT.T.T.TT.TT.@@@@@@@@T.T.TTTTTT.TTT.....@@@@@@@@@.TTT...TT@@@@@TT@@T...TTT@@@@@@@@@
@@@@@@@@@@@@@@@@@@@@@@@@@@@@@@@@@@@@@@@@TT@@@@@T.T.TT..T.T....TT.T...T..TTTTTT.TT.T...TTTT.@@@@@@@...TT.TTTTT...TTT.@@@@@@@@@...T.T.@@TT@@@@T..TT...T.TT.T@@@@@@
@@@@@@@@@@@@@@@@@@@@@@@@@@@@@@@@@@@@@@@TTTT@@@@@T..T.TTTT.....TTTT..T.....T.T.T.TTT....T.T@@T.@@@..T.TT...T..T....@@@@@@@@@@T.TT...@@@@T.@@..@T..T.TT.T..TT.@@@@
@@@@@@@@@@@@@@@@@@@@@@@@@@@@@@@@@@@@@@TT...T@@@@T.TT...TT...TT....TT.TT.T..T..T..TT.TT..T.@@T....T...@T.TT.T.T.TT@@@@@@@T....TTT..T@@@@@T..T@@@.TT.T..T..TT..@@@
@@@@@@@@@@@@@@@@@@@@@@@@@@@@@@@@@@@@@@T..T.TT@@@TTT.TT.T........T.T......T.TTTTTTT..TTT.T..TTT.TT.T.@@@T.T.T....@@@@@@@@T..T..TTTT.T@@@@@..@@@@TTT...TTTTTTTT@@@
@@@@@@@@@@@@@@@@@@@@@@@@@@@@@@@@@@@@@@@.T...TT@@@T....TT.TT...T.TTTT..TT.T.T.TTT.T..TT..T..TT..T.T.T@@@@....TT.@@@@@@@....TTTTT....T.@@@@@.T@@TTT...T..TT..T@@@@
@@@@@@@@@@@@@@@@@@@@@@@@@@@@@@T.@@@@@@@@.T.T.T.@@...T....TTTT...T..TTTT...T...TT..T.T.T...T........@@@@@@.TTTT@@@@@@@@...TTTT.TT.T....@@@T..T.T.T.TT..TTTT.@@@@@
@@@@@@@@@@@@@@@@@@@@@@@@@@@@@@T..@@@@@@@@TTTT...@@TTTT...T..TTT.TTTTT.T.@@.TT.T.TT.T.TTT.T....TTT..@@@@@@@TT.@@@@@@@@@@...TTT.TTT.T....TT..T.T.TT.TTTT.TT.@@@@@@
@@@@@@@@@@@@@@@@@@@@@@@@@@@@@@@T..@@@@@@@@TT.TT.T@@T.T..T.TT...TT..T..@@@@@.T...T..TTTT....TTT.TT.TT.@@@@@@.@@@@@@@T.TTTTTTTT@T.TT.TT...TTTTTTTT..TTT.TTT@@@@@@@
@@@@@@@@@@@@@@@@@@@@@@@@@@@@@@@@T..T@@@@@@@T.TT.T@@TT.T..T.T.T...TTTT@@@@@@@..T.TTTT..T.TTTTTT.T...T.@@@@@@@@@@@@@.TTTT.T.TT@@@T....TTTTT.T.T.T...T..T.T@@@@@@@@
@@@@@@@@@@@@@@@@@@@@@@@@@@@@@@@@@@T.T.@@@@@TT..T.T.TT.T....TTT..TT...@@@@@@@@TTTT...TT..T.T.....TT....@.@@@@@@@@@TT...T.TTTT@@@T.T...T.T......TT...TT..@@@@@@@@@
@@@@@@@@@@@@@@@@@@@@@@@@@@@@@@@@@@.T.T.@@@@.T.T.T...TT...T.TT....T...T@@@@@@T.TTT.....TTT...TT.TT..TTT...@@@@@@@TTTT..TT.T.T.@@T.T..T.T.T..TT.TT.TT.TT@@@@@@@@@@
@@@@@@@@@@@@@@@@@@@@@@@@@@@@@@@@@@@.T.T@@@@..T..T..T.T.....T....T.TTTT.TT.T.T...T.TTTTT.T.TTT..T.TT@@TT.T.@@@@@TT.......T@@...T..T.....T.TT.T....TT..@@@@@@@@@@@
@@@@@@@@@@@@@@@@@@@@@@@.@@T@@@@@@@.T.TT@.T...@@@.TT......T..TT....T.....T...TT...T.T..TT.T.....TT.T@@.TT.@@@@@@@...T.TTT@@@@....T.T.TTTTT.T....TT..T@@@@@@@@@@@@
@@@@@@@@@@@@@@@@@@@@@@TT....@@@@@TTT..TTTTTT@@@@@.T..TTTTTTTTT.TT.T.T..TTT..T..T...TT....T...TT.T.T....TT.T.@@@@@TTTT.T..@@@.T.T.TTT..TTTTTTTT.TTT.@@@@@@@@@@@@@
@@@@@@@@@@@@@@@@@@@@@@...TT@@@@.TT..TTT..TTTT@@@@@...TT.T..TTTTT.T.T.TT.TT....T..T@@TTTT..T.T.T..TT.T..TT.T.@@@@@@@T.T..TT@@....TTTTTT..TT.TTT..T.@@@@@@@@@@@@@@
@@@@@@@@@@@@@@@@@@@@@..TTTT@@@@T...TTTT.T....@@@@@@.TTT...T...TT.......TTTTTTTTT.@@@@T..TTTTT.T.T..TTTT.T..T@@@@@@@@.T..T..T..TT.....T.TTT..TT.T@@@@@@@@@@@@@@@@
@@@@@@@@@@@@@@@@@@@@@@.T.T.T@@TT.T.T.TTT...@@@@@@@@@...TTTTT.TT.T..TT.....TTTT.TT@@@@@.T....TTT.....T..T.T.T@@.@@@@@..T.T.TT.TT...T..TT.TT...T.@@@@@@@@@@@@@@@@@
@@@@@@@@@@@@@@@@@@@@@@@TTT.TTT.....T.TT.T.@@@@@@@@@@@TTTT.TT.T..TTT.T.TT.T.TT.TTT@@@@@.TT.T.TT.TT.....TTTT@TTTT.@@@T..TTT....T.TT...T.T.....TT@@@@@@@@@@@@@@@@@@
@@@@@@@@@@@@@@@@@@@@@@@@TT.TTT..TT...T.T..@@@@@@@@@@@@TTTT....T.TTT.TT..T.TT....@@@@@@...T.TTT....T..TTTTT@@T.TT@@TTT@@.TT.....TTT.T.TT.TTT..@@@@@@@@@@@@@@@@@@@
@@@@@@@@@@@@@@@@@@@@@@@@@...T....TT.T.T.T.@@@.@@@@@@@@@.TT@@TT......TTT.T...TT..@@@@@@@@TT.T....T.T.T...TT.T..T.T..T.@@@....T.T..T.TTTT...TT@@@@@@@@@@@@@@@@@@@@
@@@@@@@@@@@@@@@@@@@@@@@@@@..T.T..TT..T....@TTT@@@@@@@@@@T.@@.T.TTT...TTT.TTT..TT@@@@@@@@@TT.TT....TTT...TT.TTTTTTTT.T@@@@.TT..T...T..T..T..@@@@@@@@@@@@@@@@@@@@@
@@@@@@@@@@@@@.@@T.@@@@@T....T.T.T..TT.T.TT@..@@@@@@@@@@@@....T.T..TT.T...T..TTT@@@@@@@@@@T.T....T..TTTT.TTT..T.T.T..@@@@@@@..TT..TT.T....T@@@@@@@@@@@@@@@@@@@@@@
@@@@@@@@@@@@TT....@@@@@......T.TT.TTT.T...TT..T.@@@.@@@@@@..TTT.TTT.TT..TTTT.TT@@@@@@@@@@..TT.TTTTTT.TT.TTTT..TTTT..@@@@@@@@...T.T.T.TTT.@@@@@@@@@@@@@@@@@@@@@@@
@@@@@@@@@@@TTTT.T@@@@.TTT..TT.TTTT.T..T.T.T..TT.@@@TT@@@@@@..TTTTTT.....T..T.TTT..T@@.T..TT..T.TTTTT.TTT.T....TTT.TTT.@@@@@@@.T..T.TTTT.@@@@@@@@@@@@@@@@@@@@@@@@
@@@@@@@@@@T.......@@@TTT...TT.TT.T..T.TT@@@TT..@@@@...@@@@@@.T...TTTTTT..TT...TTT..TT.T..TT.T@T..T.T..T.TT...T..T.TTTT.@@@@@@@...TTTTTT@@@@@@@@@@@@@@@@@@@@@@@@@
@@@@@@@@@@@TTTT...TTT.TTTT.T.T.T..T..T.T@@@.T.T@@@.TT@@@@@@@@TT.T@@TTT.T.TTT..T..TT.T.T.TT..@@@TTTTTT...TTTTT.TT...T..T@@@@@@@@...TTT.@@@@@@@@@@@@@@@@@@@@@@@@@@
@@@@@@@@@@@@TTTTT.T.....T.T.TT..T.TTT...T@@T..@@@@..@@@@@@@@@@T..@@TT...T..TT...TT..T....T..@@@@T.TT.TTTTT..T..T.T.....@@@@@@@@@@...@@@@@@@@@@@@@@@@@@@@@@@@@@@@
@@@@@@@@@@@@@.TTTT..T..T..TTTT.T.....T..T@@.T.@@.T.@@@@@@@@@@@@T.TT..T.T.TT.TT...TT.T.TTT..T@@@@@..T.TT.TT..T.TTT.T.T....T@@@@@@@@.@@@@@@@@@@@@@@@@@@@@@@@@@@@@@
@@@@.@@@@@@@@@TTT.T.TTTT.TTT..TT...T..T.@@TT.TT.T@@@@@@@@@@@@@@@..TTTTTTTT.TTT..T..T.TT.TTTT@@@@@T.TT..TTT...TT..TTTTTT.T.T@@@@@@@@@@@@@@@@@@@@@@@@@@@@@@@@@@@@@
@@@TTT@@@@@@@@@@.T..TTT...@@TTTTT.TTT..@@@@T.TT.@@@@@@@@@@T@@@@@@..TTTTTT...TT..TTTTTTT.TTT.@@@@@T.T.TTTT...T..TT.T.TTT....TT@@@@@@@@@@@@@@@@@@@@@@@@@@@@@@@@@@@
@@T.TTT@@@@@@@@.T.T.TT..T@@@..T@@.TT...@@@@..T.@@@@@@@@@T.T.@@@@@@..T..TTTTT...TT.........T.@@@@@T.T..TTT..TT.TTTT..T....TT...@@@@@@@@@@@@@@@@@@@@@@@@@@@@@@@@@@
@TT..T..@@@@@TT...T.T...@@@@T.T@@.T.T.T@@@@T..@@@@@@@@@TT@@T.@@@@TT..T..T.......TTT.T.TTT..T@@@.T.....T.TTT.T.TTT.T...TT......T@@@@@@@@@@@@@@@@@@@@@@@@@@@@@@@@@
@@....T.@@@.TTTT.......@@@@@....@@T....TT.T..@@@@@@@@@@T@@@@.@@@@..@@TT.TT...TT....TTTTTT.T....T.T..T.......T.TTTTTT..TTTT..TT.T@@@@@@@@@@@@@@@@@@@@@@@@@@@@@@@@
@@@.TTT.T@@TTT..T....TT@@@@.TT.T@@..T..T...T@@@@@@@@@T..@@@TTTT.T.T@@@TTTTT.TTTT.TT.TTT.T.TT.T...T...TT..T.T...T..T.T..T..TTTTT@@@@@@@@@@@@@@@@@@@@@@@@@@@@@@@@@
@@@@T.TT.TT..TTT.TTTT.@@@@TT@@@....TT.T.TT@@@@@@@@@@.T@@@.T.T.TT..T@@@@T..T@@..T..T.TTTTT.T..T.....T.TTT....TTTT..T.TT.T.TTTT.@@@@@@@@@@@@@@@@@@@@@@@@@@@@@@@@@@
@@@@@T..T..TT.TT.TT..@@@@TT@@@@TTT.T.TT.T@@@@@@@@@@@T@@@@.@@@T.T..@@@@@@.TT@@T....TT..T.TTT..T.T.T..TT.TT.TT..TTT.TT...T.T.T.@@@@@@@@@@@@@@@@@@@@@@@@@@@@@@@@@@@
@@@@@@...T.TT.TT....T@@@..@@@@T..TT.T...@@@@@@@@@..TT@@@@T@@@T..T@@@@@@@@TT...T.TT.TT.T...TTTTTTTTT...T.TTTT....T...TTTT....@@@@@@@@@@@@@@@@@@@@@@@@@@@@@@@@@@@@
@@@@@@@...TTT.T..TT.T....T@@@T.T....TTT@@@@@@@@@..T...@@@.@@@TT..@@@@@@@@@TTTT...T.TTT.TTTT......TT....TTT..TT..TTT.TTT..T.@@@@@@@@@@@@@@@@@@@@@@@@@@@@@@@@@@@@@
@@@@@@@@.T....T..T..T..T...@..TTTT...T@@@@@@@@@T.TT....TT.TTTTTTT.@@@@@@@@@.TTT..TT..TT.T...T.T.T.......T.....T.T.T..TTTT.@@@@@@@@@@@@@@@@@@@@@@@@@@@@@@@@@@@@@@
@@@@@@@@@T.T...TTT...T...TTTT.T.TT..T@@@@@@@@@TTT.TTTTTTTTTTT.T..T.@@@@@@@@@....TTT@@..TTT..T.TTT..T....T.T..TT...T.TTTTT@@@@@@@@@@@@@@@@@@@@@@@@@@@@@@@@@@@@@@@
@@@@@@@@@@.TT.T.TT.T.TT.T..T.T.TT...@@@@@@@@@..T......T.TTTTTT.TT.T.@@@@@@@@@.TTTTT@@TT.TTT.TT.TTT..TT.TT....TT..TTT..T.@@@@@@@@@@@@@@@@@@@@@@@@@@@@@@@@@@@@@@@@
@@@@@@@@@@@.T..T.TT.T..TT..T.T.TTT.@@@@@@@@@T.TTTTTT.T.T..T.TTTTTTTT.@@@@@@@@@.TTT....T..TTTTT...T....T..T.TT.TT.T.T.TT@@@@@@@@@@@@@@@@@@@@@@@@@@@@@@@@@@@@@@@@@
@@@@@@@@@@@@TTTTT..TT.TT..TTTTTTT.@@@@@@@@@.T.T.T.TTTT..TTT.T.TTTT.TT@@@@@@@@@@TTTT..T.....TT...T.TT....TTT.T....TT..T@@@@@@@@@@@@@@@@@@@@@@@@@@@@@@@@@@@@@@@@@@
@@@@@@@@@@@@@TTTT..T.T.TTT...TTTT@@@@@@@@@TTTT..T.TT@T.T..T.T.TTT..T@@@@@@@@@@@@.TTT...TT.T......T.T.T.T..TTT..TT..T.@@@@@@@@@@@@@@@@@@@@@@@@@@@@@@@@@@@@@@@@@@@
@@@@@@@@@@@@@@TT.TT..T..TT...T..@@@@@@@@@..T..TT....@@T.TT.TTTTT.T.@@@@@@@@.@@@@@T...T.TTT.T....T.TT.T.TTT..TT..T.TT@@@@@@@@@@@@@@@@@@@@@@@@@@@@@@@@@@@@@@@@@@@@
@@@@@@@@@@@@@@@.TT.TTT..TTTT.T.@@@@@@@@@@@T..TT.T..@@@...T.T.TTT.T@@@@@@@TTT.@@@@@.TTTTT.T...TTTTTTT....T.T.TT..TT.@@@@@@@@@@@@@@@@@@@@@@@@@@@@@@@@@@@@@@@@@@@@@
@@@@@@@@@@@@@@@@TT.TT.T...T...@@@@@@@@@@@@TTT......T@@@..T.TT.TTT@@@@@@@@@@@T.@@@@@....TT....TT..TTTT..TT..T.TTTTT@@@@@@@@@@@@@@@@@@@@@@@@@@@@@@@@@@@@@@@@@@@@@@
@@@@@@@@@@@@@@@@@.TTT.TTT..T.@@@@@@@@@@@@TTTT...TT@@@@@TT.TT....@@@@@@@@@@@@TTT@@@@.T.T.TT.T..TT...TTTTT...T..T.T@@@@@@@@@@@@@@@@@@@@@@@@@@@@@@@@@@@@@@@@@@@@@@@
@@@@@@@@@@@@@@@@@@T..T.TTTT.@@@@@@@@@@@@.T.TT.TT@@@@@@@@.T.T.T.@@@@@@@T.T.T.TTT.@@T.T..T..TT..T...TTTTTTTTTT..TT@@@@@@@@@@@@@@@@@@@@@@@@@@@@@@@@@@@@@@@@@@@@@@@@
@@@@@@@@@@@@@@@@@@@T..TTT..@@@@@@@@@@@@..TT..TT..@@@@@@@@TT..T@@@@@@@T.TT.T..T....TT@@@.TTT..TT.TT..TT...TT..T@@@@@@@@@@@@@@@@@@@@@@@@@@@@@@@@@@@@@@@@@@@@@@@@@@
@@@@@@@@@@@@@@@@@@@@TT.T.T@@@@@@@@@@@@@.TTT.T.T.T@@@@@@@@....@@@@@@@...TTTT......TT@@@@@T.TTT.TT.T.TTT.T.TT..@@@@@@@@@@@@@@@@@@@@@@@@@@@@@@@@@@@@@@@@@@@@@@@@@@@
@@@@@@@@@@@@@@@@@@@@@T..T@@@@@@@@@@@@@@@..TT...T..@@@@T@@TT.@@@@@@@.T....T.T..T..T.@@@@@@TT.T.TTTTT..TTT.T.T@@@@@@@@@@@@@@@@@@@@@@@@@@@@@@@@@@@@@@@@@@@@@@@@@@@@
@@@@@@@@@@@@@@@@@@@@@@T.@@@@@@T.@@@@@@@@@.TT.T....@@@@T.T.T@@@@@@@T..T.TT.TT....TT.T@@@@@@.T..T.TT.T..TT..T@@@@@@@@@@@@@@@@@@@@@@@@@@@@@@@@@@@@@@@@@@@@@@@@@@@@@
@@@@@@@@@@@@@@@@@@@@@@@@@@@@@.T..@@@@@@@@@...TT...T@T..TT.@@@@@@@@..TTT..T....TTT..T.@@@@@@T.......TTTT.TT@@@@@@@@@@@@@@@@@@@@@@@@@@@@@@@@@@@@@@@@@@@@@@@@@@@@@@
@@@@@@@@@@@@@@@@@@@@@@@@@@@@T...TT@@@@@@@@@T..T..T.TT.T..@@@@@@@@TTT...T..T.TT.TTTT.TT@@@@@@...T...TT..TT@@@@@@@@@@@@@@@@@@@@@@@@@@@@@@@@@@@@@@@@@@@@@@@@@@@@@@@
@@@@@@@@@@@@@@@@@@@@@@@@@@@T.T.TT..@@@@@@@T..T.TTT...T.T@@@@@@@@@....TT...TTTTT.TT.TT..@@@@@@...TT.TTTT.@@@@@@@@@@@@@@@@@@@@@@@@@@@@@@@@@@@@@@@@@@@@@@@@@@@@@@@@
@@@@@@@@@@@@@@@@@@@@@@@@@@@T.T...TTT@@@@@TTT.T.TT.TTT..@@@@@@@TTT.T..T.TTTTTT..TT.TT.T.T@@@@@@.T....TT.@@@@@@@@@@@@@@@@@@@@@@@@@@@@@@@@@@@@@@@@@@@@@@@@@@@@@@@@@
@@@@@@@@@@@@@@@@@@@@@@@@@@@@T.T..T.T.@@@T..T...T.TT.TT@@@@@@@@@TT.....TTT.T..TTT.....TT.T@@@@@@TTT....@@@@@@@@@@@@@@@@@@@@@@@@@@@@@@@@@@@@@@@@@@@@@@@@@@@@@@@@@@
@@@@@@@@@@@@@@@@@@@@@@@@@@@@@..T.T.TT.@..T...TTT.T...@@@@@@@@@@@T.T@@...TTT...TTT.T.TT.TT.@@@@@@T.T.@@@@@@@@@@@@@@@@@@@@@@@@@@@@@@@@@@@@@@@@@@@@@@@@@@@@@@@@@@@@
@@@@@@@@@@@@@@@@@@@@@@@@@@@@@@....TT.TTTT.TTTTTT..TT@@@@@@@@@@@@.T.@@T.T..T...TT.T.T.TT.T..@@@@@@TT@@@@@@@@@@@@@@@@@@@@@@@@@@@@@@@@@@@@@@@@@@@@@@@@@@@@@@@@@@@@@
@@@@@@@@@@@@@@@@@@@@@@@@@@@@@@@.TTT.T.TT.TTT....TTT@@@@@@@@@@@@TTT..TT.T.T....TT.TTTTTTT.T..@@@@@@@@@@@@@@@@@@@@@@@@@@@@@@@@@@@@@@@@@@@@@@@@@@@@@@@@@@@@@@@@@@@@
@@@@@@@@@@@@@@@@@@@@@@@@@@@@@@@@.T.T..T..TTT.TT...@@@@@@@@@@@@...T.TTTTTTTTTT.T..T.TTTTT..TTT@@@@@@@@@@@@@@@@@@@@@@@@@@@@@@@@@@@@@@@@@@@@@@@@@@@@@@@@@@@@@@@@@@@
@@@@@@@@@@@@@@@@@@@@@@@@@@@@@@@@@.T.TT..T.TT.T.T.@@@@@@.@@@@@....T..TT....T..TTTT.TTT.TTT.T..T@@@@@@@@@@@@@@@@@@@@@@@@@@@@@@@@@@@@@@@@@@@@@@@@@@@@@@@@@@@@@@@@@@
@@@@@@@@@@@@@@@@@@@@@@@@@@@@@@@@@@.T.T.T.....TTT@@@@@@.TT@@@.TTT......T.TT.TTTT.TTTTTTT..T.TT.@@@@@@@@@@@@@@@@@@@@@@@@@@@@@@@@@@@@@@@@@@@@@@@@@@@@@@@@@@@@@@@@@@
@@@@@@@@@@@@@@@@@@@@@@@@@@@@@@@@@@@.T.TT.TTT...@@@@@@@@T.T@.T........T.TT...T...TTT..T.TT.T.T@@@@@@@@@@@@@@@@@@@@@@@@@@@@@@@@@@@@@@@@@@@@@@@@@@@@@@@@@@@@@@@@@@@
@@@@@@@@@@@@@@@@@@@@@@@@@@@@@@@@@@@@T.TTTTTT.@@@@@@@T@@TTTT.T.T..TT..T...TTT.TT.T..TT....T..@@@@@@@@@@@@@@@@@@@@@@@@@@@@@@@@@@@@@@@@@@@@@@@@@@@@@@@@@@@@@@@@@@@@
@@@@@@@@@@@@@@@@@@@@@@@@@@@@@@@@@@@@@..TTTT.@@@@@@@@.TTTT.T.TT.T.TTTTTT..TT.T...TTTT.....TT@@@@@@@@@@@@@@@@@@@@@@@@@@@@@@@@@@@@@@@@@@@@@@@@@@@@@@@@@@@@@@@@@@@@@
@@@@@@@@@@@@@@@@@@@@@@@@@@@@@@@@@@@@@@TT.T.@@@@@@@@..TT...TT.TT.TT...T.T.T...T....T.T.T..T@@@@@@@@@@@@@@@@@@@@@@@@@@@@@@@@@@@@@@@@@@@@@@@@@@@@@@@@@@@@@@@@@@@@@@
@@@@@@@@@@@@@@@@@@@@@@@@@@@@@@@@@@@@@@@...@@@@@@@.T.....@@TT.TTTT.T.T...TT...TT...T......@@@@@@@@@@@@@@@@@@@@@@@@@@@@@@@@@@@@@@@@@@@@@@@@@@@@@@@@@@@@@@@@@@@@@@@
@@@@@@@@@@@@@@@@@@@@@@@@@@@@@@@@@@@@@@@@T@@@@@@@..T....T@@T.T.TTTT....TTTTTT...TTTTT..TT@@@@@@@@@@@@@@@@@@@@@@@@@@@@@@@@@@@@@@@@@@@@@@@@@@@@@@@@@@@@@@@@@@@@@@@@
@@@@@@@@@@@@@@@@@@@@@@@@@@@@@@@@@@@@@@@@@@@@@@@TTT.TTT..TT.TT....T.TT...T...TTTT..T.TT.@@@@@@@@@@@@@@@@@@@@@@@@@@@@@@@@@@@@@@@@@@@@@@@@@@@@@@@@@@@@@@@@@@@@@@@@@
@@@@@@@@@@@@@@@@@@@@@@@@@@@@@@@@@@@@@@@@@@@@@@.TT.......TT...T..T...TTT...TTT.TT.T..TT@@@@@@@@@@@@@@@@@@@@@@@@@@@@@@@@@@@@@@@@@@@@@@@@@@@@@@@@@@@@@@@@@@@@@@@@@@
@@@@@@@@@@@@@@@@@@@@@@@@@@@@@@@@@@@@@@@@@@@@@.TT.T...TTT..T..T.T.TTTT.TTTT..T..T.....@@@@@@@@@@@@@@@@@@@@@@@@@@@@@@@@@@@@@@@@@@@@@@@@@@@@@@@@@@@@@@@@@@@@@@@@@@@
@@@@@@@@@@@@@@@@@@@@@@@@@@@@@@@@@@@@@@@@@@@@@TT..T...T....T...T..T.T....T....T...TT.@@@@@@@@@@@@@@@@@@@@@@@@@@@@@@@@@@@@@@@@@@@@@@@@@@@@@@@@@@@@@@@@@@@@@@@@@@@@
@@@@@@@@@@@@@@@@@@@@@@@@@@@@@@@@@@@@@@@@@@@@@@.T.TT.T.T..T.T.TTTT.TT.TTTTT.TT.TTT.T@@@@@@@@@@@@@@@@@@@@@@@@@@@@@@@@@@@@@@@@@@@@@@@@@@@@@@@@@@@@@@@@@@@@@@@@@@@@@
@@@@@@@@@@@@@@@@@@@@@@@@@@@@@@@@@@@@@@@@@@@@@@@....TTT.TT.TTT....T...TTT.T.T.TTT.T@@@@@@@@@@@@@@@@@@@@@@@@@@@@@@@@@@@@@@@@@@@@@@@@@@@@@@@@@@@@@@@@@@@@@@@@@@@@@@
@@@@@@@@@@@@@@@@@@@@@@@@@@@@@@@@@@@@@@@@@@@@@@@@...T.T.TT.TT......T.T...T.T..T.T@@@@@@@@@@@@@@@@@@@@@@@@@@@@@@@@@@@@@@@@@@@@@@@@@@@@@@@@@@@@@@@@@@@@@@@@@@@@@@@@
@@@@@@@@@@@@@@@@@@@@@@@@@@@@@@@@@@@@@@@@@@@@@@@@@TT.TT...T....T..TT.T.T......T.@@@@@@@@@@@@@@@@@@@@@@@@@@@@@@@@@@@@@@@@@@@@@@@@@@@@@@@@@@@@@@@@@@@@@@@@@@@@@@@@@
@@@@@@@@@@@@@@@@@@@@@@@@@@@@@@@@@@@@@@@@@@@@@@@@@@..T.TTTT...TT.TTTT.TT.TTTT..@@@@@@@@@@@@@@@@@@@@@@@@@@@@@@@@@@@@@@@@@@@@@@@@@@@@@@@@@@@@@@@@@@@@@@@@@@@@@@@@@@
@@@@@@@@@@@@@@@@@@@@@@@@@@@@@@@@@@@@@@@@@@@@@@@@@@@.TTT.....T.....T..TTT...T.@@@@@@@@@@@@@@@@@@@@@@@@@@@@@@@@@@@@@@@@@@@@@@@@@@@@@@@@@@@@@@@@@@@@@@@@@@@@@@@@@@@
@@@@@@@@@@@@@@@@@@@@@@@@@@@@@@@@@@@@@@@@@@@@@@@@@@@@.T..TT.......TTT.TTTT.TT@@@@@@@@@@@@@@@@@@@@@@@@@@@@@@@@@@@@@@@@@@@@@@@@@@@@@@@@@@@@@@@@@@@@@@@@@@@@@@@@@@@@
@@@@@@@@@@@@@@@@@@@@@@@@@@@@@@@@@@@@@@@@@@@@@@@@@@@@@.TT.T...T.T.T.T.TT...@@@@@@@@@@@@@@@@@@@@@@@@@@@@@@@@@@@@@@@@@@@@@@@@@@@@@@@@@@@@@@@@@@@@@@@@@@@@@@@@@@@@@@
@@@@@@@@@@@@@@@@@@@@@@@@@@@@@@@@@@@@@@@@@@@@@@@@@@@@@@T.......T.TTTT..TTT@@@@@@@@@@@@@@@@@@@@@@@@@@@@@@@@@@@@@@@@@@@@@@@@@@@@@@@@@@@@@@@@@@@@@@@@@@@@@@@@@@@@@@@
@@@@@@@@@@@@@@@@@@@@@@@@@@@@@@@@@@@@@@@@@@@@@@@@@@@@@@@T.....TTTT..TTTTT@@@@@@@@@@@@@@@@@@@@@@@@@@@@@@@@@@@@@@@@@@@@@@@@@@@@@@@@@@@@@@@@@@@@@@@@@@@@@@@@@@@@@@@@
@@@@@@@@@@@@@@@@@@@@@@@@@@@@@@@@@@@@@@@@@@@@@@@@@@@@@@@@..TTTTTTT..TT.T@@@@@@@@@@@@@@@@@@@@@@@@@@@@@@@@@@@@@@@@@@@@@@@@@@@@@@@@@@@@@@@@@@@@@@@@@@@@@@@@@@@@@@@@@
@@@@@@@@@@@@@@@@@@@@@@@@@@@@@@@@@@@@@@@@@@@@@@@@@@@@@@@@@T.T.TT.T..TT.@@@@@@@@@@@@@@@@@@@@@@@@@@@@@@@@@@@@@@@@@@@@@@@@@@@@@@@@@@@@@@@@@@@@@@@@@@@@@@@@@@@@@@@@@@
@@@@@@@@@@@@@@@@@@@@@@@@@@@@@@@@@@@@@@@@@@@@@@@@@@@@@@@@@@....T.T..T@@@@@@@@@@@@@@@@@@@@@@@@@@@@@@@@@@@@@@@@@@@@@@@@@@@@@@@@@@@@@@@@@@@@@@@@@@@@@@@@@@@@@@@@@@@@
@@@@@@@@@@@@@@@@@@@@@@@@@@@@@@@@@@@@@@@@@@@@@@@@@@@@@@@@@@@T.TTT.TT@@@@@@@@@@@@@@@@@@@@@@@@@@@@@@@@@@@@@@@@@@@@@@@@@@@@@@@@@@@@@@@@@@@@@@@@@@@@@@@@@@@@@@@@@@@@@
@@@@@@@@@@@@@@@@@@@@@@@@@@@@@@@@@@@@@@@@@@@@@@@@@@@@@@@@@@@@..TTT@@@@@@@@@@@@@@@@@@@@@@@@@@@@@@@@@@@@@@@@@@@@@@@@@@@@@@@@@@@@@@@@@@@@@@@@@@@@@@@@@@@@@@@@@@@@@@@
@@@@@@@@@@@@@@@@@@@@@@@@@@@@@@@@@@@@@@@@@@@@@@@@@@@@@@@@@@@@@@T.@@@@@@@@@@@@@@@@@@@@@@@@@@@@@@@@@@@@@@@@@@@@@@@@@@@@@@@@@@@@@@@@@@@@@@@@@@@@@@@@@@@@@@@@@@@@@@@@
@@@@@@@@@@@@@@@@@@@@@@@@@@@@@@@@@@@@@@@@@@@@@@@@@@@@@@@@@@@@@@@@@@@@@@@@@@@@@@@@@@@@@@@@@@@@@@@@@@@@@@@@@@@@@@@@@@@@@@@@@@@@@@@@@@@@@@@@@@@@@@@@@@@@@@@@@@@@@@@@
@@@@@@@@@@@@@@@@@@@@@@@@@@@@@@@@@@@@@@@@@@@@@@@@@@@@@@@@@@@@@@@@@@@@@@@@@@@@@@@@@@@@@@@@@@@@@@@@@@@@@@@@@@@@@@@@@@@@@@@@@@@@@@@@@@@@@@@@@@@@@@@@@@@@@@@@@@@@@@@@
