type octile
height 54
width 52
map
@@@@@@@@@@@@@@@@@@@@@@@@@@@@@@@@@@@@@@@@@@@@@@@@@@@@
@@@@@@@@@@@@@@@@@@@@@@@@@@@@@@@@@@@@@@@@@@@@@@@@@@@@
@@@@@@@@@@@@@@@@@@@@@@@@@@@@@@@@@@@@@@@@@@@@@@@@@@@@
@@@@@@@@@@@@@@@@@@@@@@@@@@@@@@@@@@@@@@@@@@@@@@@@@@@@
@@@@@@@@@@@@@@@@@@@@@@@@@@@@@@@@@@@@@@@@@@@@@@@@@@@@
@@@@@@@@@@@@@@@@@@@@@@@@@@@@@@@@@@@@@@@@@@@@@@@@@@@@
@@@@@@@@@@@@@@@@@@@@@@@@@@@@@@@@@@@@@@@@@@@@@@@@@@@@
@@@@@@@@@@@@@@@@@@@@@@@@@@@@@@@@@@@@@@@@@@@@@@@@@@@@
@@@@@@@@@@@@@@@@@@@@@@@@@@@@@@@@@@@@@@@@@@@@@@@@@@@@
@@@@@@@@@@@@@@@@@@@@@@@@@@@@@@@@@@@@@@@@@@@@@@@@@@@@
@@@@@@@@@@@@@@@@@@@@@@@@@@@@@@@@@@@@@@@@@@@@@@@@@@@@
@@@@@@@@@@@@@@@@@@@@@@@@@@@@@@@@@@@@@@@@@@@@@@@@@@@@
@@@@@@@@@@@@@@@@@@@@@@@@@@@@@@@@@@@@@@@@@@@@@@@@@@@@
@@@@@@@@@@@@@@@@@@@@@@@@@@@@@T@@@@@@@@@@@@@@@@@@@@@@
@@@@@@@@@@@@@@@@@@@@@@@@@@@@TTTT@@@@@@@@@@@@@@@@@@@@
@@@@@@@@@@@@@@@@@@@@@@@@@@@@@T.TT.@@@@@@@@@@@@@@@@@@
@@@@@@@@@@@@@@@@@@@@@@@@@@@@@@.T.T@@@@@@@@@@@@@@@@@@
@@@@@@@@@@@@@@@@@@@@@@@@@@@@@.T..TT..@@@@@@@@@@@@@@@
@@@@@@@@@@@@@@@@@@@@@@@@@@..T.......T@@@@@@@@@@@@@@@
@@@@@@@@@@@@@@@@@@@@@@@@@@...T..T...T.T@@@@@@@@@@@@@
@@@@@@@@@@@@@@@@@@@@@@@@@@T.T..T.T.T..T.@@@@@@@@@@@@
@@@@@@@@@@@@@@@@@@@@@@@@....TT.T.TT.T.T.TT@@@@@@@@@@
@@@@@@@@@@@@@@@@@@@@@@@TTTT..T....T..TT..TT@@@@@@@@@
@@@@@@@@@@@@@@@@@@@@@@T...TT.TTTTTTTTTTTT.TT@@@@@@@@
@@@@@@@@@@@@@@@@@T@@@@TT...TTTTTTTT.TTTT..TTT@@@@@@@
@@@@@@@@@@@@@@@@TTT@@@..@@@@..T.TT.TTTTTTT.T..@@@@@@
@@@@@@@@@@@@@@@TTTTTTT..@@@@@T......T........T@@@@@@
@@@@@@@@@@@@@@TT.T.T..T@@@@@@@TT.T.T..TT...T.T@@@@@@
@@@@@@@@@@@@@.TT...TTT@@@@@@@@@.T.T.....TT...@@@@@@@
@@@@@@@@@@@@@TTT..T..@@@@@@@@@@....T..TTTT.T@@@@@@@@
@@@@@@@@@@@@@@T.T.TT.@@@@@@@@@...T...TTT.TT@@@@@@@@@
@@@@@@@@@@@@@@@T.T.T.@@@@@@@@......TTT.T.T@@@@@@@@@@
@@@@@@@@@@@@@@.T.TTT.@@@@@@@@.TTTT.T.TT..@@@@@@@@@@@
@@@@@@@@@@@@@TT.TTTTT@@@@@@T.T..T..TT...@@@@@@@@@@@@
@@@@@@@@@@@@.TTT.T..T.....T...T...T...T@@@@@@@@@@@@@
@@@@@@@@@@@TTT...T.T.T.TT.T.TT...T.T..@@@@@@@@@@@@@@
@@@@@@T@@@..T.T.....TT.TT.....TTT.T..@@@@@@@@@@@@@@@
@@@@@@.T@.TTT.T....T......T.TT.T.T.T@@@@@@@@@@@@@@@@
@@@@@@TTTTTTTTTT.TT.T...T..T.TTTT.T@@@@@@@@@@@@@@@@@
@@@@@@T..TTT......T.TTT..T..TT.TTT@@@@@@@@@@@@@@@@@@
@@@@@@TTTTT...T..TTT..TT.TT..TT.T@@@@@@@@@@@@@@@@@@@
@@@@@@.T..T..T..TT..TT.TT.T.TTTT@@@@@@@@@@@@@@@@@@@@
@@@@@@@T..TTT.T.T.TT....TT.T.TT@@@@@@@@@@@@@@@@@@@@@
@@@@@@@@.T.T.TT...T..TT.TTTTTT@@@@@@@@@@@@@@@@@@@@@@
@@@@@@@@@T.T.TTTTTTTTTT..T.TT@@@@@@@@@@@@@@@@@@@@@@@
@@@@@@@@@@.....T.TTTTTT.T...@@@@@@@@@@@@@@@@@@@@@@@@
@@@@@@@@@@@...TTT.......TT.@@@@@@@@@@@@@@@@@@@@@@@@@
@@@@@@@@@@@@T.T..TTTTTT..T@@@@@@@@@@@@@@@@@@@@@@@@@@
@@@@@@@@@@@@@T...TT..TTTT@@@@@@@@@@@@@@@@@@@@@@@@@@@
@@@@@@@@@@@@@@T.TT.....T@@@@@@@@@@@@@@@@@@@@@@@@@@@@
@@@@@@@@@@@@@@@.T.TT.T.@@@@@@@@@@@@@@@@@@@@@@@@@@@@@
@@@@@@@@@@@@@@@@T..T..@@@@@@@@@@@@@@@@@@@@@@@@@@@@@@
@@@@@@@@@@@@@@@@@T.T.@@@@@@@@@@@@@@@@@@@@@@@@@@@@@@@
@@@@@@@@@@@@@@@@@@@@@@@@@@@@@@@@@@@@@@@@@@@@@@@@@@@@
