type octile
height 80
width 80
map
@@@@@@@@@@@@@@@@@@@@@@@@@@@@@@@@@@@@@@@@@@@@@@@@@@@@@@@@@@@@@@@@@@@@@@@@@@@@@@@@
@@@@@@@@@@@@@@@@@@@@@@@@@@@@@@@@@@@@@@@@@@@@@@@@@@@@@@@@@@@@@@@@@@@@@@@@@@@@@@@@
@@@@@@@@@@@@@@@@@@@@@@@@@@@@@@@@@@@@@@@@@@@@@@@@@@@@@@@@@@@@@@@@@@@@@@@@@@@@@@@@
@@@@@@@@@@@@@@@@@@@@@@@@@@@@@@@@@@@@@@@@@@@@@@@@@@@@@@@@@@@@@@@@@@@@@@@@@@@@@@@@
@@@@@@@@@@@@@@@@@@@@@@@@@@@@@@@@@@@@@@@@@@@@@@@@@@@@@@@@@@@@@@@@@@@@@@@@@@@@@@@@
@@@@@@@@@@@@@@@@@@@@@@@@@@@@@@@@@@@@@@@@@@@@@@@@@@@@@@@@@@@@@@@@@@@@@@@@@@@@@@@@
@@@@@@@@@@@@@@@@@@@@@@@@@@@@@@@@@@@@@@@@@@@@@@@@@@@@@@@@@@@@@@@@@@@@@@@@@@@@@@@@
@@@@@@@@@@@@@@@@@@@@@@@@@@@@@@@@@@@@@@@@@@@@@@@@@@@@@@@@@@@@@@@@@@@@@@@@@@@@@@@@
@@@@@@@@@@@@@@@@@@@@@@@@@@@@@@@@@@@@@@@@@@@@@@@@@@@@@@@@@@@@@@@@@@@@@@@@@@@@@@@@
@@@@@@@@@@@@@@@@@@@@@@@@@@@@@@@@@@@@@@@@@@@@@@@@@@@@@@@@@@@@@@@@@@@@@@@@@@@@@@@@
@@@@@@@@@@@@@@@@@@@@@@@@@@@@@@@@@@@@@@@@@@@@@@@@@@@@@@@@@@@@@@@@@@@@@@@@@@@@@@@@
@@@@@@@@@@@@@@@@@@@@@@@@@@@@@@@@@@@@@@@@@@@@@@@@@@@@@@@@@@@@@@@@@@@@@@@@@@@@@@@@
@@@@@@@@@@@@@@@@@@@@@@@@@@@@@@@@@@@@@@@@@@@@@@@@@@@@@@@@@@@@@@@@@@@@@@@@@@@@@@@@
@@@@@@@@@@@@@@@@@@@@@@@@@@@@@@@@@@@@@@@@@@@@@@@@@@@@@@@@@@@@@@@@@@@@@@@@@@@@@@@@
@@@@@@@@@@@@@@@@@@@@@@@@@@@@@@@@@@@@@@@@@@@@@@@@@@@@@@@@@@@@@@@@@@@@@@@@@@@@@@@@
@@@@@@@@@@@@@@@@@@@@@@@@@@@@@@@@@@@@@@@@@@@@@@@@@@@@@@@@@@@@@@@@@@@@@@@@@@@@@@@@
@@@@@@@@@@@@@@@@@@@@@@@@@@@@@@@@@@@@@@@@@@@@@@@@@@@@@@@@@@@@@@@@@@@@@@@@@@@@@@@@
@@@@@@@@@@@@@@@@@@@@@@@@@@@@@@@@@@@@@@@@@@@@@@@@@@@@@@@@@@@@@@@@@@@@@@@@@@@@@@@@
@@@@@@@@@@@@@@@@@@@@@@@@@@@@@@@@@@@@@@@T@@@@@@@@@@@@@@@@@@@@@@@@@@@@@@@@@@@@@@@@
@@@@@@@@@@@@@@@@@@@@@@@@@@@@@@@@@@@@@@@.@@@@@@@@@@@@@@@@@@@@@@@@@@@@@@@@@@@@@@@@
@@@@@@@@@@@@@@@@@@@@@@@@@@@@@@@@@@@@@@T.T.@@@@@@@@@@@@@@@@@@@@@@@@@@@@@@@@@@@@@@
@@@@@@@@@@@@@@@@@@@@@@@@@@@@@@@@@@@@@@.T.T@@@@@@@@@@@T@@@@@@@@@@@@@@@@@@@@@@@@@@
@@@@@@@@@@@@@@@@@@@@@@@@@@@@@@@@@@@@@@..TT@@@@@@@@@TTTT@@@@@@@@@@@@@@@@@@@@@@@@@
@@@@@@@@@@@@@@@@@@@@@@@@@@@@@@@@@@@@@@T.TT@@@@@@@@@.T.T@@@@@@@@@@@@@@@@@@@@@@@@@
@@@@@@@@@@@@@@@@@@@@@@@@@@@@@@@@@@@@@@@TT..@@@@@@@T...@@@@@@@@@@@@@@@@@@@@@@@@@@
@@@@@@@@@@@@@@@@@@@@@@@@@@@@@@@@@@@@@@TTT..T.T@@@TTTT@@@@@@@@@@@@@@@@@@@@@@@@@@@
@@@@@@@@@@@@@@@@@@@@@@@@@@@@@@@@@@@@@...TT..T.T..T..@@@@@@@@@@@@@@@@@@@@@@@@@@@@
@@@@@@@@@@@@@@@@@@@@@@@@@@@@@@@@@@@@@TTTT.TT.T.....@@@@@@@@@@@@@@@@@@@@@@@@@@@@@
@@@@@@@@@@@@@@@@@@@@@@@@@@@@@@@@@.T..TTT.T..TTTTTT.@@@@@@@@@@@@@@@@@@@@@@@@@@@@@
@@@@@@@@@@@@@@@@@@@@@@@@@@@@T@@T.T.TT.TT.T.TTT....@@@@@@@@@@@@@.T@@@@@@@@@@@@@@@
@@@@@@@@@@@@@@@@@@@@@@@@@@@@T@@.....TT.TT....TT.T.@@@@@@@@@@@@@T.T@@@@@@@@@@@@@@
@@@@@@@@@@@@@@@@@@@@@@@@@@@@TT@TT.T..T..TT.T.TT.TTT@@@@@@@@@@@..T@@@@@@@@@@@@@@@
@@@@@@@@@@@@@@@@@@@@@@@@@@@@.T@@.TTTT.TTT.T..T..T.T@@@@@@@@@@@.TT@@@@@@@@@@@@@@@
@@@@@@@@@@@@@@@@@@@@@@@@@@@@@.@@T.TT..T.TTT.TT.TTT.T@@@@@@@@@T..@@@@@@@@@@@@@@@@
@@@@@@@@@@@@@@@@@@@@@@@@@@@@@T@@T.T..TT.TTT.TTTT...T@@@@@@@@.T.@@@@@@@@@@@@@@@@@
@@@@@@@@@@@@@@@@@@@@@@@@@@@.TT@@.TTT.TT..T.T.T.TT.TT.T@@@@@.TTT@@@@@@@@@@@@@@@@@
@@@@@@@@@@@@@@@@@@@@@@TTT@@TT.....T...TT.......T.TT.TT.TT....TT@@@@@@@@@@@@@@@@@
@@@@@@@@@@@@@@@@@@@@@.T..T@TT.T...TT.TTTT.T..T..TTT..T.TT..TTT.T@@@@@@@@@@@@@@@@
@@@@@@@@@@@@@@@@@@@@@T....TT.T..T.TTT...T..T.....T.TTT..TTT.@@@@@@@@@@@@@@@@@@@@
@@@@@@@@@@@@@@@@@@@@@..T...T..TTTTTT..TT.T.TTTT.T.TT..T.T.T@@@@@@@@@@@@@@@@@@@@@
@@@@@@@@@@@@@@@@@@@@@@T.T.TT.T..TTTTT..........TTT.TTTTT.T@@@@@@@@@@@@@@@@@@@@@@
@@@@@@@@@@@@@@@@@@@@@@@TT...T.TT..T.TT..TTT...TTT.T.TTTTT.@@@@@@@@@@@@@@@@@@@@@@
@@@@@@@@@@@@@@@@@@@@@@@T.T.TTT..T.T.TT.TTTTT..T.T..T....T@@@@@@@@@@@@@@@@@@@@@@@
@@@@@@@@@@@@@@@@@@@@@@@@TT....TTTTT.TTTT..TT......T...TT.@@@@@@@@@@TT@@@@@@@@@@@
@@@@@@@@@@@@@@@@@@@@@@@@@TTTT...TT.T.TTT..TTT..T.T.......@@@@@@@@@@T.@@@@@@@@@@@
@@@@@@@@@@@@@@@@@@@@@@@@@TT.TT..T....TTT......T...T..TT.T.@@@@@@@@@TT.@@@@@@@@@@
@@@@@@@@@@@@@@@@@@@@@@@@@TT.T..TT.TTT..TT....TTTTTT.TT.TTT.@@@@@@@.TTT@@@@@@@@@@
@@@@@@@@@@@@@@@@@@@@@@@@@...TT...T....T.T..TTT...T..T.TTTT...@@@..TTTT@@@@@@@@@@
@@@@@@@@@@@@@@@@@@@@@@@@T...TTT...TTTTT.TT.T.TTTTT.....TTT.....TT..TT.@@@@@@@@@@
@@@@@@@@@@@@@@@@@@@@@@@TT..T.TT.TTT...TT.T..T..T..TTTT....TT.T...TT..T@@@@@@@@@@
@@@@@@@@@@@@@@@@@@@@@T..TT.T.TTTTTTT.......TT.TT.TTT..T.TTT....T.T.T..@@@@@@@@@@
@@@@@@@@@@@@@@@@@@@@T..T..TT...T......TT.T..T..T.T.TT..@@@@....TT....@@@@@@@@@@@
@@@@@@@@@@@@@@@@@@@@T....T....TTT..T.....T.....TT..T..@@@@@@TT....T..@@@@@@@@@@@
@@@@@@@@@@@@@@@@@@@.T..T.TT.TTTT.T.T.T.TT..TT.TT.T..T.@@@@@@....TTT.T@@@@@@@@@@@
@@@@@@@@@@@@@@@T@@TTT...TT.TT.TTT.TT...TT..TTT.TT.TTTT@@@@@@..TT...T@@@@@@@@@@@@
@@@@@@@@@@@@@@@T@@TT.T.TT.......T.T.TT.TT..T..TTTTTT..@@@@@@T.T..T.T@@@@@@@@@@@@
@@@@@@@@@@@@@@@T@@TTTTT...T.TTT....T.T.T.T.TTTT..TT.TTT@@@@@TT.T...@@@@@@@@@@@@@
@@@@@@@@@@@@@@..T@..TTTT..T......T.....T...TTT..T......T..T.T.TTTT.@@@@@@@@@@@@@
@@@@@@@@@@@@@T....TT....TT.TT....TTTT.T.TTT.@@@@.T...T.TTTT.T..T.T@@@@@@@@@@@@@@
@@@@@@@@@@@@@TTT.TTT..T.TT....T.T.T.TTTT.TT@@@@@@.....TT.TT.T.TT.@@@@@@@@@@@@@@@
@@@@@@@@@@@@@T.T.TT.T....T..T..TTTTTTTT.TT@@@@@@@@TTTTTT..TTTT.T@@@@@@@@@@@@@@@@
@@@@@@@@@@@@@@.T..TTT.TT..TT.T..TTTT...TT.@@@@@@@@TT..T.TT....T@@@@@@@@@@@@@@@@@
@@@@@@@@@@@@@@.TT.TT..T..TT.TTT.T...T..T..@@@@@@@@..T...T.TTTT@@@@@@@@@@@@@@@@@@
@@@@@@@@@@@@@@T.TTT.TTT.TTTT..TTTT.TTT..@@@@@@@@@..TTTT..TT.T@@@@@@@@@@@@@@@@@@@
@@@@@@@@@@@@@T.TT..T.T.TTT.TTT.TTTT..T@@@@@@@@@@.TT.TTT..T..@@@@@@@@@@@@@@@@@@@@
@@@@@@@@@@@@@TTT......TT.TTT...TT.T..@@@@@@@@@@.T.TT..T...@@@@@@@@@@@@@@@@@@@@@@
@@@@@@@@@@@@...TTTTTT.TTTTT....TT.T.T@@@@@@@@@T.TTTT.TTT@@@@@@@@@@@@@@@@@@@@@@@@
@@@@@@@@@@@@T...T.TT..TTT.T...T.T..TT@@@@@@@T....T..T.@@@@@@@@@@@@@@@@@@@@@@@@@@
@@@@@@@@@@@@T.T....T.TT.T.TT.T.TTTTTTT@@@@..T...T.T@@@@@@@@@@@@@@@@@@@@@@@@@@@@@
@@@@@@@@@@@@..TTTT....TT..TT.TT..TT.T...T....TT.T@@@@@@@@@@@@@@@@@@@@@@@@@@@@@@@
@@@@@@@@@@@@T...TTTT...TTT.T..TT..TT....T..TT...@@@@@@@@@@@@@@@@@@@@@@@@@@@@@@@@
@@@@@@@@@@@@T..T.T...T.....T..T..TTT..T...TT.T@@@@@@@@@@@@@@@@@@@@@@@@@@@@@@@@@@
@@@@@@@@@@@@@.TTT.TTTT.TT....TTTTT.TTTTT...T.@@@@@@@@@@@@@@@@@@@@@@@@@@@@@@@@@@@
@@@@@@@@@@@@@@T..TTTTT.TT.TTTT..TTTT.....TTT@@@@@@@@@@@@@@@@@@@@@@@@@@@@@@@@@@@@
@@@@@@@@@@@@@@@TT......TT.TT...TTTT..T.TTT@@@@@@@@@@@@@@@@@@@@@@@@@@@@@@@@@@@@@@
@@@@@@@@@@@@@@@@@..TT..TTTT..TTT.T.TT..TT@@@@@@@@@@@@@@@@@@@@@@@@@@@@@@@@@@@@@@@
@@@@@@@@@@@@@@@@@@T.T..TT...TT.TT.TT..T.@@@@@@@@@@@@@@@@@@@@@@@@@@@@@@@@@@@@@@@@
@@@@@@@@@@@@@@@@@@@T.T...T.T.T.TT.T.TT@@@@@@@@@@@@@@@@@@@@@@@@@@@@@@@@@@@@@@@@@@
@@@@@@@@@@@@@@@@@@@@@@T..TTT.T.T..TT.@@@@@@@@@@@@@@@@@@@@@@@@@@@@@@@@@@@@@@@@@@@
@@@@@@@@@@@@@@@@@@@@@@@@@@@@@@@@@@@@@@@@@@@@@@@@@@@@@@@@@@@@@@@@@@@@@@@@@@@@@@@@
