type octile
height 64
width 60
map
@@@@@@@@@@@@@@@@@@@@@@@@@@@@@@@@@@@@@@@@@@@@@@@@@@@@@@@@@@@@
@@@@@@@@@@@@@@@@@@@@@@@@@@@@@@@@@@@@@@@@@@@@@@@@@@@@@@@@@@@@
@@@@@@@@@@@@@@@@@@@@@@@@@@@@@@@@@@@@@@@@@@@@@@@@@@@@@@@@@@@@
@@@@@@@@@@@@@@@@@@@@@@@@@@@@@@@@@@@@@@@@@@@@@@@@@@@@@@@@@@@@
@@@@@@@@@@@@@@@@@@@@@@@@@@@@@@@@@@@@@@@@@@@@@@@@@@@@@@@@@@@@
@@@@@@@@@@@@@@@@@@@@@@@@@@@@@@@@@@@@@@@@@@@@@@@@@@@@@@@@@@@@
@@@@@@@@@@@@@@@@@@@@@@@@@@@@@@@@@@@@@@@@@@@@@@@@@@@@@@@@@@@@
@@@@@@@@@@@@@@@@@@@@@@@@@@@@@@@@@@@@@@@@@@@@@@@@@@@@@@@@@@@@
@@@@@@@@@@@@@@@@@@@@@@@@@@@@@@@@@@@@@@@@@@@@@@@@@@@@@@@@@@@@
@@@@@@@@@@@@@@@@@@@@@@@@@@@@@@@@@@@@@@@@@@@@@@@@@@@@@@@@@@@@
@@@@@@@@@@@@@@@@@@@@@@@@@@@@@@@@@@@@@@@@@@@@@@@@@@@@@@@@@@@@
@@@@@@@@@@@@@@@@@@@@@@@@@@@@@@@@.@@@@@@@@@@@@@@@@@@@@@@@@@@@
@@@@@@@@@@@@@@@@@@@@@@@@@@@@@@@TT@@@@@@@@@@@@@@@@@@@@@@@@@@@
@@@@@@@@@@@@@@@@@@@@@@@@@@@@@@@T.@@@@..T@@@@@@@@@@@@@@@@@@@@
@@@@@@@@@@@@@@@@@@@@@@@@@@@@@@@TT@@@@@@.T@@@@@@@@@@@@@@@@@@@
@@@@@@@@@@@@@@@@@@@@@@@@@@@@@@@..@T@@@@@..@@@@@@@@@@@@@@@@@@
@@@@@@@@@@@@@@@@@@@@@@@@@@@@@@@..TT.@@@@@.T@@@@@@@@@@@@@@@@@
@@@@@@@@@@@@@@@@@@@@@@@@@@@@@@@T..T.T@@@@@..@@@@@@@@@@@@@@@@
@@@@@@@@@@@@@@@@@@@@@@@@@@@@@@@.TTT.T@@@@@...@@@@@@@@@@@@@@@
@@@@@@@@@@@@@@@@@@@@@@@@@@@@@@@@@....@@@@T.TTT..@@@@@@@@@@@@
@@@@@@@@@@@@@@@@@@@@@@@@@@@@@@@@@TT....T..T..T@.T@@@@@@@@@@@
@@@@@@@@@@@@@@@@@@@@@@@@@@@@@@@TTT.T..TTTTTT.@@@..@@@@@@@@@@
@@@@@@@@@@@@@@@@@@@@@@@@@@@@@@TTTT...T...T..@@@T.T.@@@@@@@@@
@@@@@@@@@@@@@@@@@@@@@@@@@@@@@T..TT.T.T..TT.@@@@@....@@@@@@@@
@@@@@@@@@@@@@@@@@@@@@@@@@@..@@......TT.TTT.@@@@@@@@..@@@@@@@
@@@@@@@@@@@@@@@@@@@@@@@.@@.@@@...TTTT....T@@@@@@@@@TT.@@@@@@
@@@@@@@@@@@@@@@@@@@@@@@...T..T.T...T.T.TT.@@@T@@...TT.T@@@@@
@@@@@@@@@@@@@@@@@@@@@@TTTTT.T..TT..@@@..TTT.T..TT...TT.T@@@@
@@@@@@@@@@@@@@@@@@@@...T.T..T..T.TT@@@TTTTT.TT....T.TTTT@@@@
@@@@@@@@@@@@@@@@@@@TT.TT.TT.T.TT.T..T.T.T.T.....TTTTT.T@@@@@
@@@@@@@@@@@@@@@@@@..T..@@TT.TT.T...TT...T..T.TT.T.TT.T@@@@@@
@@@@@@@@@@@@@@@@@T..T.@@@@TT@@...TT..TTTTT..TTTT..T.T@@@@@@@
@@@@@@@@@@@@@@@@@.T..@@@@@@@@@T.T..TT.T..T.TTTT....T@@@@@@@@
@@@@@@@T@@@@@@@@.T.@@@@@@@@@T.TT...T.....TTT......T@@@@@@@@@
@@@@@@..T@@@@@@TTT@@@@@@@@@@@.T@@TTTTT...TT..T...T@@@@@@@@@@
@@@@@..T.T@@@@T...T@@@@@@@@@@@@@@..TTT...T...T..T@@@@@@@@@@@
@@@@..T.T.@@@TTT.T.@@@@@@@@@@@@TT....TT.T..TT...@@@@@@@@@@@@
@@@@TTTTT..@..T.T...@TT@@@@@@@@@.TTT..T.TT..T..@@@@@@@@@@@@@
@@@@@TTT.TT@.T.T...T.TTT@@@@@@@@@......TTTT...@@@@@@@@@@@@@@
@@@@@.T.T.T@@..TT.T....T@@@@@@@@@@.TTTTTT.T.T@@@@@@@@@@@@@@@
@@@@@@TT..TT@....TTTTT..@@@@@@@@.T.....TTT.T@@@@@@@@@@@@@@@@
@@@@@@T..T.T@@TTTT.TT..@@@@@@@@TTTTT..TTT.T@@@@@@@@@@@@@@@@@
@@@@@@.....TT@T.T.....@@@@@@@@..T......T.T@@@@@@@@@@@@@@@@@@
@@@@@T.T..TT.@@..TTTT@@@@@@@@@@.TTTT.TT..@@@@@@@@@@@@@@@@@@@
@@@@..T.TT.TT.@..T..@@@@@@@@@@TT.TT.....@@@@@@@@@@@@@@@@@@@@
@@@@.......TT.@TTT.@@@@@@@@...T..TTT.TT@@@@@@@@@@@@@@@@@@@@@
@@@@@T...T.T...T..@@@@@@@@@@...T..T.T.@@@@@@@@@@@@@@@@@@@@@@
@@@@@@...TTT.TTTT@@@@@@@@.@...T.....T@@@@@@@@@@@@@@@@@@@@@@@
@@@@@@@T.T.T..T.@@@@@@@@.T.T.TTT..TT@@@@@@@@@@@@@@@@@@@@@@@@
@@@@@@@@.T.TTT.@@@@@@@@TT.TTT.T...T@@@@@@@@@@@@@@@@@@@@@@@@@
@@@@@@@@@....T@@@@@@@@@TTT.T..T...@@@@@@@@@@@@@@@@@@@@@@@@@@
@@@@@@@@@@.T..T@@@@@@@TT.T.T..TTT@@@@@@@@@@@@@@@@@@@@@@@@@@@
@@@@@@@@@@@TTTTT@@@@.T.TT....T..@@@@@@@@@@@@@@@@@@@@@@@@@@@@
@@@@@@@@@@@@TT.TT@@T.T..TTT.TTT@@@@@@@@@@@@@@@@@@@@@@@@@@@@@
@@@@@@@@@@@@@.T.T..T.TT.TTT..T@@@@@@@@@@@@@@@@@@@@@@@@@@@@@@
@@@@@@@@@@@@@@.....T.TT....T@@@@@@@@@@@@@@@@@@@@@@@@@@@@@@@@
@@@@@@@@@@@@@@@TTTTTTTT.TTT@@@@@@@@@@@@@@@@@@@@@@@@@@@@@@@@@
@@@@@@@@@@@@@@@@......T.TT@@@@@@@@@@@@@@@@@@@@@@@@@@@@@@@@@@
@@@@@@@@@@@@@@@@@T.....TT@@@@@@@@@@@@@@@@@@@@@@@@@@@@@@@@@@@
@@@@@@@@@@@@@@@@@@@.TT.T@@@@@@@@@@@@@@@@@@@@@@@@@@@@@@@@@@@@
@@@@@@@@@@@@@@@@@@@@T..@@@@@@@@@@@@@@@@@@@@@@@@@@@@@@@@@@@@@
@@@@@@@@@@@@@@@@@@@@@@@@@@@@@@@@@@@@@@@@@@@@@@@@@@@@@@@@@@@@
@@@@@@@@@@@@@@@@@@@@@@@@@@@@@@@@@@@@@@@@@@@@@@@@@@@@@@@@@@@@
@@@@@@@@@@@@@@@@@@@@@@@@@@@@@@@@@@@@@@@@@@@@@@@@@@@@@@@@@@@@
