type octile
height 80
width 80
map
@@@@@@@@@@@@@@@@@@@@@@@@@@@@@@@@@@@@@@@@@@@@@@@@@@@@@@@@@@@@@@@@@@@@@@@@@@@@@@@@
@@@@@@@@@@@@@@@@@@@@@@@@@@@@@@@@@@@@@@@@@@@@@@@@@@@@@@@@@@@@@@@@@@@@@@@@@@@@@@@@
@@@@@@@@@@@@@@@@@@@@@@@@@@@@@@@@@@@@@@@TT..T.T..T.T.T...TTTT..T..T......TT...T@@
@@@@@@@@@@@@@@@@@@@@@@@@@@@@@@@@@@@@@T....TT.TT.T..T.T.T.TT..TT....T..TTT.T..T@@
@@@@@@@@@@@@@@@@@@@@@@@@@@@@@@@@@@@@...T..TT.T..T..TTT.....T...T..T.TT...T.T.@@@
@@@@@@@@@@@@@@@@@@@@@@@@@@@@@@@@@@..TTTTTT.T......T.T.T.TT....T..TTTT.TTT.TTT@@@
@@@@@@@@@@@@@@@@@@@@@@@@@@@@@@@@@..TT..TT...T.T.T.T.T...TT....TTTTTTTTT...TT.@@@
@@@@@@@@@@@@@@@@@@@@@@@@@@@@@@@@.TT.TTT.T..T.TT..T.TT..TTT.TTT..T..T.T.TTTT.@@@@
@@@@@@@@@@@@@@@@@@@@@@@@@@@@@@@..T......TT..TT...TTTTT.T.....T.TTT.T.T.T..TT@@@@
@@@@@@@@@@@@@@@@@@@@@@@@@@@@@@.....T.T....T..TTT.TTT..T.T..TT........T....T@@@@@
@@@@@@@@@@@@@@@@@@@@@@@@@@@@@.T..TT.TTTT...TT.T...TT...T.TT.TT.TT...TTTT..T@@@@@
@@@@@@@@@@@@@@@@@@@@@@@@@@@@...........T..T....TT.T.TTTTTT.T....TTTT.T.T..T@@@@@
@@@@@@@@@@@@@@@@@@@@@@@@@@@TT.TT.....T.T..T.T..TTTT..T.TT.T....T..T.T.T.TT@@@@@@
@@@@@@@@@@@@@@@@@@@@@@@@@@..T.TT@@@TTTT.TT....T.T...TTTT.TTT.TT..TT.TTTTTT@@@@@@
@@@@@@@@@@@@@@@@@@@@@@@@@.T.T..@@@@@T....T.T...TT.T....TTTT.TTTTT..T.T.TT@@@@@@@
@@@@@@@@@@@@@@@@@@@@@@@@..T.T.@@@@@@.TT.T.T..T.T.T..TTTT..T..TT.T..TTTTT.@@@@@@@
@@@@@@@@@@@@@@@@@@@@@@@T..T....@@@@@.T.TT..TT.T..TT.T.TTTT.TT..TTTT...TT@@@@@@@@
@@@@@@@@@@@@@@@@@@@@@@TT.TT..T.T.TTTTTTT....T.T..TTTTTTT....T..TT.TT....@@@@@@@@
@@@@@@@@@@@@@@@@@@@@@..TTT.TTT..TTT..TT..T..TTT.T.T.TT.TT.TT..T..TT..TT.@@@@@@@@
@@@@@@@@@@@@@@@@@@@@@...T...T..T.T.T..TTT.TTTT.....T..T.TTT..TT..TT...T@@@@@@@@@
@@@@@@@@@@@@@@@@@@@@@.T.T.TTT..TT.T.TTTTT.TTTT.TT....TTTTTTTT.TT..T.TTT@@@@@@@@@
@@@@@@@@@@@@@@@@@@@@.T..T.T@@@@TT.TT.T.TTTT...T.T...T.TTTT.TTTT...T..T@@@@@@@@@@
@@@@@@@@@@@@@@@@@@@@.TT....@@@@...TT.TT...TTT.....T...T....TTTTTTT.T..@@@@@@@@@@
@@@@@@@@@@@@@@@@@@@@.T.T.T.@@@@T.TTTTTTTT.T.....T...T....T..TTT.TTTT.T@@@@@@@@@@
@@@@@@@@@@@@@@@@@@@.T.TT..T@@@@.TTT...T...T..T..T.T.TTT...T....T..T...@@@@@@@@@@
@@@@@@@@@@@@@@@@@@@...T.T.TTTT...TTTTTT....TTT..T.T.TTTTT....T...T..T.@@@@@@@@@@
@@@@@@@@@@@@@@@@@@.TT...T...T.T..TTTTT.TT..T..TTTT...T.TTTTTTT....TT.T@@@@@@@@@@
@@@@@@@@@@@@@@@@@@T..T.T....T..TTTTTT...TTT..TTT.T..TT.T............TT@@@@@@@@@@
@@@@@@@@@@@@@@@@@@....T..T..T....TTTTTTTT.TTT..TT..T..TT.TT...TT.TT..T@@@@@@@@@@
@@@@@@@@@@@@@@@@@TT..TT.TTTT..T.T.TTT.TT....TT...TT.TTT.TT.TTT...TTT.T@@@@@@@@@@
@@@@@@@@@@@@@@@@@TT.TT.....T...T..TT..TTT..TTTTTTT.T.TT....TTTTTT.TTT.@@@@@@@@@@
@@@@@@@@@@@@@@@@@.T....T.T.TT...TT.TT.TTT....TTTT......T..T.TT.TT...T.@@@@@@@@@@
@@@@@@@@@@@@@@@@.T.T.TTT.T..TT...TT.T.T.TT.TTT..TTT.T.......T.T...TT..@@@@@@@@@@
@@@@@@@@@@@@@@@@.TT..T..T..T.T.T.T..T.TTT.TT..TTTT....TT.TTT.T...TT.TT@@@@@@@@@@
@@@@@@@@@@@@@@@.T.T.T.TT..TT.TTTT..TT.TT......TT.TTT..T..TTT.TTTTT.TTT@@@@@@@@@@
@@@@@@@@@@@@@@@T.T.T.TTT..T.TTTT.T..T.TTTTTTTTT...TT.T....TTTT.TTT.T..@@@@@@@@@@
@@@@@@@@@@@@@@..TT..TT.T.T..TTT..T..T.T.TTT.T.T.T.TT..TTT.TT..TT...TT@@@@@@@@@@@
@@@@@@@@@@@@@.TT.T..TTTT......T.T...T.T.TT.T..TTTT.TT.......TTTTT....@@@@@@@@@@@
@@@@@@@@@@@@.........T.TTT.T..TT.TT.T......T......T..TT.....TT...T.T.@@@@@@@@@@@
@@@@@@@@@@@TTT.T.........T.TT.TTT.....TTTT.TTT...TTTT...TT....TT.TTTT@@@@@@@@@@@
@@@@@@@@@.T...T.T......TT....T.......TTT....TTT.T....T.TT.T..T..TT...@@@@@@@@@@@
@@@@@@@.TT.T.T.TTTT...TTTTTT.T.T..TTTTTT.T.......TT.TT...T.T..TTT.T@@@@@@@@@@@@@
@@@@@.T.T.T.T...T....TTT.T.....TTT...T..TTT....TTT..T.T.T...T.T.T.T@@@@@@@@@@@@@
@@@@@@TTTT...TT..TTT....TT.T..T...TT.TT..TT.TTTT.T..TT.TTTT.T.T...@@@@@@@@@@@@@@
@@@@@@@.T@@@@@..TTTT.TT..TT.T..TTT..T.....T.TT..TTT.TT.T..TT.T.TT@@@@@@@@@@@@@@@
@@@@@@@T@@@@@@TTT...T..T.T.T.TT..TT.TTT..TT..T..TTT.TT..TT..TT.T@@@@@@@@@@@@@@@@
@@@@@@..@@@@@@@TT.TTTT...T.TT..T..TT...T..TT.T...TT.TT..T..T.TT@@@@@@@@@@@@@@@@@
@@@@@@T..@@@@@@T...T.TT.T...T.T..TTTT..T.T.T...TTT..T....T.T..@@@@@@@@@@@@@@@@@@
@@T.TTTT.@@@@@@TT..T..T.T.T.TTTTT.TT.....TTT...T.T.TT.TT..TT@@@@@@@@@@@@@@@@@@@@
@@T..TT.TT..T..TTT...T.T..T.T.TTT.TTTTTTTT.TTT.T.T..TTTTTT@@@@@@@@@@@@@@@@@@@@@@
@@T.T..T....T.TTTTTT.TT.T.T..T.T.T...TTTT..T.TTT.....TTT.@@@@@@@@@@@@@@@@@@@@@@@
@@TT..T.T.T.T...TTTTT..TT.....TTTTT....TTT..TT.T.T...TT@@@@@@@@@@@@@@@@@@@@@@@@@
@@....TT.T.T..T....TT.T....TTT...T...TT.TT.TTTT..TTT.@@@@@@@@@@@@@@@@@@@@@@@@@@@
@@TT.TTT.TT.T...TT.TTT.T.T..T.TTTTT..TTT.T.T....T..@@@@@@@@@@@@@@@@@@@@@@@@@@@@@
@@T.....T.T.TTTTTT.TT.TTT..T...T.T.T...TTTT.TTTT.T@@@@@@@@@@@@@@@@@@@@@@@@@@@@@@
@@....T.TT...T...TTT.TTTTT...T...T.TT.T..T....T.T@@@@@@@@@@@@@@@@@@@@@@@@@@@@@@@
@@.T.TTT..TTT.T....T.T..T.T.T.TTTT..TT...T.T..TT@@@@@@@@@@@@@@@@@@@@@@@@@@@@@@@@
@@.....TT.T.T.TTT..TT.TTT.T....TT.TTTT.TTTTTT..@@@@@@@@@@@@@@@@@@@@@@@@@@@@@@@@@
@@TT..TTT.TT.TTTT.TT.TT.TT.TTTTTT...T..T.TTTTT@@@@@@@@@@@@@@@@@@@@@@@@@@@@@@@@@@
@@T......TTT...T..T.T.T...TTT..T.T..TTT.TTTT.@@@@@@@@@@@@@@@@@@@@@@@@@@@@@@@@@@@
@@T.T..TT.T.TTT.T..TTTTT....T.T.T..T.T.TT...@@@@@@@@@@@@@@@@@@@@@@@@@@@@@@@@@@@@
@@T.T....TT..TT....T....TTTTT..T.T...TT..TT.@@@@@@@@@@@@@@@@@@@@@@@@@@@@@@@@@@@@
@@..TT.TTT.....TTTTTT.TT.TT.TT.TTT.T.......@@@@@@@@@@@@@@@@@@@@@@@@@@@@@@@@@@@@@
@@.T..TT...T..T..T.TTT..TT...T.TT....TTT.T.@@@@@@@@@@@@@@@@@@@@@@@@@@@@@@@@@@@@@
@@.T.TTTT...TT.TT.T....TTTT.TT.T.T..TT.T.T@@@@@@@@@@@@@@@@@@@@@@@@@@@@@@@@@@@@@@
@@........TTT...TT.T..T.T.TTTTT.T..T.TTTT@@@@@@@@@@@@@@@@@@@@@@@@@@@@@@@@@@@@@@@
@@.T.T.TTTTT.TT.TTTTT..TT..T.T...TTT..TT.@@@@@@@@@@@@@@@@@@@@@@@@@@@@@@@@@@@@@@@
@@T.TT.TT.TT.T.T.T..T....T..TTTTTTT.TTT.T@@@@@@@@@@@@@@@@@@@@@@@@@@@@@@@@@@@@@@@
@@..T.T..TT...T.T..TT..TT.TTT....TT.TTT.@@@@@@@@@@@@@@@@@@@@@@@@@@@@@@@@@@@@@@@@
@@TT.T....T.TT.TT.....T.T...T..T.T..T..T@@@@@@@@@@@@@@@@@@@@@@@@@@@@@@@@@@@@@@@@
@@..TT.TTT...TT..T.T.TT.....TT.TT...TTTT@@@@@@@@@@@@@@@@@@@@@@@@@@@@@@@@@@@@@@@@
@@T..T...TT..T...TTTTT..TTT..TT..T..T.T@@@@@@@@@@@@@@@@@@@@@@@@@@@@@@@@@@@@@@@@@
@@T.TTT..TTTTT.T....TTTT.TTT.T.T...TTT.@@@@@@@@@@@@@@@@@@@@@@@@@@@@@@@@@@@@@@@@@
@@.T.T..TTT.T.T.TT.T..T...TTTTTTT.TT.T.@@@@@@@@@@@@@@@@@@@@@@@@@@@@@@@@@@@@@@@@@
@@T..TT..TT..TT.TT.....T.TT.TT.T.TT..TT@@@@@@@@@@@@@@@@@@@@@@@@@@@@@@@@@@@@@@@@@
@@...TT..TT.....TTTT.TT.T.T.TT..TT..T..@@@@@@@@@@@@@@@@@@@@@@@@@@@@@@@@@@@@@@@@@
@@TT.T..TT.TT.....T......TT.TTT..TTT.TT@@@@@@@@@@@@@@@@@@@@@@@@@@@@@@@@@@@@@@@@@
@@.TTT..TT.TTTT...T.T.TT.T.TT.T..TT.TTT@@@@@@@@@@@@@@@@@@@@@@@@@@@@@@@@@@@@@@@@@
@@@@@@@@@@@@@@@@@@@@@@@@@@@@@@@@@@@@@@@@@@@@@@@@@@@@@@@@@@@@@@@@@@@@@@@@@@@@@@@@
@@@@@@@@@@@@@@@@@@@@@@@@@@@@@@@@@@@@@@@@@@@@@@@@@@@@@@@@@@@@@@@@@@@@@@@@@@@@@@@@
