type octile
height 70
width 68
map
@@@@@@@@@@@@@@@@@@@@@@@@@@@@@@@@@@@@@@@@@@@@@@@@@@@@@@@@@@@@@@@@@@@@
@@@@@@@@@@@@@@@@@@@@@@@@@@@@@@@@@@@@@@@@@@@@@@@@@@@@@@@@@@@@@@@@@@@@
@@@@@@@@@@@@@@@@@@@@@@@@@@@@@@@@@@@@@@@@@@@@@@@@@@@@@@@@@@@@@@@@@@@@
@@@@@@@@@@@@@@@@@@@@@@@@@@@@@@@@@@@@@@@@@@@@@@@@@@@@@@@@@@@@@@@@@@@@
@@@@@@@@@@@@@@@@@@@@@@@@@@@@@@@@@@@@@@@@@@@@@@@@@@@@@@@@@@@@@@@@@@@@
@@@@@@@@@@@@@@@@@@@@@@@@@@@@@@@@@@@@@@@@@@@@@@@@@@@@@@@@@@@@@@@@@@@@
@@@@@@@@@@@@@@@@@@@@@@@@@@@@@@@@@@@@@@@@@@@@@@@@@@@@@@@@@@@@@@@@@@@@
@@@@@@@@@@@@@@@@@@@@@@@@@@@@@@@@@@@@@@@@@@@@@@@@@@@@@@@@@@@@@@@@@@@@
@@@@@@@@@@@@@@@@@@@@@@@@@@@@@@@@@@@@@@@@@@@@@@@@@@@@@@@@@@@@@@@@@@@@
@@@@@@@@@@@@@@@@@@@@@@@@@@@@@@@@@@@@@@@@@@@@@@@@@@@@@@@@@@@@@@@@@@@@
@@@@@@@@@@@@@@@@@@@@@@@@@@@@@@@@T@@@@@@@@@@@@@@@@@@@@@@@@@@@@@@@@@@@
@@@@@@@@@@@@@@@@@@@@@@@@@@@@@@@T..@@@@@@@@@@@@@@@@@@@@@@@@@@@@@@@@@@
@@@@@@@@@@@@@@@@@@@@@@@@@@@@@@.TT.T@@@@@@@@@@@@@@@@@@@@@@@@@@@@@@@@@
@@@@@@@@@@@@@@@@@@@@@@@@@@@@@..T.TT.@@@@@@@@@@@@@@@@@@@@@@@@@@@@@@@@
@@@@@@@@@@@@@@@@@@@@@@@@@@@@@T.TTT.TT@@@@@@@@@@@@@@@@@@@@@@@@@@@@@@@
@@@@@@@@@@@@@@@@@@@@@@@@@@@@@TT.T.T.TT.T@@@@@@@@@@@@@@@@@@@@@@@@@@@@
@@@@@@@@@@@@@@@@@@@@@@@@@@@@..TT...TT.T.T@@@@@@@@@@@@@@@@@@@@@@@@@@@
@@@@@@@@@@@@@@@@@@@@@@@@@T@T...T.T...T..T.@@@@@@@@@@@@@@@@@@@@@@@@@@
@@@@@@@@@@@@@@@@@@@@@@@@T.T.T.T@@@...T...T.@@@@@@@@@@@@@@@@@@@@@@@@@
@@@@@@@@@@@@@@@@@@@@@@@T..TT..@@@@T..@@.TT.T@@@@@@@@@@@@@@@@@@@@@@@@
@@@@@@@@@@@@@@@@@@@@@@..TT..T@@@@@@@..@@T.TTT@@@@@@@@@@@@@@@@@@@@@@@
@@@@@@@@@@@@@@@@@@@@@TTTTTTTT@@@@@@@@TT@@.T.TT@@@@@@@@@@@@@@@@@@@@@@
@@@@@@@@@@@@@@@@@@@@T..T.T.T...@@@@@@@.T@TT.T.T@@@@@@@@@@@@@@@@@@@@@
@@@@@@@@@@@@@@@@@@@@@TTT.T.T.T.@@@@@@@@.T.T..T..@@@@@@@@@@@@@@@@@@@@
@@@@@@@@@@@@@@@@@.@@@@T.TTT.TT.T@@@@@@@TTT.T.TT.T@@@@@@@@@@@@@@@@@@@
@@@@@@@@@@@@@@@@T.T@@@@TT.TT.@@..@@@@@...TTTTT....@@@@@@@@@@@@@@@@@@
@@@@@@@@@@@@@@@@@...@@@@...T.T@@TT@@@T.T...TT.TTTT@@@@@@@@@@@@@@@@@@
@@@@@@@@@@@@@@@@@@...@@@@.T..TT@@.T@T.TTT...T....@@@@@@@@@@@@@@@@@@@
@@@@@@@@@@@@@@@@@@@.T@@@@@TTT.T.@@.T..TTT.......@@@@@@@@@@@@@@@@@@@@
@@@@@@@@@@@@@@@@@@@@.@@@@@@TTT...T.T.T.TT.TTT..@@@@@@@@@@@@@@@@@@@@@
@@@@@@@@@@@@@T@@@@@.TT@@@@@@T.T....TTT.TT...T.@@@@@@@@@@@@@@@@@@@@@@
@@@@@@@@@@@@TT.@@@T.TTT@@@@@@T.TT..T....TTT..@@@@@@@@@@.@@@@@@@@@@@@
@@@@@@@@@@@TT.T.@T.TT.TTTT@@@@...TTT.TT.T.T.@@@@@@@@@@T..@@@@@@@@@@@
@@@@@@@@@@@@TT..TTTTT....T.T@@@@.T..T.TT.TT@@@@@@@@T..T.T@@@@@@@@@@@
@@@@@@@@@@@@@.TT.T.T..TTTT.TT@@@@.TT..T.T.@@@@@@@@@TTTT..T@@@@@@@@@@
@@@@@@@@@@@@@@T..T..TT....TTT@@@@.T..TTT.@@@@@@@@TTTT.@@..@@@@@@@@@@
@@@@@.T.@@@@@.TT..TTTT.TTT..T@@@@TTT..TT@@@@@@....T.T@@@@..@@@@@@@@@
@@@@@@...@@@TT..T.T.T..TT..T.T.T.TTTTTT..@@@@..T...T@@@@@TT..@@@@@@@
@@@@@@@..T@.TT....TT.....T@TTTTT.TTTT....TTTTTT.TT.@@@@@@...TT@@@@@@
@@@@@@@@.TTT.T..TT.TTT.TT@@@.....T.T.T...T.TTTTT.TT@@@@@TT.TT@@@@@@@
@@@@@@@@@TTT.T.TT..T..TT@@@TTT..T.....T.TTT.T......@@@@.TTT.@@@@@@@@
@@@@@@@@@@..TTTT..T....@@@TT...TTTT...TTT...T.T@...@@@@TT.@@@@@@@@@@
@@@@@@@@@@@.TTTTT.TT..@@@T........TTTT..T.T.T.@@@....@@.T@@@@@@@@@@@
@@@@@@@@@@@@......TTT@@@...T.TT.TT.TT....T..T.@@@@.T.T..@@@@@@@@@@@@
@@@@@@@@@@@@@TT..T.T@@@@T.......T.T....TTT.....@@@@TT.T@@@@@@@@@@@@@
@@@@@@@@@@@@@....T.@@@@@..TTT....T..T.TT.TT.TTTTT@@@T.@@@@@@@@@@@@@@
@@@@@@@@@@@@@@TT..@@@@@.T.T...T.@@....T.T.TTTT..TT@@@@@@@@@@@@@@@@@@
@@@@@@@@@@@@@@@TT@@@.T.....TTT.@@@@@...TT.TT.T..TTT@@@@@@@@@@@@@@@@@
@@@@@@@@@@@@@@@@@@@...T.TT.TT@@@@@@@TTT......TTT.TT@@@@@@@@@@@@@@@@@
@@@@@@@@@@@@@@@@@@TT.TTTT.TT.@@@@@@@T.T.T.T.TTT...@@@@@@@@@@@@@@@@@@
@@@@@@@@@@@@@@@@@@TTTTTTTTTT.T@@@@@@T@@@....T....@@@@@@@@@@@@@@@@@@@
@@@@@@@@@@@@@@@@@@@.TT.T...TT@@@@@@@@@@@TT.T.TTT@@@@@@@@@@@@@@@@@@@@
@@@@@@@@@@@@@@@@@@@@T.TT.T..@@@@@@@@@@@@...TTTT@@@@@@@@@@@@@@@@@@@@@
@@@@@@@@@@@@@@@@@@@@@T.TT..T@@@@@@@@@@@.T....T@@@@@@@@@@@@@@@@@@@@@@
@@@@@@@@@@@@@@@@@@@@@@.TTT.T.@@@@@@@@@.TT....@@@@@@@@@@@@@@@@@@@@@@@
@@@@@@@@@@@@@@@@@@@@@@@T.T..TT@@@@@@@T..T.T.@@@@@@@@@@@@@@@@@@@@@@@@
@@@@@@@@@@@@@@@@@@@@@@@@TT.T.T.@@@@@T..TT..@@@@@@@@@@@@@@@@@@@@@@@@@
@@@@@@@@@@@@@@@@@@@@@@@@@T.....TTTT.TT..TT@@@@@@@@@@@@@@@@@@@@@@@@@@
@@@@@@@@@@@@@@@@@@@@@@@@@@TTTTTT..TT..TT.@@@@@@@@@@@@@@@@@@@@@@@@@@@
@@@@@@@@@@@@@@@@@@@@@@@@@@@T.TT..T..T...@@@@@@@@@@@@@@@@@@@@@@@@@@@@
@@@@@@@@@@@@@@@@@@@@@@@@@@@@.T..TT..TTT@@@@@@@@@@@@@@@@@@@@@@@@@@@@@
@@@@@@@@@@@@@@@@@@@@@@@@@@@@@T...TT..T@@@@@@@@@@@@@@@@@@@@@@@@@@@@@@
@@@@@@@@@@@@@@@@@@@@@@@@@@@@@@.T....T@@@@@@@@@@@@@@@@@@@@@@@@@@@@@@@
@@@@@@@@@@@@@@@@@@@@@@@@@@@@@@@@..T.@@@@@@@@@@@@@@@@@@@@@@@@@@@@@@@@
@@@@@@@@@@@@@@@@@@@@@@@@@@@@@@@@@@@@@@@@@@@@@@@@@@@@@@@@@@@@@@@@@@@@
@@@@@@@@@@@@@@@@@@@@@@@@@@@@@@@@@@@@@@@@@@@@@@@@@@@@@@@@@@@@@@@@@@@@
@@@@@@@@@@@@@@@@@@@@@@@@@@@@@@@@@@@@@@@@@@@@@@@@@@@@@@@@@@@@@@@@@@@@
@@@@@@@@@@@@@@@@@@@@@@@@@@@@@@@@@@@@@@@@@@@@@@@@@@@@@@@@@@@@@@@@@@@@
@@@@@@@@@@@@@@@@@@@@@@@@@@@@@@@@@@@@@@@@@@@@@@@@@@@@@@@@@@@@@@@@@@@@
@@@@@@@@@@@@@@@@@@@@@@@@@@@@@@@@@@@@@@@@@@@@@@@@@@@@@@@@@@@@@@@@@@@@
