type octile
height 59
width 56
map
@@@@@@@@@@@@@@@@@@@@@@@@@@@@@@@@@@@@@@@@@@@@@@@@@@@@@@@@
@@@@@@@@@@@@@@@@@@@@@@@@@@@@@@@@@@@@@@@@@@@@@@@@@@@@@@@@
@@@@@@@@@@@@@@@@@@@@@@@@@@@@@@@@@@@@@@@@@@@@@@@@@@@@@@@@
@@@@@@@@@@@@@@@@@@@@@@@@@@@@@@@@@@@@@@@@@@@@@@@@@@@@@@@@
@@@@@@@@@@@@@@@@@@@@@@@@@@@@@@@@@@@@@@@@@@@@@@@@@@@@@@@@
@@@@@@@@@@@@@@@@@@@@@@@@@@@@@@@@@@@@@@@@@@@@@@@@@@@@@@@@
@@@@@@@@@@@@@@@@@@@@@@@@@@@@@@@@@@@@@@@@@@@@@@@@@@@@@@@@
@@@@@@@@@@@@@@@@@@@@@@@@@@@@@@@@@@@@@@@@@@@@@@@@@@@@@@@@
@@@@@@@@@@@@@@@@@@@@@@@@@@@@@@@@@@@@@@@@@@@@@@@@@@@@@@@@
@@@@@@@@@@@@@@@@@@@@@@@@@@@@@@@@@@@@@@@@@@@@@@@@@@@@@@@@
@@@@@@@@@@@@@@@@@@@@@@@@@@@@@..@@@@@@@@@@@@@@@@@@@@@@@@@
@@@@@@@@@@@@@@@@@@@@@@@@@@@@@@..@@@@@@@@@@@@@@@@@@@@@@@@
@@@@@@@@@@@@@@@@@@@@@@@@@@@@@@@TT@@@@@@@@@@@@@@@@@@@@@@@
@@@@@@@@@@@@@@@@@@@@@@@@@@@@@@@@...T@@@@@@@@@@@@@@@@@@@@
@@@@@@@@@@@@@@@@@@@@@@@@@@@@@@@@@TTT.@@@@@@@@@@@@@@@@@@@
@@@@@@@@@@@@@@@@@@@@@@@@@@@@@@@@@@.T..@@@@@.@@@@@@@@@@@@
@@@@@@@@@@@@@@@@@@@@@@@..@@@@@@@@@.T.TT@@@T..@@@@@@@@@@@
@@@@@@@@@@@@@@@@@@@@@@T.T@@@@@@@@@TT.T.T@.TT@@@@@@@@@@@@
@@@@@@@@@@@@@@@@@@@@@TTTT..@@@@@@TTTTT.TTTT@@@@@@@@@@@@@
@@@@@@@@@@@@@@@@@@@@TT.TTT@@@@@@.TT.TTT.TTT@@@@@@@@@@@@@
@@@@@@@@@@@@@@@@@@@@@T....@@@@@T..T.TTT.TT.T@@@@@@@@@@@@
@@@@@@@@@@@@@@@@@@@@@@.TT.T@@@T.TT.T.TTTTTTT.@@@@@@@@@@@
@@@@@@@@@@@@@@@@@@@@@@@T.TT.TT.....T.T......T@@@@@@@@@@@
@@@@@@@@@@@@@@@@@@@@@@@@.TTT.TT.T...T.T.T@@@@@@@@@@@@@@@
@@@@@@@@@@@@@@@@@@@@@@@@@TTT....T..TTTTTT@@@@@@@@@@@@@@@
@@@@@@@@@@@@@@@@@@@@@@@@@T.TTTTT.T..TTT..@TT..T@@@@@@@@@
@@@@@@@@@@@@@@@T.@@@@@@.TTTT.TT..T..T...T@TT.T...T@@@@@@
@@@@@@@@@@@@.T.TT@@@@@@.TT...T...TTT...TTTTTTT@@@..@@@@@
@@@@@@@@@@@TTTT.T@@@@T..TT......T...T.TT.T.T.T@@@@TT@@@@
@@@@@@@@@@T..TT..@@@@..TT..T..TTTTTT...T@@..T.@@@@..@@@@
@@@@@@@@@@TTT...T..TTT.T..T......TTTTTT.@@TTT@@@@@.@@@@@
@@@@@@@@@@@..TT.....TTT..T.T.T..........@@T..@@@@@@@@@@@
@@@@@@@@@@@@@TTTTT.TT.....T..TTTT.T..T..@@.TTT@@@@@@@@@@
@@@@@@@@@@@@@@TTT.TTT.TT.TTTT..T...TT...@@TT..TT@@@@@@@@
@@@@.@@@@@@@@@@.T..TTT.T...T.T.....T...@@TTT.TTT@@@@@@@@
@@@..T@@@@@@@@@...TT..TT.T.T....TT.TT.T@@@T...T@@@@@@@@@
@@T...T@@@@@@...TTTT...TTT.T.T....T...T.@@T..T@@@@@@@@@@
@@T..TT@@@@@T.TT....TT..T.T.TTT.@@TTT.T.T@T.T@@@@@@@@@@@
@@TTT.T.@@TT.T.T.......TT.T.....@@T.T.T..TTT@@@@@@@@@@@@
@@..TTT.TTT.TT.TT..T..........T@@@@.T....T.@@@@@@@@@@@@@
@@@.T......T..T....TTTT......@@@@@@@@T....@@@@@@@@@@@@@@
@@@@T.TTT.TT..TTTT..T....T...@@@@@@@@T.TT@@@@@@@@@@@@@@@
@@@@@......T..TTTTT....T.TT..@@@@@@@.TTT@@@@@@@@@@@@@@@@
@@@@@@T..T.T..TT.TTT.T.TTTTT...@@@@...@@@@@@@@@@@@@@@@@@
@@@@@@@.T.T...T..TT.TT.T....TT.T.....@@@@@@@@@@@@@@@@@@@
@@@@@@@@.T..T..TT.T....@@T.TTTTT.T.T@@@@@@@@@@@@@@@@@@@@
@@@@@@@@@T.T..T.T..TT.T@@@TTT.TTTT.@@@@@@@@@@@@@@@@@@@@@
@@@@@@@@@@T.T...T...TT@@@@T.T....T@@@@@@@@@@@@@@@@@@@@@@
@@@@@@@@@@@.TT..T...@@@@@@T..TTT.@@@@@@@@@@@@@@@@@@@@@@@
@@@@@@@@@@@@..T..TT.@@@@@@@.T.TT@@@@@@@@@@@@@@@@@@@@@@@@
@@@@@@@@@@@@@.T.T.TTTT@@@@@T.TT@@@@@@@@@@@@@@@@@@@@@@@@@
@@@@@@@@@@@@@@.TT..TT.T@@@@TTT@@@@@@@@@@@@@@@@@@@@@@@@@@
@@@@@@@@@@@@@@@T.T.TT.TT..TT.@@@@@@@@@@@@@@@@@@@@@@@@@@@
@@@@@@@@@@@@@@@@TTT.TT...TT.@@@@@@@@@@@@@@@@@@@@@@@@@@@@
@@@@@@@@@@@@@@@@@TTTT.TTT.T@@@@@@@@@@@@@@@@@@@@@@@@@@@@@
@@@@@@@@@@@@@@@@@@...T...T@@@@@@@@@@@@@@@@@@@@@@@@@@@@@@
@@@@@@@@@@@@@@@@@@@.T..T.@@@@@@@@@@@@@@@@@@@@@@@@@@@@@@@
@@@@@@@@@@@@@@@@@@@@TT.T@@@@@@@@@@@@@@@@@@@@@@@@@@@@@@@@
@@@@@@@@@@@@@@@@@@@@@@@@@@@@@@@@@@@@@@@@@@@@@@@@@@@@@@@@
