type octile
height 54
width 52
map
@@@@@@@@@@@@@@@@@@@@@@@@@@@@@@@@@@@@@@@@@@@@@@@@@@@@
@@@@@@@@@@@@@@@@@@@@@@@@@@@@@@@@@@@@@@@@@@@@@@@@@@@@
@@@@@@@@@@@@@@@@@@@@@@@@@@@@@@@@@@@@@@@@@@@@@@@@@@@@
@@@@@@@@@@@@@@@@@@@@@@@@@@@@@@@@@@@@@@@@@@@@@@@@@@@@
@@@@@@@@@@@@@@@@@@@@@@@@@@@@@@@@@@@@@@@@@@@@@@@@@@@@
@@@@@@@@@@@@@@@@@@@@@@@@@@@@@@@@@@@@@@@@@@@@@@@@@@@@
@@@@@@@@@@@@@@@@@@@@@@@@@@@@@@@@@@@@@@@@@@@@@@@@@@@@
@@@@@@@@@@@@@@@@@@@@@@@@@@@@@@@@@@@@@@@@@@@@@@@@@@@@
@@@@@@@@@@@@@@@@@@@@@@@@@@@@@@@@@@@@@@@@@@@@@@@@@@@@
@@@@@@@@@@@@@@@@@@@@@@@@@@@@@@@@@@@@@@@@@@@@@@@@@@@@
@@@@@@@@@@@@@@@@@@@@@@@@@@@@@@@@@@@@@@@@@@@@@@@@@@@@
@@@@@@@@@@@@@@@@@@@@@@@@@@@@@@@T@@@@@@@@@@@@@@@@@@@@
@@@@@@@@@@@@@@@@@@@@@@@@@@@@@@@T.@@@@@@@@@@@@@@@@@@@
@@@@@@@@@@@@@@@@@@@@@@@@@@@@@@@..T@@@@@@@@@@@@@@@@@@
@@@@@@@@@@@@@@@@@@@@@@@@@@@@@@@@TT.@@@@@@@@@@@@@@@@@
@@@@@@@@@@@@@@@@@@@@@@@@@@@T@@@....@@@@@@@@@@@@@@@@@
@@@@@@@@@@@@@@@@@@@@@@@@@@TT..T.T.@@@@@@@@@@@@@@@@@@
@@@@@@@@@@@@@@@@@@@@@@@@@T.T.T.T.@@@@@@@@@@@@@@@@@@@
@@@@@@@@@@@@@@@@@@@@@@@@.TTTTTT.@@@@@@@@@@@@@@@@@@@@
@@@@@@@@@@@@@@@@@@@@@@@TTTT.TT.@@@@@@@@@@@@@@@@@@@@@
@@@@@@@@@@@@@@@@@@@@@@.TT..TT.@@@@@@@@T@.@@@@@@@@@@@
@@@@@@@@@@@@@@@@@@@@@@......T.@@@@@@@...T.@@@@@@@@@@
@@@@@@@@@@@@@@@@@@@@@@.T......T@@@@@.T.T.TT@@@@@@@@@
@@@@@@@@@@@@@@@@@@@@T....T...TT.@@@...T..TT.@@@@@@@@
@@@@@@@@@@@@@@@@@@@T...TTT..TTT.TT...T.T.T...@@@@@@@
@@@@@@@@@@@@@@@@@@T.TTT..T..T.TT...TTT..T.TTT@@@@@@@
@@@@@@@@@@@@@@@@T..T.TTT@@@..T.T.TTTT.T.TTTT@@@@@@@@
@@@@@@@@@@@@@@@.T..TTT.T@@@@@TTT.T....TTT..@@@@@@@@@
@@@@@@@@@@@@@@TTT.T..TTT.@@@@@.TTT....T.T.@@@@@@@@@@
@@@@@@@@@@@@@TT....@.TTTT..@@@.T..T..T.T.@@@@@@@@@@@
@@@@@@@@@@@.T.TTT@@@@T@@@@T@@...TTT...TT@@@@@@@@@@@@
@@@@@@@@@@TT..TTTT@@@@@@@@..T..T.......@@@@@@@@@@@@@
@@@@@@@@@@@@TTTTTT@@@@@@@@.TTT.T..T...@@@@@@@@@@@@@@
@@@@@@@@@@@@@TTT...@@@@@@.TT.T..T...T@@@@@@@@@@@@@@@
@@@@@@@@@@@@@@.T.TT.@@@@@@.T...T..T.@@@@@@@@@@@@@@@@
@@@@@@@@@@@@@@T.TT.T.@@@@@TT.T.TT.T@@@@@@@@@@@@@@@@@
@@@@@@@@@@@@@.TT.T...T@@@TT..T..TT@@@@@@@@@@@@@@@@@@
@@@@@@@.TTTT..TT.TTTT.....TTT.T..@@@@@@@@@@@@@@@@@@@
@@@@@@@@.TT.T...TT.T..T.....TTTT@@@@@@@@@@@@@@@@@@@@
@@@@@@@@@TT.TT.T..T.T..T.T.TTT.@@@@@@@@@@@@@@@@@@@@@
@@@@@@@@@@TTT.TT..TT.TTT..T...@@@@@@@@@@@@@@@@@@@@@@
@@@@@@@@@@@.T...T.T.TTT...TT.@@@@@@@@@@@@@@@@@@@@@@@
@@@@@@@@@@@@..T...T..TT...T.@@@@@@@@@@@@@@@@@@@@@@@@
@@@@@@@@@@@@@T.T..TTTTTTT.T@@@@@@@@@@@@@@@@@@@@@@@@@
@@@@@@@@@@@@@@TT.T...T...T@@@@@@@@@@@@@@@@@@@@@@@@@@
@@@@@@@@@@@@@@@TTTTTTTT.T@@@@@@@@@@@@@@@@@@@@@@@@@@@
@@@@@@@@@@@@@@@@.....T..@@@@@@@@@@@@@@@@@@@@@@@@@@@@
@@@@@@@@@@@@@@@@@..T.TT@@@@@@@@@@@@@@@@@@@@@@@@@@@@@
@@@@@@@@@@@@@@@@@@.T..@@@@@@@@@@@@@@@@@@@@@@@@@@@@@@
@@@@@@@@@@@@@@@@@@@TT@@@@@@@@@@@@@@@@@@@@@@@@@@@@@@@
@@@@@@@@@@@@@@@@@@@@@@@@@@@@@@@@@@@@@@@@@@@@@@@@@@@@
@@@@@@@@@@@@@@@@@@@@@@@@@@@@@@@@@@@@@@@@@@@@@@@@@@@@
@@@@@@@@@@@@@@@@@@@@@@@@@@@@@@@@@@@@@@@@@@@@@@@@@@@@
@@@@@@@@@@@@@@@@@@@@@@@@@@@@@@@@@@@@@@@@@@@@@@@@@@@@
