type octile
height 86
width 80
map
@@@@@@@@@@@@@@@@@@@@@@@@@@@@@@@@@@@@@@@@@@@@@@@@@@@@@@@@@@@@@@@@@@@@@@@@@@@@@@@@
@@@@@@@@@@@@@@@@@@@@@@@@@@@@@@@@@@@@@@@@@@@@@@@@@@@@@@@@@@@@@@@@@@@@@@@@@@@@@@@@
@@@@@@@@@@@@@@@@@@@@@@@@@@@@@@@@@@@@@@@@@@@@@@@@@@@@@@@@@@@@@@@@@@@@@@@@@@@@@@@@
@@@@@@@@@@@@@@@@@@@@@@@@@@@@@@@@@@@@@@@@@@@@@@@@@@@@@@@@@@@@@@@@@@@@@@@@@@@@@@@@
@@@@@@@@@@@@@@@@@@@@@@@@@@@@@@@@@@@@@@@@@@@@@@@@@@@@@@@@@@@@@@@@@@@@@@@@@@@@@@@@
@@@@@@@@@@@@@@@@@@@@@@@@@@@@@@@@@@@@@@@@@@@@@@@@@@@@@@@@@@@@@@@@@@@@@@@@@@@@@@@@
@@@@@@@@@@@@@@@@@@@@@@@@@@@@@@@@@@@@@@@@@@@@@@@@@@@@@@@@@@@@@@@@@@@@@@@@@@@@@@@@
@@@@@@@@@@@@@@@@@@@@@@@@@@@@@@@@@@@@@@@@@@@@@@@@@@@@@@@@@@@@@@@@@@@@@@@@@@@@@@@@
@@@@@@@@@@@@@@@@@@@@@@@@@@@@@@@@@@@@@@@@@@@@@@@@@@@@@@@@@@@@@@@@@@@@@@@@@@@@@@@@
@@@@@@@@@@@@@@@@@@@@@@@@@@@@@@@@@@@@@@@@@@@@@@@@@@@@@@@@@@@@@@@@@@@@@@@@@@@@@@@@
@@@@@@@@@@@@@@@@@@@@@@@@@@@@@@@@@@@@@@@@@@@@@@@@@@@@@@@@@@@@@@@@@@@@@@@@@@@@@@@@
@@@@@@@@@@@@@@@@@@@@@@@@@@@@@@@@@@@@@@@@@@@@@@@@@@@@@@@@@@@@@@@@@@@@@@@@@@@@@@@@
@@@@@@@@@@@@@@@@@@@@@@@@@@@@@@@@@@@@@@@@@@@@@@@@@@@@@@@@@@@@@@@@@@@@@@@@@@@@@@@@
@@@@@@@@@@@@@@@@@@@@@@@@@@@@@@@@@@@@@@@@@@@@@@@@@@@@@@@@@@@@@@@@@@@@@@@@@@@@@@@@
@@@@@@@@@@@@@@@@@@@@@@@@@@@@@@@@@@@@@@@@@@@@@@@@@@@@@@@@@@@@@@@@@@@@@@@@@@@@@@@@
@@@@@@@@@@@@@@@@@@@@@@@@@@@@@@@@@@@@@@@@@@@@@@@@@@@@@@@@@@@@.@@@@@@@@@@@@@@@@@@@
@@@@@@@@@@@@@@@@@@@@@@@@@@@@@@@@@@@@@@@@@@@@@@@@@@@@@@@@@@@@TT@@@@@@@@@@@@@@@@@@
@@@@@@@@@@@@@@@@@@@@@@@@@@@@@@@@@@@@@@@@@@@@@@@@@@@@@@@@@@@TTT@@@@@@@@@@@@@@@@@@
@@@@@@@@@@@@@@@@@@@@@@@@@@@@@@@@@@@@@@TT@@@@@@@@@@@@@@@@@@..T@@@@@@@@@@@@@@@@@@@
@@@@@@@@@@@@@@@@@@@@@@@@@@@@@@@@@@@..T..TT..T.TTT.T.TT@@@.TTT@@@@@@@@@@@@@@@@@@@
@@@@@@@@@@@@@@@@@@@@@@@@@@@@@@@@@@.....TTT..TTTTT.TTT.TT@.TT@@@@@@@@@@@@@@@@@@@@
@@@@@@@@@@@@@@@@@@@@@@@@@@.T..T.@@..T..T.TT..T....T..TT@@TTT@@@@@@@@@@@@@@@@@@@@
@@@@@@@@@@@@@@@@@@@@@@@@.T..TTT.TTTT...T.T.TT..TTT.T..T@TT.T@@T@@@@@@@@@@@@@@@@@
@@@@@@@@@@@@@@@@@@@@@@..T.T...TTTTT.T......T..T.TT.T.T.@TTT.@..@@@@@@@@@@@@@@@@@
@@@@@@@@@@@@@@@@@@@@@TTT..T.....TTT.TTT.....TT.TTTT...@@..T@@T.@@@@@@@@@@@@@@@@@
@@@@@@@@@@@@@@@@@.@@@TT..T....TT....T.T.....T..T...TT.@.TTT@@TT@@@@@@@@@@@@@@@@@
@@@@@@@@@@@@@@T@@.T@@..T....TTT.T.T.T....T.......T....@.T.T@@TTT@@@@@@@@@@@@@@@@
@@@@@@@@@@@@@@T...T.TT....T....TTTTTT....T.TTT......T@@TTT@@@TTTT@@@@@@@@@@@@@@@
@@@@@@@@@@@@@....TT.T.TTT..TTTT..TT...T.TT.T.T..T.TTT@TTT.@@@.T.TT@@@@@@@@@@@@@@
@@@@@@@@@@@@@.TT.TT..TTT.TTT.....T.T.T.TTTT.TTT.TTT@@@....@@..T.TTT@@@@@@@@@@@@@
@@@@@@@@@@@@..T..TT..TT...T..TTTTT.TTTT...T.T..T...@@@TT.@@@T.T...TT@@@@@@@@@@@@
@@@@@@@@@@@@...TTT...TTT..T.T...TT.TTT.TT....T.TTT@@@.T..@@TTT...T.T.@@@@@@@@@@@
@@@@@@@@@@@.T...TT..T.TTTTTT.TT.TTTT..T..T.TT.TTT.TT.T.T.@@T...TT.TT..@@@@@@@@@@
@@@@@@@@@@.T...TT....TT.TTT.T.TTT.TTT.TT.TT.T..T...TTTT.@@@.T..TT.T..TT@@@@@@@@@
@@@@@@@@@T........TTT.TTTT..T.TTT..T..T.T.TTT.TTTT..TTT@@@@@T..T.......@@@@@@@@@
@@@@@@@@@TT.T..T.TT..T.T...TT...T.T..TT......T.T..T......T.T..T.T.TT...@@@@@@@@@
@@@@@@@@@T.TTT..TT....TT..TTT.TT...T.TT.TT.TTTTT.T...T...T..TTT.TTTTTTT@@@@@@@@@
@@@@@@@@@@.TT.TTT.....T.TT.T.T.TT..TTTTT.TTT....T.T...TT..T.T.TT.TT.TT..@@@@@@@@
@@@@@.@@@@TTTTTTTT.T....T.T.TT.......T..TTTTTT.T.TTTT.TTTT.TT.T..T..T..T@@@@@@@@
@@@@@TTTTT.T.TTTTT...TT...T..TTT.T.TTT....TTTT.TTT.T.T.TT.TT.TT..TTTTT.TT@@@@@@@
@@@@@T...T.T...TTTTTTTTT.T.T.TTTT.TTT...TTT.TTTTT...T..T.......TTTT......@@@@@@@
@@@@@T..T........TT...T....TTTT.TTTT....T.TT...TT.TT..TTTT.T..TT.TTT.TTT..@@@@@@
@@@@@.T....T....T.T....TT.TTTT.TTT.T@@@@@@@TT...TTTT.TTT.TTT......T.TT...TT@@@@@
@@@@@TTTT....TT.T.T...T..TTTT.T...@@@@@@@@@@T..TT.TT.....TT.TT.T...TT.....T@@@@@
@@@@@.TTT.TT...T..T..T.T..T.TTT..T@@@@@@@@@@.TTTT...T.T.T.TT.T.T.....T......@@@@
@@@@@.TT.TTTTTT..T...T.T...TTTT..@@@@@..@@@@T...@@............T..T..T..TTT..T@@@
@@@@@.T.TTTTT...TTT..TTT...T.TT.T@@@TT..@@@TTT.@@@T...TTTTTTT.TT..TT..TTT.T.T@@@
@@@@@...T.....T.T.....TTT...TTTTTT........TT..@@@@.TTTTTTT...TTT.TT.TTT..TTT.@@@
@@@@@.TT..T.TT..T.TTT.....T.T@@TT...T...TT.TT@@@@@@T...TTTT.T..T..TTTTT..TTT.@@@
@@@@@T.T.T.T...TT.....T..T@@.@@@TTT..TT.TTT.T@@@@@@.TTT.....TTTT.TTTTT.TTTT..@@@
@@@@@T..TT..TT..TTTT...T..@@@@@@@.TTT..T.TTTT@@@@@@.TT.T...T..T.TTT...TT.TT..@@@
@@@@@TTT....T.TT.T..TTT.T.TT@@@@@.TT.TT.T.T..T@@@@@@T......T.TT...TTT..T..T..@@@
@@@@@TT..T..TTT.T.TT....T.T.@@@@@..TTT...T.T....@@@@TTTT.TT.TTTTTTTTTT.TTTTTT@@@
@@@@@T.TT.TT.T...T..T.T..T..@@@@T.T...TTT.TT....T@@@T..TTT.....TTTT.TTT..TT.T@@@
@@@@@TTT.TT...T...T.T..T.T..@@@@TT....T.......T.@@@@...T....TT.TT.TT.T.TT.T.T@@@
@@@@@..TT...TTTT.T..T...T.T.@@@TTT..TT..T..TTT.@@@@@.T......TTTT.........TT.T@@@
@@@@@TTT..TT..TT..T....TTT..@@@....TT...T.T.T.@@@@@T.T.T.TTT..TTT.TT.T...T...@@@
@@@@@..T.TT...T..T.TT.T.TTTT@@@@@TTTT......T..T@@@@..T.T..T.T...T..T.........@@@
@@@@@.TT..TT.T..TTTTT..T..TT.@@@@...TTT..TT.T.TT@@@TT..TT.T....TT.T.T.T..T..T@@@
@@@@@..TT.T.TT.T..T.TTTT.T.T.@@@@@@T.TTT.TT.TTTT.T..TT.TTTTTTTT..T.TT.T.T..T.@@@
@@@@@...T....TT..TT..T..TTTT.T@@@@..T.T....T..@TTTT..T.TTT.T..TTTT...T....T.T@@@
@@@@@...T....T..TT.T.TTT.TTTT.T.T..TT.T.TT..@@@TTTTTTTT..TT.TTT.......T.TT.TT@@@
@@@@@.TTT.T.TTT.T.TT..TT.T.T.....TT.T.@@@@@@@@@@@T.T...TTT..TT.TTT..T...TTTTT@@@
@@@@@..TTTT.TTTTTT.TTTTTT..TTT.TTTT.T@@@@@@@@@@@@T...TT.TTT.T.T.TTT....TTTT.T@@@
@@@@@TT...TT...T...TT..T..TT.T..TTT@@@@@@@@@@@TT.T...TTTTT.TTT......T........@@@
@@@@@TTT.T.T...T.TTT.T...TTT..TT.T.@@@@@@@@@@TT.TT.TTT.T...T..T..T.T.....TT..@@@
@@@@@T.TT.T.TTT.T.TTTTTTTTT...T..TTT..T.T.TT..T.T.TT.TTT.T....TT.....TT...T.T@@@
@@@@@T.T..TTT..TT.T...T.........T.T.TT....TT...T..TT..T......T..TT.TT...T.T.T@@@
@@@@@T.TTT.......TTTT....T.T..TT.TT.T.T.T...T...T.TT...TTT.T..TT..TTT.TT.....@@@
@@@@@TT.T..TT..T...T..T.T...T.TTTT.TTTTT.TTTT..TT.T.TT.T..T.T..T..TTTT.TTT.T@@@@
@@@@@TTT..TT.TT.T.TTT..TT.TTTT.TTTTTT..TT..T..T.T.TTTT.T.TT..T.....TT.T..T.T@@@@
@@@@@@T..TT..TTT.TT........TTTTTTT.TTT..TTT.T..TTT.TTT.T..TTT..T.....T..T..@@@@@
@@@@@@...T...T..TTTTTT.T.T.TT..T......T.TT......T..TT..TTTT.T.TTT.....TTT.T@@@@@
@@@@@@@......TTT.TTT.T.T.T..T.T......T.TT....TTTTT....T.TTTT.T...TT.TT.T..@@@@@@
@@@@@@@@TT..T..T...T.T.T.T.T..TTT.TT.T.T..TTTTTTT.T.TT...T....TTTT.T.TTT@@@@@@@@
@@@@@@@@@.T.TT..T.T.TT...T...T.TT.TT.T.T.TTT......TT..T..T...T.T...T.TT@@@@@@@@@
@@@@@@@@@@@....TTT....TT.....T...TTTT.T.TT..T.TTT..TT..T..TTTT.TTT..T@@@@@@@@@@@
@@@@@@@@@@@@@@..T..TTT......T.TTTTT...TT.T....TTT.TT....T..T.....TT@@@@@@@@@@@@@
@@@@@@@@@@@@@@@@...TTTT.....T.T.TTT..T.TTT..T..TTTTTT.T.TT..TT...@@@@@@@@@@@@@@@
@@@@@@@@@@@@@@@@@@@T......T.......TT.TTT..T..TTTTT.T..TT.TT.TTT@@@@@@@@@@@@@@@@@
@@@@@@@@@@@@@@@@@@@@@...T.TTTT..T.TT...T..T..T..TTT.T..TTTT.@@@@@@@@@@@@@@@@@@@@
@@@@@@@@@@@@@@@@@@@@@@@@..TT....TT.T..T.TT...T..T.T..TTT..@@@@@@@@@@@@@@@@@@@@@@
@@@@@@@@@@@@@@@@@@@@@@@@@@.........T...TT...T.T..TT....T@@@@@@@@@@@@@@@@@@@@@@@@
@@@@@@@@@@@@@@@@@@@@@@@@@@@@.TTTT..TTTT.TT.TT...TTTTT.@@@@@@@@@@@@@@@@@@@@@@@@@@
@@@@@@@@@@@@@@@@@@@@@@@@@@@@@@@@@@@@@@@@@@@@@@@@@@@@@@@@@@@@@@@@@@@@@@@@@@@@@@@@
@@@@@@@@@@@@@@@@@@@@@@@@@@@@@@@@@@@@@@@@@@@@@@@@@@@@@@@@@@@@@@@@@@@@@@@@@@@@@@@@
