type octile
height 64
width 60
map
@@@@@@@@@@@@@@@@@@@@@@@@@@@@@@@@@@@@@@@@@@@@@@@@@@@@@@@@@@@@
@@@@@@@@@@@@@@@@@@@@@@@@@@@@@@@@@@@@@@@@@@@@@@@@@@@@@@@@@@@@
@@@@@@@@@@@@@@@@@@@@@@@@@@@@@@@@@@@@@@@@@@@@@@@@@@@@@@@@@@@@
@@@@@@@@@@@@@@@@@@@@@@@@@@@@@@@@@@@@@@@@@@@@@@@@@@@@@@@@@@@@
@@@@@@@@@@@@@@@@@@@@@@@@@@@@@@@@@@@@@@@@@@@@@@@@@@@@@@@@@@@@
@@@@@@@@@@@@@@@@@@@@@@@@@@@@@@@@@@@@@@@@@@@@@@@@@@@@@@@@@@@@
@@@@@@@@@@@@@@@@@@@@@@@@@@@@@@@@@@@@@@@@@@@@@@@@@@@@@@@@@@@@
@@@@@@@@@@@@@@@@@@@@@@@@@@@@@@@@@@@@@@@@@@@@@@@@@@@@@@@@@@@@
@@@@@@@@@@@@@@@@@@@@@@@@@@@@@@@@@@@@@@@@@@@@@@@@@@@@@@@@@@@@
@@@@@@@@@@@@@@@@@@@@@@@@@@@@@@@@@@@@@@@@@@@@@@@@@@@@@@@@@@@@
@@@@@@@@@@@@@@@@@@@@@@@@@@@@@@@@@@@@@@@@@@@@@@@@@@@@@@@@@@@@
@@@@@@@@@@@@@@@@@@@@@@@@@@@@@@@@@@@@@@@@@@@@@@@@@@@@@@@@@@@@
@@@@@@@@@@@@@@@@@@@@@@@@@@@@@@@@@@@@@@@@@@@@@@@@@@@@@@@@@@@@
@@@@@@@@@@@@@@@@@@@@@@@@@@@@@@@@@@@@@@@@@@@@@@@@@@@@@@@@@@@@
@@@@@@@@@@@@@@@@@@@@@@@@@@@@@@@@@@@@@@@@@@@@@@@@@@@@..T@@@@@
@@@@@@@@@@@@@@@@@@@@@@@@@@@@@@@@@@@@@@@@@@@@@@@@@@....@@@@@@
@@@@@@@@@@@@@@@@@@@@@@@@@@@@@@@@@@@@@@@@@@@@@@@@TTT...@@@@@@
@@@@@@@@@@@@@@@@@@@@@@@@@@@@@@@@@@@@@@@@@@@@@@@TTT.T...@@@@@
@@@@@@@@@@@@@@@@@@@@@@@@@@@@@@@@@@@@@@@@@@@@@@T.TT....T@@@@@
@@@@@@@@@@@@@@@@@@@@@@@@@@@@@@@@@@@@@@@@@@@@@@TT.TT.T..@@@@@
@@@@@@@@@@@@@@@@@@@@@@@@@@@@@@@@@@@@@@@@@@@@TTTTTT....T@@@@@
@@@@@@@@@@@@@@@@@@@@@@@@@@@@@@@@@@@@@@@@@@.TT.TT.T.T.@@@@@@@
@@@@@@@@@@@@@@@@@@@@@@@@@@@@@@@@@@@@@@@@@TT.TT...T.TT@@@@@@@
@@@@@@@@@@@@@@@@@@@@@@@@@@@@@@@@@@@@@@@@T.T..TTTT....@@@@@@@
@@@@@@@@@@@@@@@@@@@@@@@@@@@@@@@@@@@@@@@T.T...T......T@@@@@@@
@@@@@@@@@@@@@@@@@@@@@@@@@@@@@@@@@@@@@@.TT..TTTT.TTT.T@@@@@@@
@@@@@@@@@@@@@@@@@@@@@@@@@@@@@@@@@@@@..TTT.....TT.T.TT@@@@@@@
@@@@@@@@@@@@@@@@@@@@@@@@@@@@@@@@@@T.T.T...T...TT....T@@@@@@@
@@@@@@@@@@@@@@@@@@@@@@@@@@@@@@@@TT.TTTT......TTTTTTT@@@@@@@@
@@@@@@@@@@@@@@@@@@@@@@@@@@@@@@TT..T..TT..T.T..TTTTTT.@@@@@@@
@@@@@@@@@@@@@@@@@@@@@@@@@@@@T..T..T.TTTT..T.T...T.TT@@@@@@@@
@@@@@@@@@@@@@@@@@@@@@@@@@T.TTTTTTT......T.TTTTT.....@@@@@@@@
@@@@@@@@@@@@@@@@@@@@@@@TT.T...T.TT.T....TT.TTTTTTTTT@@@@@@@@
@@@@@@@@@@@@@@@@@@@@@..TTT.TT.T.T.TT..T.T.TT.T.TTTTTT@@@@@@@
@@@@@@@@@@@@@@@@@@@.TT..T.TT..TT....T.T.TTT...TT.T.T.@@@@@@@
@@@@@@@@@@@@@@@@@@@...T.......TTTT..@@@@TT........TTT@@@@@@@
@@@@@@@@@@@@@@@@@@@@T....T.....T...@@@@@@TT.T.T.TTTTT@@@@@@@
@@@@@@@@@@@@@@@@@@@@@.T.TTT.TTT...T@@@@@@..TT.TTT..T@@@@@@@@
@@@@@@@@@@@@@@@@@@@@@@@@@...T...TT.@@@@@@TT.T..TTT.T@@@@@@@@
@@@@@@@@@@@@@@@@@@@@@@@@@@.TT.T.T.T@@@@@@.T..T..T.T@@@@@@@@@
@@@@@@@@@@@@@@@@@@@@@@@@@@@TT..TT..T@@@@T.T......T.@@@@@@@@@
@@@@@@@@@@@@@@@@@@@@@@@@@@@@.T.T..TTTT.T..TT...T.T.@@@@@@@@@
@@@@@@@@@@@@@@@@@@@@@@@@@@@@@@TTT.TT..T..TTT...T.T.@@@@@@@@@
@@@@@@@@@@@@@@@@@@@@@@@@@@@@@@.TT.....TT.T.TTTTTTTT@@@@@@@@@
@@@@@@@@@@@@@@@@@@@@@@@@@@@@@...TTTT.T.TTTTT..TT.TT@@@@@@@@@
@@@@@@@@@@@@@@@@@@@@@@@@@@@@@.TTT.T....TT...T.TT..@@@@@@@@@@
@@@@@@@@@@@@@@@@@@@@@@@@@@@@.T.T...T.T..T..T.T...T.@@@@@@@@@
@@@@@@@@@@@@@@@@@@@@@@@@@@@@.T...T.TT.TT@.T..T..TT.@@@@@@@@@
@@@@@@@@@@@@@@@@@@@@@@@@@@@@@TT..T..T..@@@T..TT.T.T@@@@@@@@@
@@@@@@@@@@@@@@@@@@@@@@@@@@@@@@@T...TT.@@@@T@@..T..T@@@@@@@@@
@@@@@@@@@@@@@@@@@@@@@@@@@@@@@@@@@..T.T@@@@@@@TTT.TT@@@@@@@@@
@@@@@@@@@@@@@@@@@@@@@@@@@@@@@@@@@@@T.@@@@@@@@@T.TTT@@@@@@@@@
@@@@@@@@@@@@@@@@@@@@@@@@@@@@@@@@@@@@@@@@@@@@@@@@...@@@@@@@@@
@@@@@@@@@@@@@@@@@@@@@@@@@@@@@@@@@@@@@@@@@@@@@@@@@@@@@@@@@@@@
@@@@@@@@@@@@@@@@@@@@@@@@@@@@@@@@@@@@@@@@@@@@@@@@@@@@@@@@@@@@
@@@@@@@@@@@@@@@@@@@@@@@@@@@@@@@@@@@@@@@@@@@@@@@@@@@@@@@@@@@@
@@@@@@@@@@@@@@@@@@@@@@@@@@@@@@@@@@@@@@@@@@@@@@@@@@@@@@@@@@@@
@@@@@@@@@@@@@@@@@@@@@@@@@@@@@@@@@@@@@@@@@@@@@@@@@@@@@@@@@@@@
@@@@@@@@@@@@@@@@@@@@@@@@@@@@@@@@@@@@@@@@@@@@@@@@@@@@@@@@@@@@
@@@@@@@@@@@@@@@@@@@@@@@@@@@@@@@@@@@@@@@@@@@@@@@@@@@@@@@@@@@@
@@@@@@@@@@@@@@@@@@@@@@@@@@@@@@@@@@@@@@@@@@@@@@@@@@@@@@@@@@@@
@@@@@@@@@@@@@@@@@@@@@@@@@@@@@@@@@@@@@@@@@@@@@@@@@@@@@@@@@@@@
@@@@@@@@@@@@@@@@@@@@@@@@@@@@@@@@@@@@@@@@@@@@@@@@@@@@@@@@@@@@
@@@@@@@@@@@@@@@@@@@@@@@@@@@@@@@@@@@@@@@@@@@@@@@@@@@@@@@@@@@@
