type octile
height 134
width 124
map
@@@@@@@@@@@@@@@@@@@@@@@@@@@@@@@@@@@@@@@@@@@@@@@@@@@@@@@@@@@@@@@@@@@@@@@@@@@@@@@@@@@@@@@@@@@@@@@@@@@@@@@@@@@@@@@@@@@@@@@@@@@@
@...TTTT@@@@@@@@@@@@@@@@@@@@@@@@@@@@@@@@@@@@@@@@@@@@@@@@@@@@@@@@@@@@@@@@@@@@@@@@@@@@@@@@@@@@@@@@@@@@@@@@@@@@@@@@@@@@@@@@@@@@
@....TTT@@@@@@@@@@@@@@@@@@@@@@@@@@@@@@@@@@@@@@@@@@@@@@@@@@@@@@@@@@@@@@@@@@@@@@@@@@@@@@@@@@@@@@@@@@@@@@@@@@@@@@@@@@@@@@@@@@@@
@.TT.TT.@@@@@@@@@@@@@@@@@@@@@@@@@@@@@@@@@@@@@@@@@@@@@@@@@@@@@@@@@@@@@@@@@@@@@@@@@@@@@@@@@@@@@@@@@@@@@@@@@@@@@@@@@@@@@@@@@@@@
@T.....T@@@@@@@@@@@@@@@@@@@@@@@@@@@@@@@@@@@@@@@@@@@@@@@@@@@@@@@@@@@@@@@@@@@@@@@@@@@@@@@@@@@@@@@@@@@@@@@@@@@@@@@@@@@@@@@@@@@@
@..TT.TT@@@@@@@@@@@@@@@@@@@@@@@@@@@@@@@@@@@@@@@@@@@@@@@@@@@@@@@@@@@@@@@@@@@@@@@@@@@@@@@@@@@@@@@@@@@@@@@@@@@@@@@@@@@@@@@@@@@@
@.T..TT.@@@@@@@@@@@@@@@@@@@@@@@@@@@@@@@@@@@@@@@@@@@@@@@@@@@@@@@@@@@@@@@@@@@@@@@@@@@@@@@@@@@@@@@@@@@@@@@@@@@@@@@@@@@@@@@@@@@@
@.TTTT.T@@@@@@@@@@@@@@@@@@@@@@@@@@@@@@@@@@@@@@@@@@@@@@@@@@@@@@@@@@@@@@@@@@@@@@@@@@@@@@@@@@@@@@@@@@@@@@@@@@@@@@@@@@@@@@@@@@@@
@@@@@@@@@@@@@@@@@@@@@@@@@@@@@@@@@@@@@@@@@@@@@@@@@@@@@@@@@@@@@@@@@@@@@@@@@@@@@@@@@@@@@@@@@@@@@@@@@@@@@@@@@@@@@@@@@@@@@@@@@@@@
@@@@@@@@@@@@@@@@@@@@@@@@@@@@@@@@@@@@@@@@@@@@@@@@@@@@@@@@@@@@@@@@@@@@@@@@@@@@@@@@@@@@@@@@@@@@@@@@@@@@@@@@@@@@@@@@@@@@@@@@@@@@
@@@@@@@@@@@@@@@@@@@@@@@@@@@@@@@@@@@@@@@@@@@@@@@@@@@@@@@@@@@@@@@@@@@@@@@@@@@@@@@@@@@@@@@@@@@@@@@@@@@@@@@@@@@@@@@@@@@@@@@@@@@@
@@@@@@@@@@@@@@@@@@@@@@@@@@@@@@@@@@@@@@@@@@@@@@@@@T@@@@@@@@@@@@@@@@@@@@@@@@@@@@@@@@@@@@@@@@@@@@@@@@@@@@@@@@@@@@@@@@@@@@@@@@@@
@@@@@@@@@@@@@@@@@@@@@@@@@@@@@@@@@@@@@@@@@@@@@@@@TTT@@@@@@@@@@@@@@@@@@@@@@@@@@@@@@@@@@@@@@@@@@@@@@@@@@@@@@@@@@@@@@@@@@@@@@@@@
@@@@@@@@@@@@@@@@@@@@@@@@@@@@@@@@@@@@@@@@@@@@@@..TT..@@@@@@@@@@@@@@@@@@@@@@@@@@@@@@@@@@@@@@@@@@@@@@@@@@@@@@@@@@@@@@@@@@@@@@@@
@@@@@@@@@@@@@@@@@@@@@@@@@@@@@@@@@@@@@@@@@@@@@T.....T.@@@@@@@@@@@@@@@@@@@@@@@@@@@@@@@@@@@@@@@@@@@@@@@@@@@@@@@@@@@@@@@@@@@@@@@
@@@@@@@@@@@@@@@@@@@@@@@@@@@@@@@@@@@@@@@@@@@@.T.TT.T...@@@@@@@@@@@@@@@@@@@@@@@@@@@@@@@@@@@@@@@@@@@@@@@@@@@@@@@@@@@@@@@@@@@@@@
@@@@@@@@@@@@@@@@@@@@@@@@@@@@@@@@@@@@@@@@@@@.TT..T.T.TTT@@@@@@@@@@@@@@@@@@@@@@@@@@@@@@@@@@@@@@@@@@@@@@@@@@@@@@@@@@@@@@@@@@@@@
@@@@@@@@@@@@@@@@@@@@@@@@@@@@@@@@@@@@@@@@@@.TTTT.@@......@@@@@@@@@@@@@@@@@@@@@@@@@@@@@@@@@@@@@@@@@@@@@@@@@@@@@@@@@@@@@@@@@@@@
@@@@@@@@@@@@@@@@@@@@@@@@@@@@@@@@@@@@@@@@@TTT.T.@@@@TTTTTT@@@@@@@@@@@@@@@@@@@@@@@@@@@@@@@@@@@@@@@@@@@@@@@@@@@@@@@@@@@@@@@@@@@
@@@@@@@@@@@@@@@@@@@@@@@@@@@@@@@@@@@@@@@@.TT.TT@@@@@.TTTT.T@@@@@@@@@@@@@@@@@@@@@@@@@@@@@@@@@@@@@@@@@@@@@@@@@@@@@@@@@@@@@@@@@@
@@@@@@@@@@@@@@@@@@@@@@@@@@@@@@@@@@@@@@@...T..@@@@@@@...TT..@@@@@@@@@@@@@@@@@@@@@@@@@@@@@@@@@@@@@@@@@@@@@@@@@@@@@@@@@@@@@@@@@
@@@@@@@@@@@@@@@@@@@@@@@@@@@@@@@@@@@@@@T.....@@@@@@@@TTTT....T@@@@@@@@@@@@@@@@@@@@@@@@@@@@@@@@@@@@@@@@@@@@@@@@@@@@@@@@@@@@@@@
@@@@@@@@@@@@@@@@@@@@@@@@@@@@@@@@@@@@@T.TT.T@@@@@@@@@T.TTTT..T.@@@@@@@@@@@@@@@@@@@@@@@@@@@@@@@@@@@@@@@@@@@@@@@@@@@@@@@@@@@@@@
@@@@@@@@@@@@@@@@@@@@@@@@@@@@@@@@@@@@...TT.@@@@@@@@@@@...T....TT@@@@@@@@@@@@@@@@@@@@@@@@@@@@@@@@@@@@@@@@@@@@@@@@@@@@@@@@@@@@@
@@@@@@@@@@@@@@@@@@@@@@@@@@@@@@@@@@T.T.T.T@@@@@@@T.@@@T.......T.T@@@@@@@@@@@@@@@@@@@@@@@@@@@@@@@@@@@@@@@@@@@@@@@@@@@@@@@@@@@@
@@@@@@@@@@@@@@@@@@@@@@@@@@@@@@@@@TT..T..@@@@@@@TT.T@@.TTTT..T...@@@@@@@@@@@@@@@@@@@@@@@@@@@@@@@@@@@@@@@@@@@@@@@@@@@@@@@@@@@@
@@@@@@@@@@@@@@@@@@@@@@@@@@@@@@@@T...TTT@@@@@@@T.T...T..@@@@..TTT.T@@@@@@@@@@@@@@@@@@@@@@@@@@@@@@@@@@@@@@@@@@@@@@@@@@@@@@@@@@
@@@@@@@@@@@@@@@@@@@@@@@@@@@@@@@T..T.TT@@@@@@@T.T.....T.@@@@@T.T....@@@@@@@@@@@@@@@@@@@@@@@@@@@@@@@@@@@@@@@@@@@@@@@@@@@@@@@@@
@@@@@@@@@@@@@@@@@@@@@@@@@@@@@@@TT.TT.@@@@@@@T..TT...T.T.@@@@@..T.TTT@@@@@@@@@@@@@@@@@@@@@@@@@@@@@@@@@@@@@@@@@@@@@@@@@@@@@@@@
@@@@@@@@@@@@@@@@@@@@@@@@@@@@@T..TTT.@@@@@@@.TTTTT...TTT@@@@@@TTTTT.TT@@@@@@@@@@@@@@@@@@@@@@@@@@@@@@@@@@@@@@@@@@@@@@@@@@@@@@@
@@@@@@@@@@@@@@@@@@@@@@@@@@@@TT.TTTT@@@@@@@@T..TTTTTT..@@@@@@@.T...TTT.@@@@@@@@@@@@@@@@@@@@@@@@@@@@@@@@@@@@@@@@@@@@@@@@@@@@@@
@@@@@@@@@@@@@@@@@@@@@@@@@@@..TTTTT@@@@@@@@@@.TTT....T@@@@@@@@..TTT.TT..@@@@@@@@@@@@@@@@@@@@@@@@@@@@@@@@@@@@@@@@@@@@@@@@@@@@@
@@@@@@@@@@@@@@@@@@@@@@@@@@.T..TT.T@@@@@@@@@@@.T.TT..@@@@@@@@@TTT..TT..T.@@@@@@@@@@@@@@@@@@@@@@@@@@@@@@@@@@@@@@@@@@@@@@@@@@@@
@@@@@@@@@@@@@@@@@@@@@@@@@TTTTTTT..@@@@@@@@@@@@TTT.T@@@@@@@T.@TTTTTT.....T@@@@@@@@@@@@@@@@@@@@@@@@@@@@@@@@@@@@@@@@@@@@@@@@@@@
@@@@@@@@@@@@@@@@@@@@@@@@..TT.TTT.T@@@TT@@@@@@@@TT.@@@@@@@..T..TT@@.TT.T.TT@@@@@@@@@@@@@@@@@@@@@@@@@@@@@@@@@@@@@@@@@@@@@@@@@@
@@@@@@@@@@@@@@@@@@@@@@@TTTTTT.@TTT@@T..@@@@@@@@@.@@@@@@@@..T..T@@@@@.TT.TTT@@@@@@@@@@@@@@@@@@@@@@@@@@@@@@@@@@@@@@@@@@@@@@@@@
@@@@@@@@@@@@@@@@@@@@@@.TT..T.@@@.T@TT.T.@@@@@@@@@@@@@@@@@.TTTT.T@@@@T..TTT..@@@@@@@@@@@@@@@@@@@@@@@@@@@@@@@@@@@@@@@@@@@@@@@@
@@@@@@@@@@@@@@@@@@@@@.T..T..@@@@T.T......@@@@@@@@@@@@@@@T.T.TTT@@@@@@T...T..T@@@@@@@@@@@@@@@@@@@@@@@@@@@@@@@@@@@@@@@@@@@@@@@
@@@@@@@@@@@@@@@@@@@@.T..TTT@@@@@..T..TT.T.@@@@@@@@@@@@@TTT.TTT@@@@@@@TTTTT..TT.@@@@@@@@@@@@@@@@@@@@@@@@@@@@@@@@@@@@@@@@@@@@@
@@@@@@@@@@@@@@@@@@@.T.....@@@@@.....TT...TT@@@@@@@@@@@@...TTT@@@@@@@@@.TTTT.TT..@@@@@@@@@@@@@@@@@@@@@@@@@@@@@@@@@@@@@@@@@@@@
@@@@@@@@@@@@@@@@@@..TT..T@@@@@@..T.T...T.T.@@@@@@@@@@TTT..TT@@@@@@@@@@.T....TTTT.@@@@@@@@@@@@@@@@@@@@@@@@@@@@@@@@@@@@@@@@@@@
@@@@@@@@@@@@@@@@@..TTTTT@@@@@@@@.T.T.T.T..@@@@@@@@@@@@...T.@@@@@@@TTT@TT.....TTT.T@@@@@@@@@@@@@@@@@@@@@@@@@@@@@@@@@@@@@@@@@@
@@@@@@@@@@@@@@@@T..TTT..@@@@@@@@@....T.TT@@@@@@@@@@@@@@..T@@@@@@@T....TTTT.TT.TT.T@@@@@@@@@@@@@@@@@@@@@@@@@@@@@@@@@@@@@@@@@@
@@@@@@@@@@@@@@@T.TT....@@@@@@@@@@@.TTTTT@@@@@@@@@@@@@@@@T@@@@@@@T...TT..@@TT....T.T.@@@@@@@@@@@@@@@@@@@@@@@@@@@@@@@@@@@@@@@@
@@@@@@@@@@@@@@..TTT...T@@@@@@@@@@@@...T@@@@@@@@T@@@@@@@@@@@@@@@@@TTT.....@@.T..T.TT..@@@@@@@@@@@@@@@@@@@@@@@@@@@@@@@@@@@@@@@
@@@@@@@@@@@@@T.TTT.TTT.@@@T@@@@@@@@@@.@@@@@@@@@T.T.@@@@@@@@@@@@@T.T.TT..@@@@T....T.T.T@@@@@@@@@@@@@@@@@@@@@@@@@@@@@@@@@@@@@@
@@@@@@@@@@@T.TT.TT..T..@@..T@@@@@@@@@@@@@@@@@@..T..@@@@@@@@@@@@....T.TT@@@@@@T......T@@@@@@@@@@@@@@@@@@@@@@@@@@@@@@@@@@@@@@@
@@@@@@@@@@.....T..@@.TT..T.TT@@@@@@@@@@@@@@@.T..TTTT.@@@@@@@@@T.TT.TT.@@@@@@@.T.TT..@@@@@@@@@@@@@@@@@@@@@@@@@@@@@@@@@@@@@@@@
@@@@@@@@@@...TTT.@@@@..T.T.T..@@@@@@@@@@@@@T...T.TTT.@@@@@@@@..T.T.TT@@@@@@@T.T.T..@@@@@@@@@@@@@@@@@@@@@@@@@@@@@@@@@@@@@@@@@
@@@@@@@@@.T.TTT..@@@@TTT...TT..@@@@@@@@@@@T.T.T.T.TT.T@@@@@@@@T.T.TT@@@@@@@T...TTT@@@@@@@@@@@@@@@@@@@@@@@@@@@@@@@@@@@@@@@@@@
@@@@@@@@...T..TT@@@..T.TTT.TTTT.@@@@@@@@@T.TTTTTT.T.....@@@@@@@T.TT@@@@@@@@..TT..@@@@@@@@@@@@@@@@@@@@@@@@@@@@@@@@@@@@@@@@@@@
@@@@@@@.TTTTTTT@@@@@..T.T...T...@@@@@@@@TT..T..TTT.T..T..@@@@@@@T.@@@@@@@@..TTT.@@@@@@@@@@@@@@@@@@@@@@@@@@@@@@@@@@@@@@@@@@@@
@@@@@@TT.TTTT.@@@@@@@T..T.T..T.@@@@@@@@T..TT.TT.T.T..TT...@@@@@@@@@@@@@@@.T..T.@@@@@@@@@@@@@@@@@@@@@@@@@@@@@@@@@@@@@@@@@@@@@
@@@@@.TT..T..T@@@@@@@@...TTT..@@@@@@@@T...TTT.TT.TTTT.TT.T@@@@@@@@@@@@@@TTTTT.@@@@@@@@@@@@@@@@@@@@@@@@@@@@@@@@@@@@@@@@@@@@@@
@@@@.T....TT.T@@@@@@@@@..T..T@@@@@@@@TT........@@T.TT.T....T@@@@@@@@@@@@..TT.@@@@@@@@@@@@@..@@@@@@@@@@@@@@@@@@@@@@@@@@@@@@@@
@@@...T..TTT..T@@@@@@@@@.T.T@@@@@@@@.T.TT.TTT.@@@@TTT....T...@@@@@@@@@@.T...@@@@@@@@@@@@@@TTT@@@@@@@@@@@@@@@@@@@@@@@@@@@@@@@
@@@@T.T..TT.....@@@@@@@@@..@@@@@@@@T..TTTTT.T@@@@@@.T...T..T@@@@@@@@@@@TT.T@@@@@@@@@@@@@@@@TTT@@@@@@@@@@@@@@@@@@@@@@@@@@@@@@
@@@@@T.....TTTTT.@@@@@@@@@@@@@@@@@T.T...TTT.@@@@@@@@TTTTTTT@@@@@@@@@@@TTTTT@@@@@@@@@@@@@@@@@T..@@@@@@@@@@@@@@@@@@@@@@@@@@@@@
@@@@@@..T..TT..T..@@@@@@@@@@@@@@@.T..TT.T.T@@@@@@@@@T.T.TT@@@@@@@@@@@..T..T@@@@@@@@@@@@@@@@@@.TT@@@@@@@@@@@@@@@@@@@@@@@@@@@@
@@@@@@@T..TTT.TT.TT@@@@@@@@@@@@@.TTT...TT.@@@@@@@@@...TT.@@@@@@@@@@@@..TT.T@@@@@@@@@@T@@@@@@@T.T@@@@@@@@@@@@@@@@@@@@@@@@@@@@
@@@@@@@@T.T....TTT.T@@@@@@@@@@@TTTT.TT..T@@@@@@@@@@TT.TT@@@@@@@@@@@@@.TTT.T@@@@@@@@@.T.@@@@@.T.@@@@@@@@@@@@@@@@@@@@@@@@@@@@@
@@@@@@@@@TTTT.T.TTT.T@@@@@@@@@@......TTT.@@@@@@@@@T..T.@@@@@@@@@@@@T.TTT..T@@@@@@@@@...T@@.TTT.T@@@@@@@@@@@@@@@@@@@@@@@@@@@@
@@@@@@@@@@T....T..TT..@@@@@@@@@...T.TTTT.T@@@@@@@T..T.@@@@@@@@@@@@TT.TT.T.@@@@@@@@@TT...@@...TT..TTT.@@@@@@@@@@@@@@@@@@@@@@@
@@@@@@@@@@@..TT....TT..@@@@@@@@TTTT..TTT...@@@@@.T...@@@@@@@@@@@@..T.TTT.@@@@@@@@@@.T..TTTT.TT.T..T..T@@@@@@@@@@@@@@@@@@@@@@
@@@@@@@@@@@@..TT.T....TT@@@@@@@@..TT..TT...@@@@T..TT@@@@@@@@@@@@..T.TT..@@@@@@@@@@@@..TT..T..TT@TTT.TTT@@@@@@@@@@@@@@@@@@@@@
@@@@@@@@@@@@@T..TT.T.....@@@@@@@.T.TT.TT.TTT.T.T...@@@@@@@@@@@@T.T...T...@@@@@@@@@@@@.TTT..TTT@@@....T.@@@@@@@@@@@@@@@@@@@@@
@@@@@@@@@@@@@@TT..T.TT.TT.@@@@@@.TT.T.TT.TT.T.T.T.@@@@@@@@@@@...TT..T..T@@@@@@@@@@@@@@@.T..TT@@@@@..T.T@@@@@@@@@@@@@@@@@@@@@
@@@@@@@@@@@@@@@T.T.T.T.T..T@@@@@T..........T.TT..@@@@@@@@@@@TTT.TT.T..T@@@@@@@@@@@@@@@@@....@@@@@@@TT..@@@@@@@@@@@@@@@@@@@@@
@@@@@@@@@@@@@@@@T....TT...T.@@@@..TTTT..TTTT....@@@@@@@@@@@@.T.T..TTT..@@@@@@@@@@@@@@@@@@T.@@@@@@@@@.T.T@@.@@@@@@@@@@@@@@@@@
@@@@@@@@@@@@@@@@@..T...T.T...T@@..TT.TTT...TT.T@@@@@@@@@@@@.TT...T..TT.@@@@@@@@@@@@@@@@@@@@@@@@@@@@@.T...T.T@@@@@@@@@@@@@@@@
@@@@@@@@@@@@@@@@@@......T.TT.T.TT..T@@@@.T.T..@@@@@@@@@@@.T.T....T.T.T...@@@@@@@@@@@@@@@@@@@@@@@@@@@.....T.@@@@@@@@@@@@@@@@@
@@@@@@@@@@@@@@@@@@@@@@@@@TT..T.T...@@@@@@T..@@@@@@@@@@@@.T...TT.TTTT.T.TTT@@@@@@@@@@@@@@@@@@@@@@@@@@.T.....@@@@@@@@@@@@@@@@@
@@@@@@@@@@@@@@@@@@@@@@@@@@T....T...@@@@@@@T@@@@@@@@@@@@T....TTT.TTT...TT..@@@@@@@@@@@@@@@@@@@@@@@@@@T.TTTTT..@@@@@@@@@@@@@@@
@@@@@@@@@@@@@@@@@@@@@@@@@@@T..T.....@@@@@@@@@@@@@@@@@@@...T.T.T..T...T..T....@@@@@@@@@@@@@@@@@@@@@@@.TTTT.TTT.@@@@@@@@@@@@@@
@@@@@@@@@@@@@@@@@@@@@@@@@@@@.T.TT.TT.@@@@@@@@@@@@@@@@T.T...T..T...T..TT.TTT..@@@@@@@@@@@@@@@@@@@@@@@.TTTT.T.@T.@@@@@@@@@@@@@
@@@@@@@@@@@@@@@@@@@@@@@@@@@@@TTTTTT..T@@@@@@@@@@@@@@.T.T.T.TTT...TT..T.T.T.T..@@@@@@@@@@@@@@@@@@@@@@TT.T.T.@@@TTT.@@@@@@@@@@
@@@@@@@@@@@@@@@@@@@@@@@@@@@@@TTTTTT...@@@@@@@@@@@@@TTT...TTTTT..T..T.TTTT...TT.T@@@@@@@@@@@@@@@@@@@@...TTT@@@@@TT.T@@@@@@@@@
@@@@@@@@@@@@@@@@@@@@@@@@@@@@@TTTTT.T.T.@@@@@@@@@@@TT..TT.TT..TTT.TTTTTTT..TT.TT.T@@@@@@@@@@@@@@@@@@.TTT..@@@@@@@TTTT@@@@@@@@
@@@@@@@@@@@@@@@@@@@@@@@@@@@@@T.T..TTT.TT@@@@@@@@@@..TT.TTTTTTTT..T.T...TTT.TT.T...@@@@@@@@@@@@@@@@T..T.T.@@@@@@@.TT.T@@@@@@@
@@@@@@@@@@@@@@@@@@@@@@@@@.@@@T..TTT.TTTT@@@@@@@@@T........TTT....T.T.TT.TTTTT.TTT.@@@@@@@@@@@@@.T.T.TT.TT..@@@@@......@@@@@@
@@@@@@@@@@@@@@@@@@@@@@@@TT.@@.TT.TT......@@@@@@@@@.T.....T.T.TT..TTTT..T....TTT...T.@@@@@@@@@@@.T.T..T..TT@@@@@..T..T.T@@@@@
@@@@@@@@@@@@@@@@@@@@@@@..TT.T...TT..T..TTT@@@@@@@@@TT...TT.....TT..T..T.TT..TT.....T.@@@@@@@@@@T.T.T.TTT..@@@@...TTTT..@@@@@
@@@@@@@@@@@@@@@@@@@@@@....T.TTT.T@TT...TT.@@@@@@@@@@TTT.TT..T....TTTT..TTTTT.T....T.T@@@@@@@@@@..T..T@@..T@@@..TT.T..T@@@@@@
@@@@@@@@@@@@@@@@@@@@@TT.T....T.T@@@.T.TTTT@@@@@@@@@@@..T..TT..TT..T.TTTT....TT.TT.T....@@@@@@@@.TTTT@@@@@....TT.TTTTT@@@@@@@
@@@@@@@@@@@@@@@@@@@@TTT.TT...T...@@@TTTT..@@@@@@@@@@@@.TT...TT.T.T...T..TT.T..T....T..TT@@@@T@@T..T@@@@@@@T.T.T...T.@@@@@@@@
@@@@@@@@@@@@@@@@@@.T.T.T.T....TT@@@@..TT.TT@@@@@@@@@@@@T.T...T.T..T.TTTTTTT.TTT.TT.T.TTT@@@TTTT..T.@@@@@@@@...TTTTT@@@@@@@@@
@@@@@@@@@@@@@@@@@.....TTT..TT..@@@@@..TTTTT.@@@@@@@@@@@@.....TT..T.TTT.T.T..TT..T.TTTT.T...T..TTT.@@@@@@@@@@..T...@@@@@@@@@@
@@@@@@@@@@@@@@@@T..T.TTTTT.TTT@@@@@@@.T.T..TT@@@@@@@@@@@@.......T.T.T...T.TT.TTT..TTT.T...TT...T.T@@@@@@@@@@@TT.T@@@@@@@@@@@
@@@@@@@@@@@@@@@T....T....T.TT@@@@@@@@.T.TT...T@@@@@@@@@@@@..T.T....T....TT....T.T...TT.TTTT.T..TT.@@@@@@@@@@@@T.@@@@@@@@@@@@
@@@@@@@@@@@@@@@T.TTT...TT...@@@@@@@@@@.TT......@@@@@@@@@@@@T.TT..TTT.TTTTT..TTT.TT.T..T..TTTTT....@@@@@@@@@@@@@@@@@@@@@@@@@@
@@@@@@@@@@@@@@@@TTTTTTT.TT.@@@@@@@@@@@TT....TT..@@@@@@@@@@@@.T.T.TTTTTT.TT.T.TT.T.......T....T.T.@@@@@@@@@@@@@@@@@@@@@@@@@@@
@@@@@@@@@@@@@@@@@.T..T.T.@@@@@@@@@@@@T.....T.T..T@@@@@@@@@@@@TT..TTTT.T.T.T..TT.T.T...T.......TT@@@@@@@@@@@@@@@@@@@@@@@@@@@@
@@@@@@@@@@@@@@@@@@T....T@@@@@@@@@@@@TT.T.T.TTTT..T@@@@@@@@@@@@...T..TTT...TT...T.TTTTT...TTT....@@@@@@@@@@@@@@@@@@@@@@@@@@@@
@@@@@@@@@@@@@@@@@@@TTTT@@@@@@@@@@@@.TT..TTTT..T.....@@@@@@@@@@@TT.TT.T....T....TTTTT..TT.T...T..T@@@@@@@@@@@@@@@@@@@@@@@@@@@
@@@@@@@@@@@@@@@@@@@@.T@@@@@@@@@@@@.T..T.TTT.T.T.T..TT@@@@@@@@@@@...T.T.TTTTTT...TT..T...T.T..T.T.TT@@@@@@@@@@@@@@@@@@@@@@@@@
@@@@@@@@@@@@@@@@@@@@@@@@@@@@@@@@@TT....TTT...@@..T.T..@@@@@@@@@@@TTTTT..TT.......TT...T...T.TTT.TT.@@@@@@@@@@@@@@@@@@@@@@@@@
@@@@@@@@@@@@@@@@@@@@@@@@@@@@@@@@..TT......TTT@@@.TTTT.T@@@@@@@@@@@TTTT.TTT....TT.TTT.T.T.T..TTT.....@@@@@@@@@@@@@@@@@@@@@@@@
@@@@@@@@@@@@@@@@@@@@@@@@@@@@@@@.T.T...TT..T.@@@@TTTTTT.T@@@@@@@@@@@.TTT..T...T..TTT..T.T.T..TT.T.T..TT@@@@@@@@@@@@@@@@@@@@@@
@@@@@@@@@@@@@@@@@@@@@@@@@@@@@@T..TT.T.TT..T.@@@@..TTTTT.T@@@@@@@@@@@TTTT.T.T....T...T.TTTT...TT..TTTTTT@@@@@@@@@@@@@@@@@@@@@
@@@@@@@@@@@@@@@@@@@@@@@@@@@@@T..TT.T.TTT.@@@@@@@TTTTT..TT.@@@@@@@@@@@......T..TTTT..TT.T...TTT...T.TTT..@@@@@@@@@@@@@@@@@@@@
@@@@@@@@@@@@@@@@@@@@@@@@@@@@TT.T..T....T.@@@@@@@@@@@@@@TTTT@@@@@@@@@@@.T...T.T.....TT.....TT..T...TT..TTT@@@@@@@@@@@@@@@@@@@
@@@@@@@@@@@@@@@@@@@@@@@@@@@..T..TTTTTT...@@@@@@@@@@@@@@@.T..@@@@@@@@@@@.T....TT..T..TT...T...T..TT.T.TT.@@@@@@@@@@@@@@@@@@@@
@@@@@@@@@@@@@@@@@@@@@@@@@@@TT..T..TT....T@@@@@@@@@@@@@@@TT...@@@@@@@@@@@TTTT..TTTTTTTTTT...TT.......TT.@@@@@@@@@@@@@@@@@@@@@
@@@@@@@@@@@@@@@@@@@@@@@@@@@@TTT.T.T.....T@@@@@@@@@@@@@@@TT..T.@@@@@@@@@@@TT..T.T...TT.TTTTTT..T...TT..@@@@@@@@@@@@@@@@@@@@@@
@@@@@@@@@@@@@@@@@@@@@@@@@@@@@T..T..TTT...T@@@@@@@@@@@@@@.T.TT..@@@@@@@@@@@T.TT..T......T..T....T..T...T@@@@@@@@@@@@@@@@@@@@@
@@@@@@@@@@@@@@@@@@@@@@@@@@@@@@.T.T....T..T.TTT@@@@@@@@@@T.T..TTT@@@@@@@@@@@T..TT..T...TT.T......T.T....@@@@@@@@@@@@@@@@@@@@@
@@@@@@@@@@@@@@@@@@@@@@@@@@@@@@@TT..T...TTTT.T.T..T@@@@@@@T.TTTTT.@@@@@@@@@@@TTTT.T.T.T...TTTTTTTT.T..TT@@@@@@@@@@@@@@@@@@@@@
@@@@@@@@@@@@@@@@@@@@@@@@@@@@@@@@.TT.TT.T......TTTTT@@@@@@.T.TTT...@@@@@@@@@@@.TTTTTT.T..T....T.TT.TTT.@@@@@@@@@@@@@@@@@@@@@@
@@@@@@@@@@@@@@@@@@@@@@@@@@@@@@@@@..TTTT...T.T.T.T.TT@@@@@....T.T...@@@@@@@@@@..TTTTT.TT.T.T..TTT.T.T.@@@@@@@@@@@@@@@@@@@@@@@
@@@@@@@@@@@@@@@@@@@@@@@@@@@@@@@@@@.......T.T.T....TT@@@@@...@...TT..@@@@@@@@@@.T.T.TT...TTTT..TT.TT.@@@@@@@@@@@@@@@@@@@@@@@@
@@@@@@@@@@@@@@@@@@@@@@@@@@@@@@@@@@@TTT.....T..T..TT...@@@TT@@@@T.TTTT@@@@@@@@@@..TTT.TTTTTT.TTT.TTT@@@@@@@@@@@@@@@@@@@@@@@@@
@@@@@@@@@@@@@@@@@@@@@@@@@@@@@@@@@@@@..T.T..T.....T.T@@@@@T.@@@@T..T.T.@@@@@@@@@T.TTTT.T..T..T..@T.@@@@@@@@@@@@@@@@@@@@@@@@@@
@@@@@@@@@@@@@@@@@@@@@@@@@@@@@@@@@@@@@..T...TTTT..T.@@@@@..T@@@@.....TT.@@@@@@@@@TT.TTTTTTTT.T.@@@@@@@@@@@@@@@@@@@@@@@@@@@@@@
@@@@@@@@@@@@@@@@@@@@@@@@@@@@@@@@@@@@@@TT...TTTT...T.@@@@T.T@@.T.T.T..TTT@@@@@@@@@TTT.T..T..TT@@@@@@@@@@@@@@@@@@@@@@@@@@@@@@@
@@@@@@@@@@@@@@@@@@@@@@@@@@@@@@@@@@@@@@@TT.TT.TT.T...T@@@T.T.T.T.TT.TTT..@@@@@@@@@@...T.TT.TT@@@@@@@@@@@@@@@@@@@@@@@@@@@@@@@@
@@@@@@@@@@@@@@@@@@@@@@@@@@@@@@@@@@@@@@@@T.TTT.T.T..T.T@@T.T.TTT..T.TTT.@@@@@@@@@@@@T.....TT@@@@@@@@@@@@@@@@@@@@@@@@@@@@@@@@@
@@@@@@@@@@@@@@@@@@@@@@@@@@@@@@@@@@@@@@@@@.T..T.TTTTT.TTT.T...TT..TTT.T@@@@@@@@@@@@@@TT.T.T@@@@@@@@@@@@@@@@@@@@@@@@@@@@@@@@@@
@@@@@@@@@@@@@@@@@@@@@@@@@@@@@@@@@@@@@@@@@@.TT..TT.......T....T.TTT.TT@@@@@@@@@@@@@@@@T.TT@@@@@@@@@@@@@@@@@@@@@@@@@@@@@@@@@@@
@@@@@@@@@@@@@@@@@@@@@@@@@@@@@@@@@@@@@@@@@@@T.....T.TTT..TTT.T...TT..@@@@@@@@@@@@@@@@@@T.@@@@@@@@@@@@@@@@@@@@@@@@@@@@@@@@@@@@
@@@@@@@@@@@@@@@@@@@@@@@@@@@@@@@@@@@@@@@@@@@@T.T.TTT.T.TTT.....T.TTT@@@@@@@@@@@@@@@@@@@@@@@@@@@@@@@@@@@@@@@@@@@@@@@@@@@@@@@@@
@@@@@@@@@@@@@@@@@@@@@@@@@@@@@@@@@@@@@@@@@@@@@TTTT..TT..T.T.TTT....@@@@@@@@@@@@@@@@@@@@@@@@@@@@@@@@@@@@@@@@@@@@@@@@@@@@@@@@@@
@@@@@@@@@@@@@@@@@@@@@@@@@@@@@@@@@@@@@@@@@@@@@@T...T.T.TT..T..TT..@@@@@@@@@@@@@@@@@@@@@@@@@@@@@@@@@@@@@@@@@@@@@@@@@@@@@@@@@@@
@@@@@@@@@@@@@@@@@@@@@@@@@@@@@@@@@@@@@@@@@@@@@@@...TTT.TTTTT...TT@@@@@@@@@@@@@@@@@@@@@@@@@@@@@@@@@@@@@@@@@@@@@@@@@@@@@@@@@@@@
@@@@@@@@@@@@@@@@@@@@@@@@@@@@@@@@@@@@@@@@@@@@@@@@...TTT.T..TT.TT@@@@@@@@@@@@@@@@@@@@@@@@@@@@@@@@@@@@@@@@@@@@@@@@@@@@@@@@@@@@@
@@@@@@@@@@@@@@@@@@@@@@@@@@@@@@@@@@@@@@@@@@@@@@@@@TT...TT..TTT.@@@@@@@@@@@@@@@@@@@@@@@@@@@@@@@@@@@@@@@@@@@@@@@@@@@@@@@@@@@@@@
@@@@@@@@@@@@@@@@@@@@@@@@@@@@@@@@@@@@@@@@@@@@@@@@@@TT.T.TT.TTT@@@@@@@@@@@@@@@@@@@@@@@@@@@@@@@@@@@@@@@@@@@@@@@@@@@@@@@@@@@@@@@
@@@@@@@@@@@@@@@@@@@@@@@@@@@@@@@@@@@@@@@@@@@@@@@@@@@.TTT.TTT.@@@@@@@@@@@@@@@@@@@@@@@@@@@@@@@@@@@@@@@@@@@@@@@@@@@@@@@@@@@@@@@@
@@@@@@@@@@@@@@@@@@@@@@@@@@@@@@@@@@@@@@@@@@@@@@@@@@@@...T.T.@@@@@@@@@@@@@@@@@@@@@@@@@@@@@@@@@@@@@@@@@@@@@@@@@@@@@@@@@@@@@@@@@
@@@@@@@@@@@@@@@@@@@@@@@@@@@@@@@@@@@@@@@@@@@@@@@@@@@@@....T@@@@@@@@@@@@@@@@@@@@@@@@@@@@@@@@@@@@@@@@@@@@@@@@@@@@@@@@@@@@@@@@@@
@@@@@@@@@@@@@@@@@@@@@@@@@@@@@@@@@@@@@@@@@@@@@@@@@@@@@@T..@@@@@@@@@@@@@@@@@@@@@@@@@@@@@@@@@@@@@@@@@@@@@@@@@@@@@@@@@@@@@@@@@@@
@@@@@@@@@@@@@@@@@@@@@@@@@@@@@@@@@@@@@@@@@@@@@@@@@@@@@@@.@@@@@@@@@@@@@@@@@@@@@@@@@@@@@@@@@@@@@@@@@@@@@@@@@@@@@@@@@@@@@@@@@@@@
@@@@@@@@@@@@@@@@@@@@@@@@@@@@@@@@@@@@@@@@@@@@@@@@@@@@@@@@@@@@@@@@@@@@@@@@@@@@@@@@@@@@@@@@@@@@@@@@@@@@@@@@@@@@@@@@@@@@@@@@@@@@
@@@@@@@@@@@@@@@@@@@@@@@@@@@@@@@@@@@@@@@@@@@@@@@@@@@@@@@@@@@@@@@@@@@@@@@@@@@@@@@@@@@@@@@@@@@@@@@@@@@@@@@@@@@@@@@@@@@@@@@@@@@@
@@@@@@@@@@@@@@@@@@@@@@@@@@@@@@@@@@@@@@@@@@@@@@@@@@@@@@@@@@@@@@@@@@@@@@@@@@@@@@@@@@@@@@@@@@@@@@@@@@@@@@@@@@@@@@@@@@@@@@@@@@@@
