type octile
height 80
width 80
map
@@@@@@@@@@@@@@@@@@@@@@@@@@@@@@@@@@@@@@@@@@@@@@@@@@@@@@@@@@@@@@@@@@@@@@@@@@@@@@@@
@@@@@@@@@@@@@@@@@@@@@@@@@@@@@@@@@@@@@@@@@@@@@@@@@@@@@@@@@@@@@@@@@@@@@@@@@@@@@@@@
@@@@@@@@@@@@@@@@@@@@@@@@@@@@@@@@@@@@@@@@@@@@@@@@@@@@@@@@@@@@@@@@@@@@@@@@@@@@@@@@
@@@@@@@@@@@@@@@@@@@@@@@@@@@@@@@@@@@@@@@@@@@@@@@@@@@@@@@@@@@@@@@@@@@@@@@@@@@@@@@@
@@@@@@@@@@@@@@@@@@@@@@@@@@@@@@@@@@@@@@@@@@@@@@@@@@@@@@@@@@@@@@@@@@@@@@@@@@@@@@@@
@@@@@@@@@@@@@@@@@@@@@@@@@@@@@@@@@@@@@@@@@@@@@@@@@@@@@@@@@@@@@@@@@@@@@@@@@@@@@@@@
@@@@@@@@@@@@@@@@@@@@@@@@@@@@@@@@@@@@@@@@@@@@@@@@@@@@@@@@@@@@@@@@@@@@@@@@@@@@@@@@
@@@@@@@@@@@@@@@@@@@@@@@@@@@@@@@@@@@@@@@@@@@@@@@@@@@@@@@@@@@@@@@@@@@@@@@@@@@@@@@@
@@@@@@@@@@@@@@@@@@@@@@@@@@@@@@@@@@@@@@@@@@@@@@@@@@@@T@@@@@@@@@@@@@@@@@@@@@@@@@@@
@@@@@@@@@@@@@@@@@@@@@@@@@@@@@@@@@@@@@@@@@@@@@@@@@@@..T@@@@@@@@@@@@@@@@@@@@@@@@@@
@@@@@@@@@@@@@@@@@@@@@@@@@@@@@@@@@@@@@@@@@@@@@@@@@@.T.TT@@@@@@@@@@@@@@@@@@@@@@@@@
@@@@@@@@@@@@@@@@@@@@@@@@@@@@@@@@@@@@@@@@@@@@@@@@@.T.@@.T@@@@@@@@@@@@@@@@@@@@@@@@
@@@@@@@@@@@@@@@@@@@@@@@@@@@@@@@@@@@@@@@@@@@@@@@@TT.@@@@@@@@@@@@@@@@@@@@@@@@@@@@@
@@@@@@@@@@@@@@@@@@@@@@@@@@@@@@@@@@@@@@@@@@@@@@@.TT@@@@@@@@@@@@@@@@@@@@@@@@@@@@@@
@@@@@@@@@@@@@@@@@@@@@@@@@@@@@@@@@@@@@@@@@@@@@@T.T@@@@@@@@@@@@@@@@@@@@@@@@@@@@@@@
@@@@@@@@@@@@@@@@@@@@@@@@@@@@@@@@@@@@@@@@@@@@@..T@@@@..@@@@@@@@@@@@@@@@@@@@@@@@@@
@@@@@@@@@@@@@@@@@@@@@@@@@@@@@@@@@@@@@@@@@@@@.T.@@@@@@..@@@@@@@@@@@@@@@@@@@@@@@@@
@@@@@@@@@@@@@@@@@@@@@@@@@@@@@@@@@@@@@@@@@@@.TT.T@@.@@T.TT@.@@@@@@@@@@@@@@@@@@@@@
@@@@@@@@@@@@@@@@@@@@@@@@@@@@@@@@@@@@@@@@@@T..TT...T.T.T....@@@@@@@@@@@@@@@@@@@@@
@@@@@@@@@@@@@@@@@@@@@@@@@@@@@@@@@@@@@@@@@@@T...T.T..TT..TT@@@@@@@@@@@@@@@@@@@@@@
@@@@@@@@@@@@@@@@@@@@@@@@@@@@@@@@@@@@@@@@@@@@.T..T....T.TT@@@@@@@@@@@@@@@@@@@@@@@
@@@@@@@@@@@@@@@@@@@@@@@@@@@@@@@@@@@@@@@@@@@@@TTTTT..T....T@@@@@@@@@@@@@@@@@@@@@@
@@@@@@@@@@@@@@@@@@@@@@@@@@@@@@@@@@@@@@@@@@@@@@.TTT...T.T...@@@@@@@@@@@@@@@@@@@@@
@@@@@@@@@@@@@@@@@@@@@@@@@@@@@@@@@@@@T@@@@.@@@@@.TT.TT..T.T.T@@@@@@@@@@@@@@@@@@@@
@@@@@@@@@@@@@@@@@@@@@@@@@@@@@@@@@@@.T@@@@TT@@@@@T..T..TT.T.T.@@@@@@@@@@@@@@@@@@@
@@@@@@@@@@@@@@@@@@@@@@@@@@@@@@@@@@T..T..T.@@@@@@@TT..TTTT......@@@@@@@@@@@@@@@@@
@@@@@@@@@@@@@@@@@@@@@@@@@@@@@@@@@@TTTT.TT@@@@@@@@@..TTTT.TTT..TTT.T@@@@@@@@@@@@@
@@@@@@@@@@@@@@@@@@@@@@@@@@@@@@@@@.TT.TT.T..@@@@@@@@.TTT.....TTTTT...@@@@@@@@@@@@
@@@@@@@@@@@@@@@@@@@@@@@@@@@@@@@@..T.TT......@@@@@@@@..TT....T..T..TTT@@@@@@@@@@@
@@@@@@@@@@@@@@@@@@@@@@@@@@@@@@@TT...TT.TT.T..@@@@@@T..TTT.T.T..T.TT....@@@@@@@@@
@@@@@@@@@@@@@@@@@@@@@@@@@@@@@@@TT.T.T.TT...TTT@@@@@.TT..TT..TTTTT...T..@@@@@@@@@
@@@@@@@@@@@@@@@@@@@@@@@@@@@@.TTT..T.TTT.@@@TT.T@T.TT.T@@.....T.TTTTT..@@@@@@@@@@
@@@@@@@@@@@@@@@@@@@@@@@@@@@..TT....TT..@@@@@...T.TTT.T@@@T..TTTTTTT.T..@@@@@@@@@
@@@@@@@@@@@@@@@@@@@@@@@@@@...TT.@@@@...@@@@@@T..TT.TT@@@@@....T.T...TTT.T@@@@@@@
@@@@@@@@@@@@@@@@@@@@@@@@.TTT...@@@@@...T@@@@@@T..TTTTT@@@@@TTTT.T..T.T.T.T@@@@@@
@@@@@@@@@@@@@@@@@@@@@@@.TTT..@@@@@@.T...T@@@@@@T...TT..@@@@@.TTT...TTT.TT@@@@@@@
@@@@@@@@@@@@@@@@@@@@@@.T.TTT.T@@@@@.TTTTTT@@@@@@TTT..T..@@@@@....TTTT.T.@@@@@@@@
@@@@@@@@@@@@@@@@@@@@@.T.T.T..T.T.@@@.TT..@@@@@@@@.T......@@@@@T.TT..T..@@@@@@@@@
@@@@@@@@@@@@@@@@@@@@.....TT...T.T@@.....T@@@@@@@@@T..T...@@@@@@..T.TTT@@@@@@@@@@
@@@@@@@@@@@@@@@@@@@.T....TT..T@.T..T..TTT...@@@@@@@@TT.T..@@@@@@TT.TT@@@@@@@@@@@
@@@@@@@@@@@@@@@@@@....TT....T@@.TT...@@.TT..@@@@@@@@@T..TTT@@@@@@...@@@@@@@@@@@@
@@@@@@@@@@@@@@@@@..TTTT.T..TT.@T.T@@@@@@T..T.@@@@@@@@@TT...@@@@@@@.@@@@@@@@@@@@@
@@@@@@@@@@@@@@@@TTTT.T....TT...TTT@@@@@@.TT.TTT@@@@@@@.....T@@@@@@@@@@@@@@@@@@@@
@@@@@@@@@@@@@@@.T.TT.TTTT.TT@@TTT.T@@@@@@.....T@@@@@@TT.T.T...@@@@@@@@@@@@@@@@@@
@@@@@@@@@@@@@@T.T.TTTTT.T@@@@@@T...@@@@@TT..T...@@.@@TT...T.T.T@@@@@@@@@@@@@@@@@
@@@@@@@@@@@@@@.TT..T@@@T.@@@@@T.TTTT@TTTT...T.....T.T....T....T@@@@@@@@@@@@@@@@@
@@@@@@@@@@@@@.TT...TT@@.T@@@@@@TTTTT...TTTTT.@@..TTT..TT.T.T..@@@@@@@@@@@@@@@@@@
@@@@@@@@@@@@..TTTTTTTT@..@@@@@@TTTTTTT..TT.@@@@@TTT..T..T.T..@@@@@@@@@@@@@@@@@@@
@@@@@@@@@@@T.T.....TT@@@..@@T.TT....T.@.T.@@@@@@TT.T.TTTTTT.@@@@@@@@@@@@@@@@@@@@
@@@@@@@@@@.T.TT@....T@@@.T....TTT..TT@@@.T.@@@@@T..TTT.T.T.@@@@@@@@@@@@@@@@@@@@@
@@@@@@@@TTTTT@@@@@T....@@.TT...T.T.T.T@.TT@@@@@@.TTTT.TTT.@@@@@@@@@@@@@@@@@@@@@@
@@@@@@@T....@@@@@@@..TT..T.T.TT.TT@@@..T..T@@@@@TTTTT.TTT@@@@@@@@@@@@@@@@@@@@@@@
@@@@@@.T..TT@@@@@@@TTTTT..TT....@@@@@@@.T.T..T.TTT.....T@@@@@@@@@@@@@@@@@@@@@@@@
@@@@@TT....@@@@@@@@@..T.TT.T.T.T@@@@@@@....T....TTTT.TT@@@@@@@@@@@@@@@@@@@@@@@@@
@@@@T.TT.T.@@@@@@@@@.TTT....TTTT..@@@TTTT...TT....T...@@@@@@@@@@@@@@@@@@@@@@@@@@
@@@T.T.TT.T.@@@@@@TTTT.TT.......TT@@@TTTT......T.TTT@@@@@@@@@@@@@@@@@@@@@@@@@@@@
@@@T....T..T@@.@@@...T..T..TT........T.TTTTTT.T.TT.@@@@@@@@@@@@@@@@@@@@@@@@@@@@@
@@@@TTTT.T.TT.T.@.TT.TTTTT.T..T.TTTT.T.TT.TT.TTT..@@@@@@@@@@@@@@@@@@@@@@@@@@@@@@
@@@@@..TT.TTT.TTTTT.TTTT.TTT....T.T..T.T....TT.T.@@@@@@@@@@@@@@@@@@@@@@@@@@@@@@@
@@@@@@...T.T..T.T..TTTTT@.TT....T.T.T...TTT.TTT.@@@@@@@@@@@@@@@@@@@@@@@@@@@@@@@@
@@@@@@@.TTTTTT..T..T.@@@@.TT.T.T@TTT.TT...TT..T@@@@@@@@@@@@@@@@@@@@@@@@@@@@@@@@@
@@@@@@@@.TTT..TT.T..@@@.T..TTT..@@@T.@@TT.T...@@@@@@@@@@@@@@@@@@@@@@@@@@@@@@@@@@
@@@@@@@@@.T.......T@@@@@.T@@@@@@@@@@T@@@T.TT.@@@@@@@@@@@@@@@@@@@@@@@@@@@@@@@@@@@
@@@@@@@@@@TT..T.TT@@@@@@T.@@@@@@@@@@@@@@..T.@@@@@@@@@@@@@@@@@@@@@@@@@@@@@@@@@@@@
@@@@@@@@@@@T.TT.T@@.T@@T..@@@@@@@@@T@@@T...@@@@@@@@@@@@@@@@@@@@@@@@@@@@@@@@@@@@@
@@@@@@@@@@@@TT.TT@TT...T@@@@@@@@@@@.T@@...@@@@@@@@@@@@@@@@@@@@@@@@@@@@@@@@@@@@@@
@@@@@@@@@@@@@.TT.@T.TTTT@@@@@@@@@@@T.T@@.@@@@@@@@@@@@@@@@@@@@@@@@@@@@@@@@@@@@@@@
@@@@@@@@@@@@@@@..@T.TTTTTT@@@@@@@@TTT.T@@@@@@@@@@@@@@@@@@@@@@@@@@@@@@@@@@@@@@@@@
@@@@@@@@@@@@@@@@.@.T..T.TT@@@@@T.TTTT.T@@@@@@@@@@@@@@@@@@@@@@@@@@@@@@@@@@@@@@@@@
@@@@@@@@@@@@@@@@@@.T..TTT.@@@@..T...TT@@@@@@@@@@@@@@@@@@@@@@@@@@@@@@@@@@@@@@@@@@
@@@@@@@@@@@@@@@@@@T..TTT..@@@...T..TT@@@@@@@@@@@@@@@@@@@@@@@@@@@@@@@@@@@@@@@@@@@
@@@@@@@@@@@@@@@@@@TTTT.TT..TT......T@@@@@@@@@@@@@@@@@@@@@@@@@@@@@@@@@@@@@@@@@@@@
@@@@@@@@@@@@@@@@@@@T...TTTT.T..TTTT@@@@@@@@@@@@@@@@@@@@@@@@@@@@@@@@@@@@@@@@@@@@@
@@@@@@@@@@@@@@@@@@@@TTT.TT.T.TT.TT@@@@@@@@@@@@@@@@@@@@@@@@@@@@@@@@@@@@@@@@@@@@@@
@@@@@@@@@@@@@@@@@@@@@......TT..TT@@@@@@@@@@@@@@@@@@@@@@@@@@@@@@@@@@@@@@@@@@@@@@@
@@@@@@@@@@@@@@@@@@@@@@..TT..T.T.@@@@@@@@@@@@@@@@@@@@@@@@@@@@@@@@@@@@@@@@@@@@@@@@
@@@@@@@@@@@@@@@@@@@@@@@@.T....@@@@@@@@@@@@@@@@@@@@@@@@@@@@@@@@@@@@@@@@@@@@@@@@@@
@@@@@@@@@@@@@@@@@@@@@@@@@@TT.@@@@@@@@@@@@@@@@@@@@@@@@@@@@@@@@@@@@@@@@@@@@@@@@@@@
@@@@@@@@@@@@@@@@@@@@@@@@@@@@@@@@@@@@@@@@@@@@@@@@@@@@@@@@@@@@@@@@@@@@@@@@@@@@@@@@
@@@@@@@@@@@@@@@@@@@@@@@@@@@@@@@@@@@@@@@@@@@@@@@@@@@@@@@@@@@@@@@@@@@@@@@@@@@@@@@@
