type octile
height 64
width 60
map
@@@@@@@@@@@@@@@@@@@@@@@@@@@@@@@@@@@@@@@@@@@@@@@@@@@@@@@@@@@@
@@@@@@@@@@@@@@@@@@@@@@@@@@@@@@@@@@@@@@@@@@@@@@@@@@@@@@@@@@@@
@@@@@@@@@@@@@@@@@@@@@@@@@@@@@@@@@@@@@@@@@@@@@@@@@@@@@@@@@@@@
@@@@@@@@@@@@@@@@@@@@@@@@@@@@@@@@@@@@@@@@@@@@@@@@@@@@@@@@@@@@
@@@@@@@@@@@@@@@@@@@@@@@@@@@@@@@@@@@@@@@@@@@@@@@@@@@@@@@@@@@@
@@@@@@@@@@@@@@@@@@@@@@@@@@@@@@@@@@@@@@@@@@@@@@@@@@@@@@@@@@@@
@@@@@@@@@@@@@@@@@@@@@@@@@@@@@@@@@@@@@@@@@@@@@@@@@@@@@@@@@@@@
@@@@@@@@@@@@@@@@@@@@@@@@@@@@@@@@@@@@@@@@@@@@@@@@@@@@@@@@@@@@
@@@@@@@@@@@@@@@@@@@@@@@@@@@@@@@@@@@@@@@@@@@@@@@@@@@@@@@@@@@@
@@@@@@@@@@@@@@@@@@@@@@@@@@@@@@@@@@@@@@@@@@@@@@@@@@@@@@@@@@@@
@@@@@@@@@@@@@@@@@@@@@@@@@@@@@@@@@@@@@@@@@@@@@@@@@@@@@@@@@@@@
@@@@@@@@@@@@@@@@@@@@@@@@@@@@@@@@@@@@@@@@@@@@@@@@@@@@@@@@@@@@
@@@@@@@@@@@@@@@@@@@@@@@@@@@@@@@@@@@@@@@@@@@@@@@@@@@@@@@@@@@@
@@@@@@@@@@@@@@@@@@@@@@@@@@@@@@@@@@@@@@@@@@@@@@@@@@@@@@@@@@@@
@@@@@@@@@@@@@@@@@@@@@@@@@@@@@@@@@@@@@@@@@@@@@@@@@@@@@@@@@@@@
@@@@@@@@@@@@@@@@@@@@@@@@@@@@@@@@@@@@@@@@@@@@@@@@@@@@@@@@@@@@
@@@@@@@@@@@@@@@@@@@@@@@@@@@@@@@@@@@@TT@@@@@@@@@@@@@@@@@@@@@@
@@@@@@@@@@@@@@@@@@@@@@@@@@@@@@@@@@@@TTT...@@@@@@@@@@@@@@@@@@
@@@@@@@@@@@@@@@@@@@@@@@@@@@@@@@@@@@.TT...T@@@@@@@@@@@@@@@@@@
@@@@@@@@@@@@@@@@@@@@@@@@@@@@@@@@@@.TT.....T@@@@@@@@@@@@@@@@@
@@@@@@@@@@@@@@@@@@@@@@@@@@@@@@@@@.T.TT.T.TTTT@@@@@@@@@@@@@@@
@@@@@@@@@@@@@@@@@@@@@@@@@@@@@@@@...T.TT...TT.T@@@@@@@@@@@@@@
@@@@@@@@@@@@@@@@@@@@@@@@@@@@@@@@@.@@...T.T.TT..@@@@@@@@@@@@@
@@@@@@@@@@@@@@@@@@@@@@@@@@@@@@@@@.@@T.TT.T...T.T@@@@@@@@@@@@
@@@@@@@@@@@@@@@@@@@@@@@@@@@@@@@@...T.T.TT@@.T...@@@@@@@@@@@@
@@@@@@@@@@@@@@@@@@@@@@@@@@@T@@.TTTTT..T..@@T.TTTT@@@..@@@@@@
@@@@@@@@@@@@@@@@@@@@@@@@@@..T...TT.TTTTTT@..TTTT.T@@.T.@@@@@
@@@@@@@@@@@@@@@@@@@@@@@@@@TT.TTTTT.........TT....TT.TTT@@@@@
@@@@@@@@@@@@@@@@@@@@@@@@@TTTTT.TT.T.T..T.T..TT.T.TT...T.@@@@
@@@@@@@@@@@@@@@@@@@@@@@@....TT.TTTTTT.T...TT...T...T...T@@@@
@@@@@@@@@@@@@@@@@@@@@.T.TTT.T@T.TT.T......T..T.TTT.T..T@@@@@
@@@@@@@@@@@@@@@@@@@@@@@.T.TT@@@T...TT..TTTTT.TTTTTT.TT@@@@@@
@@@@@@@@@@@@@@@@@@@@@@@@T.T@@@@@.TT..T..T..T.TTTTT.T.@@@@@@@
@@@@@@@@@@@@@@@@@@@@@@@@T.@@@@@@@TT....T.T.TT..TT.T.@@@@@@@@
@@@@@@@@@@@@@@@@@@@@@@@T.T@@@@@@@@T.T.T..TTTT.T...T@@@@@@@@@
@@@@@@@@@@@@@@@@@@@@@T...TT@@@@@@@@....T.TTTTTT.T.@@@@@@@@@@
@@@@@@@@@@@@@@@@@@@@..T..TT.@@@@@@@TT.T...TT.T..T@@@@@@@@@@@
@@@@@@@@@@@@@@@@@@@.TTT.T..TT@@@@@T.TTTTTTTTTT.T@@@@@@@@@@@@
@@@@@@@@@@@@@@@@@@...T.TTT.TTT@@@.TT...TTTT.TT.@@@@@@@@@@@@@
@@@@@@@@@@@@@@@@@T...T.T.TTT.TT..T.T...TTTT.T.@@@@@@@@@@@@@@
@@@@@@@@@@@@@@@@T.T.T..TTT..TT.TTT.T..T.TTT.T@@@@@@@@@@@@@@@
@@@@@@@@@@@@@@@TT@@@.T.TT..TT.TTT.....T..TT.@@@@@@@@@@@@@@@@
@@@@@@T@@@@@@@@T@@@@@.T.T..T.T..T..T.TT.TT.@@@@@@@@@@@@@@@@@
@@@@@T.T@@@@@@..@@@@@@..TT.TT.T.T..TTTTT.T@@@@@@@@@@@@@@@@@@
@@@@......@@@.TTT@@@@@@TTT.T.TT.TTT..TT..@@@@@@@@@@@@@@@@@@@
@@@.T.T..TT@TT...T@@@@@...TTT....TT...TT@@@@@@@@@@@@@@@@@@@@
@@T.TT.T.TT...T.T..@@@T..T.TT..T.......@@@@@@@@@@@@@@@@@@@@@
@@.T.T.TT...TT..T.T.T.TTT.T.TT..TTTT..@@@@@@@@@@@@@@@@@@@@@@
@@@.TTTT.....TT..TTTTT..T.TTT..T..T.T@@@@@@@@@@@@@@@@@@@@@@@
@@@@...TTT.T...T..T...TTTTTTTTTTT.TT@@@@@@@@@@@@@@@@@@@@@@@@
@@@@@.TT....T.TTT.TTTTT.TTT.TT.TT.T@@@@@@@@@@@@@@@@@@@@@@@@@
@@@@@@T.T...TTT..TT.TTTT.TTTTTTT.T@@@@@@@@@@@@@@@@@@@@@@@@@@
@@@@@@@T.TT.T.TT..T...TTTT.TT.T..@@@@@@@@@@@@@@@@@@@@@@@@@@@
@@@@@@@@.TTT..TT..T..T..TTT.TT..@@@@@@@@@@@@@@@@@@@@@@@@@@@@
@@@@@@@@@..TT....TT..TT..TTTT..@@@@@@@@@@@@@@@@@@@@@@@@@@@@@
@@@@@@@@@@.T....TTT.TTTTT....T@@@@@@@@@@@@@@@@@@@@@@@@@@@@@@
@@@@@@@@@@@T.T....T..TTT.T..@@@@@@@@@@@@@@@@@@@@@@@@@@@@@@@@
@@@@@@@@@@@@.T..TT.....T..T@@@@@@@@@@@@@@@@@@@@@@@@@@@@@@@@@
@@@@@@@@@@@@@TT...T.T.....@@@@@@@@@@@@@@@@@@@@@@@@@@@@@@@@@@
@@@@@@@@@@@@@@..T.T..TTTT@@@@@@@@@@@@@@@@@@@@@@@@@@@@@@@@@@@
@@@@@@@@@@@@@@@.T..T....@@@@@@@@@@@@@@@@@@@@@@@@@@@@@@@@@@@@
@@@@@@@@@@@@@@@@.T.T.T.@@@@@@@@@@@@@@@@@@@@@@@@@@@@@@@@@@@@@
@@@@@@@@@@@@@@@@@@@@@@@@@@@@@@@@@@@@@@@@@@@@@@@@@@@@@@@@@@@@
@@@@@@@@@@@@@@@@@@@@@@@@@@@@@@@@@@@@@@@@@@@@@@@@@@@@@@@@@@@@
