type octile
height 112
width 108
map
@@@@@@@@@@@@@@@@@@@@@@@@@@@@@@@@@@@@@@@@@@@@@@@@@@@@@@@@@@@@@@@@@@@@@@@@@@@@@@@@@@@@@@@@@@@@@@@@@@@@@@@@@@@@
@@@@@@@@@@@@@@@@@@@@@@@@@@@@@@@@@@@@@@@@@@@@@@@@@@@@@@@@@@@@@@@@@@@@@@@@@@@@@@@@@@@@@@@@@@@@@@@@@@@@@@@@@@@@
@@@@@@@@@@@@@@@@@@@@@@@@@@@@@@@@@@@@@@@@@@@@@@@@@@@@@@@@@@@@@@@@@@@@@@@@@@@@@@@@@@@@@@@@@@@@@@@@@@@@@@@@@@@@
@@@@@@@@@@@@@@@@@@@@@@@@@@@@@@@@@@@@@@@@@@@@@@@@@@@@@@@@@@@@@@@@@@@@@@@@@@@@@@@@@@@@@@@@@@@@@@@@@@@@@@@@@@@@
@@@@@@@@@@@@@@@@@@@@@@@@@@@@@@@@@@@@@@@@@@@@@@@@@@@@@@@@@@@@@@@@@@@@@@@@@@@@@@@@@@@@@@@@@@@@@@@@@@@@@@@@@@@@
@@@@@@@@@@@@@@@@@@@@@@@@@@@@@@@@@@@@@@@@@@@@@@@@@@@@@@@@@@@@@@@@@@@@@@@@@@@@@@@@@@@@@@@@@@@@@@@@@@@@@@@@@@@@
@@@@@@@@@@@@@@@@@@@@@@@@@@@@@@@@@@@@@@@@@@@@@@@@@@@@@@@@@@@@@@@@@@@@@@@@@@@@@@@@@@@@@@@@@@@@@@@@@@@@@@@@@@@@
@@@@@@@@@@@@@@@@@@@@@@@@@@@@@@@@@@@@@@@@@@@@@@@@@@@@@@@@@@@@@@@@@@@@@@@@@@@@@@@@@@@@@@@@@@@@@@@@@@@@@@@@@@@@
@@@@@@@@@@@@@@@@@@@@@@@@@@@@@@@@@@@@@@@@@@@@@@@@@@@@@@@@@@@@@@@@@T.@@@@@@@@@@@@@@@@@@@@@@@@@@@@@@@@@@@@@@@@@
@@@@@@@@@@@@@@@@@@@@@@@@@@@@@@@@@@@@@@@@@@@@@@@@@@@@@@@@@@@@@@@@@TTT@@@@@@@@@@@@@@@@@@@@@@@@@@@@@@@@@@@@@@@@
@@@@@@@@@@@@@@@@@@@@@@@@@@@@@@@@@@@@@@@@@@@@@@@@@@@@@@@@@@@@@@@@@....@@@@@@@@@@@@@@@@@@@@@@@@@@@@@@@@@@@@@@@
@@@@@@@@@@@@@@@@@@@@@@@@@@@@@@@@@@@@@@@@@@@@@@@@@@@@@@@@@@@@@@@@@.TTTT@@@@@@@@@@@@@@@@@@@@@@@@@@@@@@@@@@@@@@
@@@@@@@@@@@@@@@@@@@@@@@@@@@@@@@@@@@@@@@@@@@@@@@@@@@@@@@@@@@@@@@@@T.T..T@@@@@@@@@@@@@@@@@@@@@@@@@@@@@@@@@@@@@
@@@@@@@@@@@@@@@@@@@@@@@@@@@@@@@@@@@@@@@@@@@@@@@@@@@@@@@@@@@@@@@@TTT..T.T@@@@@@@@@@@@@@@@@@@@@@@@@@@@@@@@@@@@
@@@@@@@@@@@@@@@@@@@@@@@@@@@@@@@@@@@@@@@@@@@@@@@@@@@@@@@@@@@@@@TT..T.@@T..@@@@@@@@@@@@@@@@@@@@@@@@@@@@@@@@@@@
@@@@@@@@@@@@@@@@@@@@@@@@@@@@@@@@@@@@@@@@@@@@@@@@@.@@@@@@@@@@@.TT..TT@@.TT@@@@@@@@@@@@@@@@@@@@@@@@@@@@@@@@@@@
@@@@@@@@@@@@@@@@@@@@@@@@@@@@@@@@@@@@@@@@@@@@@@@@.TT@@@@@@T@@.T.@@@.T@@T...@@@@@@@@@@@@@@@@@@@@@@@@@@@@@@@@@@
@@@@@@@@@@@@@@@@@@@@@@@@@@@@@@@@@@@@@@@@@@@@@@@TT.T@@@@@....T.@@@@T@@@.TTT@@@@@@@@@@@@@@@@@@@@@@@@@@@@@@@@@@
@@@@@@@@@@@@@@@@@@@@@@@@@@@@@@@@@@@@@@@@@@@@@@@.T.T.@@T.TTTTTT@@TT.@@@..T...@@@@@@@@@@@@@@@@@@@@@@@@@@@@@@@@
@@@@@@@@@@@@@@@@@@@@@@@@@@@@@@@@@@@@@@@@@@@@@@@@@T.T.TT..T.@.TT.T@@@@@@TT...@@@@@@@@@@@@@@@@@@@@@@@@@@@@@@@@
@@@@@@@@@@@@@@@@@@@@@@@@@@@@@@@@@@@@@@@@@@@@@@@@@@TTTT...T.@@@..@@@@@@@.T.TT@@..@@@@@@@@@@@@@@@@@@@@@@@@@@@@
@@@@@@@@@@@@@@@@@@@@@@@@@@@@@@@@@@@@@@@@@@@@@@@@@@@T..TT.T.@@@T@@@@...T.TT.T.TT.T@@@@@@@@@@@@@@@@@@@@@@@@@@@
@@@@@@@@@@@@@@@@@@@@@@@@@@@@@@@@@@@@@@@@@@@@@@@@@@@@.......@@@T@@@@TTT.TT.TT.T.TTT@@@@@@@@@@@@@@@@@@@@@@@@@@
@@@@@@@@@@@@@@@@@@@@@@@@@@@@@@@@@@@@@@@@@@@@@@@@@@@@@.TT.TT...TTTT..TTTT..T.TT...T.@@@@@@@@@@@@@@@@@@@@@@@@@
@@@@@@@@@@@@@@@@@@@@@@@@@@@@@@@@@@@@@@@@@@@@@@@@@@@@@@T..TTTTT..TTTT.T.T..TT.TTT.TT.@@@@@@@@@@@@@@@@@@@@@@@@
@@@@@@@@@@@@@@@@@@@@@@@@@@@@@@@@@@@@@@@@@@@@@@@@@@@@@@@@..T........T.T.T.TT.T..T..T@@@@@@@@@@@@@@@@@@@@@@@@@
@@@@@@@@@@@@@@@@@@@@@@@@@@@@@@@@@@@@@@@@@@@@@@@@@@@@@@@@T.T.TT....T.TTT.T.TTT.TT..@@@@@@@@@@@@@@@@@@@@@@@@@@
@@@@@@@@@@@@@@@@@@@@@@@@@@@@@@@@@@@@@@@@@@@@@@@@@@@@@@@@@T..T...T.T.T.TT..TT.T.T.@@@@@@@@@@@@@@@@@@@@@@@@@@@
@@@@@@@@@@@@@@@@@@@@@@@@@@@@@@@@@@@@@@@@@@@@@@@@@@@@@@@@@@..T.....TTT..T....T..T@@@@@@@@@@@@@@@@@@@@@@@@@@@@
@@@@@@@@@@@@@@@@@@@@@@@@@@@@@@@@@@@@@@@@@@@@@@@@.@@@@@@@@@@.T.T...T.T......TTTT@@@@@@@T@@@@@@@@@@@@@@@@@@@@@
@@@@@@@@@@@@@@@@@@@@@@@@@@@@@@@@@@@@@@@@@@@@@@@@.@@@@@@@@@@@@.T...TTTTTTTTT.T..@@@@@@.T.TT@@@@@@@@@@@@@@@@@@
@@@@@@@@@@@@@@@@@@@@@@@@@@@@@@@@@@@@@@@@@@@@@@@@..@T@@@@@@@T@@..T.TTTTTT....TT..@@@@.TT.T..@@@@@@@@@@@@@@@@@
@@@@@@@@@@@@@@@@@@@@@@@@@@@@@@@@@@@@@@@@@@@@@..T...T@@T.@@..T@@...T..TTTT.T.....T@TT.T.T.TT@@@@@@@@@@@@@@@@@
@@@@@@@@@@@@@@@@@@@@@@@@@@@@@@@@@@@@@@@@@@@@@.TT..T...T@@..TTT@@TTT.TTTT..TT..TTT...TTT.T.T@@@@@@@@@@@@@@@@@
@@@@@@@@@@@@@@@@@@@@@@@@@@@@@@@@@@@@@@@@@@@@T...T...TT@@...TT.@@@...TTTTTTTT.TT....T..T..TT@@@@@@@@@@@@@@@@@
@@@@@@@@@@@@@@@@@@@@@@@@@@@@@@@@@@@@@@@@@@...TTTT.TTT@@..TT..@@@@TT.T.TTT..TTT...TT..T...TTT.@@@@@@@@@@@@@@@
@@@@@@@@@@@@@@@@@@@@@@@@@@@@@@@@@@@@@@@@@TTTT.T.TTT.@@.TT...@@@@@.T...T..TT.T.TTT..TT...T.TT@@@@T@@@@@@@@@@@
@@@@@@@@@@@@@@@@@@@@@@@@@@@@@@@@@@@@@@@@....T.TT.TT@@.T.TT.@@@@@@T.....TTTTT.T.T..T.TTT....T..@@..@@@@@@@@@@
@@@@@@@@@@@@@@@@@@@@@@@@@@@@@@@@@@@@@@@T..T.T.T.T.T@....T.@@@@@@@.T.TTTTTTTT.TT..TT.TT@@@.TT.TTTTTT@@@@@@@@@
@@@@@@@@@@@@@@@@@@@@@@@@@@@@@@@@@@@@@@.TT..TT.T.T.T@...TT@@@@@@@@..TT.TTTTTTTTT.T....T@@@TT.TTT.....@@@@@@@@
@@@@@@@@@@@@@@@@@@@@@@@@@@@@@@@@@@@@@@@T..TT.TT....@TTTT@@@@@@@@@TTT.T.TT.TTT..TT...T.@@@T@TT....T@TT@@@@@@@
@@@@@@@@@@@@@@@@@@@@@@@@@@@@@@@@@@@@@@@@..TT.....TTT..T@@@@@@@@@....TT.@@..TTTT..T....@@T.@@..T.@@@@..@@@@@@
@@@@@@@@@@@@@@@@@@@@@@@@@@@@@@@@@@@@@@@@..TTTT.TTT..TT@@@@@@@..T.T.T.T@@@@..T.T.T...T@@@.@@T..@@@@@@@@@@@@@@
@@@@@@@@@@@@@@@@@@@@@@@@@@@@@@@@@@@@@@@@T..TTTTT..T.TT@@@@@@.TTTT..T.@@T@@@.TT.TTT..T@@@T@@...@@@@@@@@@@@@@@
@@@@@@@@@@@@@@@@@@@@@@@@@@@@@@@@@@@@@@@@T....TTT@@T.T.@@@@@TTT..T...@@TT.@@@T.T....TT@@@.@@.T.@@@@@@@@@@@@@@
@@@@@@@@@@@@@@@@@@@@@@@@@@@@@@@@@@@@@@TTTT.T.T.@@@@T.T@@@@@....TT..@@T.TT.@@.T.T....T.@@.T.T..T.@@T.TT@..T@@
@@@@@@@@@@@@@@@@@@@@@@@@@@@@@@@@@@@@..T.T......@@@@@T.@@@@..T..T.T@@TT..T@@@@T..TT.T.T@@@TT.TTTTTTT.T..T.T@@
@@@@@@@@@@@@@@@@@@@@@@@@@@@@@@@@@@@T.......T...T@@@@T.@@T..T.TTTT@@....T@@@@@@TT...TTT@@@TT....TTTT.TT...@@@
@@@@@@@@@@@@@@@@@@@@@@@@@@@@@@@@@@@.....TTTT.T..T@@@TT.@T..TT..T@@.T.T.@@@@@@@@.T.TT.....T.T.TT...TTT...@@@@
@@@@@@@@@@@@@@@@@@@@@@@@@@TT@@@@@@@@.TT..T.T.T...T@@@.TTTTTT..T@@TT...@@@@@@@@@@TT..T..TT...TT..TTT..T.@@@@@
@@@@@@@@@@@@@@@@@@@@T.TT..T.T@@@@@@@@TT.TTT.TTTT...@@TTTTTT..TT@..T..@@@@@@@@@@@..TTTT..TTTT..T.T...T.@@@@@@
@@@@@@@@@@@@@@@@@@@TTTT.TTTT.T@@@@@@@@.TTT...T...TT.T..T.TT....@.T..@@@@@@@@@@@@TTTT.TT.TTTT.T....TTT@@@@@@@
@@@@@@@@@@@@@@@@@@TT.T.@@@T.TT.@@@@@@@@.TTTT....T...TT...T....T....@@@@@@@@@@@@@T.T.T.T..T.T.T.TT.TT@@@@@@@@
@@@@@@@@@@@@@@@@@TT..T@@@@@TTTTT@@@@@@@@....T..T.T.TT..TT......T.T@@@@@@@@@@@@@@.TTT...TT.T.T.T..TT@@@@@@@@@
@@@@@@@@@@@@@@@@@T.T.@@@@@@@.T.T.@@@@@@@@..T.TT..T...TT.TT..TTTT..@@@@@@.T@@@@T.TTTT..T.TT.TTTT...@@@@@@@@@@
@@@@@@@@@@@@@@@@@@T.T@@@@@@@@TTT.T@@@@@@@@TT..TT.T.T...T.TT.@@TTTT@@@@@@T..@@TTT.TT..TT...T.TT..T@@@@@@@@@@@
@@@@@@@@@@@@@@@@@@@TTT@@@@@@@@TT..T@@@@@@@@.T.TT.T.TT.T..TT.@@@...@@@@@..T....T@@@.TTT.TTTTT.TTT@@@@@@@@@@@@
@@@@@@@@@@@@@@@@@@T...@@@@@@@@@TTT.T@@@@@@@.TTT.T.TT.TTTT..T@@@@TT@@@@@T.TT..T@@@@@.T.T..TTTTT.@@@@@@@@@@@@@
@@@@@@@@@@@@@@@@@@T....@@@@@@@@.T...T@@@@@@.TTTTT..TT..T...TT@@@..@@@@..TT..T.@@@@@@.TT....TTT@@@@@@@@@@@@@@
@@@@@@@@@@@@@@@@@@@TTT.T@@@@@@@T.T.TTT@@@@@@T.T.T....T.T..T...@@@TT@TTTTT.TT.T@@@@@@...TTT.T.@@@@@@@@@@@@@@@
@@@@@@@@@@@@@@@@@@@@TTTT.@@@@@@TTTTT..T@@@@@.T..T..TT.T..TT...T@@.T@.T.TT....T@@@@@@TT.T..TT@@@@@@@@@@@@@@@@
@@@@@@@@@@@@@@@@@@@@@TT.T@@@TTT.TT.T.T..@@@T..TT..T.T.TT.TTT.TT@@.TT..TTT.TTTT@@@@@.TTT.T..@@@@@@@@@@@@@@@@@
@@@@@@@@@@@@@@@@@@@@@@...TT.T...T..TTT.T@@.T..TTTT..T.T.TTT...TT@.TTT.T..TTT.TT.T.TTTT.TT.@@@@@@@@@@@@@@@@@@
@@@@@@@@@.@@@@.@@@@@@@@.T.TTTTTT.TT..TTT@.TT..T.TTT....T.TT..TTTT.TTTTTTT..T.TT...TTTT..T@@@@@@@@@@@@@@@@@@@
@@@@@@@@..T@@...@@@@@@@@.TTTTTT.@@@@TT....T..TT..T.T.T......T..T...T..TTTTT.T...TTT.TTT.@@@@@@@@@@@@@@@@@@@@
@@@@@@@.T..@@TTT@@@@@@@@@TT..T.@@@@@@..TTT..T..TT.@@..TTT..TTTT.T...T..TTTT...T....T..T@@@@@@@@@@@@@@@@@@@@@
@@@@@@...TT..T..T@@@@@@@@@TT.T@@@@@@@TTTTTT..T....@@@@TTTT.TT.TT.....T..T..@@T.....TT.@@@@@@@@@@@@@@@@@@@@@@
@@@@@@@@TT....TT..@@@@@@@@@TT@@@@@@@T.TT.TTT......@@@@@.....T..TTTT.TTTTTT@@@@...TT.T@@@@@@@@@@@@@@@@@@@@@@@
@@@@@@@@@T.TTTTT..TTT@@@@@@@@@@@@@@TTTTTT.TTT.T.T@@@@@@@T.TTTT.T..T.TT...@@@@@@.TT.T@@@@@@@@@@@@@@@@@@@@@@@@
@@.@@@@@@TTT.TT.TTT.T.@@@@@@@@@@@@...TT.T.T.T....@@@@@@@@TT..T...TT.T..T@@@@@@T..T.@@@@@@@@@@@@@@@@@@@@@@@@@
@@.T@@@@.TT.TTT.TTTT.TT@@@@@@@@@@.....T.TTTT..TT.@@@@@@@@@TT..T.TTT.T.T@@@@@@.....@@@@@@@@@@@@@@@@@@@@@@@@@@
@@..TT...T....TT........@@@@@@@@...T.TT..TT.T.T.T@@@@@@@@@@TT.TTT..TTT@@@@@@..T..@@@@@@@@@@@@@@@@@@@@@@@@@@@
@@.......T.TT....T.....T.@@@@@@@T.T..T..TT.TTTT..TT.@@@@@@@@TTTTT..TT@@@@@@...T.@@@@@@@@@@@@@@@@@@@@@@@@@@@@
@@..TTTTT.T.T.......TTT.T@@@@@.@.TTT.T..@@@@@.T...TTT@@@@@@@@.T..TT.@@@@@@TTTT.@@@@@@@@@@@@@@@@@@@@@@@@@@@@@
@@.TT...TTTT..TTTT..TT.TT@@@@TTT.TT.T..@@@@@@@T.T.TTT.@@@@@@@@TT.T.T@@@@@T.T.@@@@@@@@@@@@@@@@@@@@@@@@@@@@@@@
@@@.TT.T.TT..T.T.T.T.T...@@@..TTT.T.T.@@@@@@@@.T.TT..@@@@@@@@@@T.T.T@@@@.TT.@@@@@@@@@@@@@@@@@@@@@@@@@@@@@@@@
@@@@.TT..TT.TT..TT.T..TT.@@T......TTT@@@@@@@@.TT.T..TTT@@@@@@@@@.TT..@@.T.T@@@@@@@@@@@@@@@@@@@@@@@@@@@@@@@@@
@@@@@...TT....T.T.@@@T.TT@TTT.TTT.T.@@@@@@@@T..TT..T..TT@@@@@@@@@.T..TT..T@@@@@@@@@@@@@@@@@@@@@@@@@@@@@@@@@@
@@@@@@T.TTT..TT.T@@@@@...T.TT......@@@@@@@@TTT...TTTT.T.T@@@@@@@@@T..T...@@@@@@@@@@@@@@@@@@@@@@@@@@@@@@@@@@@
@@@@@@@...T..T..@@@@@@.T.TTT....TT@@@@@@@@...TT...@..T..T@@@@@@@@@@T.TTT@@@@@@@@@@@@@@@@@@@@@@@@@@@@@@@@@@@@
@@@@@@@@.T..TT.@@@@@@@TTT..T.TT.TT@@@@@@@T.T.T...@@@@@T.T.TT@@@@@@@@...@@@@@@@@@@@@@@@@@@@@@@@@@@@@@@@@@@@@@
@@@@@@@@@.T..T@@@@@@@@T...T....T.T@@@@@@@@..TT..T@@@@@@@TTTTT@@@@@@@@.@@@@@@@@@@@@@@@@@@@@@@@@@@@@@@@@@@@@@@
@@@@@@@@@@TTT@@@@@@@@....TT....T..@@@@@@@@@T.....T@@@@@@T..T.T@@@@@@@@@@@@@@@@@@@@@@@@@@@@@@@@@@@@@@@@@@@@@@
@@@@@@@@@@@.@@@@@@@@T..T..TTT...TT@@@@@@@@@@..T..@@@@@@@.T.T...@@@@@@@@@@@@@@@@@@@@@@@@@@@@@@@@@@@@@@@@@@@@@
@@@@@@@@@@@@@@@@@@@.TT...T.TT..T..@@@@@@@@@@@.TTT@@@@TTTT....TTT@@@@@@@@@@@@@@@@@@@@@@@@@@@@@@@@@@@@@@@@@@@@
@@@@@@@@@@@@@@@@@@TT.T..T.T....T..@@@@@@@@@@@@.T..@TT.TTTTTT...T.@@@@@@@@@@@@@@@@@@@@@@@@@@@@@@@@@@@@@@@@@@@
@@@@@@@@@@@@@@@@@T.T..T..T..T.TT...TT..@@@@@@@@....T.T......T..T@@@@@@@@@@@@@@@@@@@@@@@@@@@@@@@@@@@@@@@@@@@@
@@@@@@@@@@@@@@@@.TTTTTT.T.@@@TT.TTTTTT@@@@@@@@@@.T.TTTTT.TTTTTT@@@@@@@@@@@@@@@@@@@@@@@@@@@@@@@@@@@@@@@@@@@@@
@@@@@@@@@@@@@@@@TTTTT.T..@@@@@T.T..TT.@@@@@@@@@@@T.T.T.T..TT..@@@@@@@@@@@@@@@@@@@@@@@@@@@@@@@@@@@@@@@@@@@@@@
@@@@@@@@@@@@@@@@@T.T..TT@@@@@@@...TT..T.T.T@@@@@@@TTTTTTT.TT.@@@@@@@@@@@@@@@@@@@@@@@@@@@@@@@@@@@@@@@@@@@@@@@
@@@@@@@@@@@@@@@@@@.T.T.@@@@@@@..TTTTTT..T.@@@@@@@@@T...TTTT.@@@@@@@@@@@@@@@@@@@@@@@@@@@@@@@@@@@@@@@@@@@@@@@@
@@@@@@@@@@@@@@@@@@@TTT@@@@@@@...TT.......@@@@@@@@@@@....TT.@@@@@@@@@@@@@@@@@@@@@@@@@@@@@@@@@@@@@@@@@@@@@@@@@
@@@@@@@@@@@@@@@@@@@@.@@@@@@@TTTTT.TT.T.@@@@@@@@@@@@@@T.T..@@@@@@@@@@@@@@@@@@@@@@@@@@@@@@@@@@@@@@@@@@@@@@@@@@
@@@@@@@@@@@@@@@@@@@@@@@@@@@......T.T....@@@@@@@@@@@@@@..T@@@@@@@@@@@@@@@@@@@@@@@@@@@@@@@@@@@@@@@@@@@@@@@@@@@
@@@@@@@@@@@@@@@@@@@@@@@@@@....T.TT.TTT..T@@@.T@@@@@@@@@.@@@@@@@@@@@@@@@@@@@@@@@@@@@@@@@@@@@@@@@@@@@@@@@@@@@@
@@@@@@@@@@@@@@@@@@@@@@@@@T.TTT..TT.T.T..T.@.....@@@@@@@@@@@@@@@@@@@@@@@@@@@@@@@@@@@@@@@@@@@@@@@@@@@@@@@@@@@@
@@@@@@@@@@@@@@@@@@@@@@@@T...TT..TT...TT.T.TT.TTT.@@@@@@@@@@@@@@@@@@@@@@@@@@@@@@@@@@@@@@@@@@@@@@@@@@@@@@@@@@@
@@@@@@@@@@@@@@@@@@@@@@@@@..T..T.T.T.TTT....TT.TT.T@@@@@@@@@@@@@@@@@@@@@@@@@@@@@@@@@@@@@@@@@@@@@@@@@@@@@@@@@@
@@@@@@@@@@@@@@@@@@@@@@@@@@.T.T..T.T..T....TTTTTTTT.@@@@@@@@@@@@@@@@@@@@@@@@@@@@@@@@@@@@@@@@@@@@@@@@@@@@@@@@@
@@@@@@@@@@@@@@@@@@@@@@@@@@@.....TT.T..TTT.TTTT.T..T@@@@@@@@@@@@@@@@@@@@@@@@@@@@@@@@@@@@@@@@@@@@@@@@@@@@@@@@@
@@@@@@@@@@@@@@@@@@@@@@@@@@@@.TT.T..T.TTTT.TTTTTTT.@@@@@@@@@@@@@@@@@@@@@@@@@@@@@@@@@@@@@@@@@@@@@@@@@@@@@@@@@@
@@@@@@@@@@@@@@@@@@@@@@@@@@@@@TT..TT..TTT.T.T..TT.@@@@@@@@@@@@@@@@@@@@@@@@@@@@@@@@@@@@@@@@@@@@@@@@@@@@@@@@@@@
@@@@@@@@@@@@@@@@@@@@@@@@@@@@@@..T...TTTTTTTT..TT@@@@@@@@@@@@@@@@@@@@@@@@@@@@@@@@@@@@@@@@@@@@@@@@@@@@@@@@@@@@
@@@@@@@@@@@@@@@@@@@@@@@@@@@@@@@TTTTTTTTT.T.T.TT@@@@@@@@@@@@@@@@@@@@@@@@@@@@@@@@@@@@@@@@@@@@@@@@@@@@@@@@@@@@@
@@@@@@@@@@@@@@@@@@@@@@@@@@@@@@@@T.TTT.T...T..T@@@@@@@@@@@@@@@@@@@@@@@@@@@@@@@@@@@@@@@@@@@@@@@@@@@@@@@@@@@@@@
@@@@@@@@@@@@@@@@@@@@@@@@@@@@@@@@@...TT.T.T.T.@@@@@@@@@@@@@@@@@@@@@@@@@@@@@@@@@@@@@@@@@@@@@@@@@@@@@@@@@@@@@@@
@@@@@@@@@@@@@@@@@@@@@@@@@@@@@@@@@@TTTT..T...@@@@@@@@@@@@@@@@@@@@@@@@@@@@@@@@@@@@@@@@@@@@@@@@@@@@@@@@@@@@@@@@
@@@@@@@@@@@@@@@@@@@@@@@@@@@@@@@@@@@.TT..T..@@@@@@@@@@@@@@@@@@@@@@@@@@@@@@@@@@@@@@@@@@@@@@@@@@@@@@@@@@@@@@@@@
@@@@@@@@@@@@@@@@@@@@@@@@@@@@@@@@@@@@TTT.T.@@@@@@@@@@@@@@@@@@@@@@@@@@@@@@@@@@@@@@@@@@@@@@@@@@@@@@@@@@@@@@@@@@
@@@@@@@@@@@@@@@@@@@@@@@@@@@@@@@@@@@@@..TT@@@@@@@@@@@@@@@@@@@@@@@@@@@@@@@@@@@@@@@@@@@@@@@@@@@@@@@@@@@@@@@@@@@
@@@@@@@@@@@@@@@@@@@@@@@@@@@@@@@@@@@@@@..@@@@@@@@@@@@@@@@@@@@@@@@@@@@@@@@@@@@@@@@@@@@@@@@@@@@@@@@@@@@@@@@@@@@
@@@@@@@@@@@@@@@@@@@@@@@@@@@@@@@@@@@@@@@@@@@@@@@@@@@@@@@@@@@@@@@@@@@@@@@@@@@@@@@@@@@@@@@@@@@@@@@@@@@@@@@@@@@@
