type octile
height 64
width 60
map
@@@@@@@@@@@@@@@@@@@@@@@@@@@@@@@@@@@@@@@@@@@@@@@@@@@@@@@@@@@@
@@@@@@@@@@@@@@@@@@@@@@@@@@@@@@@@@@@@@@@@@@@@@@@@@@@@@@@@@@@@
@@@@@@@@@@@@@@@@@@@@@@@@@@@@@@@@@@@@@@@@@@@@@@@@@@@@@@@@@@@@
@@@@@@@@@@@@@@@@@@@@@@@@@@@@@@@@@@@@@@@@@@@@@@@@@@@@@@@@@@@@
@@@@@@@@@@@@@@@@@@@@@@@@@@@@@@@@@@@@@@@@@@@@@@@@@@@@@@@@@@@@
@@@@@@@@@@@@@@@@@@@@@@@@@@@@@@@@@@@@@@@@@@@@@@@@@@@@@@@@@@@@
@@@@@@@@@@@@@@@@@@@@@@@@@@@@@@@@@@@@@@@@@@@@@@@@@@@@@@@@@@@@
@@@@@@@@@@@@@@@@@@@@@@@@@@@@@@@@@@@@@@@@@@@@@@@@@@@@@@@@@@@@
@@@@@@@@@@@@@@@@@@@@@@@@@@@@@@@@@@@@@@@@@@@@@@@@@@@@@@@@@@@@
@@@@@@@@@@@@@@@@@@@@@@@@@@@@@@@@@@@@@@@@@@@@@@@@@@@@@@@@@@@@
@@@@@@@@@@@@@@@@@@@@@@@@@@@@@@@@@@@@@@@@@@@@@@@@@@@@@@@@@@@@
@@@@@@@@@@@@@@@@@@@@@@@@@@@@@@@@.@@@@@@@@@@@@@@@@@@@@@@@@@@@
@@@@@@@@@@@@@@@@@@@@@@@@@@@@@@@TT@@@@@@@@@@@@@@@@@@@@@@@@@@@
@@@@@@@@@@@@@@@@@@@@@@@@@@@@@@@T.@@@@.T.@@@@@@@@@@@@@@@@@@@@
@@@@@@@@@@@@@@@@@@@@@@@@@@@@@@@.T@@@@@@T.@@@@@@@@@@@@@@@@@@@
@@@@@@@@@@@@@@@@@@@@@@@@@@@@@@@TT@T@@@@@.T@@@@@@@@@@@@@@@@@@
@@@@@@@@@@@@@@@@@@@@@@@@@@@@@@@.TTTT@@@@@T.@@@@@@@@@@@@@@@@@
@@@@@@@@@@@@@@@@@@@@@@@@@@@@@@@..T.TT@@@@@.T@@@@@@@@@@@@@@@@
@@@@@@@@@@@@@@@@@@@@@@@@@@@@@@@......@@@@@.TT@@@@@@@@@@@@@@@
@@@@@@@@@@@@@@@@@@@@@@@@@@@@@@@@@..TT@@@@TT.TT..@@@@@@@@@@@@
@@@@@@@@@@@@@@@@@@@@@@@@@@@@@@@@@..TT.T..TTTT.@.T@@@@@@@@@@@
@@@@@@@@@@@@@@@@@@@@@@@@@@@@@@@.T.TT.TT....T.@@@TT@@@@@@@@@@
@@@@@@@@@@@@@@@@@@@@@@@@@@@@@@T.TTTTT.T.T...@@@...T@@@@@@@@@
@@@@@@@@@@@@@@@@@@@@@@@@@@@@@TT.T..TTTTT.TT@@@@@TTTT@@@@@@@@
@@@@@@@@@@@@@@@@@@@@@@@@@@.T@@T..T..TT..T..@@@@@@@@.T@@@@@@@
@@@@@@@@@@@@@@@@@@@@@@@.@@.@@@TTTT......T.@@@@@@@@@.TT@@@@@@
@@@@@@@@@@@@@@@@@@@@@@@T..TTTTTTTT..TT..T.@@@T@@TT...T.@@@@@
@@@@@@@@@@@@@@@@@@@@@@.T..T.TTT.TT.@@@....T.T...TTTT...T@@@@
@@@@@@@@@@@@@@@@@@@@T.....TT...TTTT@@@T...TT.TT.T.T.TTTT@@@@
@@@@@@@@@@@@@@@@@@@T.TTTT..TT.TT.TTTT...T..T.....TT..T.@@@@@
@@@@@@@@@@@@@@@@@@.TT.T@@..T..TT..TTTTT..T.T.T...T.T..@@@@@@
@@@@@@@@@@@@@@@@@.TT.T@@@@.T@@..TTTT.TTTT.T...T.TTT.T@@@@@@@
@@@@@@@@@@@@@@@@@T...@@@@@@@@@T.T..TT...TTTT..T...TT@@@@@@@@
@@@@@@@T@@@@@@@@..T@@@@@@@@@..TTT...TT.T.TTT..T..TT@@@@@@@@@
@@@@@@..T@@@@@@..T@@@@@@@@@@@TT@@T.TT.............@@@@@@@@@@
@@@@@.T..T@@@@T.TTT@@@@@@@@@@@@@@TTTTTTT..TTTT...@@@@@@@@@@@
@@@@TT....@@@TT.TT.@@@@@@@@@@@@.....T..TTT...TTT@@@@@@@@@@@@
@@@@T.TT...@T..TT.TT@T.@@@@@@@@@T.T..T..T.TT...@@@@@@@@@@@@@
@@@@@TTT.TT@T.TTTT...TTT@@@@@@@@@.TTT.TTTT....@@@@@@@@@@@@@@
@@@@@...TT.@@TTTT...T.TT@@@@@@@@@@TT.T.T.TTTT@@@@@@@@@@@@@@@
@@@@@@TTT.TT@T...T.TTT..@@@@@@@@.....T.TTT..@@@@@@@@@@@@@@@@
@@@@@@TTTT..@@T.TTT.TT.@@@@@@@@T..T...T.TT.@@@@@@@@@@@@@@@@@
@@@@@@..T.T.T@TT.TT.T.@@@@@@@@TT..T.TT..TT@@@@@@@@@@@@@@@@@@
@@@@@T.T.TT.T@@..TT.T@@@@@@@@@@TTTT..T..T@@@@@@@@@@@@@@@@@@@
@@@@.TT.TTT..T@.T...@@@@@@@@@@TT...TTTTT@@@@@@@@@@@@@@@@@@@@
@@@@TT..TT....@T.T.@@@@@@@@TTT.....T..T@@@@@@@@@@@@@@@@@@@@@
@@@@@T.T.T.T.T...T@@@@@@@@@@T..T.TTT.T@@@@@@@@@@@@@@@@@@@@@@
@@@@@@..T......TT@@@@@@@@.@TTT...T...@@@@@@@@@@@@@@@@@@@@@@@
@@@@@@@TT..T..T.@@@@@@@@.T.TT.TT..T.@@@@@@@@@@@@@@@@@@@@@@@@
@@@@@@@@..TTTTT@@@@@@@@TTT...T..T.T@@@@@@@@@@@@@@@@@@@@@@@@@
@@@@@@@@@.T.TT@@@@@@@@@TTTT....T..@@@@@@@@@@@@@@@@@@@@@@@@@@
@@@@@@@@@@TTT..@@@@@@@T..........@@@@@@@@@@@@@@@@@@@@@@@@@@@
@@@@@@@@@@@TT..T@@@@.TTT.T.TTT.T@@@@@@@@@@@@@@@@@@@@@@@@@@@@
@@@@@@@@@@@@.TTTT@@T....T.TTT..@@@@@@@@@@@@@@@@@@@@@@@@@@@@@
@@@@@@@@@@@@@.T.TTTTT.TTT...TT@@@@@@@@@@@@@@@@@@@@@@@@@@@@@@
@@@@@@@@@@@@@@TTT.T.TT.TTTTT@@@@@@@@@@@@@@@@@@@@@@@@@@@@@@@@
@@@@@@@@@@@@@@@.T.TT.TTTT..@@@@@@@@@@@@@@@@@@@@@@@@@@@@@@@@@
@@@@@@@@@@@@@@@@...TT...T.@@@@@@@@@@@@@@@@@@@@@@@@@@@@@@@@@@
@@@@@@@@@@@@@@@@@...TTT..@@@@@@@@@@@@@@@@@@@@@@@@@@@@@@@@@@@
@@@@@@@@@@@@@@@@@@@TTT.T@@@@@@@@@@@@@@@@@@@@@@@@@@@@@@@@@@@@
@@@@@@@@@@@@@@@@@@@@.TT@@@@@@@@@@@@@@@@@@@@@@@@@@@@@@@@@@@@@
@@@@@@@@@@@@@@@@@@@@@@@@@@@@@@@@@@@@@@@@@@@@@@@@@@@@@@@@@@@@
@@@@@@@@@@@@@@@@@@@@@@@@@@@@@@@@@@@@@@@@@@@@@@@@@@@@@@@@@@@@
@@@@@@@@@@@@@@@@@@@@@@@@@@@@@@@@@@@@@@@@@@@@@@@@@@@@@@@@@@@@
