type octile
height 80
width 80
map
@@@@@@@@@@@@@@@@@@@@@@@@@@@@@@@@@@@@@@@@@@@@@@@@@@@@@@@@@@@@@@@@@@@@@@@@@@@@@@@@
@@@@@@@@@@@@@@@@@@@@@@@@@@@@@@@@@@@@@@@@@@@@@@@@@@@@@@@@@@@@@@@@@@@@@@@@@@@@@@@@
@@@@@@@@@@@@@@@@@@@@@@@@@@@@@@@@@@@@@@@@@@@@@@@@@@@@@@@@@@@@@@@@@@@@@@@@@@@@@@@@
@@@@@@@@@@@@@@@@@@@@@@@@@@@@@@@@@@@@@@@@@@@@@@@@@@@@@@@@@@@@@@@@@@@@@@@@@@@@@@@@
@@@@@@@@@@@@@@@@@@@@@@@@@@@@@@@@@@@@@@@@@@@@@@@@@@@@@@@@@@@@@@@@@@@@@@@@@@@@@@@@
@@@@@@@@@@@@@@@@@@@@@@@@@@@@@@@@@@@@@@@@@@@@@@@@@@@@@@@@@@@@@@@@@@@@@@@@@@@@@@@@
@@@@@@@@@@@@@@@@@@@@@@@@@@@@@@@@@@@@@@@@@@@@@@@@@@@@@@@@@@@@@@@@@@@@@@@@@@@@@@@@
@@@@@@@@@@@@@@@@@@@@@@@@@@@@T.@@@@@@@@@@@@@@@@@@@@@@@@@@@@@@@@@@@@@@@@@@@@@@@@@@
@@@@@@@@@@@@@@@@@@@@@@@@@T.TTT@@@@@@@@@@@@@@@@@@@@@@@@@@@@@@@@@@@@@@@@@@@@@@@@@@
@@@@@@@@@@@@@@@@@@@@@@@@.T...@@@@@@@@@@@@@@@@@@@@@@@@@@@@@@@@@@@@@@@@@@@@@@@@@@@
@@@@@@@@@@@@@@@@@@@@@@@T.T.T.@@@@@@@@@@@@@@@@@@@@@@@@@@@@@@@@@@@@@@@@@@@@@@@@@@@
@@@@@@@@@@@@@@@@@@@@@@@TT.TTT@@@@@@@@@@@@@@@@@@@@@@@@@@@@@@@@@@@@@@@@@@@@@@@@@@@
@@@@@@@@@@@@@@@@@@@@@@T.TTTTT@@@@@@@@@@@@@@@@@@@@@@@@@@@@@@@@@@@@@@@@@@@@@@@@@@@
@@@@@@@@@@@@@@@@@@@@@@...T.T.@@@@@@@@@@@@@@@@@@@@@@@@@@@@@@@@@@@@@@@@@@@@@@@@@@@
@@@@@@@@@@@@@@@@@@@@@.T......T@@@@@@@@@@@@@@@@@@@@@@@@@@@@@@@@@@@@@@@@@@@@@@@@@@
@@@@@@@@@@@@@@@@@@@@@T.TTTT.TTT@@@@@@@@@@@@@@@@@@@@@@@@@@@@@@@@@@@@@@@@@@@@@@@@@
@@@@@@@@@@@@@@@@@@@@..T.TTTTT.T.@@@@@@@@@@@@@@@@@@@@@@@@@@@@@@@@@@@@@@@@@@@@@@@@
@@@@@@@@@@@@@@@@@@@@.T@@T.T.T.T..T@...@@@@@@@@@@@@@@@@@@@@@@@@@@@@@@@@@@@@@@@@@@
@@@@@@@@@@@@@@@@@@@...@@..TT...T.TTTTTT@@@@@@@@@@@@@@@@@@@@@@@@@@@@@@@@@@@@@@@@@
@@@@@@@@@@@@@@@@@@@...@@T.TTTTTT..TT.T..T...T@@@@@@@@@@@@@@@@@@@@@@@@@@@@@@@@@@@
@@@@@@@@@@@@@@@@@@@...TT..TT..T..T.T.T..T.TTT@@@@@@@@@@@@@@@@@@@@@@@@@@@@@@@@@@@
@@@@@@@@@@@@@@@@@@@T..TTT.TTTT..TT.TT..T..T...@@@@@@@@@@@@@@@@@@@@@@@@@@@@@@@@@@
@@@@@@@@@@@@@@@@@@@.T..T..TT.TTTTT.TT...TT.TT.@@@@@@@@@@@@@@@@@@@@@@@@@@@@@@@@@@
@@@@@@@@@@@@@@@@@@@TT.T..T.TTT....TTT.TTT.TTTT@@@@@@@@@@@@@@@@@@@@@@@@@@@@@@@@@@
@@@@@@@@@@@@@@@@@@@TT.T.TTT....T.TT.TTT..T..@@@@@@@@@@@@@@@@@@@@@@@@@@@@@@@@@@@@
@@@@@@@@@@@@@@@@@@...T..T..TT..TT.T.T.....TT@@@@@@@@@@@@@@@@@@@@@@@@@@@@@@@@@@@@
@@@@@@@@@@@@@@@@@@T.TT.T.T........TT.TTT....@@@@@@@@@@@@@@@@@@@@@@@@@@@@@@@@@@@@
@@@@@@@@@@@@@@@@@@.T..T.T.TT.T...TT...T.T.TT..@@@@@@@@@@@@@@@@@@@@@@@@@@@@@@@@@@
@@@@@@@@@@@@@@@@@@T.TT.TTTTT.T.TTT....TT.T.TT@@@@@@@@@@@@@@@@@@@@@@@@@@@@@@@@@@@
@@@@@@@@@@@@@@@@@@TT..T.TT....T.TTTTT.TT..T.@@@@@@@@@@@@@@@@@@@@@@@@@@@@@@@@@@@@
@@@@@@@@@@@@@@@@@@..T.......T..T.TT.TTT.T.T@@@@@@@@@@@@@@@@@@@@@@@@@@@@@@@@@@@@@
@@@@@@@@@@@@@@@@@@.TT...T...T.TT..TT.T...T@@@@@@@@@@@@@@@@@@@@@@@@@@@@@@@@@@@@@@
@@@@@@@@@@@@@@@@@T...T...T.T..T....T....T.T@@@@@@@@@@@@@@@@@@@@@@@@@@@@@@@@@@@@@
@@@@@@@@@@@@@@@@.T.TTTTT...TT.T....TT.TTT....@@@@@@@@@@@@@@@@@@@@@@@@@@@@@@@@@@@
@@@@@@@@@@@@@@@TT...TT..T..TTT.T.TT.T..TT.TT.T@@@@@@@@@@@@@@@@@@@@@@@@@@@@@@@@@@
@@@@@@@T..TTTTTTTT.TTT.T..TTTT.TT.TT.T..T...TT.@@@@@@@@@@@@@@@@@@@@@@@@@@@@@@@@@
@@@@@@@@....T..T.T.T..T.TT.T.....T.T.TT...TTTT@@@@@@@@@@@@@@@@@@@@@@@@@@@@@@@@@@
@@@@@@@@...T.TTTT.T....T..TT...T..TTT.TTT....@@@@@@@@@@@@@@@@@@@@@@@@@@@@@@@@@@@
@@.@@..T.TT.T.TT........TT.T.T.TT.TTTT.T..TT@@@@@@@@@@@@@@@@@@@@@@@@@@@@@@@@@@@@
@@.TTTTTT.T.TT......TT.T.TTTT..T.TTT..TT..T.@@@@@@@@@@@@@@@@@@@@@@@@@@@@@@@@@@@@
@@.....T...T...TT...T.T.T.TTT.T..T.TT.TTTTT.T@@@@@@@@@@@@@@@@@@@@@@@@@@@@@@@@@@@
@@..T.TT..T..T..T.T....TT......TT...TT..T...T.@@@@@@@@@@@@@@@@@@@@@@@@@@@@@@@@@@
@@....TT..T.TTTTT.T....TT..T.....TT.TT.T.TT.TT.@@@@@@@@@@@@@@@@@@@@@@@@@@@@@@@@@
@@TTTTT.TTTTT...T.T..TTT.T....T.TT.TTTT..TTTTTTTT.T@@@@@@@@@@@@@@@@@@@@@@@@@@@@@
@@TT...T.T....T..T.....T......TTTTT.TTT.....T.....TT@@@@@.@@@@@@@@@@@@@@@@@@@@@@
@@..T....T.T.....T..T.TTTTT.T..T.T.T.T.T..T.TT....T..TTT.T@@@T.@@@@@@@@@@@@@@@@@
@@TTT.TTTTT..T..T.........T.TT....TTTT....TTT..T..T...TT.....TT@@@@@@@@@@@@@@@@@
@@TT..TTT...T...TTTT.TT.TTTT.TTT.TTT.T.TT.T....TT..T.T..T...@..@@@@@@@@@@@@@@@@@
@@TT.TT..TTT.T.TT....TT.T..T.T..TTT.TTTTT..T....TTT....T..T@@@T@@@@@@@@@@@@@@@@@
@@.T...T..T..T..TT..TT.T..T..TT.TTT..TTTT.T...TTT.......T.T.@TT@@@@@@@@@@@@@@@@@
@@.TTT.T.TTT.TT.TT.T..T...T.TTTT.TT.....T.TTTT.TT..TTTT..TT..T@@@@@@@@@@@@@@@@@@
@@T.......TTT.....T..TTTTTT.T.T.....T..TT.......T.T.TT......T.@@@@@@@@@@@@@@@@@@
@@TTT......TT..TTTTT.T...TT.TT..T.T..T..T....TT..T.TT.T.T..T..@@@@@@@@@@@@@@@@@@
@@.TT.T......TTT..T..T..TT..T..TTTTTTT..T..TT.TTT.T.TTT...T...@@@@@@@@@@@@@@@@@@
@@.T.TT..T.T.T..T......TT...TTT.TT.T.TT.T.T.TT.TTTT.T..TT....TT@@@@@@@@@@@@@@@@@
@@.T.TTT.T....T....T.TTTT...TTTT..T.TTT...T....T.T...T...T.TTTT..T.@@@@@@@@@@@@@
@@T.TTT.TTTTT..T...TTTTT..TTT..........TT.....T...TT.T.....T...TTTTT@@T@@@@@@@@@
@@TT..T...TTTTTTTTT.TTT......T..TT...T...TTT....T..TTT.T.TT.T.......T.T@@@@@@@@@
@@T..TT.TTT.T.TT.TTTTT..T..TT...TTT.TTTTT.T...TTTTT....TT.TT.TTTT...T.T@@@@@@@@@
@@..TTT...TT.TT.TTTTTT...T.TTTTTTT.TT.TTTT.T..TTTT.TTTT.T.T.T..TTTT..TT@@@@@@@@@
@@TT.T.TTT.TT...T...TT..TT..TTTT.T.T.TT..TT..T....T..TT.TT.T.T..TTTT.TT.@@@@@@@@
@@..T....T..TTTTTT.TTT.T.T.TTTTT.TTT..TTTTT.TTT.TT....TTT.T..T.T.T...T..T@@@@@@@
@@TT.T...T.T..TTTT..T.TT...TTT...TTT..T.TTTT...T..TTT......TT.T.TTTTT...TT.@@@@@
@@....T.T.TT..T.TT...T.TTT..T..T...TT.T....T.TTT...TT.TT..TT....TT..TT...TTT@@@@
@@.T.TTT......TTT....T.TTT.TT..T.TTTTTT.TT..T...T...T.T.TTTT...T....TT..T...T.@@
@@TT...TTTT...T....T.T.T....T.TT.TTTT.TT.TTTT..T.TTTTT.T.T....TTT.T.TT.T..T...@@
@@TT...T.TT..TT....TTTTTT.....T.TT....TT..T...T..TT.T.T.T..TTTTTTTT.T.T..TT.T.@@
@@T.T..T..TTTTTT....TT..T...TTT.T.TT.TTT..T.......T...T...TTTTT.T.T.TTT.T.TTT.@@
@@T..T...TTTTTT....@T...TTT..T.......TT..TT..T.T..T..T.T..TT.T.T..TTTTTTTT.TTT@@
@@.TTTT....TT.TT@@@@@@T..T.T.TT.T..TTT.TT..TTT.TT..TTT..T..TT..TT.T..T.T...T.T@@
@@T.T..TTT.T....@@@@@@@..TTT.T..T.TTTTTT....T...T.TTT.TTT.TTTT..T....TT.TTT..T@@
@@.T.T...TTT..T@@@@@@@@@@T...T...TTT.T.T.TTTTT..T.TTT.T.TT..TT...TT..T..TT.T.T@@
@@.TT...TTTTT..@@@@@@@@@@@T..T.....TT..TT...TT..T..TTT...TT....TTT.T....TTTTT.@@
@@TTTT..T...T.@@@@@@@@@@@@@@@@@@@.T.....TT.TTTT..TTTT.TT.TT.T.T....TTTT.TTTTTT@@
@@T..TTTT.....@@@@@@@@@@@@@@@@@@@@@@@@@..T.T...T...TT..T.TTT..T..TTT...T..TTT.@@
@@@@@.....TT.@@@@@@@@@@@@@@@@@@@@@@@@@@@@..TT...TTTTT.....TT@@..T...T.TTT..TTT@@
@@@@@@@@....T@@@@@@@@@@@@@@@@@@@@@@@@@@@@@..T@@.TTT.TT..TT..@@.T...T.T..T.T.T.@@
@@@@@@@@@T.T@@@@@@@@@@@@@@@@@@@@@@@@@@@@@@@@@@@@@@@@@.T.T@@@@@@@@@T.TTT...T.T.@@
@@@@@@@@@@@@@@@@@@@@@@@@@@@@@@@@@@@@@@@@@@@@@@@@@@@@@@@@@@@@@@@@@@@@@@@@@@@@@@@@
@@@@@@@@@@@@@@@@@@@@@@@@@@@@@@@@@@@@@@@@@@@@@@@@@@@@@@@@@@@@@@@@@@@@@@@@@@@@@@@@
