type octile
height 59
width 56
map
@@@@@@@@@@@@@@@@@@@@@@@@@@@@@@@@@@@@@@@@@@@@@@@@@@@@@@@@
@@@@@@@@@@@@@@@@@@@@@@@@@@@@@@@@@@@@@@@@@@@@@@@@@@@@@@@@
@@@@@@@@@@@@@@@@@@@@@@@@@@@@@@@@@@@@@@@@@@@@@@@@@@@@@@@@
@@@@@@@@@@@@@@@@@@@@@@@@@@@@@@@@@@@@@@@@@@@@@@@@@@@@@@@@
@@@@@@@@@@@@@@@@@@@@@@@@@@@@@@@@@@@@@@@@@@@@@@@@@@@@@@@@
@@@@@@@@@@@@@@@@@@@@@@@@@@@@@@@@@@@@@@@@@@@@@@@@@@@@@@@@
@@@@@@@@@@@@@@@@@@@@@@@@@@@@@@@@@@@@@@@@@@@@@@@@@@@@@@@@
@@@@@@@@@@@@@@@@@@@@@@@@@@@@@@@@@@@@@@@@@@@@@@@@@@@@@@@@
@@@@@@@@@@@@@@@@@@@@@@@@@@@@@@@@@@@@@@@@@@@@@@@@@@@@@@@@
@@@@@@@@@@@@@@@@@@@@@@@@@@@@@@@@@@@@@@@@@@@@@@@@@@@@@@@@
@@@@@@@@@@@@@@@@@@@@@@@@@@@@@@@@@@@@@@@@@@@@@@@@@@@@@@@@
@@@@@@@@@@@@@@@@@@@@@@@@@@@@@@@@@@@@@@@@@@@@@@@@@@@@@@@@
@@@@@@@@@@@@@@@@@@@@@@@...T...T..T@@@@@@@@@@@@@@@@@@@@@@
@@@@@@@@@@@@@@@@@@@@.T....T....TTTTTT@@@@@@@@@@@@@@@@@@@
@@@@@@@@@@@@@@@@@.T...@@@@@@@...TTT.T.T@@@@@@@@@@@@@@@@@
@@@@@@@@@@@@@@@@@.TTT@@@@@@@@@T..T.T..T@@@@@@@@@@@@@@@@@
@@@@@@@@@@@@@@@@@.TT.@@@@@@@@@@.T.TT..@@@@@@@@@@@@@@@@@@
@@@@@@@@@@@@@@@@...T@@@@@@@@.T.T.......@@@@@@@@@@@@@@@@@
@@@@@@@@@@@@@@@@@.TT@@@@@TT.T.T.....TTTTT@@@@@@@@@@@@@@@
@@@@@@@@@@@@@@@@@@..@@@T.TTTT...TTTTT....T@@@@@@@@@@@@@@
@@@@@@@@@@@@@@@@@@T.TT@@@.T..T.T....T.T.TT@@@@@@@@@@@@@@
@@@@@@@@@@@@@.T@@T.TT.TT.TT..T.T...T...TT.T@@@@@@@@@@@@@
@@@@@@@@@@@.TTT.TTT....T.TT.TT..TTTT.TTT..T@@@@@@@@@@@@@
@@@@@@@@@@T.T.....TTT.TTTT.TT.TT.T..TT....TT@@@@@@@@@@@@
@@@@@@@@@TT.T......TT..TTT..T..TT..TT.TT.......@@@@@@@@@
@@@@@@@@@TT.T.TT.TTTT.T..T..T.TTT.T..TT.TT.TT.T@@@@@@@@@
@@@@@@@@@.TTT.T...TT.T.T.T.@@@@@@@@@.TT.TT.T...@@@@@@@@@
@@@@@@@@@TTTT..TT.T..TT.T@@@@@@@@@@@@T..T....TT@@@@@@@@@
@@@@@@@@@@.T.T.T...TTT@@@@@@@@@@@@@@@@TTTTT.T.T@@@@@@@@@
@@@@@@@@@@@@T.T.TTT@@@@@@@@@@@@@@@@@@@.T..T..T.TTT@@@@@@
@@@@@@@@@@@@@.TT..@@@@@@@@@@@@@@@@@@@@T.T...T.T.T.@@@@@@
@@@@@@@@@@@@@.TT..@@@@@@@@@@@@@@@@@@@@@.TTT@@@TT..@@@@@@
@@@@@@@@@@@@@T.TT.@@@@@@@@@@@@@@@@@@@@@.T..@@@@@..@@@@@@
@@@@@@@@@@..@@.TT.@@@@@@@@@@@@@@@@@@@@@@.T@@@@@@@T@@@@@@
@@@@@@@@@....@.T.@@@@@@@@@@@@@@@@@@@@@@@..@@@@@TTT@@@@@@
@@@@@@@@@TTT.....@@@@@@@@@@@@@@@@@@@@@@@T.T..@@.TT@@@@@@
@@@TT.T..TTT..TT.@@@@@@@@@@@@@@@@@@@@@@@TT.TT.TT.TT@@@@@
@@@T.T..TTT.TT...@@@@@@@@@@@@@@@@@@@@@@@TTT...T.TTT.@@@@
@@@T...T..TT.TTT..@@@@@@@@@@@@@@@@@@@@TTTT..TTT@@@.T.T.@
@@@.T.TTT.....T.T.T@@@@@@@@@@@@@@@@@@@T.T.T.T..@@@TTT..@
@@@T.T.@@TT.T.T...T.@@@@@@@@@@@@@@@@@T..TTTTTTT@@@.T.TT@
@@@@.T.@@TT........T.@@@@@@@@@@@@@@@@@.T...TTTT.TT..T..@
@@@@TT.TT.T..TTT.T....@@@@@@@@@@@@@@@@.T...TT.T......TT@
@@@@.TT...T.T.T.T..T...@@@@@@@@@@@@@@@TT.T.T..T..T.TT.T@
@@@@TT.T......T..TT...TT..@@@@@@@@@@@TTT...TT.T.T....T.@
@@@@...T..T.TTT.T.TTT.T.TT..@@@@@@@@.TTT.T.TTTTTTT.T.TT@
@@@@T.TT..TTT...TTT.TT.T.T.TT.TT..T...T....TTT.TTTTTTTT@
@@@@@TT..TT...T..TTT..T.TT....TT..T.T.TT.T.T..TTTT..T.T@
@@@@@.TTT.T.TTT..TTTTTTTT.TTT....TTT..T....TTTTTTTTTT..@
@@@@@@.T.TT...TT....TTT.TT...T.TTTT.T..T.T.TT.T.TT.TTT.@
@@@@@@@T.TT......TTTTTT..TTT....T..@@..TTT....T.T..T.TT@
@@@@@@@@T.T..T.T.TT@@T..TT.T.....TT@@T.TT.T....T.T.TT.T@
@@@@@@@@@T.TT.TT.T.@@TTTTTTT.T..T.T.T.T.T.T..T.T.......@
@@@@@@@@@@TTT.T..T..T.TT.TTTT..TT...T.T....TTT.T.T....@@
@@@@@@@@@@@..T.TT..T.TT...TT.T..TTTTT.T.TTT.TT.TT..TT@@@
@@@@@@@@@@@@T..T.TTT.T.TT...TT..TTT...TT........T.@@@@@@
@@@@@@@@@@@@@TT..TT.....TT.TT.T.TT.T.TTT.TTT.T.TT@@@@@@@
@@@@@@@@@@@@@@@T.T.T..TT.......T.TTT..TT.TT...T@@@@@@@@@
@@@@@@@@@@@@@@@@@@@@@@@@@@@@@@@@@@@@@@@@@@@@@@@@@@@@@@@@
