type octile
height 144
width 148
map
@@@@@@@@@@@@@@@@@@@@@@@@@@@@@@@@@@@@@@@@@@@@@@@@@@@@@@@@@@@@@@@@@@@@@@@@@@@@@@@@@@@@@@@@@@@@@@@@@@@@@@@@@@@@@@@@@@@@@@@@@@@@@@@@@@@@@@@@@@@@@@@@@@@@
@@@@@@@@@@@@@@@@@@@@@@@@@@@@@@@@@@@@@@@@@@@@@@@@@@@@@@@@@@@@@@@@@@@@@@@@@@@@@@@@@@@@@@@@@@@@@@@@@@@@@@@@@@@@@@@@@@@@@@@@@@@@@@@@@@@@@@@@@@@@@@@@@@@@
@@@@@@@@@@@@@@@@@@@@@@@@@@@@@@@@@@@@@@@@@@@@@@@@@@@@@@@@@@@@@@@@@@@@@@@@@@@@@@@@@@@@@@@@@@@@@@@@@@@@@@@@@@@@@@@@@@@@@@@@@@@@@@@@@@@@@@@@@@@@@@@@@@@@
@@@@@@@@@@@@@@@@@@@@@@@@@@@@@@@@@@@@@@@@@@@@@@@@@@@@@@@@@@@@@@@@@@@@@@@@@@@@@@@@@@@@@@@@@@@@@@@@@@@@@@@@@@@@@@@@@@@@@@@@@@@@@@@@@@@@@@@@@@@@@@@@@@@@
@@@@@@@@@@@@@@@@@@@@@@@@@@@@@@@@@@@@@@@@@@@@@@@@@@@@@@@@@@@@@@@@@@@@@@@@@@@@@@@@@@@@@@@@@@@@@@@@@@@@@@@@@@@@@@@@@@@@@@@@@@@@@@@@@@@@@@@@@@@@@@@@@@@@
@@@@@@@@@@@@@@@@@@@@@@@@@@@@@@@@@@@@@@@@@@@@@@@@@@@@@@@@@@@@@@@@@@@@@@@@@@@@@@@@@@@@@@@@@@@@@@@@@@@@@@@@@@@@@@@@@@@@@@@@@@@@@@@@@@@@@@@@@@@@@@@@@@@@
@@@@@@@@@@@@@@@@@@@@@@@@@@@@@@@@@@@@@@@@@@@@@@@@@@@@@@@@@@@@@@@@@@@@@@@@@@@@@@@@@@@@@@@@@@@@@@@@@@@@@@@@@@@@@@@@@@@@@@@@@@@@@@@@@@@@@@@@@@@@@@@@@@@@
@@@@@@@@@@@@@@@@@@@@@@@@@@@@@@@@@@@@@@@@@@@@@@@@@@@@@@@@@@@@@@@@@@@@@@@@@@@@@@@@@@@@@@@@@@@@@@@@@@@@@@@@@@@@@@@@@@@@@@@@@@@@@@@@@@@@@@@@@@@@@@@@@@@@
@@@@@@@@@@@@@@@@@@@@@@@@@@@@@@@@@@@@@@@@@@@@@@@@@@@@@@@@@@@@@@@@@@@@@@@@@@@@@@@@@@@@@@@@@@@@@@@@@@@@@@@@@@@@@@@@@@@@@@@@@@@@@@@@@@@@@@@@@@@@@@@@@@@@
@@@@@@@@@@@@@@@@@@@@@@@@@@@@@@@@@@@@@@@@@@@@@@@@@@@@@@@@@@@@@@@@@@@@@@@@@@@@@@@@@@@@@@@@@@@@@@@@@@@@@@@@@@@@@@@@@@@@@@@@@@@@@@@@@@@@@@@@@@@@@@@@@@@@
@@@@@@@@@@@@@@@@@@@@@@@@@@@@@@@@@@@@@@@@@@@@@@@@@@@@@@@@@@@@@@@@@@@@@@@@@@@@@@@@@@@@@@@@@@@@@@@@@@@@@@@@@@@@@@@@@@@@@@@@@@@@@@@@@@@@@@@@@@@@@@@@@@@@
@@@@@@@@@@@@@@@@@@@@@@@@@@@@@@@@@@@@@@@@@@@@@@@@@@@@@@@@@@@@@@@@@@@@@@@@@@@@@@@@@@@@@@@@@@@@@@@@@@@@@@@@@@@@@@@@@@@@@@@@@@@@@@@@@@@@@@@@@@@@@@@@@@@@
@@@@@@@@@@@@@@@@@@@@@@@@@@@@@@@@@@@@@@@@@@@@@@@@@@@@@@@@@@@@@@@@@@@@@@@@@@@@@@@@@@@@@@@@@@@@@@@@@@@@@@@@@@@@@@@@@@@@@@@@@@@@@@@@@@@@@@@@@@@@@@@@@@@@
@@@@@@@@@@@@@@@@@@@@@@@@@@@@@@@@@@@@@@@@@@@@@@@@@@@@@@@@@@@@@@@@@@@@@@@@@@@@@@@@@@@@@@@@@@@@@@@@@@@@@@@@@@@@@@@@@@@@@@@@@@@@@@@@@@@@@@@@@@@@@@@@@@@@
@@@@@@@@@@@@@@@@@@@@@@@@@@@@@@@@@@@@@@@@@@@@@@@@@@@@@@@@@@@@@@@@@@@@@@@@@@@@@@@@@@@@@@@@@@@@@@@@@@@@@@@@@@@@@@@@@@@@@@@@@@@@@@@@@@@@@@@@@@@@@@@@@@@@
@@@@@@@@@@@@@@@@@@@@@@@@@@@@@@@@@@@@@@@@@@@@@@@@@@@@@@@@@@@@@@@@@.@@@@@@@@@@@@@@@@@@@@@@@@@@@@@@@@@@@@@@@@@@@@@@@@@@@@@@@@@@@@@@@@@@@@@@@@@@@@@@@@@@
@@@@@@@@@@@@@@@@@@@@@@@@@@@@@@@@@@@@@@@@@@@@@@@@@@@@@@@@@@@@@@@@T.@@T@@@@@@@@@@@@@@@@@@@@@@@@@@@@@@@@@@@@@@@@@@@@@@@@@@@@@@@@@@@@@@@@@@@@@@@@@@@@@@@
@@@@@@@@@@@@@@@@@@@@@@@@@@@@@@@@@@@@@@@@@@@@@@@@@@@@@@@@@@@@@@@@TT@@.@@@@@@@@@@@@@@@@@@@@@@@@@@@@@@@@@@@@@@@@@@@@@@@@@@@@@@@@@@@@@@@@@@@@@@@@@@@@@@@
@@@@@@@@@@@@@@@@@@@@@@@@@@@@@@@@@@@@@@@@@@@@@@@@@@@@@@@@@@@@@@@@TT..T@@@@@@@@@@@@@@@@@@@@@@@@@@@@@@@@@@@@@@@@@@@@@@@@@@@@@@@@@@@@@@@@@@@@@@@@@@@@@@@
@@@@@@@@@@@@@@@@@@@@@@@@@@@@@@@@@@@@@@@@@@@@@@@@@@@@@@@@@@@@@@@@..T..@@@@@@@@@@@@@@@@@@@@@@@@@@@@@@@@@@@@@@@@@@@@@@@@@@@@@@@@@@@@@@@@@@@@@@@@@@@@@@@
@@@@@@@@@@@@@@@@@@@@@@@@@@@@@@@@@@@@@@@@@@@@@@@@@@@@@@@@@@@@@@@..T....@@@@@@@@@@@@@@@@@@@@@@@@@@@@@@@@@@@@@@@@@@@@@@@@@@@@@@@@@@@@@@@@@@@@@@@@@@@@@@
@@@@@@@@@@@@@@@@@@@@@@@@@@@@@@@@@@@@@@@@@@@@@@@@@@@@@@@@@@@@@@@@.T.T.TT@@@@@@@@@@@@@@@@@@@@@@@@@@@@@@@@@@@@@@@@@@@@@@@@@@@@@@@@@@@@@@@@@@@@@@@@@@@@@
@@@@@@@@@@@@@@@@@@@@@@@@@@@@@@@@@@@@@@@@@@@@@@@@@@@@@@@@@@@@..@@..T..TTT@@@@@@@@@@@@@@@@@@@@@@@@@@@@@@@@@@@@@@@@@@@@@@@@@@@@@@@@@@@@@@@@@@@@@@@@@@@@
@@@@@@@@@@@@@@@@@@@@@@@@@@@@@@@@@@@@@@@@@@@@@@@@@@@@@@@@@@@T...T.T.TT..T.@@@@@@@@@@@@@@@@@@@@@@@@@@@@@@@@@@@@@@@@@@@@@@@@@@@@@@@@@@@@@@@@@@@@@@@@@@@
@@@@@@@@@@@@@@@@@@@@@@@@@@@@@@@@@@@@@@@@@@@@@@@@@@@@@@@@@@.T..T..T..TTT.TT@@@@@@@@@@@@@@@@@@@@@@@@@@@@@@@@@@@@@@@@@@@@@@@@@@@@@@@@@@@@@@@@@@@@@@@@@@
@@@@@@@@@@@@@@@@@@@@@@@@@@@@@@@@@@@@@@@@@@@@@@@@@@@@@@@@@.T.T.TTT.TTT.TT.@@@@@@@@@@@@@@@@@@@@@@@@@@@@@@@@@@@@@@@@@@@@@@@@@@@@@@@@@@@@@@@@@@@@@@@@@@@
@@@@@@@@@@@@@@@@@@@@@@@@@@@@@@@@@@@@@@@@@@@@@@@@@@@@@@@@@T..TT.TT...T.TT@@@@@@@@@@@@@@@@@@@@@@@@@@@@@@@@@@@@@@@@@@@@@@@@@@@@@@@@@@@@@@@@@@@@@@@@@@@@
@@@@@@@@@@@@@@@@@@@@@@@@@@@@@@@@@@@@@@@@@@@@@@@@@@@@@@TTT...TTTTTTT...T@@@@@@@@@@@@@@@@@@@@@@@@@@@@@@@@@@@@@@@@@@@@@@@@@@@@@@@@@@@@@@@@@@@@@@@@@@@@@
@@@@@@@@@@@@@@@@@@@@@@@@@@@@@@@@@@@@@@@@@@@@@@@@@@@@@@TTTTT.@@T.....TT@@@@@@@@@@@@@@@@@@@@@@@@@@@@@@@@@@@@@@@@@@@@@@@@@@@@@@@@@@@@@@@@@@@@@@@@@@@@@@
@@@@@@@@@@@@@@@@@@@@@@@@@@@@@@@@@@@@@@@@@@@@@@@@@@@@@TT.T..@@@@.T.T.T@@@@@@@@@@@@@@@@@@@@@@@@@@@@@@@@@@@@@@@@@@@@@@@@@@@@@@@@@@@@@@@@@@@@@@@@@@@@@@@
@@@@@@@@@@@@@@@@@@@@@@@@@@@@@@@@@@@@@@@@@@@@@@@@@@@@T..TTT@@@@@T.T..@@@@@@.@@@@@@@T@@@@@@@@@@@@@@@@@@@@@@@@@@@@@@@@@@@@@@@@@@@@@@@@@@@@@@@@@@@@@@@@@
@@@@@@@@@@@@@@@@@@@@@@@@@@@@@@@@@@@@@@@@@@@@@@@@@@@T..T..T@@@@....T@@@@@@@T@@@@@@TT.@@@@@@@@@@@@@@@@@@@@@@@@@@@@@@@@@@@@@@@@@@@@@@@@@@@@@@@@@@@@@@@@
@@@@@@@@@@@@@@@@@@@@@@@@@@@@@@@@@@@@@@@@@@@@@@@@@@.T.TT.TT@@@..T.TT@@@@@@..@@@@@@T.T@@@@@@@@@@@@@@@@@@@@@@@@@@@@@@@@@@@@@@@@@@@@@@@@@@@@@@@@@@@@@@@@
@@@@@@@@@@@@@@@@@@@@@@@@@@@@@@@@@@@@@@@@@@@@@@@@@...T.T...T@TTT.TT@@@@@@.T.@@@@@..T.@@@@@@@@@@@@@@@@@@@@@@@@@@@@@@@@@@@@@@@@@@@@@@@@@@@@@@@@@@@@@@@@
@@@@@@@@@@@@@@@@@@@@@@@@@@@@@@@@@@@@@@@@@@@@@@@.TTT.T.T.TTT.T..TT@@@@@@T..TT..@@T..TTT@@@@@@@@@@@@@@@@@@@@@@@@@@@@@@@@@@@@@@@@@@@@@@@@@@@@@@@@@@@@@@
@@@@@@@@@@@@@@@@@@@@@@@@@@@@@@@@@@@@@@@@@@@@@@@T...TTTTTT....TT.T@@@@@.T..TT..T..T.TT.@@@@@@@@@@@@@@@@@@@@@@@@@@@@@@@@@@@@@@@@@@@@@@@@@@@@@@@@@@@@@@
@@@@@@@@@@@@@@@@@@@@@@@@@@@@@@@@@@@@@@@@@@@.@@@.TTT...T...T.T.T.T@@@@@@.T.T.T..TTT...TT@@@@@@@@@@@@@@@@@@@@@@@@@@@@@@@@@@@@@@@@@@@@@@@@@@@@@@@@@@@@@
@@@@@@@@@@@@@@@@@@@@@@@@@@@@@@@@@@@@@@@@@@@.TTT.T...T..TTT.TTT...@@@@@@@.T..T...T..TTTTTT.@@@@@@@@@@@@@@@@@@@@@@@@@@@@@@@@@@@@@@@@@@@@@@@@@@@@@@@@@@
@@@@@@@@@@@@@@@@@@@@@@@@@@@@@@@@@@@@@@@@@@.T..TTTT.T..T..T..TT.TTT@@@@@@TT..TTTT.TT..TT.T.@@@@@@@@@@@@@@@@@@@@@@@@@@@@@@@@@@@@@@@@@@@@@@@@@@@@@@@@@@
@@@@@@@@@@@@@@@@@@@@@@@@@@@@@@@@@@@@@@@@T.....T..TTT.TT...T..TTT...T@@@@@T.T...T..T.TTTTT@@@@@@@@@@@@@@@@@@@@@@@@@@@@@@@@@@@@@@@@@@@@@@@@@@@@@@@@@@@
@@@@@@@@@@@@@@@@@@@@@@@@@@@@@@@@@@@@@@@T.T..T.T.TT..TTTTTTTTT...TTTT.@@@@@T..TT..TT.TT..@@@@@@@@@@@@@@@@@@@@@@@@@@@@@@@@@@@@@@@@@@@@@@@@@@@@@@@@@@@@
@@@@@@@@@@@@@@@@@@@@@@@@@@@@@@@@@@@@@@..T....TTTT...TT..TTTT......T..@@@@@..T..T.TT.T.T@@@@@@@@@@@@@@@@@@@@@@@@@@@@@@@@@@@@@@@@@@@@@@@@@@@@@@@@@@@@@
@@@@@@@@@@@@@@@@@@@@@@@@@@@@@@@@@@@@@T.T..T..TT.T..T.T..T...TT.T.TT..TT@@@..TT....T.T.@@@@@@@@..@@@@@@@@@@@@@@@@@@@@@@@@@@@@@@@@@@@@@@@@@@@@@@@@@@@@
@@@@@@@@@@@@@@@@@@@@@@@@@@@@@@@@@@@@.TTTTTT.T..TTTTT......T@@T..T.TTTT..@T...@@@...T.@@@@@@@@T...@@@@@@@@@@@@@@@@@@@@@@@@@@@@@@@@@@@@@@@@@@@@@@@@@@@
@@@@@@@@@@@@@@@@@@@@@@@@@@@@@@@@@@@T.TT...T.T.T.TTTT...T..@@@@.T..T..TT.TT..@@@@@.TT@@@@@@@@@TT.TT@@@@@@@@@@@@@@@@@@@@@@@@@@@@@@@@@@@@@@@@@@@@@@@@@@
@@@@@@@@@@@@@@@@@@@@@@@@@@@@@@@@@@..T.TTTT..TTTT.....TTT.@@@@@@.T..T.TTT.T.@@@@@@@.@@@@@@@@@@@@...T@@@@@@@@@@@@@@@@@@@@@@@@@@@@@@@@@@@@@@@@@@@@@@@@@
@@@@@@@@@@@@@@@@@@@@@@@@@@@@@@@@@.T.T.TT.....TTTT..T.TT..@@@@@@.....T..TTT.@@@@@@@@@@@@@@@@@@@@T....@@@@@@@@@@@@@@@@@@@@@@@@@@@@@@@@@@@@@@@@@@@@@@@@
@@@@@@@@@@@@@@@@@@@@@@@@@@@@@@@@T.TT...T@@.TTTTT.TT....T@@@@@@@@TTTTT...T.TT@@@@@@@@@@@@@@@@@@TT..T.T@@@@@@@@@@@@@@@@@@@@@@@@@@@@@@@@@@@@@@@@@@@@@@@
@@@@@@@@@@@@@@@@@@@@@@@@@@@@@@@TTT.T.T.@@@@T.T....TTT.TT@@@@@@@@@..TTTT.T.T..@@@@@@@@@@@@@@@@@.TT..T..@@@@@@@@@@@@@@@@@@@@@@@@@@@@@@@@@@@@@@@@@@@@@@
@@@@@@@@@@@@@@@@@@@@@@@@@@@@@@.T.T.TT.@@@@@T.TT.TTTTT.T@@@@@@@@@@@T.TT.T...TT.@@@@@@@@@@.T@@@@.T.T.T.T@@@@@@@@@@@@@@@@@@@@@@@@@@@@@@@@@@@@@@@@@@@@@@
@@@@@@@@@@@@@@@@@@@@@@@@@@@@@..T.T.T.@@@@@....T.....T@@@@@@@@@@@@@@.T....T.T...@@@@@@@@.TTT.@@..TTT.T.@@@@@@@@@@@@@@@@@@@@@@@@@@@@@@@@@@@@@@@@@@@@@@
@@@@@@@@@@@@@@@@@@@@@@@@@@@@T.....T..T@@@...TTT.TTTT.@@@@@@@@@@@@@@@T.TT.TTTTTTT@@@@@@TT..T...TT..TT..T@@@@@@@@@@@@@@@@@@@@@@@@@@@@@@@@@@@@@@@@@@@@@
@@@@@@@@@@@@@@@@@@@@@@@@@@@T..TTT.TTTTT@.T.TT.TT.TTTTT@@T@@@@@@@@@@@.T..TTT.T.TT.@@@@@@.T..T.TT.T.TTTTTT@@@@@@@@@@@@@@@@@@@@@@@@@@@@@@@@@@@@@@@@@@@@
@@@@@@@@@@@@@@@@@@@@@@@@@@@TT.TTT..TT...T..TT.TT..T..TT.T@@@@@@@@@@@@@TT.TTTT.TT..@@@@@@...TT.TTT.T.T..TTTT@@@@@@@@@@@@@@@@@@@@@@@@@@@@@@@@@@@@@@@@@
@@@@@@@@@@@@@@@@@@@@@@@@@@@.T.T.TTT.T.TTT..TTT.TTT......T@@@@@@@@@@@@@@.T..TTT..TTT@@@@@@T..T....T.TT..T...T@@@@@@@@@@@@@@@@@@@@@@@@@@@@@@@@@@@@@@@@
@@@@@@@@@@@@@@@@@@@@@@@@@..TT...TT..TTT.TTTTT.TTTT..TTTTT@@TT@@@@@@@@@@T..TT.TT.TT..@@@@@@T.TT.TT....T....TT@@@@@@@@@@@@@@@@@@@@@@@@@@@@@@@@@@@@@@@@
@@@@@@@@@@@@@@@@@@@@@@@@@T...TT...T...T..TT..TT..TTT.....T..@@@@@@@@@@@@TT....T.TT.TT@@@@@@T..TTT..TTT.....@@@@@@@@@@@@@@@@@@@@@@@@@@@@@@@@@@@@@@@@@
@@@@@@@@@@@@@@@@@@@@@@@@@@T.TT..TT.T.TT..T.T.T.TT..T.T..TT.T@@@@@@@@@@@@@@..TTTT...T.T@@@@@TT..TT..T.TT..T@@@@@@@@@@@@@@@@@@@@@@@@@@@@@@@@@@@@@@@@@@
@@@@@@@@@@@@@@@@@@@@@@T@@T..T.T.T.....TT..T..TTTT..TT..T...T.@@.@@@@@@@@@@@.TTTT.......T@@@T.......TT.TT.@@@@@@@@@@@@@@@@@@@@@@@@@@@@@@@@@@@@@@@@@@@
@@@@@@@@@@@@@@@@@@@@@...TTT...T.T.T.T.TTT.TT..TTT...TT.TT.TT.TT.@@@@@@@@@@@@T..TTT..T..TTT.TT.@T.T.TTTTT@@@@@@@@@@@@@@@@@@@@@@@@@@@@@@@@@@@@@@@@@@@@
@@@@@@@@@@@@@@@@@@@@@TT..TT..T.TTTT.TT..@@@T.T.T.TT....T.T.TT..@@@@@@@@@@@@@@T.TTT..T.TT.TT..@@@TTTTTTT@@@@@@@@@@@@@@@@@@@@@@@@@@@@@@@@@@@@@@@@@@@@@
@@@@@@@@@@@@@@@@@@@@@TTTTTTT.TTTTT....@@@@@TTTT..T..TT..TT.TTTT.@@@T@@@@@@@@@...T..T.T...TT.@@@@@TTT.@@@@@@@@@@@@@@@@@@@@@@@@@@@@@@@@@@@@@@@@@@@@@@@
@@@@@@@@@@@@@@@@@@@@@T....T.TTTT.....T@@@@@....T...T.TT..T.TTTTT@@.T@@@@@@@@@@T.TT.T...T..T.@@@@@@T.@@@@@@@@.@@@@@@@.@@@@@@@@@@@@@@@@@@@@@@@@@@@@@@@
@@@@@@@@@@@@@@@@@T...T....T.T.T....TT@@@@@@@@@TT..TTTTT.TTTT..T...T@@@@@@@@@@@........TT.T.TT@@@@@@@@@@@@@@.T@@@@@@...@@@@@@@@@@@@@@@@@@@@@@@@@@@@@@
@@@@@@@@@@@@@@@@@.T...T..T..TTTTTTTT@@@@@@@@@@T.T...TTT.TTTTT.T.T.T@@@@T@@@@@.T.@@@TT.T.T.....@@@@@@@@@@@@.TT.@@@@.TTTT@@@@@@@@@@@@@@@@@@@@@@@@@@@@@
@@@@@@@@@@@@@@@.TT.TT@TTT....TT.T...@@@@@@@@@@TT..T......TTTTTT..TTT@@.T@@@@T..@@@@@TTTTT.T.T..@@@@@@@@@@..TTT@@TTTT...@@@@@@@@@@@@@@@@@@@@@@@@@@@@@
@@@@@@@@@@@@@@.T..TT@@@.T....TTT.TT.@@@@@@@@@@@T@@T.TT...T..T.T.TT.T..T@@@@@TT@@@@@@@TTT..T...T.@@@@@@@@.TTT...T...TT..@@@@@@@@@@@@@@@@@@@@@@@@@@@@@
@@@@@@@@@@@@@T..TTT@@@@...TTT..TTT..@@@@@@@@@@@@@@@T..T...TT.TT.TTT.TTT@@@@T.T@@@@@@@T.....TTTTTT@@@@@@.TTT......TT.T.T.@@@@@@@@@@@@@@@@@@@@@@@@@@@@
@@@@@@@@@@@@..TT.T@@@@.....TTT..T.T.T@@@@@@@@@@@@@....TT.TTTTTT...TTT..T@@.T..@@@@@@@@..TT.TT.T.T.@@@@@@TT..TTT.T..TT..TT@.@@@@@@@@@@@@@@@@@@@@@@@@@
@@@@@@@@@@@T.TTTT.@@@.T..TT.TT.T.TT.T.@@@@@@@@@@@@.T@@..TT.TT.T.TT.T..TTTTT.T.T@@@@@@@@TTTT...T...T@@@@@@......TTTTT..T...TT@@@@@@@@@@@@@@@@@@@@@@@@
@@@@@@@@@@T..T.T.T..T.T..T.TT.T.T...T.T@@@@@@@@@@@@@@@.TT..TT.T..TTT..T.T.TT@@T..@@@@@@@.T..TTTT....@@@@@@TTTTT.T...T.TT.....@@@@@@@@@@@@@@@@@@@@@@@
@@@@@@@@@TTTTT..T.T.T.TTT@@T.T.T...TTT.T@@@@@@@@@@@@@T......TT.TT..T....T..@@@@..T@@@@@@@TTTT.T..TT.T@@@@@..T.TT..T....T.TT.TT@@@@@@@@@@@@@@@@@@@@@@
@@@@@@@@T...TTTTTT.TT..T@@@@T.TT..T.TTT..@@@@@@@@@@@@TT@T.T...TT.T...T....@@@@@@.TT@@@@@@@T.T.T.TTTTTT@@@@@TTT..TT.TTT.T..T..T@@@@@@@@@@@@@@@@@@@@@@
@@@@@@@.TT.T.T.TTT.....@@@@@@T...T.TTT.TT.@@@@@@@@@@@@T@@..T...T....T.T..@@@T.@@@TTT@@@@@@@@T.TT.T..T.T@@@@@.T.TTTTTTTTT...TT@@@@@@@@@@@@@@@@@@@@@@@
@@@@@@@TT.TT..TT..T..T@@@@@@@@TTT.TT.TTT.TT@@@@@@@@@@@@@@.....T..T.T.TTT@@@.TTT.@@..T@@@@@@@@.....TT..T.@@@@T....T.TT...TTT.@@@@@@@@@@@@@@@@@@@@@@@@
@@@@@@T..TTT.TT.T.T..@@@@@@@@@@T..TT.T.TT...@@@@@@@@@@@@TT.TTTT.T.T....@@@.....T.@@TT.@@@@@@@@.T.T.TTT.T...TTTTTT..T.T...T.@@@@@@T.@@@@@@@@@@@@@@@@@
@@@@@@@.T.T.T..T.TTT@@@@@@@@@@@@..T..T..TTT.T@@@@@@@@@@@@TT@TTT..T.TTT@@@TT..TTTTT@@TTT@@@@@@@@.TTT..TTT..T...@@T..TTT...TT@@@@@T..T@@@@@@@@@@@@@@@@
@@@@@@@@TTT.T.T..TT@@@@@@@@@@@@@@TT..T..T.TT..@@@@@@@@@@@@@@@T..TTT..@@@T.T.T.T.TTT@@...@@@@@@@T.TTTT.TTTT.TT@@@@@.TT..TT.@@@@@.TT.T.@@@@@@@@@@@@@@@
@@@@@@@@@@T..TTTT.@@@@@@@@@@@@@@@TTT.T.TTTTTTT@@@@@@@@@@@@@@.T.TTTT@@@@TTT......T..T@@T..@@@@@@T.T.......T...@@@@@@T.T..T@@@@@T.T.T.@@@@@@@@@@@@@@@@
@@@@@@@@@@@TTTT..@@@@@@@@@@@@@@@@@.T.TT.....TTT.@@@@@@@@@@@@TTTTT.@@@@..TT.T.T.....T@@@TT.@@@@@T...TTT....T.TT@@@@@@..TT@@@@@T.TT.@@@@@@@@@@@@@@@@@@
@@@@@@@@@@@@....@@@@@@@@@T@@@@@@@@T.TT.T....TT...@@@@@@@@@@TTT...@@@@.TTTT...@@@T.TTT@@@T.@@@@@..TT.TTTT.T.T...@@@@@@.T.@@@@.TTT.@@@@@@@@@@@@@@@@@@@
@@@@@@@@@@@@@..@@@@@@@@@TTT.T@@T.....T.T.TT..T.T.T@@@@@@@@.TT..T.@@@@.TTTTTTT@@@....T@@@T...@T..TT@@T..T..T...TT@@@@@@@@@@@TTTTT.@@@@@@T@@@@@@@@@@@@
@@@@@@@@@@@@@@@@@@@@@T@@T.T.TT.....TT@@.T..T...TTT.@@@@@@..T.T.T.@@@@@TT..T.T.@@@TTTT.@@T...TTTTT@@@@..T.TT.TT..T@@@@@@@@@....T.@@@@@@@.@@@@@@@@@@@@
@@@@@@@@@@@@@@@@@@@@TT.TTT.TTT.T.TTT@@@@TTTT.T...TTT@@@@@T.T.TTTT@@@@@@T....TT.@@.TTT.@@T.T.TT..@@@@@@T.T..T.TTT..@@@@@@@.T.TT..@@@@@@...@@@@@@@@@@@
@@@@@@@@@@@@@@@@@@@.T.TTTTTT....TT..@@@@@T..TT...TT.T@@@T..@@.T...@@@@@@..TTT.@@@T.T.T..TTT...T@@@@@@@@..TT..T.T..T@@@@@@....TT.TT@@@@TT.T@@@@@@@@@@
@@@@@@@@@@@@@@@@@@@TT..TTTTTTTTTTT..@@@@@@.TT.TTT..T.TT.T.@@@@@TTTT@@@@@@..TT@@@@@T.T.....TT.T.@@@@@@@@@.TTT..T...T.@@@@@@TTT..TT.TT.TT....TT@@@@@@@
@@@@@@@@@@@@@@@@@@@.T....T..TT.TT.TTT@@@@@@T..T.T.T..T..T@@@@@@@.T.T@@@@@@@@@@@@@@.T..T.TTTTT.@@@@@@@@@@@.TTT....TTT.@@@@@@.TTTTT.TTTTT.TT....@@@@@@
@@@@@@@@@@@@@@@@@@@@...T..T..@@@T....T@@@@@@.T..TT...T.TT@@@@@@@@T.TT@@@@@@@@TT@@@@TT.TTTT..T@@@@@@@@@@@@@TTTTTTT.TT.T@@@@@@TT.TT.TT...T.T.....@@@@@
@@@@@@@@@@@@@@@@@@@@@.TTT.T.@@@@T.T.TT@@@@@@@T.T..T...T.T@@@@@@@@@.TT.@@@@@@....@@@..T..T.T.@@@@@@@@@@@@@@@TT.TTTTT.TTT@@@@@@..T.T.TT....TTT..T.@@@@
@@@@@@@@@@@@@@@@@@@@@@.T.T.@@@@@@T..TT@@@@@@@@TT.T.T...T..@@@@@@@@@.TT.@@@@..TTT.T.TTTT..TTT.@@@@@@@@@@@@@@@.TT....TT.T.@@@@@T.....T...TTT.T...@@@@@
@@@@@@@@@@@@@@@@@@@@@@@...@@@@@@@...T@@@@@@@@@@.TT.TT.T.....@@@@@@@@.TT.@@@TT.T.T.TTTTTTT.TT.T..@@@@@@@@@@@@@.T.T..TTTTTT@@@@.T.....T.T.T..T.@@@@@@@
@@@@@@@@@@@@@@@@@@@@@@@@T@@@@@@@@T.@@@@@@@@@@@@@T.TTT.TT.TTTT@@@@@@@@.T.T@@@T..TTTTTT..T.T......@@@@T@@@@@@@@@T.TTTT.T.T..@@@T.TTT..T..T..@.@@@@@@@@
@@@@@@@@@@@@@@@@@@@@@@@@@@@@@@@@@@@@@@@@@@@@@@@@@.T.....TT.TT.@@@@@@@@..TT@@@T.TTT.T...TTT.TT.T.@@@TTT@@@@@@@@@T...T....TT..T..@@@.TT..T.@@@@@@@@@@@
@@@@@@@@@@@@@@@@@@@@@@@@@@@@@@@@@@@@@@@@@@@@@@@@@@TT.TT.T....TT@@@@@@@@....@@TTT...T..T..TT.T.TT...TTT@@@@@@@@@@T.T.T.T...TTTT.@@@@TTTT.@@@@@@@@@@@@
@@@@@@@@@@@@@@@@@@@@@@@@@@@@@@@@@@@@@@@@@@@@@@@@@@@......TTTT.T.@@@@@@@@..T..TT...T.TT.TTT.TT..TTT...@@@@@@@@@@@@TTTT.T....T..T@@@@@T..@@@@@@@@@@@@@
@@@@@@@@@@@@@@@@@@@@@@@@@@@@@@@@@@@@@@@@@@@.T@@@@@@.TTTT.T.TT...T@@@@@@@@...T..T.TTTTT.T...........T@@@@@T@@@@@@@@.....TT.TT.TTT@@@@@T@@@@@@@@@@@@@@
@@@@@@@@@@@@@@@@@@@@@@@@@@@@@@@@@@@@@TT@@@.TT.@@@@T....TTT...T.TTT@@@@@@@@....TTTT.T.TT.TTTTTTT.T.T..@@@TT@@@@@@@@@.TTT.TTT.T.T.T@@@@@@@@@@@@@@@@@@@
@@@@@@@@@@@@@@@@@@@@@@@@@@@@@@@@@@@.......T.TTT@@T.T@@T.TTTT..TT...@@@@@@@@.TT..@@TT..TT.TTTTTTT...TT.@TT@@@@@@@@@@@T....TTT.T...T@@@@@@@@@@@@@@@@@@
@@@@@@@@@@@@@@@@@@@@@@@@@@@@@@@@@@TT..TT..TTTT...T.T@@@TTT...T..T..T@@@@@@@TTT@@@TTTTTT..TT..TT..TTTTTT.@@@@@@@@@@@@@...T..T...TTT.@@@@@@@@@@@@@@@@@
@@@@@@@@@@@@@@@@@@@@@@@@@@@@@@@@@..TT......T..T.TT.T@@@@..T..TT...T..@@@@@.T.@@@@.T@T....TTT..T..TTT.T.T@@@@@T@@@@@@@TT....TTTT.TTTT@@@@@@@@@@@@@@@@
@@@@@@@@@@@@@@@@@@@@@@@@@@@@@@@@@T.T...TT.T.....TT..@@@@@TT.TTTTTTTTT.@@@TTT@@@@@@@@@TT.T.TTT..T.TT.T.T..@@@..@@@@@@@.TTTTT..TTTT..@@@@@@@@@@@@@@@@@
@@@@@@@@@@@@@@@@@@@@@@@@@@@@@@@@@@TT..T...T@.....T.T@@@@@@T.TT.T....TTT@.T.@@@@@@@@@@@T..TT.T..TTT...T.T..T..T@@@@@@.T.TTTT..TTTT.@@@@@@@@@@@@@@@@@@
@@@@@@@@@@@@@@@@@@@@@@@@@@@@@@@@@@@..T..TT@@@@T..T.T.@@@@@@@..T.TT.T.TTTT.@@@@@@@@@@@TTT.T.T.T...@@TTTT...T.@@@@@T.....TTT.TTT...@@@@@@@@@@@@@@@@@@@
@@@@@@@@@@@@@@@@@@@@@@@@@@@@@@@@@@@@T..TT@@@@@@T....T.@@@@@@@TT.TT...T....@@@@@@@@@@@TT......T.T@@@.TTT.T.T.@@@@T.T.T.TTTTT..TTT@@@@@@@@@@@@@@@@@@@@
@@@@@@@@@@@@@@@@@@@@@@@@@@@@@@@@@@@@@T.T.@@@@@@@..TT..T@@@@@@@..T.TTT.T.T.@@@@@@@@@@@@...@.T...@@@@TT..TTTTTT@@T.T.TT.T..T..T.T@@@@@@@@@@@@@@@@@@@@@
@@@@@@@@@@@@@@@@@@@@@@@@@@@@@@@@@@@@@@.TT@@@@@@@TTTTTTTT@@@@@@@@.TTTTTTTTTT@@@@@@@@@@@@.@@@...TT@@T..TTTT.T.T..TT..T.TT.TTTT.T@@@@@@@@@@@@@@@@@@@@@@
@@@@@@@@@@@@@@@@@@@@@@@@@@@@@@@@@@@@@@@T.T@@@TTT....TT.T@@@@@@@@@TTTT.TTTTTT@@@@@@@@@@@@@@TT......T.TT...TTT.....TTT.TT..TTT.@@@@@@@@@@@@@@@@@@@@@@@
@@@@@@@@@@@@@@@@@@@@@@@@@@@@@@@@@@@@@@@@.TTTT.TTT..TTTT@@@@@@@@@@T.T...T.TTT.@@@@@@@@@@@@T...TT.T.T...T..@...T.TTT.T.T.TTT.T@@@@@@@@@@@@@@@@@@@@@@@@
@@@@@@@@@@@@@@@@@@@@@@@@@@@@@@@@@@@@@@@@@...TTT.T.TT..@@@@@@@@@@@@.TTTTT.TT.T.@@@@@@@@@@@@...@..TT.TTTTT@@T.T..TT.T.T.TTT.T@@@@@@@@@@@@@@@@@@@@@@@@@
@@@@@@@@@@@@@@@@@@@@@@@@@@@@@@@@@@@@@@@@@@T..T....T.@@@@@@@@@@@@@@@TT...T.TT.T.@@@@@@@@@@@@@@@@.T...TTT@@@.......T..T.TT..@@@@@@@@@@@@@@@@@@@@@@@@@@
@@@@@@@@@@@@@@@@@@@@@@@@@@@@@@@@@@@@@@@@@@@@T.T..TT@@@@@@@@@@@@@@@@...TT....TT.T@@@@@@@@@@@@@@TT.T.T..@@@T.TT......T.T..T@@@@@@@@@@@@@@@@@@@@@@@@@@@
@@@@@@@@@@@@@@@@@@@@@@@@@@@@@@@@@@@@@@@@@@@@@.....@@@@@@@@@@@T@@@@@@T....T..TTTT.@@@@@@@@@@@@@...T.TTT@@.......TT.TTT.T.@@@@@@@@@@@@@@@@@@@@@@@@@@@@
@@@@@@@@@@@@@@@@@@@@@@@@@@@@@@@@@@@@@@@@@@@@@@T.T@@@@@@@@@@@TT.@@@@TT.TT.T..T.TT.T.@@@@@@@@@@@@.T.T.TT..T..T.T..TTTTT.T@@@@@@@@@@@@@@@@@@@@@@@@@@@@@
@@@@@@@@@@@@@@@@@@@@@@@@@@@@@@@@@@@@@@@@@@@@@@@.@@@@@@@@@@..TT.T.TTTT.T@TT.T......TT@@@@@@@@@@@@@@TT.TT....T..TTT...T@@@@@@@@@@@@@@@@@@@@@@@@@@@@@@@
@@@@@@@@@@@@@@@@@@@@@@@@@@@@@@@@@@@@@@@@@@@@@@@@@@@@@@@@@T.TT..TT.T...@@@..T...T.T.T.@@@@@@@@@@@@@@T.TT...TT..TTTTTT@@@@@@@@@@@@@@@@@@@@@@@@@@@@@@@@
@@@@@@@@@@@@@@@@@@@@@@@@@@@@@@@@@@@@@@@@@@@@@@@@@@@@@@TTTTT.T..TTT.TT@@@@@TTT......TTT@@@@@@@@@@@@@T..TT.TTTTT.TTT.@@@@@@@@@@@@@@@@@@@@@@@@@@@@@@@@@
@@@@@@@@@@@@@@@@@@@@@@@@@@@@@@@@@@@@@@@@@@@@@@@@@@@@@T.T.TTT.TT...TTTT@@@@@.T.TT.T.TTTT@@@@@@@@@@@@.TTT.TTT..T..T.@@@@@@@@@@@@@@@@@@@@@@@@@@@@@@@@@@
@@@@@@@@@@@@@@@@@@@@@@@@@@@@@@@@@@@@@@@@@@@@@@@@@@@@T.T....T...T.TTT...@@@@@T....TTT...T@@@@@@@@@...T....T..TT...@@@@@@@@@@@@@@@@@@@@@@@@@@@@@@@@@@@
@@@@@@@@@@@@@@@@@@@@@@@@@@@@@@@@@@@@@@@@@@@@@@@@@@@@@TTT.TTT.T@TTT.T.TT@@@@@@.TT..TT..TTT@@@@@@@.TTT..TT.T.T.T.T@@@@@@@@@@@@@@@@@@@@@@@@@@@@@@@@@@@@
@@@@@@@@@@@@@@@@@@@@@@@@@@@@@@@@@@@@@@@@@@@@@@@@@@@@@@TT..TT@@@@....TT..@@@@@@@T...T.TTT.T@@@@@@TTT.TTTT.TTT.TT@@@@@@@@@@@@@@@@@@@@@@@@@@@@@@@@@@@@@
@@@@@@@@@@@@@@@@@@@@@@@@@@@@@@@@@@@@@@@@@@@@@@@@@@@@@@@T.TTT@@@@@@.T..T..@@@@@@@TTT.TTTTTTT@@@@@.TTT.T..TTT.T@@@@@@@@@@@@@@@@@@@@@@@@@@@@@@@@@@@@@@@
@@@@@@@@@@@@@@@@@@@@@@@@@@@@@@@@@@@@@@@@@@@@@@@@@@@@@@@@..T.@@@@@@TT...TT.@@@@@@@TTT..T....T@@@...TT....T.TT@@@@@@@@@@@@@@@@@@@@@@@@@@@@@@@@@@@@@@@@
@@@@@@@@@@@@@@@@@@@@@@@@@@@@@@@@@@@@@@@@@@@@@@@@@@@@@@@@@@T.@@@@@TT.TTTTT@@@@@@@@@TTT..TTT..T..T..T.TTT....@@@@@@@@@@@@@@@@@@@@@@@@@@@@@@@@@@@@@@@@@
@@@@@@@@@@@@@@@@@@@@@@@@@@@@@@@@@@@@@@@@@@@@@@@@@@@@@@@@@@@T.@@@.T.T....@@@@@@@@@@@TTTT.TT.....T.T..TTTTTT@@@@@@@@@@@@@@@@@@@@@@@@@@@@@@@@@@@@@@@@@@
@@@@@@@@@@@@@@@@@@@@@@@@@@@@@@@@@@@@@@@@@@@@@@@@@@@@@@@@@@@@.T.TTT.TT.@@@@@@@@@@@@@@...T..T..TTT....T.T..@@@@@@@@@@@@@@@@@@@@@@@@@@@@@@@@@@@@@@@@@@@
@@@@@@@@@@@@@@@@@@@@@@@@@@@@@@@@@@@@@@@@@@@@@@@@@@@@@@@@@@@@TT....T.T@@@@@@@@@@@@@@@T......TT.T.TTT..T.T@@@@@@@@@@@@@@@@@@@@@@@@@@@@@@@@@@@@@@@@@@@@
@@@@@@@@@@@@@@@@@@@@@@@@@@@@@@@@@@@@@@@@@@@@@@@@@@@@@@@@@@@@@@TTTT..@@@@@@@@@@@@@@@@@TTTTT...T....T.TT.@@@@@@@@@@@@@@@@@@@@@@@@@@@@@@@@@@@@@@@@@@@@@
@@@@@@@@@@@@@@@@@@@@@@@@@@@@@@@@@@@@@@@@@@@@@@@@@@@@@@@@@@@@@@@.TTT@@@@@@@@@@@@@@@@@@T.TTTT.TTT.TT.TTT@@@@@@@@@@@@@@@@@@@@@@@@@@@@@@@@@@@@@@@@@@@@@@
@@@@@@@@@@@@@@@@@@@@@@@@@@@@@@@@@@@@@@@@@@@@@@@@@@@@@@@@@@@@@@@@..@@@@@@@T@@@@@@@@@@@..TTTT..TT....TT@@@@@@@@@@@@@@@@@@@@@@@@@@@@@@@@@@@@@@@@@@@@@@@
@@@@@@@@@@@@@@@@@@@@@@@@@@@@@@@@@@@@@@@@@@@@@@@@@@@@@@@@@@@@@@@@@@@@@@@@TTT@@@@.@@@@@.T.@@@TT...TTTT@@@@@@@@@@@@@@@@@@@@@@@@@@@@@@@@@@@@@@@@@@@@@@@@
@@@@@@@@@@@@@@@@@@@@@@@@@@@@@@@@@@@@@@@@@@@@@@@@@@@@@@@@@@@@@@@@@@@@@@@.TT..@@TTT.T.TT.@@@@...T..T.@@@@@@@@@@@@@@@@@@@@@@@@@@@@@@@@@@@@@@@@@@@@@@@@@
@@@@@@@@@@@@@@@@@@@@@@@@@@@@@@@@@@@@@@@@@@@@@@@@@@@@@@@@@@@@@@@@@@@@@@@TT.TTTT.TT.....T@@@@@.TT.T.@@@@@@@@@@@@@@@@@@@@@@@@@@@@@@@@@@@@@@@@@@@@@@@@@@
@@@@@@@@@@@@@@@@@@@@@@@@@@@@@@@@@@@@@@@@@@@@@@@@@@@@@@@@@@@@@@@@@@@@@TTTT..T.TT.TT.TTT.@@@@@@.T..@@@@@@@@@@@@@@@@@@@@@@@@@@@@@@@@@@@@@@@@@@@@@@@@@@@
@@@@@@@@@@@@@@@@@@@@@@@@@@@@@@@@@@@@@@@@@@@@@@@@@@@@@@@@@@@@@@@@@@@@@........T.....TTT.@@@@@@@@.@@@@@@@@@@@@@@@@@@@@@@@@@@@@@@@@@@@@@@@@@@@@@@@@@@@@
@@@@@@@@@@@@@@@@@@@@@@@@@@@@@@@@@@@@@@@@@@@@@@@@@@@@@@@@@@@@@@@@@@@@@@TTT.TTTT....T..T..@@@@@@@@@@@@@@@@@@@@@@@@@@@@@@@@@@@@@@@@@@@@@@@@@@@@@@@@@@@@
@@@@@@@@@@@@@@@@@@@@@@@@@@@@@@@@@@@@@@@@@@@@@@@@@@@@@@@@@@@@@@@@@@@@@@@TTTTTT...T.T.TT..T@@@@@@@@@@@@@@@@@@@@@@@@@@@@@@@@@@@@@@@@@@@@@@@@@@@@@@@@@@@
@@@@@@@@@@@@@@@@@@@@@@@@@@@@@@@@@@@@@@@@@@@@@@@@@@@@@@@@@@@@@@@@@@@@@@@@..TTTT..T.T..TTTT.@@@@@@@@@@@@@@@@@@@@@@@@@@@@@@@@@@@@@@@@@@@@@@@@@@@@@@@@@@
@@@@@@@@@@@@@@@@@@@@@@@@@@@@@@@@@@@@@@@@@@@@@@@@@@@@@@@@@@@@@@@@@@@@@@@@@.....TT@@@@TT.TTTT@@@@@@@@@@@@@@@@@@@@@@@@@@@@@@@@@@@@@@@@@@@@@@@@@@@@@@@@@
@@@@@@@@@@@@@@@@@@@@@@@@@@@@@@@@@@@@@@@@@@@@@@@@@@@@@@@@@@@@@@@@@@@@@@@@@@@T.T.T@@@@TTTTTT@@@@@@@@@@@@@@@@@@@@@@@@@@@@@@@@@@@@@@@@@@@@@@@@@@@@@@@@@@
@@@@@@@@@@@@@@@@@@@@@@@@@@@@@@@@@@@@@@@@@@@@@@@@@@@@@@@@@@@@@@@@@@@@@@@@@@@@..T.@@@@@TT.T@@@@@@@@@@@@@@@@@@@@@@@@@@@@@@@@@@@@@@@@@@@@@@@@@@@@@@@@@@@
@@@@@@@@@@@@@@@@@@@@@@@@@@@@@@@@@@@@@@@@@@@@@@@@@@@@@@@@@@@@@@@@@@@@@@@@@@@@@..@@@@@@@.T@@@@@@@@@@@@@@@@@@@@@@@@@@@@@@@@@@@@@@@@@@@@@@@@@@@@@@@@@@@@
@@@@@@@@@@@@@@@@@@@@@@@@@@@@@@@@@@@@@@@@@@@@@@@@@@@@@@@@@@@@@@@@@@@@@@@@@@@@@@@@@@@@@@T@@@@@@@@@@@@@@@@@@@@@@@@@@@@@@@@@@@@@@@@@@@@@@@@@@@@@@@@@@@@@
@@@@@@@@@@@@@@@@@@@@@@@@@@@@@@@@@@@@@@@@@@@@@@@@@@@@@@@@@@@@@@@@@@@@@@@@@@@@@@@@@@@@@@@@@@@@@@@@@@@@@@@@@@@@@@@@@@@@@@@@@@@@@@@@@@@@@@@@@@@@@@@@@@@@
@@@@@@@@@@@@@@@@@@@@@@@@@@@@@@@@@@@@@@@@@@@@@@@@@@@@@@@@@@@@@@@@@@@@@@@@@@@@@@@@@@@@@@@@@@@@@@@@@@@@@@@@@@@@@@@@@@@@@@@@@@@@@@@@@@@@@@@@@@@@@@@@@@@@
