type octile
height 160
width 160
map
@@@@@@@@@@@@@@@@@@@@@@@@@@@@@@@@@@@@@@@@@@@@@@@@@@@@@@@@@@@@@@@@@@@@@@@@@@@@@@@@@@@@@@@@@@@@@@@@@@@@@@@@@@@@@@@@@@@@@@@@@@@@@@@@@@@@@@@@@@@@@@@@@@@@@@@@@@@@@@@@
@@@@@@@@@@@@@@@@@@@@@@@@@@@@@@@@@@@@@@@@@@@@@@@@@@@@@@@@@@@@@@@@@@@@@@TT.T.T@@@@@@@@@@@@@@@@@@@@@@@@@@@@@@@@@@@@@@@@@@@@@@@@@@@@@@@@@@@@@@@@@@@@@@@@@@@@@@@@@@@@
@@@@@@@@@@@@@@@@@@@@@@@@@@@@@@@@@@@@@@@@@@@@@@@@@@@@@@@@@@@@@@@@@@@@@T..T.TT@@@@@@@@@@@@@@@@@@@@@@@@@@@@@@@@@@@@@@@@@@@@@@@@@@@@@@@@@@@@@@@@@@@@@@@@@@@@@@@@@@@@
@@@@@@@@@@@@@@@@@@@@@@@@@@@@@@@@@@@@@@@@@@@@@@@@@@@@@@@@@@@@@@@@@@@@@.T.TTT@@@@@@@@@@@@@@@@@@@@@@@@@@@@@@@@@@@@@@@@@@@@@@@@@@@@@@@@@@@@@@@@@@@@@@@@@@@@@@@@@@@@@
@@@@@@@@@@@@@@@@@@@@@@@@@@@@@@@@@@@@@@@@@@@@@@@@@@@@@@@@@@@@@@@@@@@@T.TT...@@@@@@@@@@@@@@@@@@@@@@@@@@@@@@@@@@@@@@@@@@@@@@@@@@@@@@@@@@@@@@@@@@@@@@@@@@@@@@@@@@@@@
@@@@@@@@@@@@@@@@@@@@@@@@@@@@@@@@@@@@@@@@@@@@@@@@@@@@@@@@@@@@@@@@@@@.T..TT.@@@@@@@@@@@@@@@@@@@@@@@@@@@@@@@@@@@@@@@@@@@@@@@@@@@@@@@@@@@@@@@@@@@@@@@@@@@@@@@@@@@@@@
@@@@@@@@@@@@@@@@@@@@@@@@@@@@@@@@@@@@@@@@@@@@@@@@@@@@@@@@@@@@@@@@@@@T..T.T.@@@@@@@@@@@@@@@@@@@@@@@@@@@@@@@@@@@@@@@@@@@@@@@@@@@@@@@@@@@@@@@@@@@@@@@@@@@@@@@@@@@@@@
@@@@@@@@@@@@@@@@@@@@@@@@@@@@@@@@@@@@@@@@@@@@@@@@@@@@@@@@@@@@@@@@@@TT.T..T@@@@@@@@@@@@@@@@@@@@@@@@@@@@@@@@@@@@@@@@@@@@@@@@@@@@@@@@@@@@@@@@@@@@@@@@@@@@@@@@@@@@@@@
@@@@@@@@@@@@@@@@@@@@@@@@@@@@@@@@@@@@@@@@@@@@@@@@@@@@@@@@@@@@@@@@@@TT.T.TT@@@@@@@@@@@@@@@@@@@@@@@@@@@@@@@@@@@@@@@@@@@@@@@@@@@@@@@@@@@@@@@@@@@@@@@@@@@@@@@@@@@@@@@
@@@@@@@@@@@@@@@@@@@@@@@@@@@@@@@@@@@@@@@@@@@@@@@@@@@@@@@@@@@@@@@@@..T.T..@@@@@@@@@@@@@@@@@@@@@@@@@@@@@@@@@@@@@@@@@@@@@@@@@@@@@@@@@@@@@@@@@@@@@@@@@@@@@@@@@@@@@@@@
@@@@@@@@@@@@@@@@@@@@@@@@@@@@@@@@@@@@@@@@@@@@@@@@@@@@@@@@@@@@@@@@@T.TT.TT@@@@@@@@@@@@@@@@@@@@@@@@@@@@@@@@@@@@@@@@@@@@@@@@@@@@@@@@@@@@@@@@@@@@@@@@@@@@@@@@@@@@@@@@
@@@@@@@@@@@@@@@@@@@@@@@@@@@@@@@@@@@@@@@@@@@@@@@@@@@@@@@@@@@@@@@@.TTTTTT@@@@@@@@@@@@@@@@@@@@@@@@@@@@@@@@@@@@@@@@@@@@@@@@@@@@@@@@@@@@@@@@@@@@@@@@@@@@@@@@@@@@@@@@@
@@@@@@@@@@@@@@@@@@@@@@@@@@@@@@@@@@@@@@@@@@@@@@@@@@@@@@@@@@@@@@@@TTTTT.@@@@@@@@@@@@@@@@@@@@@@@@@@@@@@@@@@@@@@@@@@@@@@@@@@@@@@@@@@@@@@@@@@@@@@@@@@@@@@@@@@@@@@@@@@
@@@@@@@@@@@@@@@@@@@@@@@@@@@@@@@@@@@@@@@@@@@@@@@@@@@@@@@@@@@@@@@...T...@@@@@@@@@@@@@@@@@@@@@@@@@@@@@@@@@@@@@@@@@@@@@@@@@@@@@@@@@@@@@@@@@@@@@@@@@@@@@@@@@@@@@@@@@@
@@@@@@@@@@@@@@@@@@@@@@@@@@@@@@@@@@@@@@@@@@@@@@@@@@@@@@@@@@@@@@@T..TTT@@@@@@@@@@@@@@@@@@@@@@@@@@@@@@@@@@@@@@@@@@@@@@@@@@@@@@@@@@@@@@@@@@@@@@@@@@@@@@@@@@@@@@@@@@@
@@@@@@@@@@@@@@@@@@@@@@@@@@@@@@@@@@@@@@@@@@@@@@@@@@@@@@@@@@@@@@TT....T@@@@@@@@@@@@@@@@@@@@@@@@@@@@@@@@@@@@@@@@@@@@@@@@@@@@@@@@@@@@@@@@@@@@@@@@@@@@@@@@@@@@@@@@@@@
@@@@@@@@@@@@@@@@@@@@@@@@@@@@@@@@@@@@@@@@@@@@@@@@@@@@@@@@@@@@@.TT.TTT@@@@@@@@@@@@@@@@@@@@@@@@@@@@@@@@@@@@@@@@@@@@@@@@@@@@@@@@@@@@@@@@@@@@@@@@@@@@@@@@@@@@@@@@@@@@
@@@@@@@@@@@@@@@@@@@@@@@@@@@@@@@@@@@@@@@@@@@@@@@@@@@@@@@@@@@@@....TT.@@@@@@@@@@@@@@@@@@@@@@@@@@@@@@@@@@@.T.@@@@@@@@@@@@@@@@@@@@@@@@@@@@@@@@@@@@@@@@@@@@@@@@@@@@@@
@@@@@@@@@@@@@@@@@@@@@@@@@@@@@@@@@@@@@@@@@@@@@@@@@@@@@@@@@@@@.T.TT.T@@@@@@@@@@@@@@@@@@@@@@@@@@@@@@@@@.TTT..@@@@@@@@@@@@@@@@@@@@@@@@@@@@@@@@@@@@@@@@@@@@@@@@@@@@@@
@@@@@@@@@@@@@@@@@@@@@@@@@@@@@@@@@@@@@@@@@@@@@@@@@@@@@@@@@@@.T.T...@@@@@@@@@@@@@@@@@@@@@@@@@@@@@@@@@@T.T..TT@@@@@@@@@@@@@@@@@@@@@@@@@@@@@@@@@@@@@@@@@@@@@@@@@@@@@
@@@@@@@@@@@@@@@@@@@@@@@@@@@@@@@@@@@@@@@@@@@@@@@@@@@@@@@@@@@TT..TT@@@@@@@@@@@@@@@@@@@@@@@@@@@@@@@@@@@@.TT.TT@@@@@@@@@@@@@@@@@@@@@@@@@@@@@@@@@@@@@@@@@@@@@@@@@@@@@
@@@@@@@@@@@@@@@@@@@@@@@@@@@@@@@@@@@@@@@@@@@@@@@@@@@@@@@@@@.TT...@@@@@@@@@@@@@@@@@@@@@@@@@@@@@@@@@@@@@....TT@@@@@@@@@@@@@@@@@@@@@@@@@@@@@@@@@@@@@@@@@@@@@@@@@@@@@
@@@@@@@@@@@@@@@@@@@@@@@@@@@@@@@@@@@@@@@@@@@@@@@@@@@@@@@@@@.TT..@@@@@@@@@@@@@@@@@@@@@@@@@@@@@@@@@@@@@@TT.T...@@@@@@@@@@@@@@@@@@@@@@@@@@@@@@@@@@@@@@@@@@@@@@@@@@@@
@@@@@@@@@@@@@@@@@@@@@@@@@@@@@@@@..T@@@@@@@@@@@@@@@@@@@@@@@TT...@@@@@@@@@@@@@@@@@@@@@@@@@@@@@@@@@@@@@@.TT..TT@@@@@@@@@@@@@@@@@@@@@@@@@@@@@@@@@@@@@@@@@@@@@@@@@@@@
@@@@@@@@@@@@@@@@@@@@@@@@@@@@@@@@...T..TT@@@@@@@@@@@@@@@@@T...T@@@@@@@@@@@@@@@@@@@@@@@@@@@@@@@@@@@@@@@@..TTTT@@@@@@@@@@@@@@@@@@@@@@@@@@@@@@@@@@@@@@@@@@@@@@@@@@@@
@@@@@@@@@@@@@@@@@@@@@@@@@@@@@@@@@TT.TT.TT.@@@@@@@@@@@@@@@.T..T@@@@@@@@@@@@@@@@@@@@@@@@@@@@@@@@@@@@@@@@.TT...@@@@@@@@@@@@@@@@@@@@@@@@@@@@@@@@@@@@@@@@@@@@@@@@@@@@
@@@@@@@@@@@@@@@@@@@@@@@@@@@@@@@@@@@@.TT..TTT@@@@T@@@@@@@@T.TT.@@@@@@@@@@@@@@@@@@@@@@@@@@@@@@@@@@@@@@@@....T.@@@@@@@@@@@@@@@@@@@@@@@@@@@@@@@@@@@@@@@@@@@@@@@@@@@@
@@@@@@@@@@@@@@@@@@@@@@@@@.T@@@@@@@@@@..T.TTTTTT.T@@@@@@@@T.TT.@@@@@@@@@@@@@@@@@@@@@@@@@@@@@@@@@@@@@@@@.T...TT@@@@@@@@@@@@@@@@@@@@@@@@@@@@@@@@@@@@@@@@@@@@@@@@@@@
@@@@@@@@@@@@@@@@@@@@@@@@@TT...@@@@@@@@.TT.T...TT.@@@@@@@T.TTTT@@@@@@@@@@@@@@@@@@@@@@@@@@@@@@@@@@@@@@@@@TTTTTT@@@@@@@@@@@@@@@@@@@@@@@@@@@@@@@@@@@@@@@@@@@@@@@@@@@
@@@@@@@@@@@@@@@@@@@@@@@@@@@..@@@@@@@@..T.T.TT...@@@@.TTTTTT...@@@@@@@@@@@@@@@@@@@@@@@@@@@@@@@@@@@@@@@@@T......@@@@@@@@@@@@@@@@@@@@@@@@@@@@@@@@@@@@@@@@@@@@@@@@@@
@@@@@@@@@@@@@@@@@@@@@@@@@@@@T@@@@@@.T.T.T.T.TTT.@@@@T.TT..T...@@@@@@.@@@@@@@@@@@@@@@@@@@@@@@@@@@@@@@@@@.T....T@@@@@@@@@@@@@@@@@@@@@@@@@@@@@@@@@@@@@@@@@@@@@@@@@@
@@@@@@@@@@@@@@@@@@@@@@@@@@@@.T@@@.TTTTT..T.TT.T.TTTTTT.TTTT.TT@@@@@.T.@@@@@@@@@@@@@@@@@@@@@@@@@@@@@@@@@@T.TT..@@@@@@@@@@@@@@@@@@@@@@@@@@@@@@@@@@@@@@@@@@@@@@@@@@
@@@@@@@@@@@@@@@@@@@@.@@@@@@@@..T..TT.TTTTT.T.T.TTTTTT...T.TTTTTT.T..T.@@@@@@@@@@@@@@@@@@@@@@@@@@@@@@@@@@T..TTT@@@@@@@@@@@@@@@@@@@@@@@@@@@@@@@@@@@@@@@@@@@@@@@@@@
@@@@@@@@@@@@@@@@@@@@TT.@@@@@@.T..TT.TTTT.T...TT..TT..TT.TT..T.TTTT.T.@@@@@@@@@@@@@@@@@@@@@@@@@@@@@@@@@@@T.T..T@@@@@@@@@@@@@@@@@@@@@@@@@@@@@@@@@@@@@@@@@@@@@@@@@@
@@@@@@@@@@@@@@@@@@@..T..T@@@@T.T.T..TTTTT.TTTTT.....TT.T...T.TTT.T.@@@@@@@@@@@@@@@@@@@@@@@@@@@@@@@@@@@@@T...TT.@@@@@@@@@@@@@@@@@@@@@@@@@@@@@@@@@@@@@@@@@@@@@@@@@
@@@@@@@@@@@@@@@@@@@.T....TT@@T.TTT.T.T.TT.T.....TTTT..T.TT.....T.@@@@@@@@@@@@@@@@@@@@@@@@@@@@@@@@@@@@@@@@.T.TT.@@@@@@@@@@@@@@@@@@@@@@@@@@@@@@@@@@@@@@@@@@@@@@@@@
@@@@@@@@@@@@@@@@@@@@..T.@@.TTTT..TTT.T.TTTT..T....T...T.T.....T.T@@@@@@@@@@@@@@@@@@@@@@@@@@@@@@@@@@@@@@@@...TTT@@@@@@@@@@@@@@@@@@@@@@@@@@@@@@@@@@@@@@@@@@@@@@@@@
@@@@@@@@@@@@@@@@@@@@@@.@@@@TTT...T...TTTT.T.TTT.T....TT.TTTT.TTTT@@@@@@@@@@@@@@@@@@@@@@@@@@@@@@@@@@@@@@@@.T..T..@@@@@@@@@@@@@@@@@@@@@@@@@@@@@@@@@@@@@@@@@@@@@@@@
@@@@@@@@@@@@@@@@@@@@@@@@@@@@.....TT..T..TT..TT.T.TTT.TTT.TTTTTT..@@@@@@@@@@@@@@@@@@@@@@@@@@@@@@@@@@@@@@@@@.T..TT@@@@@@@@@@@@@@@@@@@@@@@@@@@@@@@@@@@@@@@@@@@@@@@@
@@@@@@@@@@@@@@@@@@@@@@@@@@@TT..TTT......T.........TT.TTTTT..TTT..@@@@@@@@.T@@@@@@@@@@@@@@@@@@@@@@@@@@@@@@@.T.T..@@@@@@@@@@@@@@@@@@@@@@@@@@@@@@@@@@@@@@@@@@@@@@@@
@@@@@@@@@@@@@@@@@@@@@@@@@@TT.T...T...T.T.T.TTT.T..TT...T.TTTT..T..@@@T.....@@@@@@@@@@@@@@@@@@@@@@@@@@@@@@@.T.T..@@@@@@@@@@@@@@@@@@@@@@@@@@@@@@@@@@@@@@@@@@@@@@@@
@@@@@@@@@@@@@@@@@@@@@@@@@@...T.T...TT...T.TTT.T.T.TT.T..TT.....TT..T.TT.@@@@@@@@@@@@@@@@@@@@@@@@@@@@@@@@@@TT.....@@@@@@@@@@@@@@@@@@@@@@@@@@@@@@@@@@@@@@@@@@@@@@@
@@@@@@@@@@@@@@@@@@@@@@@@@@...TTTTTT.T.TT.T..TTTT.TT...T.TTT.TT........@@@@@@@@@@@@@@@@@@@@@@@@@@@@@@@@@@@@@..TT.T@@@@@@@@@@@@@@@@@@@@@@@@@@@@@@@@@@@@@@@@@@@@@@@
@@@@@@@@@@@@@@@@@T..T..T@@.T.T.T.TTTT.T.TT..TT.T@@@TTTT.T.TTTT.T.T.TT@@@@@@@@@@@@@@@@@@@@@@@@@@@@@@@@@@@@@@TTT.T.@@@@@@@@@@@@@@@@@@@@@@@@@@@@@@@@@@@@@@@@@@@@@@@
@@@@@@@@@@@@@@@@@TT.T...TT..T..TT.TTT.TT...TT.T@@@@@T.T..T..TT.TTTT..@@@@@@@@@@@@@@@@@@@@@@@@@@@@@@@@@@@@@@@TT...@@@@@@@@@@@@@@@@@@@@@@@@@@@@@@@@@@@@@@@@@@@@@@@
@@@@@@@@@@@@@@@@@.TT..TT.T.TT.T...T....TT.@@@@@@@@@@....TTT.T.T...T..T@@@@@@@@@@@@@@@@@@@@@@@@@@@@@@@@@@@@@@T.TTTTTTT.@@@@@@@@@@@@@@@@@@@@@@@@@@@@@@@@@@@@@@@@@@
@@@@@@@@@@@@@@@@@@.TTTTTTTT.T..TTTT.TT.T.@@@@@@@@@@.....T..T...T.T..TT@@@@@@@@@@@@@@@@@@@@@@@@@@@@@@@@@@@@@@.T.T.....T@@@@@@@@@@@@@@@@@@@@@@@@@@@@@@@@@@@@@@@@@@
@@@@@@@@@@@@@@@@@@@@@...T.....T.TT.....T@@@@@@@@@@@...T.T.....TT.TT.T.@@@@@@@@@@@@@@@@@@@@@@@@@@@@@@@@@@@@@T..TTTT..T.T@@@@@@@@@@@@@@@@@@@@@@@@@@@@@@@@@@@@@@@@@
@@@@@@@@@@@@@@@@@@@@@TTTTT.TT...T...TTT.@@@@@@@@@@@.T....T.TT..T.TT.T.@@@@@@@@@@@@@@@@@@@@@@@@@@@@@@@@@@@@@TT.T....T.T.@@@@@@@@@@@@@@@@@@@@@@@@@@@@@@@@@@@@@@@@@
@@@@@@@@@@@@@@@@@@@@TT.TTTT.TTTT.TT..T.@@@@@@@@@@@@@..T.T.TTT.TTT....@@@@@@@@@@@@@@@@@@@@@@@@@@@@@@@@@@@@@@T..TTT...TT.@@@@@@@@@@@@@@@@@@@@@@@@@@@@@@@@@@@@@@@@@
@@@@@@@@@@@@@@@@@@@@TT...T..T..TTT...@@@@@@@@@@@@@@T.TT.TT..T.....T.@@@@@@@@@@@@@@@@@@@@@@@@@@@@@@@@@@@@@@TT....T.TT..T@@@@@@@@@@@@@@@@@@@@@@@@@@@@@@@@@@@@@@@@@
@@@@@@@@@@@@@@@@@@@.TT.TTTT.....T.T.@@@@@@@@@@@@@@@T.TTTTT..TT...TT@@@@@@@@@@@@@@@@@@@@@@@@@@@@@@@@@@@@@@@@T....T..TTT@@@@@@@@@@@@@@@@@@@@@@@@@@@@@@@@@@@@@@@@@@
@@@@@@@@@@@@@@@@@@...T.......T...T..@@@@@@@@@@@@@@...TT.T..TTT...T@@@@@@@@@@@@@@@@@@@@@@@@@@@@@@@@@@@@@@@@@@.....TTTTT@@@@@@@@@@@@@@@@@@.T@@@@@@@@@@@@@@@@@@@@@@
@@@@@@@@@@@@@@@@@@.T.TTTTT.T.T.T..T.T@@@@@@@@@@@@TTT.TTT.TT.TTT.T.@@@@@@@@@@@@@@@@@@@@@@@@@@@@@@@@@@@@@@@@@@@T..T...T.@@@@@@@@@@@@@@@@@TTT.@@@@@@@@@@@@@@@@@@@@@
@@@@@@@@@@@@@@@@@@T.TTT.....TTTTT.T.T.@@@@@@@@@@@T..T..T.TT.T.T..T@@@@@@@@@@@@@@@@@@@@@@@@@@@@@@@@@@@@@@@@@@@....T.TTT@@@@@@@@@@@@@@@@TT...T@@@@@@@@@@@@@@@@@@@@
@@@@@@@@@@@@@@@@@T....T.T.T..TTTTTT...T@@..T.@@@@....T.T.....T..TT...@@@@@@@@@@@@@@@@@@@@@@@@@@@@@@@@@@@@@@@@T...TT..T@@@@@@@@@@@@@@@@.TT...@@@@@@@@@@@@@@@@@@@@
@@@@@@@@@@@@@@@@@@...TTTT.TTTT.T.TTT..T.T..T..@@@TT..TTTT..T.T....TTT.@@@@@@@@@@@@@@@@@@@@@@@@@@@@@@@@@@@@@@@.T.TT...TT@@@@@@@@@@@@@@.T..T...@@@@@@@@@@@@@@@@@@@
@@@@@@@@@@@@@@@@@@@.T..TTTTT......T..TT.T.T.T.@@T.TTT......TT....TTTT..@@@@@@@@@@@@@@@@@@@@@@@@@@@@@@@@@@@@@@.......T..@@@@@@@@@@@@@@TTTTT...T@@@@@@@@@@@@@@@@@@
@@@@@@@@@@@@@@@@@@@@T..T.T..T..T.TT.....T..T..TT.T.T.....TT..TT.TTTT....@@@@@@@@@@@@@@@@@@@@@@@@@@@@@@@@@@@@@TTTT.TTTTTT@@@@@@@@@@@@TTT.T...T.T@@@@@@@@@@@@@@@@@
@@@@@@@@@@@@@@@@@@@@.T.T..T.TT..TT....T......TT.TTT.TTTT...T..TTT@@@..T.@@@@@@@@@@@@@@@@@@TT.@@@@@@@@@@@@@@@@...TTTT.TT...@@@@@@@@@TT.TT.TT.TTT.@@@@@@@@@@@@@@@@
@@@@@@@@@@@@@@@@@@..T.T...T....TTT.TTTTT...T..T.T...TTT.T.TT.TT@@@@@@T.T@@@@@@@@@@@@@@@@@@T.TT@@@@@@@@@@@@@@.T....T.TTT.T.TTT.@@..T....T.T.T.TT.@@@@@@@@@@@@@@@@
@@@@@@@@@@@@@@@@T..TT.T.TTTTTT..TTT...TT.....TTT.T..T.T.....TT@@@@@@@.T@@@@@@@@@@@@@@@@@@TTT.T@@@@@@@@@@@@@@.TTT..TT...TT.T.T......TT.....T.T...T@@@@@@@@@@@@@@@
@@@@@@@@@@@@@@@@T..T.TTTT.T..TTTT...T....T.TT.TTTT...T..TT..TT@@@@@@@.T@@@@@@@@@@@@@@@@@@TT.TT..@@@@@@@@@@@..T.TT.T...T...T.TTT...TT.T.T.TTT....T@@@@@@@@@@@@@@@
@@@@@@@@@@@@@@@@@....T.T.TT.T..TT....T.T..TTTT..T.T..TTTT.TTT.T@@@@@.T@@@@@@@@@@@@@@@@@@@TTT.TTT..@@@@@@@TTT.T....TT..TT..T.TT.TT..T..T.TT.T.TTTT.@@@@@@@@@@@@@@
@@@@@@@@@@@@@@@@@T.T..TTT....TTT......TTTT.TT.T..TT.T.T...T.TTT@@@@@.@@@@@@@@@@@@@@@@@@@T..T......TT.TTTT.TTT.....T.......TTT.TT.T.T.TT...T.T.T...@@@@@@@@@@@@@@
@@@@@@@@@@@@@@@@@@@@@@@@@@@TT.TTTTTT....T..TTT....T.T....TTT.....T.T.@@@@@@@@@@@@@@@@@@@T.T....T.TT..T..T.....TTTTTTT.TTT.T.T......TT..T.TTT..T.TTT@@@@@@@@@@@@@
@@@@@@@@@@@@@@@@@@@@@@@@@@@@TT.....TT.TT.TTT...T.T..TT.TT..TTT..T.TT.@@@@@@@@@@@@@@@@@@@.T.TT..TT...TTTTT....TTTTT.T.T.......T.....TT..T......TT.TT@@@@@@@@@@@@@
@@@@@@@@@@@@@@@@@@@@@@@@@@@@@T.T.T.T...TT.TT..TT.TTTT..T..@@@..T.T..@@@@@@@@@@@@@@@@@@@T..T.TTTT.TTT..TTTTT.TTT..T...T..TT.TT..TTTT.T...TT......T.T.@@@@@@@@@@@@
@@@@@@@@@@@@@@@@@@@@@@@@@@@@@@TT.TTTTTTT.....TTT.T...TT.@@@@@....TTT@@@@@@@@@@@@@@@@@@@TTT....TT...T.TT.T.TTTT.TTTT.T.TTTT..T...T...TTT..T......TT..@@@@@@@@@@@@
@@@@@@@@@@@@@@@@@@@@@@@@@@@@@@TT...TT...TTTT...TTTTTT..@@@@@@T..TTTTT.@@@@@@@@@@@@@@@@@TTT..TTTTT.T.T...TT.TTT.T.TTT..TTTTTTTTT.T....T...T.T.T..TT..@@@@@@@@@@@@
@@@@@@@@@@@@@@@@@@@@@@@@@@@@@@@TT.TTT.TTT.TT.T.TT.TTT.@@@@@T...T.TT..@@@@@@@@@@@@@@@@@@TT...T.T....T........TTT.T.@@@@@@@@..T..TTT...T.TTTTT.T.T....@@@@@@@@@@@@
@@@@@@@@@@@@@@@@@@@@@@@@@@@@@@@TTTTT.TTT.@TTTTTTT....T@@@@T...T...T.@@@@@@@@@@@@@@@@@@....TT...T.TT.TTTT..T.......@@@@@@@@@.T..TTTT.TT...TTT..T...T.@@@@@@@@@@@@
@@@@@@@@@@@@@@@@@@@@@@@@@@@@@@@TTTT.TTTT@@@.T...TT..TTTT...TT..TTTT@@@@@@@@@@@@@@@@@@@.TT..TT.TTTTT.T.TTT..TT.TT.@@@@@@@@@@.TTTT......T...TTTT.T...T@@@@@@@@@@@@
@@@@@@@@@@@@@@@@@@@@@@@@@@@@@@TTTTT..@@@@@@..TT.TT......TTT...T..@@@@@@@@@@@@@@@@@@@@@.TT.T..TTT.TTTTTT...TT.TTTT@@@@@@@@@@T....TTT........TT.T.....@@@@@@@@@@@@
@@@@@@@@@@@@@@@@@@@@@@@@@@@@@@..TT..@@@@@@@@@..T...T.TTTTTT.T..T@@@@@@@@@@@@@@@@@@@@@@.TT.T.TTTT.T.T.TT.TT..TT..@@@@@@@@@@@.T..T.T.TTT..T...TT..TTTT@@@@@@@@@@@@
@@@@@@@@@@@@@@@@@@@@@@@@@@@@@@@@....@@@@@@@@@@...TT.TT.T.T....@@@@@@@@@@@@@@@@@@@@@@@@TTT.T.TT....T.TT.T..T...T.@@@@@@@@@@@.....T.T.T....TTT.T.T....@@@@@@@@@@@@
@@@@@@@@@@@@@@@@@@@@@@@@@@@@@@@@@T.T@@@@@@@@@@.TTTT.T...T.TT@@@@@@@@@@@@@@@@@@@@@@@@@@T.....T..T...TT..T..T..T..@@@@@@@@@@@TTT.T....T.TTTT.TTTTTTTTTT@@@@@@@@@@@
@@@@@@@@@@@@@@@@@@@@@@@@@@@@@@@@@@@@@@@@@@@@@@@@@@@..TTT..T@@@@@@@@@@@@@@@@@@@@@@@@@@@T.TTT.TTT.TTTTT.TT..TT....@@@@@@@@@@.....T.TT.....T...T.T.T..TT@@@@@@@@@@@
@@@@@@@@@@@TT.@@@@@@@@@@@@@@@@@@@@@@@@@@@@@@@@@@@@@@.TT...T@@@@@@@@@@@@@@@@@@@@@@@@@@@T..T.TTTTT.T..T.TTT.....TT@@@@@@@@@@T.T...TTT.TT...T.T.T......T@@@@@@@@@@@
@@@@@@@@@@....T@@@@@@@@@@@@@@@@@@@@@@@@@@@@@@@@@@@@@@.T....@@@@@@@@@@@@@@@@@@@@@@@@@@@TT..T.TTT..T..T.TT.T..T..T.T.T@@@@@....T.TTTT..TT.TT.TT...TTTT.@@@@@@@@@@@
@@@@@@@@@@.TT.T.@@@@@@@@@@@@@@@@@@@@@@@@@@@@@@@@@@@@@TT.T.T...T@@@@@@@@@@@@@@@@@@@@@@@@.T...TTTT.TT..TTT.T..TTT.T..TTT@@.T.TTT.TT.T.T..TT..TTTT..TTT.@@@@@@@@@@@
@@@@@@@@@T..TT...T@@@@@@@@@@@@@@@@@@@@@@@@@@@@@@@@@TT.T..TTT.T.@@@@@@TT.TT@@@@@@@@@@@@@T.....T.T..TT..T.T.TT......TTT.TTT..TT.TT..T..TTT...TTT.T.....@@@@@@@@@@@
@@@@@@@@@.TT.TT.TTTT@@@@@@@@@@@@@@@@@@@@@@@@@@@@@@T..TTTT...T.T.T...T....TT.@@@@@@@@@@@.T..T.T...TTT..TTTT.TT.T.T..TT.TT....TT..TT.T..TTT......T..TT.@@@@@@@@@@@
@@@@@@@@@@@T.TT.TT...T@@@@@@@@@@@@@@@@@@@@@@@@@@..TTT.TT..TT.T.@@@.TTT.....TT.@@@@@@@@@.T.T.T..TTTTTT......TTTTTT...T....T..T..T.TT..TTTT.TT...T....@@@@@@@@@@@@
@@@@@@@@@@@@TT.TTTTT.TTT@@@@@@@@@@@@@@@@@@@@@@@TTT.T..T........@@@@TTT.TT.T.T.@@@@@@@@@@..T.T.TT.T....TT....T...TTTTTTT..TTT.T..TT..TT.TT..TTTT...T.@@@@@@@@@@@@
@@@@@@@@@@@@@@.....TTTTTT@@@@@@@@@@@@@@@@@@@@@.T.TTT.T..TT....T@@@@TTT..TT..TT@@@@@@@@@@TT....T.TT...T.T.......T..TT.T..TT..T..TTT.TTT.TTT..T..TTT.T@@@@@@@@@@@@
@@@@@@@@@@@@@@@..T.T.T.TT..@@@@@@@@@@@@@@@@@@T..TT...T.TT.TT..TT..TTTT.....T..T@@@@@@@@@T.TTT.TT.TT...T.T.T.T..TTT.T..TT..TT...TTT@@@@@@T..T..TTT...@@@@@@@@@@@@
@@@@@@@@@@@@@@@@@T....TT.TT.T@@@@@@@@@@@@@@TTT...@T.TTTT...T.T.T.T..T..TT...T..TT@@@@@@@.TTTTT.T.....TT..T.T...T.T.T....TTTTT.TT@@@@@@@@@....T.T..TT@@@@@@@@@@@@
@@@@@@@@@@@@@@@@@@@TT.TT.TT..T@@@@@@@@@@@@...TT@@@..@@TT..T...T.TTTTT.TTTT.TTTTT..T.T@@@@.TTT.TTTTTT....TT.TTT...TT..TT.T.TT..T@@@@@@@@@@@T...T.T.T@@@@@@@@@@@@@
@@@@@@@@@@@@@@@@@@@@@.T..T.....T@@@@@@@@@T.T.T.@@@T@@@T.....TT...TT...T.T..TTTTTTT...T@@.T.TTTT.....T.TT.T.@@@@T..TTTT..T...T.@@@@@@@@@@@@@@@...T..@@@@@@@@@@@@@
@@@@@@@@@@@@@@@@@@@@@@@TTTT....TT..T@@@@TTT..T.@@@.@@@T.T..T....TTT.TTTTT.TT....TT.TTT....T.TT........TT.T@@@@@@@TT...T..T.TT.@@@@@@@@@@@@@@@@.TTT@@@@@@@@@@@@@@
@@@@@@@@@@@@@@@@@@@@@@@@TTT..T..TTT.T@T...TT.TTTTT.@@@T..TTTT.T.TT..TT....T.T.TT...TT..T.T..TTTT..TTT...@@@@@@@@@@TTT..TTTTT.T@@@@@@@@@@@@@@@@T.T@@@@@@@@@@@@@@@
@@@@@@@@@@@@@@@@@@@@@@@@@@...TTT.TTT.TT...T.T.TT..T..TT.TTT.T.T....T.TTT...TTTT.T....TTTTTT@@.T.TT.TTT.@@@@@@@@@@@@...TTT...T.@@@@@@@@@@@@@@@@@.T@@@@@@@@@@@@@@@
@@@@@@@@@@@@@@@@@@@@@@@@@@@@T.TTT....TT.TT.T...TTT.T..TT.TTT.T...TTTTTTT.TTT.TTTTTTTT.T.T.T@@@TT...T..T@@@@@@@@@@@@@TTT.T.T..T@@@@@@@@@@@@@@@@@T@@@@@@@@@@@@@@@@
@@@@@@@@@@@@@@@@@@@@@@@@@@@@@TT...TTT..T......TT..TTTT...T.T.T.T..TTTTT.TTT..TT...T.TTT.TT@@@@@T.T..TT@@@@@@@@@@@@@@..T.T.TT..@@@@@@@@@@@@@@@@@@@@@@@@@@@@@@@@@@
@@@@@@@@@@@@@@@@@@@@@@@@@@@@@@@..@@TTTTT..T..T..TT.TT.T.T.TT.TT.TTT....T.T.TTTT.TT.TTTT.TTT@@@@@TT.TT@@@@@@@@@@@@@@@T.T....T..@@@@@@@@@@@@@@@@@@@@@@@@@@@@@@@@@@
@@@@@@@@@@@@@@@@@@@@@@@@@@@@@@@@@@@T..TT..T...T.TTTT...TTT.TT....TT..T..TTTTTT...TT...T...T.@@@@@...@@@@@@@@@@@@@@@@..T.....TT@@@@@@@@@@@@@@@@@@@@@@@@@@@@@@@@@@
@@@@@@@@@@@@@@@@@@@@@@@@@@@@@@@@@@@.TT..T...TTT.T.T.TT..T.....TT.TTT.T.T.T.......TTT....T...@@@@@@TT@@@@@@@@@@@@@@@@TT..T.T...T@@@@@@@@@@@@@@@@@@@@@@@@@@@@@@@@@
@@@@@@@@@@@@@@@@@@@@@@@@@@@@@@@@@@@TTTT.T.TT..TT..TTTTTT..TT......TTTTTTT..TTTT.T...T...TT.T@@@@@@@@@@@@@@@@@@@@@@@@T..T..TT...@@@@@@@@@@@@@@@@@@@@@@@@@@@@@@@@@
@@@@@@@@@@@@@@@@@@@@@@@@@@@@@@@@@@TTT..T.T.T.T.TTTTTT..T.T.T...TTTT...TT..T..TT..T.TT.TTT.T.T@@@@@@@@@@@@@@@@@@@@@@@..TT.TTT.TT@@@@@@@@@@@@@@@@@@@@@@@@@@@@@@@@@
@@@@@@@@@@@@@@@@@@@@@@@@@@@@@@@@@@.TT.T..TTTTT.......TTTTTT..T.....TTT.TTT.TTT...TTT.@@@T.TT.@@@@@@@@@@@@@@@@@@@@@@@TT.TT..TTTTT@@@@@@@@@@@@@@@@@@@@@@@@@@@@@@@@
@@@@@@@@@@@@@@@@@@@@@@@@@@@@@@@@@@.T.T....T.T....T..T.TTT..TT..T.TT.TT..T.TTTTT...TT@@@@@..T.T@@@@@@@@@@@@@@@@@@@@@@T...T......T@@@@@@@@@@@@@@@@@@@@@@@@@@@@@@@@
@@@@@@@@@@@@@@@@@@@@@@@@@@@@@@@@@@TTTTT..T...T....T...TT.T.T.T.T.T..TTTT.....TT......@@@@@...T@@@@@@@@@@@@@@@@@@@@@@....TT..T..@@@@@@@@@@@@@@@@@@@@@@@@@@@@@@@@@
@@@@@@@@@@@@@@@@@@@@@@@@@@@@@@@@@...TT.TT..TTTT....T.T.T..T.T.......T..TT..T.T.T.T.T.TT.@@@TT.T@@@@@@@@@@@@@@@@@@@@@T.T.T.@@@@@@@@@@@@@@@@@@@@@@@@@@@@@@@@@@@@@@
@@@@@@@@@@@@@@@@@@@@@@@@@@@@@@@@@.TT..TTT..TT.TT.TTT..TT..T....TT..T.TTTT..TT.TTT.TT....T@@...T@@@@@@@@@@@@@@@@@@@@@@@@@@@@@@@@@@@@@@@@@@@@@@@@@@@@@@@@@@@@@@@@@
@@@@@@@@@@@@@@@@@@@@@@@@@@@@@@@@.TT....TT...T...T..TTTTT...T...TTTT.TT.T...TT..TTT.T....TT.TT..@@@@@@@@@@@@@@@@@@@@@@@@@@@@@@@@@@@@@@@@@@@@@@@@@@@@@@@@@@@@@@@@@
@@@@@@@@@@@@@@@@@@@@@@@@@@@@@@@@.TT.TTT.T..T..TTTTT..T...TT.T.T.TT.TTTTT.TTT...T..TT.T...TT.T.T@@@@@@@@@@@@@@@@@@@@@@@@@@@@@@@@@@@@@@@@@@@@@@@@@@@@@@@@@@@@@@@@@
@@@@@@@@@@@@@@@@@@@@@@@@@@@@@@@@TT.TTT.T.T..T.TTT.TT.T..TT..TTTTTTTTTTT...T.T.TT......T..T.TTT.@@@@@@@@@@@@@@@@@@@@@@@@@@@@@@@@@@@@@@@@@@@@@@@@@@@@@@@@@@@@@@@@@
@@@@@@@@@@@@@@@@@@@@@@@@@@@@@@@@TT....TT.TTT..TTT..T..T.TTT......T....T.TTTTTT.TT.T..T.T.T.T..TT@@@@@@@@@@@@@@@@@@@@@@@@@@@@@@@@@@@@@@@@@@@@@@@@@@@@@@@@@@@@@@@@
@@@@@@@@@@@@@@@@@@@@@@@@@@@@@@@@.TTT.TT.TT...TT.TT..TT...TT.TT..T.....TTT..T.TT..T.TTTT.......TT@@@@@@@@@@@@@@@@@@@@@@@@@@@@@@@@@@@@@@@@@@@@@@@@@@@@@@@@@@@@@@@@
@@@@@@@@@@@@@@@@@@@@@@@@@@@@@@@@.T..TT.TTTT......T..TTTT...T.TT.TT.....T..T.TTTT...TTTTTT.T.T...@@@@@@@@@@@@@@@@@@@@@@@@@@@@@@@@@@@@@@@@@@@@@@@@@@@@@@@@@@@@@@@@
@@@@@@@@@@@@@@@@@@@@@@@@@@@@@@@@.TT..T..TT.TTT...TTTTT.T.T..T.T.TT.TT..T.TTT....T.TT...T..T...T.@@@@@@@@@@@@@@@@@@@@@@@@@@@@@@@@@@@@@@@@@@@@@@@@@@@@@@@@@@@@@@@@
@@@@@@@@@@@@@@@@@@@@@@@@@@@@@@@@TTTTT.T....T.T.T.TTTT.TTTTT.TTTT.TTT...TT.T.T..TT.T..T.T.....TT.@@@@@@@@@@@@@@@@@@@@@@@@@@@@@@@@@@@@@@@@@@@@@@@@@@@@@@@@@@@@@@@@
@@@@@@@@@@@@@@@@@@@@@@@@@@@@@@@@T.TTT..TTT.T..TT..TT.TTTTT...T...T.TT.TTT...T..T.T..T.T..T......@@@@@@@@@@@@@@@@@@@@@@@@@@@@@@@@@@@@@@@@@@@@@@@@@@@@@@@@@@@@@@@@
@@@@@@@@@@@@@@@@@@@@@@@@@@@@@@@@...T..T...T..T.T.TT.T..T.TTTTT.TTTT.T.TTT.....T.T..T....TT...T.T@@@@@@@@@@@@@@@@@@@@@@@@@@@@@@@@@@@@@@@@@@@@@@@@@@@@@@@@@@@@@@@@
@@@@@@@@@@@@@@@@@@@@@@@@@@@@@@@@..T.T..T..TT..T.TTT...TT.T....TT..TTT..T...T..T.T...TT....TT...T@@@@@@@@@@@@@@@@@@@@@@@@@@@@@@@@@@@@@@@@@@@@@@@@@@@@@@@@@@@@@@@@
@@@@@@@@@@@@@@@@@@@@@@@@@@@@@@@@TTTT.TT...TT.T..T....TT...TT...T..TTTTT..T..T.T..T....TT.T..T...@@@@@@@@@@@@@@@@@@@@@@@@@@@@@@@@@@@@@@@@@@@@@@@@@@@@@@@@@@@@@@@@
@@@@@@@@@@@@@@@@@@@@@@@@@@@@@@@@..TTT.T.T.T.T.T...T...T.TTT...T......T...TTTTT.T..TT..T...TT.T.@@@@@@@@@@@@@@@@@@@@@@@@@@@@@@@@@@@@@@@@@@@@@@@@@@@@@@@@@@@@@@@@@
@@@@@@@@@@@@@@@@@@@@@@@@@@@@@@@@T.T..T....TT..T....T.T.T.T.T.T.T.T..TTTTT.TTTTTT....TTTTT..T.T.@@@@@@@@@@@@@@@@@@@@@@@@@@@@@@@@@@@@@@@@@@@@@@@@@@@@@@@@@@@@@@@@@
@@@@@@@@@@@@@@@@@@@@@@@@@@@@@@@@.T..TTTT.TT..TTTTTT..T...T..TTT...T..T...T...TTT....T..TT..T.TT@@@@@@@@@@@@@@@@@@@@@@@@@@@@@@@@@@@@@@@@@@@@@@@@@@@@@@@@@@@@@@@@@
@@@@@@@@@@@@@@@@@@@@@@@@@@@@@@@@T..TTT.T..TT.TTTT.T.T..TTTTT.T..TTT..T..TT.T.TTTTTTT.TT...TT..@@@@@@@@@@@@@@@@@@@@@@@@@@@@@@@@@@@@@@@@@@@@@@@@@@@@@@@@@@@@@@@@@@
@@@@@@@@@@@@@@@@@@@@@@@@@@@@@@@@@..T.T....T.TTTT.TT.TT..T.TTT..TTTTTTTT..T.TTTT.T.T.TTTT...TTT@@@@@@@@@@@@@@@@@@@@@@@@@@@@@@@@@@@@@@@@@@@@@@@@@@@@@@@@@@@@@@@@@@
@@@@@@@@@@@@@@@@@@@@@@@@@@@@@@@@@@T...T.TTTTTT.TT.T..TT..T.T.T.TTTTTTTT.TT..T..TT...TTTTT..T.T@@@@@@@@@@@@@@@@@@@@@@@@@@@@@@@@@@@@@@@@@@@@@@@@@@@@@@@@@@@@@@@@@@
@@@@@@@@@@@@@@@@@@@@@@@@@@@@@@@@@@T.TT...T...T.TTT..TT.TT..T.T...T.T.T..TTT..TT.TTTTT...T...T@@@@@@@@@@@@@@@@@@@@@@@@@@@@@@@@@@@@@@@@@@@@@@@@@@@@@@@@@@@@@@@@@@@
@@@@@@@@@@@@@@@@@@@@@@@@@@@@@@@@@@@.T.T.TTTTT..TT.TTT..T..TT.TTTTT...T...T.TTT...T.T..T.TTTTT@@@@@@@@@@@@@@@@@@@@@@@@@@@@@@@@@@@@@@@@@@@@@@@@@@@@@@@@@@@@@@@@@@@
@@@@@@@@@@@@@@@@@@@@@@@@@@@@@@@@@@@@TT.TTTT....T.TTTTT..TT.....T...TTT..T.TT...TTTT....TT...@@@@@@@@@@@@@@@@@@@@@@@@@@@@@@@@@@@@@@@@@@@@@@@@@@@@@@@@@@@@@@@@@@@@
@@@@@@@@@@@@@@@@@@@@@@@@@@@@@@@@@@@@@.T..T..TTTTTTT.T.TT.T...T.T...TT..T.TT..TTT.....TTT.T.@@@@@@@@@@@@@@@@@@@@@@@@@@@@@@@@@@@@@@@@@@@@@@@@@@@@@@@@@@@@@@@@@@@@@
@@@@@@@@@@@@@@@@@@@@@@@@@@@@@@@@@@@@@@TT.TTT..T..TT.TT..T......T.T....T....T.T.TT.TTT.TTT.@@@@@@@@@@@@@@@@@@@@@@@@@@@@@@@@@@@@@@@@@@@@@@@@@@@@@@@@@@@@@@@@@@@@@@
@@@@@@@@@@@@@@@@@@@@@@@@@@@@@@@@@@@@@@@.T.TT..T..TTT.TT.T.TT..TT.TT.....T.TTTT..TTTT..TTT@@@@@@@@@@@@@@@@@@@@@@@@@@@@@@@@@@@@@@@@@@@@@@@@@@@@@@@@@@@@@@@@@@@@@@@
@@@@@@@@@@@@@@@@@@@@@@@@@@@@@@@@@@@@@@@@T.T.T..TTT.T...T.T..T.TT...T.TT..T.T..TTT.TTTTTT@@@@@@@@@@@@@@@@@@@@@@@@@@@@@@@@@@@@@@@@@@@@@@@@@@@@@@@@@@@@@@@@@@@@@@@@
@@@@@@@@@@@@@@@@@@@@@@@@@@@@@@@@@@@@@@@@@TTT...TT...T.....TTTT..T.T.T..TTT.T.TTTTTTT.TT@@@@@@@@@@@@@@@@@@@@@@@@@@@@@@@@@@@@@@@@@@@@@@@@@@@@@@@@@@@@@@@@@@@@@@@@@
@@@@@@@@@@@@@@@@@@@@@@@@@@@@@@@@@@@@@@@@@@.....T..T.T......T..T.T...TTT......TTTT.TT..@@@@@@@@@@@@@@@@@@@@@@@@@@@@@@@@@@@@@@@@@@@@@@@@@@@@@@@@@@@@@@@@@@@@@@@@@@
@@@@@@@@@@@@@@@@@@@@@@@@@@@@@@@@@@@@@@@@@@@..T....TTTTTTT.TT........T..TTT.T...TT.T.@@@@@@@@@@@@@@@@@@@@@@@@@@@@@@@@@@@@@@@@@@@@@@@@@@@@@@@@@@@@@@@@@@@@@@@@@@@@
@@@@@@@@@@@@@@@@@@@@@@@@@@@@@@@@@@@@@@@@@@@@...T...T....T....TTT.....T....T.....T.@@@@@@@@@@@@@@@@@@@@@@@@@@@@@@@@@@@@@@@@@@@@@@@@@@@@@@@@@@@@@@@@@@@@@@@@@@@@@@
@@@@@@@@@@@@@@@@@@@@@@@@@@@@@@@@@@@@@@@@@@@@@T..TTTT...T.TT.TT.T...T.TTTT.TTT..T@@@@@@@@@@@@@@@@@@@@@@@@@@@@@@@@@@@@@@@@@@@@@@@@@@@@@@@@@@@@@@@@@@@@@@@@@@@@@@@@
@@@@@@@@@@@@@@@@@@@@@@@@@@@@@@@@@@@@@@@@@@@@@.TTTT..T.TT.TT.TTTT...T...TTTT..T@@@@@@@@@@@@@@@@@@@@@@@@@@@@@@@@@@@@@@@@@@@@@@@@@@@@@@@@@@@@@@@@@@@@@@@@@@@@@@@@@@
@@@@@@@@@@@@@@@@@@@@@@@@@@@@@@@@@@@@@@@@@@@@T...@@.T.TTTTTTT.T.TT.TT.TT.TTTT@@@@@@@@@@@@@@@@@@@@@@@@@@@@@@@@@@@@@@@@@@@@@@@@@@@@@@@@@@@@@@@@@@@@@@@@@@@@@@@@@@@@
@@@@@@@@@@@@@@@@@@@@@@@@@@@@@@@@@@@@@@@@@@@...T@@@@@....T...TT.....TTT.TTT@@@@@@@@@@@@@@@@@@@@@@@@@@@@@@@@@@@@@@@@@@@@@@@@@@@@@@@@@@@@@@@@@@@@@@@@@@@@@@@@@@@@@@
@@@@@@@@@@@@@@@@@@@@@@@@@@@@@@@@@@@@@@@@@@..T.TT@@@@@@..TT.TTTT....TT.T.@@@@@@@@@@@@@@@@@@@@@@@@@@@@@@@@@@@@@@@@@@@@@@@@@@@@@@@@@@@@@@@@@@@@@@@@@@@@@@@@@@@@@@@@
@@@@@@@@@@@@@@@@@@@@@@@@@@@@@@@@@@@@@@@@@@T..TTT@@@@@@@@@T......T.@@@@@@@@@@@@@@@@@@@@@@@@@@@@@@@@@@@@@@@@@@@@@@@@@@@@@@@@@@@@@@@@@@@@@@@@@@@@@@@@@@@@@@@@@@@@@@
@@@@@@@@@@@@@@@@@@@@@@@@@@@@@@@@@@@@@@@@@.T.TT.T@@@@@@@@@@@@@@@@@@@@@@@@@@@@@@@@@@@@@@@@@@@@@@@@@@@@@@@@@@@@@@@@@@@@@@@@@@@@@@@@@@@@@@@@@@@@@@@@@@@@@@@@@@@@@@@@
@@@@@@@@@@@@@@@@@@@@@@@@@@@@@@@@@@@@@@@@@.....T@@@@@@@@@@@@@@@@@@@@@@@@@@@@@@@@@@@@@@@@@@@@@@@@@@@@@@@@@@@@@@@@@@@@@@@@@@@@@@@@@@@@@@@@@@@@@@@@@@@@@@@@@@@@@@@@@
@@@@@@@@@@@@@@@@@@@@@@@@@@@@@@@@@@@@@@@@TTTT..@@@@@@@@@@@@@@@@@@@@@@@@@@@@@@@@@@@@@@@@@@@@@@@@@@@@@@@@@@@@@@@@@@@@@@@@@@@@@@@@@@@@@@@@@@@@@@@@@@@@@@@@@@@@@@@@@@
@@@@@@@@@@@@@@@@@@@@@@@@@@@@@@@@@@@@@@@T...TT.@@@@@@@@@@@@@@@@@@@@@@@@@@@@@@@@@@@@@@@@@@@@@@@@@@@@@@@@@@@@@@@@@@@@@@@@@@@@@@@@@@@@@@@@@@@@@@@@@@@@@@@@@@@@@@@@@@
@@@@@@@@@@@@@@@@@@@@@@@@@@@@@@@@@@@@@@@TTT..T@@@@@@@@@@@@@@@@@@@@@@@@@@@@@@@@@@@@@@@@@@@@@@@@@@@@@@@@@@@@@@@@@@@@@@@@@@@@@@@@@@@@@@@@@@@@@@@@@@@@@@@@@@@@@@@@@@@
@@@@@@@@@@@@@@@@@@@@@@@@@@@@@@@@@@@@@@.TTT..T@@@@@@@@@@@@@@@@@@@@@@@@@@@@@@@@@@@@@@@@@@@@@@@@@@@@@@@@@@@@@@@@@@@@@@@@@@@@@@@@@@@@@@@@@@@@@@@@@@@@@@@@@@@@@@@@@@@
@@@@@@@@@@@@@@@@@@@@@@@@@@@@@@@@@@@@@T..T.TT@@@@@@@@@@@@@@@@@@@@@@@@@@@@@@@@@@@@@@@@@@@@@@@@@@@@@@@@@@@@@@@@@@@@@@@@@@@@@@@@@@@@@@@@@@@@@@@@@@@@@@@@@@@@@@@@@@@@
@@@@@@@@@@@@@@@@@@@@@@@@@@@@@@@@@@@@@.TT..TT@@@@@@@@@@@@@@@@@@@@@@@@@@@@@@@@@@@@@@@@@@@@@@@@@@@@@@@@@@@@@@@@@@@@@@@@@@@@@@@@@@@@@@@@@@@@@@@@@@@@@@@@@@@@@@@@@@@@
@@@@@@@@@@@@@@@@@@@@@@@@@@@@@@@@@@@@..TT.TT@@@@@@@@@@@@@@@@@@@@@@@@@@@@@@@@@@@@@@@@@@@@@@@@@@@@@@@@@@@@@@@@@@@@@@@@@@@@@@@@@@@@@@@@@@@@@@@@@@@@@@@@@@@@@@@@@@@@@
@@@@@@@@@@@@@@@@@@@@@@@@@@@@@@@@@@@T..T..T@@@@@@@@@@@@@@@@@@@@@@@@@@@@@@@@@@@@@@@@@@@@@@@@@@@@@@@@@@@@@@@@@@@@@@@@@@@@@@@@@@@@@@@@@@@@@@@@@@@@@@@@@@@@@@@@@@@@@@
@@@@@@@@@@@@@@@@@@@@@@@@@@@@@@@@@@@TT.....@@@@@@@@@@@@@@@@@@@@@@@@@@@@@@@@@@@@@@@@@@@@@@@@@@@@@@@@@@@@@@@@@@@@@@@@@@@@@@@@@@@@@@@@@@@@@@@@@@@@@@@@@@@@@@@@@@@@@@
@@@@@@@@@@@@@@@@@@@@@@@@@@@@@@@@@@.T.TT..@@@@@@@@@@@@@@@@@@@@@@@@@@@@@@@@@@@@@@@@@@@@@@@@@@@@@@@@@@@@@@@@@@@@@@@@@@@@@@@@@@@@@@@@@@@@@@@@@@@@@@@@@@@@@@@@@@@@@@@
@@@@@@@@@@@@@@@@@@@@@@@@@@@@@@@@@@.T...T.@@@@@@@@@@@@@@@@@@@@@@@@@@@@@@@@@@@@@@@@@@@@@@@@@@@@@@@@@@@@@@@@@@@@@@@@@@@@@@@@@@@@@@@@@@@@@@@@@@@@@@@@@@@@@@@@@@@@@@@
@@@@@@@@@@@@@@@@@@@@@@@@@@@@@@@@@T...T.T@@@@@@@@@@@@@@@@@@@@@@@@@@@@@@@@@@@@@@@@@@@@@@@@@@@@@@@@@@@@@@@@@@@@@@@@@@@@@@@@@@@@@@@@@@@@@@@@@@@@@@@@@@@@@@@@@@@@@@@@
@@@@@@@@@@@@@@@@@@@@@@@@@@@@@@@@@..TTT.@@@@@@@@@@@@@@@@@@@@@@@@@@@@@@@@@@@@@@@@@@@@@@@@@@@@@@@@@@@@@@@@@@@@@@@@@@@@@@@@@@@@@@@@@@@@@@@@@@@@@@@@@@@@@@@@@@@@@@@@@
@@@@@@@@@@@@@@@@@@@@@@@@@@@@@@@@.T...TT@@@@@@@@@@@@@@@@@@@@@@@@@@@@@@@@@@@@@@@@@@@@@@@@@@@@@@@@@@@@@@@@@@@@@@@@@@@@@@@@@@@@@@@@@@@@@@@@@@@@@@@@@@@@@@@@@@@@@@@@@
@@@@@@@@@@@@@@@@@@@@@@@@@@@@@@@TT.TTTT@@@@@@@@@@@@@@@@@@@@@@@@@@@@@@@@@@@@@@@@@@@@@@@@@@@@@@@@@@@@@@@@@@@@@@@@@@@@@@@@@@@@@@@@@@@@@@@@@@@@@@@@@@@@@@@@@@@@@@@@@@
@@@@@@@@@@@@@@@@@@@@@@@@@@@@@@T.TTTTTT@@@@@@@@@@@@@@@@@@@@@@@@@@@@@@@@@@@@@@@@@@@@@@@@@@@@@@@@@@@@@@@@@@@@@@@@@@@@@@@@@@@@@@@@@@@@@@@@@@@@@@@@@@@@@@@@@@@@@@@@@@
@@@@@@@@@@@@@@@@@@@@@@@@@@@@@@..TT..T@@@@@@@@@@@@@@@@@@@@@@@@@@@@@@@@@@@@@@@@@@@@@@@@@@@@@@@@@@@@@@@@@@@@@@@@@@@@@@@@@@@@@@@@@@@@@@@@@@@@@@@@@@@@@@@@@@@@@@@@@@@
@@@@@@@@@@@@@@@@@@@@@@@@@@@@@@@@@@@@@@@@@@@@@@@@@@@@@@@@@@@@@@@@@@@@@@@@@@@@@@@@@@@@@@@@@@@@@@@@@@@@@@@@@@@@@@@@@@@@@@@@@@@@@@@@@@@@@@@@@@@@@@@@@@@@@@@@@@@@@@@@
