type octile
height 118
width 112
map
@@@@@@@@@@@@@@@@@@@@@@@@@@@@@@@@@@@@@@@@@@@@@@@@@@@@@@@@@@@@@@@@@@@@@@@@@@@@@@@@@@@@@@@@@@@@@@@@@@@@@@@@@@@@@@@@
@@@@@@@@@@@@@@@@@@@@@@@@@@@@@@@@@@@@@@@@@@@@@@@@@@@@@@@@@@@@@@@@@@@@@@@@@@@@@@@@@@@@@@@@@@@@@@@@@@@@@@@@@@@@@@@@
@@@@@@@@@@@@@@@@@@@@@@@@@@@@@@@@@@@@@@@@@@@@@@@@@@@@@@@@@@@@@@@@@@@@@@@@@@@@@@@@@@@@@@@@@@@@@@@@@@@@@@@@@@@@@@@@
@@@@@@@@@@@@@@@@@@@@@@@@@@@@@@@@@@@@@@@@@@@@@@@@@@@@@@@@@@@@@@@@@@@@@@@@@@@@@@@@@@@@@@@@@@@@@@@@@@@@@@@@@@@@@@@@
@@@@@@@@@@@@@@@@@@@@@@@@@@@@@@@@@@@@@@@@@@@@@@@@@@@@@@@@@@@@@@@@@@@@@@@@@@@@@@@@@@@@@@@@@@@@@@@@@@@@@@@@@@@@@@@@
@@@@@@@@@@@@@@@@@@@@@@@@@@@@@@@@@@@@@@@@@@@@@@@@@@@@@@@@@@@@@@@@@@@@@@@@@@@@@@@@@@@@@@@@@@@@@@@@@@@@@@@@@@@@@@@@
@@@@@@@@@@@@@@@@@@@@@@@@@@@@@@@@@@@@@@@@@@@@@@@@@@@@@@@@@@@@@@@@@@@@@@@@@@@@@@@@@@@@@@@@@@@@@@@@@@@@@@@@@@@@@@@@
@@@@@@@@@@@@@@@@@@@@@@@@@@@@@@@@@@@@@@@@@@@@@@@@@@@@@@@@@@@@@@@@@@@@@@@@@@@@@@@@@@@@@@@@@@@@@@@@@@@@@@@@@@@@@@@@
@@@@@@@@@@@@@@@@@@@@@@@@@@@@@@@@@@@@@@@@@@@@@@@@@@@@@@@@@@@@@@@@@@@@@@@@@@@@@@@@@@@@@@@@@@@@@@@@@@@@@@@@@@@@@@@@
@@@@@@@@@@@@@@@@@@@@@@@@@@@@@@@@@@@@@@@@@@@@@@@@@@@@@@@@@@@@@@@@@@@@@@@@@@@@@@@@@@@@@@@@@@@@@@@@@@@@@@@@@@@@@@@@
@@@@@@@@@@@@@@@@@@@@@@@@@@@@@@@@@@@@@@@@@@@@@@@@@@@@@@@@@@@@@@@@@@@@..@@@@@@@@@@@@@@@@@@@@@@@@@@@@@@@@@@@@@@@@@@
@@@@@@@@@@@@@@@@@@@@@@@@@@@@@@@@@@@@@@@@@@@@@@@@@@@@@@@@@@@@@@@@@@@.T.T@@@@@@@@@@@@@@@@@@@@@@@@@@@@@@@@@@@@@@@@@
@@@@@@@@@@@@@@@@@@@@@@@@@@@@@@@@@@@@@@@@@@@@@@@@@@@@@@@@@@@@@@@@@@.TTT.T@@@@@@@@@@@@@@@@@@@@@@@@@@@@@@@@@@@@@@@@
@@@@@@@@@@@@@@@@@@@@@@@@@@@@@@@@@@@@@@@@@@@@@@@@@@@@@@@@@@@@@@@@@.TTTT..T@@@@@@@@@@@@@@@@@@@@@@@@@@@@@@@@@@@@@@@
@@@@@@@@@@@@@@@@@@@@@@@@@@@@@@@@@@@@@@@@@@@@@@@@@@@@@@@@@@@@@@@@T...TT.T.T@@@@@@@@@@@@@@@@@@@@@@@@@@@@@@@@@@@@@@
@@@@@@@@@@@@@@@@@@@@@@@@@@@@@@@@@@@@@@@@@@@@@@@@@@@@@@@@@@@@@@@T..T.TT.TT..@@@@@@@@@@@@@@@@@@@@@@@@@@@@@@@@@@@@@
@@@@@@@@@@@@@@@@@@@@@@@@@@@@@@@@@@@@@@@@@@@@@@@@@@@@@@@@@@@@@@.T...T@TTT....@@@@@@@@@@@@@@@@@@@@@@@@@@@@@@@@@@@@
@@@@@@@@@@@@@@@@@@@@@@@@@@@@@@@@@@@@@@@@@@@@@@@@@@@@@@@@@@@@@...TT.@@@.TT..TT@@@@@@@@@@@@@@@@@@@@@@@@@@@@@@@@@@@
@@@@@@@@@@@@@@@@@@@@@@@@@@@@@@@@@@@@@@@@@@@@@@@@@@@@@@@@@@@@..TT..@@@@@TTTT...@@@@@@@@@@@@@@@@@@@@@@@@@@@@@@@@@@
@@@@@@@@@@@@@@@@@@@@@@@@@@@@@@@@@@@@@@@@@@@@@@@@@@@@@@@@@@@T.TTT.@@@@@@@.TTT..T@@@@@@@@@@@@@@@@@@@@@@@@@@@@@@@@@
@@@@@@@@@@@@@@@@@@@@@@@@@@@@@@@@@@@@@@@@@@@@@@@@@@@@@@@@@@TTTT.T@@@@@@@@@.T.T...@@@@@@@@@@@@@@@@@@@@@@@@@@@@@@@@
@@@@@@@@@@@@@@@@@@@@@@@@@@@@@@@@@@@@@@@@@@@@@@@@@@@@@@@@@T..TTT@@@@@@@@@@@....T.T.@@@@@@@@@@@@@@@@@@@@@@@@@@@@@@
@@@@@@@@@@@@@@@@@@@@@@@@@@@@@@@@@@@@@@@@@@@@@@@@@@@@@@@@.T.T..@@@@@@@@@@@@@TTT.....@@@@@@@@@@@@@@@@@@@@@@@@@@@@@
@@@@@@@@@@@@@@@@@@@@@@@@@@@@@@@@@@@@@@@@@@@@@@@@@@@@@@@T....T@@@@@@@@.T@@@@@.TTTTTTT@@@@@@@@@@@@@@@@@@@@@@@@@@@@
@@@@@@@@@@@@@@@@@@@@@@@@@@@@@@@@@@@@@@@@@@@@@@@@@@@@@@.TTT.T@@@@@@@TT.T@@@@@@TTTT..TT@@@@@@@@@@@@@@@@@@@@@@@@@@@
@@@@@@@@@@@@@@@@@@@@@@@@@@@@@@@@@@@@@@@@@@@@@@@@@@@@@TT....@@@@@@@.T....@@@@@@T.TTT.T.@@@@@@@@@@@@@@@@@@@@@@@@@@
@@@@@@@@@@@@@@@@@@@@@@@@@@@@@@@@@@@@@@@@@@@@@@@@@@@@..TTTT@@@@@@@T.T..TT.@@@@@@TTT...T.@@@@@@@@@@@@@@@@@@@@@@@@@
@@@@@@@@@@@@@@@@@@@@@@@@@@@@@@@@@@@@@@@@@@@@@@@@@@TTT.TT.@@@@@@@@.T...T.TT@@@@@@T.TT.TTT@@@@@@@@@@@@@@@@@@@@@@@@
@@@@@@@@@@@@@@@@@@@@@@@@@@@@@@@@@@@@@@@@@@@@@@@@@.TT..T.@@@@@@@@TT.T.@@.T.TT@@@@@.TT....T@@@@@@@@@@@@@@@@@@@@@@@
@@@@@@@@@@@@@@@@@@@@@@@@@@@@@@@@@@@@@@@@@@@@@@@@.T.TTTT@@@@@@@T.T.TT@@@@TT.TT@@@@@T.T....T@@@@@@@@@@@@@@@@@@@@@@
@@@@@@@@@@@@@@@@@@@@@@@@@@@@@@@@@@@@@@@@@@@@@@@TTTT.TT@@@@@TTTTTTT.@@@@@@TT..T@@@@@..TTTT..@@@@@@@@@@@@@@@@@@@@@
@@@@@@@@@@@@@@@@@@@@@@@@@@@@@@@@@@@@@@@@@@T@@@TT.T..T@@@@@...T...T@@@@@@@@..TTT@@@@@T.TTTTT.@@@@@@@@@@@@@@@@@@@@
@@@@@@@@@@@@@@@@@@@@@@@@@@@@@@@@@@@@@@@@@T.T@@TT......@@@@@.TTTTT@@@@@@@@@..T..T@@@@@...T..T.@@@@@@@@@@@@@@@@@@@
@@@@@@@@@@@@@@@@@@@@@@@@@@@@@@@@@@@@@@@@.T...@T.TTTT.TT@@@@@T.T.@@@@@@@@TT..TTTTT@@@@@@.T.T..T@@@@@@@@@@@@@@@@@@
@@@@@@@@@@@@@@@@@@@@@@@@@@@@@@@@@@@@@@@.....@@T@@@..TT..@@@@@TT@@@@@@@@@TT....TT..@@@@@@TT..TTT@@@@@@@@@@@@@@@@@
@@@@@@@@@@@@@@@@@@@@@@@@@TT...TTTT@@@@T...T@@@@@@@@....T.@@@@@@@@@@@@@@@TTTTTT..T.T@@@@@@..T..TT@@@@@@@@@@@@@@@@
@@@@@@@@@@@@@@@@@@@@@@TT.TTTTTT.TTT@@@.TTTT@@@@@@@...T...T@@@@@@@@@@@TTTT..T.T@@..T@@@@@@@..TT..T@@@@@@@@@@@@@@@
@@@@@@@@@@@@@@@@@@@@TTT.T......TTTT@@@.T.T@@@@.@@T.TT......@@@@@@@@@TTT.TT.T.@@@@...T@@@@@@TTT.TT.@@@@@@@@@@@@@@
@@@@@@@@@@@@@@@@@@@TT.T.T..T...TT.@@@@TTT.@@@@T...T.T..T.TT.@@@@@@@T.T..TT..@@@@@.T..TT@@@@@.TT.T.T@@@@@@@@@@@@@
@@@@@@@@@@@@@@@@@@.....T.TTT.T.TT..@@T...@@@@@TT.T.T@.T..T..T@@@@@@T...T.TT@@@@@@...TT.T@@@@.T.T.TTT@@@@@@@@@@@@
@@@@@@@@@@@@@@@@@..TT..TTTTTTTTT..TTTT...@@@@@...T.@@@..T.TTTT@@@@@@....TT@@@@@@@T.TT...T@@@@.T.TT...@@@@@@T.@@@
@@@@@@@@@@@@@@@@T..TTTTT.T..TT...T.T.TT.T@@@@@.TT.TTT.TT....T.T@@@@@@....@@@@@@@@.T..T.T.T@@@@TTT....T@@@@.TT@@@
@@@@@@@@@@@@@@@....T..TTT.....T.T.TT.T..@@@@@TTT.TTT...@@@.TT...@@@@@@T.@@@@@@@@.TT...TT.T@@@@@...T..TT@@T.T.@@@
@@@@@@@@@@@@@@.TT.....T.TT.TTT..TT...TT@@@@@..TT...T.T@@@@@T.TTTT@@@@@@@@@@@@@TTTTTT..TTT..@@@@@TTT.T..TTTT.@@@@
@@@@@@@@@@@@@@..TT.TT.T@@@@@@@..TTTTTTT.@@@T.T.TTTT.TT.@@@@T....TT@@@@@@@@@@@....TTTT.@@@TT.@@@@@..T..TT..T@@@@@
@@@@@@@@@@@@@..T...TT.@@@@@@@@@.T..T.TTT.@@..TT..TT.T.T.@@.TT.T..TT@@@@@@@@T...T.TT..@@@@..T@@@@@@TT.TTTT..@@@@@
@@@@@@@@@@@@@TTT.TTT.T@@@@@@@@@@TT.TTTTTTT@TTTT.T...TTT..T.......TT.@@@@@@.TTT..TT..@@@@@@TT.@@@@@@.TTT.TT..@@@@
@@@@@@@@@@@@@T...TTT.T@@@@@...@@@...TTTTT.@..T..T.T.TT.TT...@@TT...T.@@@@@@T.TTTTTT@@@@@@@..TTT@@@@@@.T..TTTT@@@
@@@@@@@@@@@@@.T.T..T..@@@@@@..T@@@T.....TT@@T..T.T.TTTT.TTT@@@.TTTT.T.@@@@@@.T...T@@@@@@@@..T...@@@@@T.T.T..T@@@
@@@@@@@@@@@@@@.TTT.TTT@@@@@@..T.@@@...T.TT.@@...T..TT..T...T.T.T.T..T.T@@@@@@.TTT@@@@@@@@.T.T.TT@@@@TT.T.T.T.@@@
@@@@@@@@@@@@@@T..T..TT.@@@@@.TT.T@@@TTTTT.T.@T.@@T......TTTT...T@@.TTT.T.@@@@@..@@@@@@@@.T.....@@@@.T.....TT@@@@
@@@@@@@@@@@@@@@..T.TT..@@@@.T..TT.@@@T......@..@@@TT..T...TT..T@@@@.T.T..T@@@@@@@@@@@@@.TTT..T@@@@TTTTTT.TT@@@@@
@@@@@@@@@@@@@@@.T.T..TTT@@@....T.TT@@@TTT..TT.T@@@.T....T...T.T@@@@.TT..TT.@@@@@@@@@@@.TT.TTT.@@@T.....T.T@@@@@@
@@@@@@@@@@@@@@@@TTT...TT@@@T...TTTTT@@.T.TT.TTT..T..T.T...T.TTT.@@..T.TT..T.@@@@@@@...TTT..T..@@TTT..TT.T@@@@@@@
@@@@@@@@@@@@@@@@TTTT.TTTTT@@TT.TT..T.@@T..T.....T.TTTT....T.T.TT.T.TTT...T..T@@@@@..TTT....TTTT@....T.T.@@@@@@@@
@@@@@@@@@@@@@@@@@.TT...T..T@@.TTTT.TTT@..TT.............TT..T.TTT.T.T@..TTTTTT@@@@@..T...@@@.TT.T...T..@@@@@@@@@
@@@@@@@@@@@@@@@@@@T...T.T.T.@@.TTTTT.T@@.TTTT.T.T..TT.T........T.T..@@@..TTTTT.@@@@@TT.T@@@@T.TTT.TTT.@@@@@@@@@@
@@@@@@@@@@@@@@@@@@@TT..TT.TTT@@.TTT....TT.TT....TT..TT.TT.TTT.T.T.T.T.TTTTT.TT.T@@@@@T.@@@@@TT.TT.TTT@@@@@@@@@@@
@@@@@@@@@@@@@@@@@@@@...TT.....@T.TTT.TT..T.T.T.T..T..TT.@@TTTT...T...TTT@@@...TT.@@@@@@@@@@TTT.T.T..@@@@@@@@@@@@
@@@@@@@@@@@@@@@@@@@@@T.TTT...T@.T.TTTTTT.T.T..TT.......@@@.TT.T.T.TTT..@@@@@T...TT@@@@@@@@...T.TTT.@@@@@@@@@@@@@
@@@@@@@@@@@@@@@@@@@@@@TTT..TTT@@.T..T..TTTTT.T.T.TT...T@@@TT.T.TTTT.TTT.@@@T.TTTTTT@@@@@@T..T..T..@@@@@@@@@@@@@@
@@@@@@@@@@@@@@.@@TT@@@@T......T@.TT..T...TT....TTT.TT.TT.T..TT.T...TTTTTT@......T...@@@@T.TT.TT..@@@@@@@@@@@@@@@
@@@@@@@@@@@@@....TT.@@@@TTTTT..@@T..TT..T.TTT......TTTT...TTTTTT.TTTTT.TTT..TT..TT.TT@@TT..T.T..@@@@@@@@@@@@@@@@
@@@@@@@@@@@@.......T.@@@@TT.TT.T@..TT.....TT.TTT.T..T.T.TTTT.T..TT.....T.T..T@@.T..T.TTT.TTT...@@@@@@@@@@@@@@@@@
@@@@@@@@@@@T....T..TTT@@@@.T...TT..TTTTTT.TT...T..TTT.T.T..TT.T...TT.T..T.TT@@@..T..TT.....TT.@@@@@@@@@@@@@@@@@@
@@@@@@@@@@.T.....T..TTT@@@T..T.TTT..TTT.T..T.T.T.T.....TT.T.TT.TT...T...TT......TT..T....TTTT@@@@@@@@@@@@@@@@@@@
@@@@@@@@@TT.TTT..TT.T.TT@@TTT.T.T.T.TT..TTTT.TT.TTTT.TTTT.TT....T@...TTT...TT.TT@@@T.T.TTT.T@@@@@@@@@@@@@@@@@@@@
@@@@@@@@..TTT..T...T.....@@...TT.T..TT..TT...T.T.TT.TT....TT.T.T@@@TTTTT.TTT.T.@@@@@T..TTT.@@@@@@@@@@@@@@@@@@@@@
@@@@@@@..T.TT....T....T.TT@TTT..TT..TT.TT.T..T.TTT..TTTTT.T.T.T.@@@..T...TT.T.T.@@@@...T.T@@@@@@@@@@@@@@@@@@@@@@
@@@@@@.T..@..TTT.T..TT.TT.TTT.T.TTTT.TT..TT...T....TT.T...TT.TTTT..TT..T.TTT...T.@@..T..T@@@@@@@@@@@@@@@@@@@@@@@
@@@@@TT..@@@TT...TTT..TT.T@@.T..TTT...TT...TTT.TT..T..TTT.....T.TTTT...TT...TTTTTT..T..T.@@@@@@@@@@@@@@@@@@@@@@@
@@@@...T@@@@@...TTTTT....@@@.TT.T.T.TTTTTTTTTTTTTT.TT.T.T..T.T.T......TTT..TTTT.TT.TTT.T.@@@@@@@@@@@@@@@@@@@@@@@
@@@.TTTT@@@@T.T..TT.TTTTT@@@@TT.T.TT.TT..TTTTTT.....TTT....T.TTT.T..T..TTT..T...TT.......@@@@@@@@@@@@@@@@@@@@@@@
@@@@TTT..@@T.TTTTTT.TT..T......TT......T...T.TTTTT.T...TT...TTTTT..T.TT.TT..TT..T.T..TT.@@@@@@@@@@@@@@@@@@@@@@@@
@@@@@T.T..T..TT...T...T...T...TTTT.....T..TT..TTT..TT..TTTTT..T.TT..TT..T@@TTT..T.....TT@@@@@@@@@@@@@@@@@@@@@@@@
@@@@@@TTTT..T.@......TT.....TT.T.T.T.......TT.T..T.T.....TT.....TTT.TTT.@@@.T.T..T.T.T.T@@@@@@@@@@@@@@@@@@@@@@@@
@@@@@@@T.TT..@@@...TTTTTT..T.TTTTT.TT..TT..T.TT....T...T....TT..TTT.TTT.@@@@T....T...TT.@@@@@@@@@@@@@@@@@@@@@@@@
@@@@@@@@....T.T.T.T..T.TT.T..TT.TTT.TTTTTT.......TTTT.T.T.......T.TT...TT..TTT..TTTTTTT@@@@@@@@@@@@@@@@@@@@@@@@@
@@@@@@@@@T..T..T.@@@T.TTTTTTT.TT.T@@@TT.T..TTTT...TTT.TT..T.TTT.T..T..T.TTTTTT.T.T.T..@@@@@@@@@@@@@@@@@@@@@@@@@@
@@@@@@@@@@T..TT.@@@@@T..T....T.T..@@@.TT.T.....T..TT.TTTTT...TTT.TT.TTTT..T.T...TT..@@@@@@@@@@@@@@@@@@@@@@@@@@@@
@@@@@@@@@@@TTT..T@@@@.TT.T...T.TT.@@@.T..TTT.T.T.T.....TTTT.T.T.TT..TT.TT.TT.T.T...@@@@@@@@@@@@@@@@@@@@@@@@@@@@@
@@@@@@@@@@@@T..TTT@@T..T.T.TT.........T.TT.TTTT..T....TTTTT.T....TTTTTTT..TTT.....@@@@@@@@@@@@@@@@@@@@@@@@@@@@@@
@@@@@@@@@@@@@........T.TTTT..T.T..T..TT..TTTT...T..T.T.T..T.TTTTTT.T.TTT.T.T..TT.T@@@@@@@@@@@@@@@@@@@@@@@@@@@@@@
@@@@@@@@@@@@@@.TTTT...@@T.T....TTT.TT..T.T..TT.TTTT.TT..T.TT..TT..T..T.T.T..TTTT.@@@@@@@@@@@@@@@@@@@@@@@@@@@@@@@
@@@@@@@@@@@@@@@..TTT..@@TTT.T.T....T....TTT.TT.T....T.TTT.TT.T.TT..TT.TTTT...TTT.@@@@@@@@@@@@@@@@@@@@@@@@@@@@@@@
@@@@@@@@@@@@@@@@T...T.TTTT....TT.....T.TTT.T.T.TTTTT.TT.......T.TT.T...T.TT.TT..@@@@@@@@@@@@@@@@@@@@@@@@@@@@@@@@
@@@@@@@@@@@@@@@@@..T.....T@@TTTT...T.T.T.T.@@.T..TTT.TTT.T...T.T...T.TT..TTT....@@@@@@@@@@@@@@@@@@@@@@@@@@@@@@@@
@@@@@@@@@@@@@@@@@@T.TTTT..@@@.T.TT.....TTT@@@@..T.T.TTT..T...T..TTT..T.T...TT..@@@@@@@@@@@@@@@@@@@@@@@@@@@@@@@@@
@@@@@@@@@@@@@@@@@@@..TT.TT.TT.TTTTT.T.....@@@@..T....T..TT...TT........T.TTTT@@@@@@@@@@@@@@@@@@@@@@@@@@@@@@@@@@@
@@@@@@@@@@@@@@@@@@@@T....T.T...TT.T..TTT....T..TT..T..TTTT..TTT..T...TT...TT@@@@@@@@@@@@@@@@@@@@@@@@@@@@@@@@@@@@
@@@@@@@@@@@@@@@@@@@@@....TT.T..T.TTT..TT..TTT.T.TT..T.TT.T.T.TT..TTT....T.T@@@@@@@@@@@@@@@@@@@@@@@@@@@@@@@@@@@@@
@@@@@@@@@@@@@@@@@@@@@@T.T...TT.@.......T.T..T.TTTT.T.T..T.....T..T..TT.T..@@@@@@@@@@@@@@@@@@@@@@@@@@@@@@@@@@@@@@
@@@@@@@@@@@@@@@@@@@@@@@TT.TTTT@@@TT.T.T.TTT...T..T.....T....T....TTTT.T..@@@@@@@@@@@@@@@@@@@@@@@@@@@@@@@@@@@@@@@
@@@@@@@@@@@@@@@@@@@@@@@@.T...TT...T..TTTT....TTT.TT.T...T.T.T.T.....TT..@@@@@@@@@@@@@@@@@@@@@@@@@@@@@@@@@@@@@@@@
@@@@@@@@@@@@@@@@@@@@@@@@@T.TT....T@@@.TTT.T..T..TT.T@TTT.T..T......TTTT@@@@@@@@@@@@@@@@@@@@@@@@@@@@@@@@@@@@@@@@@
@@@@@@@@@@@@@@@@@@@@@@@@@@T..T....@@@.TT.TTTTT..TTT@@@.TT...TT..TTTT.@@@@@@@@@@@@@@@@@@@@@@@@@@@@@@@@@@@@@@@@@@@
@@@@@@@@@@@@@@@@@@@@@@@@@@@..T.T..TT..T...T.TTT...T@@@TTT.......T@@@@@@@@@@@@@@@@@@@@@@@@@@@@@@@@@@@@@@@@@@@@@@@
@@@@@@@@@@@@@@@@@@@@@@@@@@@@.TTT..TTT.TT..T......T....T.TTTTT...@@@@@@@@@@@@@@@@@@@@@@@@@@@@@@@@@@@@@@@@@@@@@@@@
@@@@@@@@@@@@@@@@@@@@@@@@@@@@@..TTT....T.....TTT.T.T.TTT..T.T.T.@@@@@@@@@@@@@@@@@@@@@@@@@@@@@@@@@@@@@@@@@@@@@@@@@
@@@@@@@@@@@@@@@@@@@@@@@@@@@@@@.TTT....T@TTT....TTT..TTTT....TT@@@@@@@@@@@@@@@@@@@@@@@@@@@@@@@@@@@@@@@@@@@@@@@@@@
@@@@@@@@@@@@@@@@@@@@@@@@@@@@@@@TT..T.T.@@...T.TTTTTT.TTTT.T.@@@@@@@@@@@@@@@@@@@@@@@@@@@@@@@@@@@@@@@@@@@@@@@@@@@@
@@@@@@@@@@@@@@@@@@@@@@@@@@@@@@@@.TT....T.....T..TTT..T.TTT@@@@@@@@@@@@@@@@@@@@@@@@@@@@@@@@@@@@@@@@@@@@@@@@@@@@@@
@@@@@@@@@@@@@@@@@@@@@@@@@@@@@@@@@...TT..T.@@@T.TTT..T.T.@@@@@@@@@@@@@@@@@@@@@@@@@@@@@@@@@@@@@@@@@@@@@@@@@@@@@@@@
@@@@@@@@@@@@@@@@@@@@@@@@@@@@@@@@@@.TT.TTT.@@@.TTTTTT.@@@@@@@@@@@@@@@@@@@@@@@@@@@@@@@@@@@@@@@@@@@@@@@@@@@@@@@@@@@
@@@@@@@@@@@@@@@@@@@@@@@@@@@@@@@@@@@.TT.TT..TTTT...T@@@@@@@@@@@@@@@@@@@@@@@@@@@@@@@@@@@@@@@@@@@@@@@@@@@@@@@@@@@@@
@@@@@@@@@@@@@@@@@@@@@@@@@@@@@@@@@@@@@T...TT.T.TT..@@@@@@@@@@@@@@@@@@@@@@@@@@@@@@@@@@@@@@@@@@@@@@@@@@@@@@@@@@@@@@
@@@@@@@@@@@@@@@@@@@@@@@@@@@@@@@@@@@@@@@.T.TT...T.@@@@@@@@@@@@@@@@@@@@@@@@@@@@@@@@@@@@@@@@@@@@@@@@@@@@@@@@@@@@@@@
@@@@@@@@@@@@@@@@@@@@@@@@@@@@@@@@@@@@@@@@..T.T..T@@@@@@@@@@@@@@@@@@@@@@@@@@@@@@@@@@@@@@@@@@@@@@@@@@@@@@@@@@@@@@@@
@@@@@@@@@@@@@@@@@@@@@@@@@@@@@@@@@@@@@@@@@T.TTT@@@@@@@@@@@@@@@@@@@@@@@@@@@@@@@@@@@@@@@@@@@@@@@@@@@@@@@@@@@@@@@@@@
@@@@@@@@@@@@@@@@@@@@@@@@@@@@@@@@@@@@@@@@@@.T.@@@@@@@@@@@@@@@@@@@@@@@@@@@@@@@@@@@@@@@@@@@@@@@@@@@@@@@@@@@@@@@@@@@
@@@@@@@@@@@@@@@@@@@@@@@@@@@@@@@@@@@@@@@@@@@@@@@@@@@@@@@@@@@@@@@@@@@@@@@@@@@@@@@@@@@@@@@@@@@@@@@@@@@@@@@@@@@@@@@@
@@@@@@@@@@@@@@@@@@@@@@@@@@@@@@@@@@@@@@@@@@@@@@@@@@@@@@@@@@@@@@@@@@@@@@@@@@@@@@@@@@@@@@@@@@@@@@@@@@@@@@@@@@@@@@@@
@@@@@@@@@@@@@@@@@@@@@@@@@@@@@@@@@@@@@@@@@@@@@@@@@@@@@@@@@@@@@@@@@@@@@@@@@@@@@@@@@@@@@@@@@@@@@@@@@@@@@@@@@@@@@@@@
@@@@@@@@@@@@@@@@@@@@@@@@@@@@@@@@@@@@@@@@@@@@@@@@@@@@@@@@@@@@@@@@@@@@@@@@@@@@@@@@@@@@@@@@@@@@@@@@@@@@@@@@@@@@@@@@
@@@@@@@@@@@@@@@@@@@@@@@@@@@@@@@@@@@@@@@@@@@@@@@@@@@@@@@@@@@@@@@@@@@@@@@@@@@@@@@@@@@@@@@@@@@@@@@@@@@@@@@@@@@@@@@@
@@@@@@@@@@@@@@@@@@@@@@@@@@@@@@@@@@@@@@@@@@@@@@@@@@@@@@@@@@@@@@@@@@@@@@@@@@@@@@@@@@@@@@@@@@@@@@@@@@@@@@@@@@@@@@@@
@@@@@@@@@@@@@@@@@@@@@@@@@@@@@@@@@@@@@@@@@@@@@@@@@@@@@@@@@@@@@@@@@@@@@@@@@@@@@@@@@@@@@@@@@@@@@@@@@@@@@@@@@@@@@@@@
@@@@@@@@@@@@@@@@@@@@@@@@@@@@@@@@@@@@@@@@@@@@@@@@@@@@@@@@@@@@@@@@@@@@@@@@@@@@@@@@@@@@@@@@@@@@@@@@@@@@@@@@@@@@@@@@
