type octile
height 54
width 52
map
@@@@@@@@@@@@@@@@@@@@@@@@@@@@@@@@@@@@@@@@@@@@@@@@@@@@
@@@@@@@@@@@@@@@@@@@@@@@@@@@@@@@@@@@@@@@@@@@@@@@@@@@@
@@@@@@@@@@@@@@@@@@@@@@@@@@@@@@@@@@@@@@@@@@@@@@@@@@@@
@@@@@@@@@@@@@@@@@@@@@@@@@@@@@@@@@@@@@@@@@@@@@@@@@@@@
@@@@@@@@@@@@@@@@@@@@@@@@@@@@@@@@@@@@@@@@@@@@@@@@@@@@
@@@@@@@@@@@@@@@@@@@@@@@@@@@@@@@@@@@@@@@@@@@@@@@@@@@@
@@@@@@@@@@@@@@@@@@@@@@@@@@@@@@@@@@@@@@@@@@@@@@@@@@@@
@@@@@@@@@@@@@@@@@@@@@@@@@@@@@@@@@@@@@@@@@@@@@@@@@@@@
@@@@@@@@@@@@@@@@@@@@@@@@@@@@@@@@@@@@@@@@@@@@@@@@@@@@
@@@@@@@@@@@@@@@@@@@@@@@@@@@@@@@@@@@@@@@@@@@@@@@@@@@@
@@@@@@@@@@@@@@@@@@@@@@@@@@@@@@@@@@@@@@@@@@@@@@@@@@@@
@@@@@@@@@@@@@@@@@@@@@@@@@@@@@@@.@@@@@@@@@@@@@@@@@@@@
@@@@@@@@@@@@@@@@@@@@@@@@@@@@@@T..@@@@@@@@@@@@@@@@@@@
@@@@@@@@@@@@@@@@@@@@@@@@@@@@@T.T.T@@@@@@@@@@@@@@@@@@
@@@@@@@@@@@@@@@@@@@@@@@@@@@@@T.T...@@@@@@@@@@@@@@@@@
@@@@@@@@@@@@@@@@@@@@@@@@@@@@.TTTTT@@@@@@@@@@@@@@@@@@
@@@@@@@@@@@@@@@@@@@@@@@@@@@T...T...@@@@@@@@@@@@@@@@@
@@@@@@@@@@@@@@@@@@@@@@@@@.T.TT.TTT.T@@@@@@@@@@@@@@@@
@@@@@@@@@@@@@@@@@@@@@@@@..TTTTTT.T...@@.@@@@@@@@@@@@
@@@@@@@@@@@@@@@@@@@@@@@.TTTTTT.TT.T..TTT.@@@@@@@@@@@
@@@@@@@@@@@@@@@@@@@@@@..TT..T.T.@@T...TT.@@@@@@@@@@@
@@@@@@@@@@@@@@@@@@@@@T.T.T..TT@@@@T..TT.@@@@@@@@@@@@
@@@@@@@@@@@@@@@@@@@@@@T.T...@@@@@@.TT..@@@@@@@@@@@@@
@@@@@@@@@@@@@@@@@@@@@@...T..@@@@@@TT...@@@@@@@@@@@@@
@@@@@@@@@@@@@@@@@@@@@.T..TT.T@@@@@@T...T@@@@@@@@@@@@
@@@@@@@@@@@@@@@@@@@@TTTT.TTT.T@@@@@T.TT.T@@@@@@@@@@@
@@@@@@@@@@@@@@@@@@@..TTTT.TT..TT.@@.TTT.T.@@@@@@@@@@
@@@@@@@@@@@@@@@@@@TT....TTTTTTT.T...T.....T@@@@@@@@@
@@@@@@@@@@@@@.@@..TT.T..T..T........T.T...T.@@@@@@@@
@@@@@@@@@@@@T.T.TT.TT.T.TT.T..TTT.T....T...@@@@@@@@@
@@@@@@@@@@@@...TTT@.T...TTT.....T.TTT..TTT@@@@@@@@@@
@@@@@@@@@@TTT.TTT@@@T.T.TT.TT.T....TTTTTT@@@@@@@@@@@
@@@@@@@@@T...TT.@@@@@..TTT.TT.T.T...TT.T@@@@@@@@@@@@
@@@@@@@@T.TT..T@@@@@@@T..T.TT.TT.T.TTT.@@@@@@@@@@@@@
@@@@@@@.T.T..T@@@@@@@@@.TT..TT.TT..TTT@@@@@@@@@@@@@@
@@@@@@..T....@@@@@@@@@@@.T..T.T.T...T@@@@@@@@@@@@@@@
@@@@@@..T.T.@@@@@@@@@@@@@.T..TTT.T..@@@@@@@@@@@@@@@@
@@@@@@@T..T@@@@@@@@@@@@@@@...TTT...@@@@@@@@@@@@@@@@@
@@@@@@@@..TT@@@@@@@@@@@@@@T.T.TT.T@@@@@@@@@@@@@@@@@@
@@@@@@@@@..TT@@@@@@@@@@@@....TT.T@@@@@@@@@@@@@@@@@@@
@@@@@@@@@@T..T@@@@@@@@@@..T..TTT@@@@@@@@@@@@@@@@@@@@
@@@@@@@@@@@TTTT@@@@@@@@.TT...T.@@@@@@@@@@@@@@@@@@@@@
@@@@@@@@@@@@TTT.@@@@@@..TT.T.T@@@@@@@@@@@@@@@@@@@@@@
@@@@@@@@@@@@@T.TT@@@@TT.TT.TT@@@@@@@@@@@@@@@@@@@@@@@
@@@@@@@@@@@@@@T.T.@@T..TTTT.@@@@@@@@@@@@@@@@@@@@@@@@
@@@@@@@@@@@@@@@TTTTT..TTT.T@@@@@@@@@@@@@@@@@@@@@@@@@
@@@@@@@@@@@@@@@@TTTTT..TT.@@@@@@@@@@@@@@@@@@@@@@@@@@
@@@@@@@@@@@@@@@@@T.TT.TTT@@@@@@@@@@@@@@@@@@@@@@@@@@@
@@@@@@@@@@@@@@@@@@TT.T..@@@@@@@@@@@@@@@@@@@@@@@@@@@@
@@@@@@@@@@@@@@@@@@@T...@@@@@@@@@@@@@@@@@@@@@@@@@@@@@
@@@@@@@@@@@@@@@@@@@@@@@@@@@@@@@@@@@@@@@@@@@@@@@@@@@@
@@@@@@@@@@@@@@@@@@@@@@@@@@@@@@@@@@@@@@@@@@@@@@@@@@@@
@@@@@@@@@@@@@@@@@@@@@@@@@@@@@@@@@@@@@@@@@@@@@@@@@@@@
@@@@@@@@@@@@@@@@@@@@@@@@@@@@@@@@@@@@@@@@@@@@@@@@@@@@
