type octile
height 64
width 60
map
@@@@@@@@@@@@@@@@@@@@@@@@@@@@@@@@@@@@@@@@@@@@@@@@@@@@@@@@@@@@
@@@@@@@@@@@@@@@@@@@@@@@@@@@@@@@@@@@@@@@@@@@@@@@@@@@@@@@@@@@@
@@@@@@@@@@@@@@@@@@@@@@@@@@@@@@@@@@@@@@@@@@@@@@@@@@@@@@@@@@@@
@@@@@@@@@@@@@@@@@@@@@@@@@@@@@@@@@@@@@@@@@@@@@@@@@@@@@@@@@@@@
@@@@@@@@@@@@@@@@@@@@@@@@@@@@@@@@@@@@@@@@@@@@@@@@@@@@@@@@@@@@
@@@@@@@@@@@@@@@@@@@@@@@@@@@@@@@@@@@@@@@@@@@@@@@@@@@@@@@@@@@@
@@@@@@@@@@@@@@@@@@@@@@@@@@@@@@@@@@@@@@@@@@@@@@@@@@@@@@@@@@@@
@@@@@@@@@@@@@@@@@@@@@@@@@@@@@@@@@@@@@@@@@@@@@@@@@@@@@@@@@@@@
@@@@@@@@@@@@@@@@@@@@@@@@@@@@@@@@@@@@@@@@@@@@@@@@@@@@@@@@@@@@
@@@@@@@@@@@@@@@@@@@@@@@@@@@@@@@@@@@@@@@@@@@@@@@@@@@@@@@@@@@@
@@@@@@@@@@@@@@@@@@@@@@@@@@@@@@@@@@@@@@@@@@@@@@@@@@@@@@@@@@@@
@@@@@@@@@@@@@@@@@@@@@@@@@@@@@@@@@@@@@@@@@@@@@@@@@@@@@@@@@@@@
@@@@@@@@@@@@@@@@@@@@@@@@@@@@@@@@@@@@@@@@@@@@@@@@@@@@@@@@@@@@
@@@@@@@@@@@@@@@@@@@@@@@@@@@@@@@@@@@@@@@@@@@@@@@@@@@@@@@@@@@@
@@@@@@@@@@@@@@@@@@@@@@@@@@@@@@@@@@@@@@@@@@@@@@@@@@@@@@@@@@@@
@@@@@@@@@@@@@@@@@@@@@@@@@@@@@@@@@@@@@@@@@@@@@@@@@@@@@@@@@@@@
@@@@@@@@@@@@@@@@@@@@@@@@@@@@@@@@@@@@..@@@@@@@@@@@@@@@@@@@@@@
@@@@@@@@@@@@@@@@@@@@@@@@@@@@@@@@@@@@.T.T.T@@@@@@@@@@@@@@@@@@
@@@@@@@@@@@@@@@@@@@@@@@@@@@@@@@@@@@TTTTTTT@@@@@@@@@@@@@@@@@@
@@@@@@@@@@@@@@@@@@@@@@@@@@@@@@@@@@.TT..TTTT@@@@@@@@@@@@@@@@@
@@@@@@@@@@@@@@@@@@@@@@@@@@@@@@@@@TT....TTTTTT@@@@@@@@@@@@@@@
@@@@@@@@@@@@@@@@@@@@@@@@@@@@@@@@T...TTT.T.T...@@@@@@@@@@@@@@
@@@@@@@@@@@@@@@@@@@@@@@@@@@@@@@@@T@@TTTTT.T.T..@@@@@@@@@@@@@
@@@@@@@@@@@@@@@@@@@@@@@@@@@@@@@@@T@@TTT..TT...TT@@@@@@@@@@@@
@@@@@@@@@@@@@@@@@@@@@@@@@@@@@@@@TT.T.TTTT@@T....@@@@@@@@@@@@
@@@@@@@@@@@@@@@@@@@@@@@@@@@.@@.T.T.T..TT.@@TTTT.T@@@T.@@@@@@
@@@@@@@@@@@@@@@@@@@@@@@@@@....T.TTTTTTTTT@.T.TTTT.@@TTT@@@@@
@@@@@@@@@@@@@@@@@@@@@@@@@@.TTTTTTTT...TT..TTT.TTTTT.T.T@@@@@
@@@@@@@@@@@@@@@@@@@@@@@@@.T..TT.T....TTTT.TT.TTTT..TT.TT@@@@
@@@@@@@@@@@@@@@@@@@@@@@@.TT...TTT.T.T.T.T.T.TTTTT.TT....@@@@
@@@@@@@@@@@@@@@@@@@@@..TTT...@.TT.TT..T...T..TT.T.T..TT@@@@@
@@@@@@@@@@@@@@@@@@@@@@@TTTT.@@@TT.T....T..TT...T.T...T@@@@@@
@@@@@@@@@@@@@@@@@@@@@@@@T..@@@@@...TTT.T...TT....TT..@@@@@@@
@@@@@@@@@@@@@@@@@@@@@@@@T.@@@@@@@T.......T.TT....TTT@@@@@@@@
@@@@@@@@@@@@@@@@@@@@@@@T.T@@@@@@@@TT.TTT.T...TT.T..@@@@@@@@@
@@@@@@@@@@@@@@@@@@@@@..TT..@@@@@@@@T.T...TT.TTTT..@@@@@@@@@@
@@@@@@@@@@@@@@@@@@@@T.TTT..T@@@@@@@...T...TTT..T.@@@@@@@@@@@
@@@@@@@@@@@@@@@@@@@.TTT.T.T..@@@@@T.TT..TTT.....@@@@@@@@@@@@
@@@@@@@@@@@@@@@@@@TTT.TT.TTT.T@@@....TTT.T.T..T@@@@@@@@@@@@@
@@@@@@@@@@@@@@@@@TT..TTTT..T.T....T...T.T.....@@@@@@@@@@@@@@
@@@@@@@@@@@@@@@@.T........TT.T..T.T.T...TTT..@@@@@@@@@@@@@@@
@@@@@@@@@@@@@@@..@@@..TT.....T.T......TTTTTT@@@@@@@@@@@@@@@@
@@@@@@.@@@@@@@@.@@@@@T.T.TT.T..TTT.TT..T..T@@@@@@@@@@@@@@@@@
@@@@@.T.@@@@@@.T@@@@@@..TT.TTT.....T.T.TT.@@@@@@@@@@@@@@@@@@
@@@@.T..TT@@@.T..@@@@@@..TT..TTTTTTT.T.TT@@@@@@@@@@@@@@@@@@@
@@@.TTT...T@.TTTT.@@@@@.TT..TT..TTTT...T@@@@@@@@@@@@@@@@@@@@
@@..TT..T.T..T.TTTT@@@......T.T..T.TTT.@@@@@@@@@@@@@@@@@@@@@
@@....TT.T......T.T.TT..TT.T..T.TTTTTT@@@@@@@@@@@@@@@@@@@@@@
@@@..T.TTT.T.TT..T.T.T...TTT..T.TTT.T@@@@@@@@@@@@@@@@@@@@@@@
@@@@.TTTT....TT....T.TT.TTTT...T.T..@@@@@@@@@@@@@@@@@@@@@@@@
@@@@@TT...T.TTTTTTT..T.....T......T@@@@@@@@@@@@@@@@@@@@@@@@@
@@@@@@TTTTT.T.TT..T.T.T.T.T.T..T.T@@@@@@@@@@@@@@@@@@@@@@@@@@
@@@@@@@T..TT.TTT...T.TTTT....T.TT@@@@@@@@@@@@@@@@@@@@@@@@@@@
@@@@@@@@.T..T.TT..TTTT.T...TT.TT@@@@@@@@@@@@@@@@@@@@@@@@@@@@
@@@@@@@@@.TTTT..TTTTTTT.....TT.@@@@@@@@@@@@@@@@@@@@@@@@@@@@@
@@@@@@@@@@TTTTTT.TT..T.TTTTT.T@@@@@@@@@@@@@@@@@@@@@@@@@@@@@@
@@@@@@@@@@@.TTTTT.TTT...T..T@@@@@@@@@@@@@@@@@@@@@@@@@@@@@@@@
@@@@@@@@@@@@.....TTT.TTT.T.@@@@@@@@@@@@@@@@@@@@@@@@@@@@@@@@@
@@@@@@@@@@@@@T.T..TTT.T.TT@@@@@@@@@@@@@@@@@@@@@@@@@@@@@@@@@@
@@@@@@@@@@@@@@T.TT..T....@@@@@@@@@@@@@@@@@@@@@@@@@@@@@@@@@@@
@@@@@@@@@@@@@@@..T....T.@@@@@@@@@@@@@@@@@@@@@@@@@@@@@@@@@@@@
@@@@@@@@@@@@@@@@.TT..T.@@@@@@@@@@@@@@@@@@@@@@@@@@@@@@@@@@@@@
@@@@@@@@@@@@@@@@@@@@@@@@@@@@@@@@@@@@@@@@@@@@@@@@@@@@@@@@@@@@
@@@@@@@@@@@@@@@@@@@@@@@@@@@@@@@@@@@@@@@@@@@@@@@@@@@@@@@@@@@@
