type octile
height 86
width 80
map
@@@@@@@@@@@@@@@@@@@@@@@@@@@@@@@@@@@@@@@@@@@@@@@@@@@@@@@@@@@@@@@@@@@@@@@@@@@@@@@@
@@@@@@@@@@@@@@@@@@@@@@@@@@@@@@@@@@@@@@@@@@@@@@@@@@@@@@@@@@@@@@@@@@@@@@@@@@@@@@@@
@@@@@@@@@@@@@@@@@@@@@@@@@@@@@@@@@@@@@@@@@@@@@@@@@@@@@@@@@@@@@@@@@@@@@@@@@@@@@@@@
@@@@@@@@@@@@@@@@@@@@@@@@@@@@@@@@@@@@@@@@@@@@@@@@@@@@@@@@@@@@@@@@@@@@@@@@@@@@@@@@
@@@@@@@@@@@@@@@@@@@@@@@@@@@@@@@@@@@@@@@@@@@@@@@@@@@@@@@@@@@@@@@@@@@@@@@@@@@@@@@@
@@@@@@@@@@@@@@@@@@@@@@@@@@@@@@@@@@@@@@@@@@@@@@@@@@@@@@@@@@@@@@@@@@@@@@@@@@@@@@@@
@@@@@@@@@@@@@@@@@@@@@@@@@@@@@@@@@@@@@@@@@@@@@@@@@@@@@@@@@@@@@@@@@@@@@@@@@@@@@@@@
@@@@@@@@@@@@@@@@@@@@@@@@@@@@@@@@@@@@@@@@@@@@@@@@@@@@@@@@@@@@@@@@@@@@@@@@@@@@@@@@
@@@@@@@@@@@@@@@@@@@@@@@@@@@@@@@@@@@@@@@@@@@@@@@@@@@@@@@@@@@@@@@@@@@@@@@@@@@@@@@@
@@@@@@@@@@@@@@@@@@@@@@@@@@@@@@@@@@@@@@@@@@@@@@@@@@@@@@@@@@@@@@@@@@@@@@@@@@@@@@@@
@@@@@@@@@@@@@@@@@@@@@@@@@@@@@@@@@@@@@@@@@@@@@@@@@@@@@@@@@@@@@@@@@@@@@@@@@@@@@@@@
@@@@@@@@@@@@@@@@@@@@@@@@@@@@@@@@@@@@@@@@@@@@@..@@@@@@@@@@@@@@@@@@@@@@@@@@@@@@@@@
@@@@@@@@@@@@@@@@@@@@@@@@@@@@@@@@@@@@@@@@@@@@@@.T.@@@@@@@@@@@@@@@@@@@@@@@@@@@@@@@
@@@@@@@@@@@@@@@@@@@@@@@@@@@@@@@@@@@@@@@@@@@@@@TT.T@@@@@@@@@@@@@@@@@@@@@@@@@@@@@@
@@@@@@@@@@@@@@@@@@@@@@@@@@@@@@@@@@@@@@@@@@@@..TTT..@@@@@@@@@@@@@@@@@@@@@@@@@@@@@
@@@@@@@@@@@@@@@@@@@@@@@@@@@@@@@@@@@@@@@@@@@T...T..TT@@@@@@@@@@@@@@@@@@@@@@@@@@@@
@@@@@@@@@@@@@@@@@@@@@@@@@@@@@@@@@@@@@@@@@@T.T..T..T..@@@@@@@@@@@@@@@@@@@@@@@@@@@
@@@@@@@@@@@@@@@@@@@@@@@@@@@@@@@@@@@@@@@@@T.T..T...T..@@@@@@@@@@@@@@@@@@@@@@@@@@@
@@@@@@@@@@@@@@@@@@@@@@@@@@@@@@@@@@@@@@@@@T.T.TTTTT.T.@@@@@@@@@@@@@@@@@@@@@@@@@@@
@@@@@@@@@@@@@@@@@@@@@@@@@@@@@@@@@@@@@@@@@.T....TTTTT.@@TT.@@@@@@@@@@@@@@@@@@@@@@
@@@@@@@@@@@@@@@@@@@@@@@@@@@@@@@@@@@@@@T...T.TTT..T..TT..T.@@@@@@@@@@@@@@@@@@@@@@
@@@@@@@@@@@@@@@@@@@@@@@@@@@@@@@@@@@@@TTT.TTTTTT.TT.TTTTTT@@@@@@@@@@@@@@@@@@@@@@@
@@@@@@@@@@@@@@@@@@@@@@@@@@@@@@@..@@@..T.TT.T.@@@T..TTTTT@@@@@@@@@@@@@@@@@@@@@@@@
@@@@@@@@@@@@@@@@@@@@@@@@@@@@@@.TT.@.T..T...T@@@@@.....T@@@@@@@@@@@@@@@@@@@@@@@@@
@@@@@@@@@@@@@@@@@@@@@@@@@@@@@TT.TT.TT.TTT.TT@@@@@@.TTT@@@@@@@@@@@@@@@@@@@@@@@@@@
@@@@@@@@@@@@@@@@@@@@@@@@@@@@.T.TTTTTT...TT.T..T@@T..T@@@@@@@@@@@@@@@@@@@@@@@@@@@
@@@@@@@@@@@@@@@@@@@@@@@@@@@T..T.TTT.T..T..T..T.TT..T@@@@@@..@@@T@@@@@@@@@@@@@@@@
@@@@@@@@@@@@@@@@@@@@@@@@@@T..T....T.T.T.T...TT.....@@@@@@TTT@@@..@@@@@@@@@@@@@@@
@@@@@@@@@@@@@@@@@@@@@@@@@T....T@@TTTT.T...T.T.TT..@@@@@@TTTT@@TTT.@@@@.@@@@@@@@@
@@@@@@@@@@@@@@@@@@@@@@@@..TT.T@@T.TTT....T.T..TT.@@@@@@@.T...TTTT.T@@@T.@@@@@@@@
@@@@@@@@@@@@@@@@@@@@@@@TTT.T.@@TT.T....TTT.T..TT@@@@@@@@T.TT@@....T.@@TT.@@@@@@@
@@@@@@@@@@@@@@@@@@@@@@.TT...@@T....TT..T......T@@@@@@@@@.TT@@@@T.T..@...TT.@@@@@
@@@@@@@@@@@@@@@@@@@@@@.TTT.@@.T.TT..T.T..TTT.T.@@@@@@@@TT...@@@@T...@.T.T...@@@@
@@@@@@@@@@@@@@@@@@@@@@@.T.@@..T..TT..T.T.TTT...@@@@@@@@...TTT@@@@@T.@T...T.T@@@@
@@@@@@@@@@@@@@@@@@@@@@@@T@@TTTTT...TTTT.T.T.@T....TT....T..T..@@@@.@@...TT.@@@@@
@@@@@@@@@@@@@@@@@@@@@@@@@@..TT.T..T...T...T@@@..TTT..T@TT.TTTT.@@.T@TT..T.@@@@@@
@@@@@@@@@@@@@@@@@@@@T@@@@@TT.TT.TT..TTTTT.@@@@T..TTTT@@@@..TTTTT.T@@...TT@@@@@@@
@@@@@@@@@@@@@@@@@@@@T.@@@@.T.T.T.T..TTT..@@@@.TTT...@@@@@@..T...TT@.T.T.@@@@@@@@
@@@@@@@@@@@@@@@@@@TTTT..T@TT..TTTTT..T..@@@@..T..T.@@@@@@@@..T.T.@@..TT@@@@@@@@@
@@@@@@@@@@@@@@@@@@..TTTT.T..T@@..T...TT@@@@T.T.TTTT@@@@@@@@@.TT..@..TTT@@@@@@@@@
@@@@@@@@@@@@@@@@@@.TTTTT...@@@@@T..TTT@@@@.T.T..TT.@@@@@@@@@..TT@@T...@@@@@@@@@@
@@@@@@@@@@@@.@@@TTT...TTT.T.@@@@@T.T.@@@@@TT.TTTT.T@@@@@@@@TT...@..TT.@@@@@@@@@@
@@@@@@@@@@@@......T.T...T....@@@@@..@@@@@@T...T.T@@@@@@@@@@.TTT.T.T..@@@@@@@@@@@
@@@@@@@@@@@@.TT.T..TTTT.TTT.@@@@@@@@@@@@@.......T@@@@@@@@@@.TTTT...TT@@@@@@@@@@@
@@@@@@@@@@@@T..TT..TT..TTTTT@@T@@@@@@@.T....T.T.T.@@@@@@@@@TT..TT...@@@@@@@@@@@@
@@@@@@@@@@@@.TT..TT....TT..TTTT.@@@@@T.T...T..T.TTT@@@@@@@TT.TTT.T.T@@@@@@@@@@@@
@@@@@@@@@@@@..T.T..T.T.TT....T..T@@@@@TTTT...TT...TT@TT@@.T..TT..TT@@@@@@@@@@@@@
@@@@.@@@@@@.TT.T.TT..@TTT.T.TTT.T@@@@@@TTT.T..T...TTT..T.....TT...@@@@@@@@@@@@@@
@@@.T@@@@@@...T.T.TT@@@TT....T..@@@@@@@@T...T.TT.TT...T.T.T.T...T@@@@@@@@@@@@@@@
@@..T.@T.@.T.T..T..@@@@@TT.T.TT@@@@@@@@@@TTT.T..TT.T.T..T.TT.T..@@@@@@@@@@@@@@@@
@@TTTTT.....TTT...T@@@@@@TT.T.@@@@@.T@@@@T.T.T.T.T.T.TTTTT.TTTT@@@@@@@@@@@@@@@@@
@TT.TTTT..TT...T.T.@@@@@@@TT.@@@@@@.T.@@@....T.TT..TT.TTTTT..T@@@@@@@@@@@@@@@@@@
@@T..T.T....T.T.T.T@@@T@@@@T@@@@@@@@.T@@@@TTTT...TTT.TTT.TT.T@@@@@@@@@@@@@@@@@@@
@@@.TT....T.T..T..T....T@@@@@@@@@TTT.TT....T.TT.T..T.T..TTTT@@@@@@@@@@@@@@@@@@@@
@@@@.......T.T.T...T.TT.T@@@@@@@@@TT.T.TTTT.@@.T.T.T.TTTT.T@@@@@@@@@@@@@@@@@@@@@
@@@@@TT.T.T.TTT..T.T.TTT.T@@@@..T.T..TT..TT@@@@.T..T.TTTT.@@@@@@@@@@@@@@@@@@@@@@
@@@@@@T.......TTTT..T.TT.T.@@@@..TT.TT....T@@@@@T.T.T..TT@@@@@@@@@@@@@@@@@@@@@@@
@@@@@@@.T.T.TT.T.T.TT........@T...@@.T..T.@@@@@@@TT.TT@@@@@@@@@@@@@@@@@@@@@@@@@@
@@@@@@@@TT.TTT.TTTT..TT...T..TT.@@@@@TT.TT@@@@@@@@T..@@@@@@@@@@@@@@@@@@@@@@@@@@@
@@@@@@@@@.TTTT.TTTT..T...T..TT.@@@@@@@.TT.@@@@@@@@@@@@@@@@@@@@@@@@@@@@@@@@@@@@@@
@@@@@@@@@@T.....T...T....T..TT@@@@@@@@..T...@@@@@@@@@@@@@@@@@@@@@@@@@@@@@@@@@@@@
@@@@@@@@@@@...T..TTTT.TT..TT.@@@@@@@@@T...T.@@@@@@@@@@@@@@@@@@@@@@@@@@@@@@@@@@@@
@@@@@@@@@@@@TT.TT.T.T.TT..TT@@@@@@@@@T..T....T..@@@@@@@@@@@@@@@@@@@@@@@@@@@@@@@@
@@@@@@@@@@@@@T.TTT.......TT.@@@@@@@TT.......TT..@@@@@@@@@@@@@@@@@@@@@@@@@@@@@@@@
@@@@@@@@@@@@@TT...TT.TTTT.@@@@@@@@..TT@@@T..TTT@@@@@@@@@@@@@@@@@@@@@@@@@@@@@@@@@
@@@@@@@@@@@@@T.T.TT.T..T.T@@@@@@@T...@@@@@TTT.@@@@@@@@@@@@@@@@@@@@@@@@@@@@@@@@@@
@@@@@@@@@@@@@@TTTT..TTT.T.T@@@@@..TT@@@@@@@TT@@@@@@@@@@@@@@@@@@@@@@@@@@@@@@@@@@@
@@@@@@@@@@@@@@@T.TTT.T.T..TT@@.T.T.@@@@@@@@@@@@@@@@@@@@@@@@@@@@@@@@@@@@@@@@@@@@@
@@@@@@@@@@@@@@@@T.@...TT.TT..TT.TT@@@@@@@@@@@@@@@@@@@@@@@@@@@@@@@@@@@@@@@@@@@@@@
@@@@@@@@@@@@@@@@@T@@TTTTT..TTT.T.@@@@@@@@@@@@@@@@@@@@@@@@@@@@@@@@@@@@@@@@@@@@@@@
@@@@@@@@@@@@@@@@@@@@@.TTTTTT.TTTT@@@@@@@@@@@@@@@@@@@@@@@@@@@@@@@@@@@@@@@@@@@@@@@
@@@@@@@@@@@@@@@@@@@@@@..TTT...TTT..@@@@@@@@@@@@@@@@@@@@@@@@@@@@@@@@@@@@@@@@@@@@@
@@@@@@@@@@@@@@@@@@@@@@@..TT.T.T..TT.@@@@@@@@@@@@@@@@@@@@@@@@@@@@@@@@@@@@@@@@@@@@
@@@@@@@@@@@@@@@@@@@@@@@@TTTTTTT...TTT@@@@@@@@@@@@@@@@@@@@@@@@@@@@@@@@@@@@@@@@@@@
@@@@@@@@@@@@@@@@@@@@@@@@@..TTT.TTTT.T@@@@@@@@@@@@@@@@@@@@@@@@@@@@@@@@@@@@@@@@@@@
@@@@@@@@@@@@@@@@@@@@@@@@@@TTT..TTTT.@@@@@@@@@@@@@@@@@@@@@@@@@@@@@@@@@@@@@@@@@@@@
@@@@@@@@@@@@@@@@@@@@@@@@@@@@..T.T..@@@@@@@@@@@@@@@@@@@@@@@@@@@@@@@@@@@@@@@@@@@@@
@@@@@@@@@@@@@@@@@@@@@@@@@@@@@T.TT.@@@@@@@@@@@@@@@@@@@@@@@@@@@@@@@@@@@@@@@@@@@@@@
@@@@@@@@@@@@@@@@@@@@@@@@@@@@@@...@@@@@@@@@@@@@@@@@@@@@@@@@@@@@@@@@@@@@@@@@@@@@@@
@@@@@@@@@@@@@@@@@@@@@@@@@@@@@@@@@@@@@@@@@@@@@@@@@@@@@@@@@@@@@@@@@@@@@@@@@@@@@@@@
@@@@@@@@@@@@@@@@@@@@@@@@@@@@@@@@@@@@@@@@@@@@@@@@@@@@@@@@@@@@@@@@@@@@@@@@@@@@@@@@
@@@@@@@@@@@@@@@@@@@@@@@@@@@@@@@@@@@@@@@@@@@@@@@@@@@@@@@@@@@@@@@@@@@@@@@@@@@@@@@@
@@@@@@@@@@@@@@@@@@@@@@@@@@@@@@@@@@@@@@@@@@@@@@@@@@@@@@@@@@@@@@@@@@@@@@@@@@@@@@@@
@@@@@@@@@@@@@@@@@@@@@@@@@@@@@@@@@@@@@@@@@@@@@@@@@@@@@@@@@@@@@@@@@@@@@@@@@@@@@@@@
@@@@@@@@@@@@@@@@@@@@@@@@@@@@@@@@@@@@@@@@@@@@@@@@@@@@@@@@@@@@@@@@@@@@@@@@@@@@@@@@
@@@@@@@@@@@@@@@@@@@@@@@@@@@@@@@@@@@@@@@@@@@@@@@@@@@@@@@@@@@@@@@@@@@@@@@@@@@@@@@@
