type octile
height 54
width 52
map
@@@@@@@@@@@@@@@@@@@@@@@@@@@@@@@@@@@@@@@@@@@@@@@@@@@@
@@@@@@@@@@@@@@@@@@@@@@@@@@@@@@@@@@@@@@@@@@@@@@@@@@@@
@@@@@@@@@@@@@@@@@@@@@@@@@@@@@@@@@@@@@@@@@@@@@@@@@@@@
@@@@@@@@@@@@@@@@@@@@@@@@@@@@@@@@@@@@@@@@@@@@@@@@@@@@
@@@@@@@@@@@@@@@@@@@@@@@@@@@@@@@@@@@@@@@@@@@@@@@@@@@@
@@@@@@@@@@@@@@@@@@@@@@@@@@@@@@@@@@@@@@@@@@@@@@@@@@@@
@@@@@@@@@@@@@@@@@@@@@@@@@@@@@@@@@@@@@@@@@@@@@@@@@@@@
@@@@@@@@@@@@@@@@@@@@@@@@@@@@@@@@@@@@@@@@@@@@@@@@@@@@
@@@@@@@@@@@@@@@@@@@@@@@@@@@@@@@@@@@@@@@@@@@@@@@@@@@@
@@@@@@@@@@@@@@@@@@@@@@@@@@@@@@@@@@@@@@@@@@@@@@@@@@@@
@@@@@@@@@@@@@@@@@@@@@@@@@@@@@@@@@@@@@@@@@@@@@@@@@@@@
@@@@@@@@@@@@@@@@@@@@@@@@@@@@@@@@@@@@@@@@@@@@@@@@@@@@
@@@@@@@@@@@@@@@@T@@@@@@@@@@@@@@@@@@@@@@@@@@@@@@@@@@@
@@@@@@@@@@@@@..TT.@@@@@@@@@@@@@@@T@@@@@@@@@@@@@@@@@@
@@@@@@@@@@@@TT....@@@@@@@@@@@@@@@T@@@@@@@@@@@@@@@@@@
@@@@@@@@@@@...TTTT@@@@@@@@@@@@@@T.@@@@@@@@@@@@@@@@@@
@@@@@@@@@@@@T.T....@@@@@@@@@@@@TT..@@@@@@@@@@@@@@@@@
@@@@@@@@@@@@@T.TT.TT@@.@@@@@@@@.....@@@@@@@@@@@@@@@@
@@@@@@@@@@@@@@TTT...TTTT@.@@@TTTT.T.T@@@@@@@@@@@@@@@
@@@@@@@@@@@@@.T@..T.T..T.TT..TTTTTTTTTT@@@@@@@@@@@@@
@@@@@@@@@@@@..@@.TT.....TT..TT..TTT...T.@@@@@@@@@@@@
@@@@@@@@@@@@@@@@TTTTT...T..T..TT.T.T..T.T@@@@@@@@@@@
@@@@@@@@@@@@@@@..T.T.T......TT.T.TTTTT.T.TT@@@@@@@@@
@@@@@@@@@@@@.T.T.TT.TTT.TT@......@@@@@.TTTTT@@@@@@@@
@@@@@@@@@@@@@.T.TTTT..@@@@@@@@TTT@@@@@@TTT.TT@@@@@@@
@@@@@@@@@@@@@@TTT..TT@@@@@@@@@..T@@@@@@.TT..@@@@@@@@
@@@@@@@@@@@@@@T....TT@@@@@@@@@.T.@@@@@@....@@@@@@@@@
@@@@@@@@@@@@@....T.T.T@@@@@@@@T.T@@@@@T.TT@@@@@@@@@@
@@@@@@@@@@@@@@TT....TT@@@@@@.T..T..T.TTTT@@@@@@@@@@@
@@@@@@@@@@@@@@@......TT.T.T.TT........TT@@@@@@@@@@@@
@@@@@@@@@@@@@@@@TT....T.TT.T...T.T.TTT.@@@@@@@@@@@@@
@@@@@@@@@@@@@@@@@TTTT...TTTT.TTT.T.T..@@@@@@@@@@@@@@
@@@@@@@@@@T@@@@@@...TTT..TT..TT.T.TT..@@@@@@@@@@@@@@
@@@@@@@@@.T.@@@@....TT...T.T.TTTTT...@@@@@@@@@@@@@@@
@@@@@@@@@@.TT@@.T..T.TT..T.T....T.TTT@@@@@@@@@@@@@@@
@@@@@@@@@@@.TT.TT.TT@@..T.T.....T.TT@@@@@@@@@@@@@@@@
@@@@@@@@@@@@TTTTT.T@@@@....T..TTTTT@@@@@.@@@@@@@@@@@
@@@@@@@@@@@TT.T..TT.@@..T..T.TTTTT..@.@@T..@@@@@@@@@
@@@@@@@@@@@.TTT.T...@@T.TT...TT@@..TTTTTT.T.@@@@@@@@
@@@@@@@@@@TT.TT...TT.T.TTTT.T.@@@@....T..T.TT@@@@@@@
@@@@@@@@@....T.TTT..T..T..T.T@@@@@@..TT...T...@@@@@@
@@@@@@@@@T..TT.....T.TT...T..@@@@@@TTT....T...T@@@@@
@@@@@@@@@@TTTT..T.TTTTTT.T.TTT@@@@@@T..T..TTTTT.T@@@
@@@@@@@@@@@TTTTTTT.TT..TTTT..T.@@@@@@TTTT.T....TT@@@
@@@@@@@@@@@@T.TTTTTTTT.....@@..T@@@@@.TTT.TTTT.T@@@@
@@@@@@@@@@@@@.T..TT.T....T@@@@TT.@@@TTT.T.T..T.@@@@@
@@@@@@@@@@@@@@.......TT..@@@@@@TT.TT.TTT.T.T..@@@@@@
@@@@@@@@@@@@@@@TT..T..T.@@@@@@@@T....TTTTTTTT@@@@@@@
@@@@@@@@@@@@@@@@T..T..T@@@@@@@@@@T..TTTTTT..@@@@@@@@
@@@@@@@@@@@@@@@@@...T.@@@@@@@@@@@@T..T...T.@@@@@@@@@
@@@@@@@@@@@@@@@@@@..T@@@@@@@@@@@@@@.TT.TT.@@@@@@@@@@
@@@@@@@@@@@@@@@@@@@T@@@@@@@@@@@@@@@@....T@@@@@@@@@@@
@@@@@@@@@@@@@@@@@@@@@@@@@@@@@@@@@@@@@.T.@@@@@@@@@@@@
@@@@@@@@@@@@@@@@@@@@@@@@@@@@@@@@@@@@@@@@@@@@@@@@@@@@
