type octile
height 80
width 72
map
@@@@@@@@@@@@@@@@@@@@@@@@@@@@@@@@@@@@@@@@@@@@@@@@@@@@@@@@@@@@@@@@@@@@@@@@
@@@@@@@@@@@@@@@@@@@@@@@@@@@@@@@@@@@@@@@@@@@@@@@@@@@@@@@@@@@@@@@@@@@@@@@@
@@@@@@@@@@@@@@@@@@@@@@@@@@@@@@@@@@@@@@@@@@@@@@@@@@@@@@@@@@@@@@@@@@@@@@@@
@@@@@@@@@@@@@@@@@@@@@@@@@@@@@@@@@@@@@@@@@@@@@@@@@@@@@@@@@@@@@@@@@@@@@@@@
@@@@@@@@@@@@@@@@@@@@@@@@@@@@@@@@@@@@@@@@@@@@@@@@@@@@@@@@@@@@@@@@@@@@@@@@
@@@@@@@@@@@@@@@@@@@@@@@@@@@@@@@@@@@@@@@@@@@@@@@@@@@@@@@@@@@@@@@@@@@@@@@@
@@@@@@@@@@@@@@@@@@@@@@@@@@@@@@@@@@@@@@@@@@@@@@@@@@@@@@@@@@@@@@@@@@@@@@@@
@@@@@@@@@@@@@@@@@@@@@@@@@@@@@@@@@@@@@@@@@@@@@@@@@@@@@@@@@@@@@@@@@@@@@@@@
@@@@@@@@@@@@@@@@@@@@@@@@@@@@@@@@@@@@@@@@@@@@@@@@@@@@@@@@@@@@@@@@@@@@@@@@
@@@@@@@@@@@@@@@@@@@@@@@@@@@@@@@@@@@@@@@@@@@@@@@@@@@@@@@@@@@@@@@@@@@@@@@@
@@@@@@@@@@@@@@@@@@@@@@@@@@@@@@@@@@@@@@@@@@@@@@@@@@@@@@@@@@@@@@@@@@@@@@@@
@@@@@@@@@@@@@@@@@@@@@@@@@@@@@@@@@@@@@@@@@@@@@@@@@@@@@@@@@@@@@@@@@@@@@@@@
@@@@@@@@@@@@@@@@@@@@@@@@@@@@@@@@@@@@@@@@@@@@@@@@@@@@@@@@@@@@@@@@@@@@@@@@
@@@@@@@@@@@@@@@@@@@@@@@@@@@@@@@@@@@@@@@@@@@@@@@@@@@@@@@@@@@@@@@@@@@@@@@@
@@@@@@@@@@@@@@@@@@@@@@@@@@@@@@@@@@@@@@@@@@@@@@@@@@@@@@@@@@@@@@@@@@@@@@@@
@@@@@@@@@@@@@@@@@@@@@@@@@@@@@@@@@@@@@@@@@@@@@@@@@@@@@@@@@@@@@@@@@@@@@@@@
@@@@@@@@@@@@@@@@@@@@@@@@@@@@@@@@@@@@@@@@@@@@@@@@@@@@@@@@@@@@@@@@@@@@@@@@
@@@@@@@@@@@@@@@@@@@@@@@@@@@@@@@@@@@@@@@@@@@@@@@@@@@@@@@@@@@@@@@@@@@@@@@@
@@@@@@@@@@@@@@@@@@@@@@@@@@@@@@@@@@@@@@@@@@@@@@@@@@@@@@@@@@@@@@@@@@@@@@@@
@@@@@@@@@@@@@@@@@@@@@@@@@@@@@@@@@@@@@@@@@@@@@@@@@@@@@@@@@@@@@@@@@@@@@@@@
@@@@@@@@@@@@@@@@@@@@@@@@@@@@@@@@@@@@@@@@@@@@@@@@@@@@@@@@@@@@@@@@@@@@@@@@
@@@@@@@@@@@@@@@@@@@@@@@@@@@@@@@@@@@@@@@@@@@@@@@@@@@@@@@@@@@@@@@@@@@@@@@@
@@@@@@@@@@@@@@@@@@@@@@@@@@@@@@@@@@@@@@@@@@@@@@@@@@@@@@@@@@@@@@@@@@@@@@@@
@@@@@@@@@@@@@@@@@@@@@@@@@@@@@@@@@@@@@@@@@@@@@@@@@@@@@@@@@@@@@@@@@@@@@@@@
@@@@@@@@@@@@@@@@@@@@@@@@@@@@@@@@@@@@@@@@@@@@@@@TT@@@@@@@@@@@@@@@@@@@@@@@
@@@@@@@@@@@@@@@@@@@@@@@@@@@@@@@@@@@@@@@@@@@@@@.TTT@@@@@@@@@@@@@@@@@@@@@@
@@@@@@@@@@@@@@@@@@@@@@@@@@@@@@@@@@@@@@@@@@@@@.TT.T.@@@T.@@@@@@@@@@@@@@@@
@@@@@@@@@@@@@@@@@@@@@@@@@@@@@@@@@@@@@@@@@@@....T.T.T.T...@@@@@@@@@@@@@@@
@@@@@@@@@@@@@@@@@@@@@@@@@@@@@@@@@@@@@@@@@@.T...TT...T.TT.T@@@@@@@@@@@@@@
@@@@@@@@@@@@@@@@@@@@@@@@@@@@@@@@@@@@@@@@@T.......TTT..TTTT.@@@@@@@@@@@@@
@@@@@@@@@@@@@@@@@@@@@@@@@@@@@@@@@@@@@@@@.TT.....T@@@@.TT..T.@@@@@@@@@@@@
@@@@@@@@@@@@@@@@@@@@@@@@@@@@@@@@@@@@@@@TTTT.TT.@@@@@@@TT.T..T@@@@@@@@@@@
@@@@@@@@@@@@@@@@@@@@@@@@@@@@@@@@@@@@@@..TT.@@@@@@@@@@@@.T..T.@@@@@@@@@@@
@@@@@@@@@@@@@@@@@@@@@@@@@@@@@@@@@@@@@..TTT@@@@@@@@@@@@@@@....T@@@@@@@@@@
@@@@@@@@@@@@@@@@@@@@@@@@@@@@@@@@@@@@.TTTT@@@@@@@@@@@@@@@@...TT@@@@@@@@@@
@@@@@@@@@@@@@@@@@@@@@@@@@@@@@@@@@@@TTTT.@@@@@@@@@@@@@@@@@@...T@@@@@@@@@@
@@@@@@@@@@@@@@@@@@@@@@@@@@@@@@@@@@..TT.@@@@@@@@@@@@@@@@@@@..TTT@@@@@@@@@
@@@@@@@@@@@@@@@@@@@@@@@@@@@@@@@@@.T...@@@@@@@@@@@@@@@@@@@@@T..T@@@T@@@@@
@@@@@@@@@@@@@@@@@@@@@@@@@@@@@@@@...TT@@@@@@@@@@@@@@@@@@@@@@TTTTT@@TT@@@@
@@@@@@@@@@@@@@@@@@@@@@@@@@@@@@@T....@@@@@@@@@@@@@@@@@@@@@@@@T..T.@.T@@@@
@@@@@@@@@@@@@@@@@@@@@@@@@@@@@@.TT...@@@@@@@@@@@@@@@@@@@@@@@@T.TT.TTT@@@@
@@@@@@@@@@@@@@@@@@@@@@@@@@@@@.T.T.T.@@T.@@@@@@@@@@@@@@@@@@@@..TTTTT.@@@@
@@@@@@@@@@@@@@@@@@@@@@@@@@@@.TT...T@@.TT.@@@@@@@@@@@@@@@@@@@..T.TT..T@@@
@@@@@@@@@@@@@@@@@@@@@@@@@@@T.T.TT.@@@TT...@@@@@@@@@@@@@@@@@@T.TT.TT...@@
@@@@@@@@@@@@@@@@@@@@@@@@@@..T.TT.@@@@TT...@@@@@@@@@@@@@@@@..T.TT..TT.T@@
@@@@@@@@@@@@@@@@@@@@@@@@@T.T....@@@@.T.T.@@@@@@@@@@@@@@@@TT...TT.T.TT@@@
@@@@@@@@@@@@@@@@@@@@@@@@.T.TT.T@@@@@.T.T.@@@@@@@@@@@@@@@..TT.....T.T@@@@
@@@@@@@@@@@@@@@@@@@@@@@.T....T@@@@@@TT.TT@@@@@@@@@@@@@@T..T..TTT...@@@@@
@@@@@@@@@@@@@@@@@@@@@@..TTT..@@@@@@.....@@@@@@@@@@@@@@TT.T.TTTTT..@@@@@@
@@@@@@@@@@@@@@@@@@@@@.TTT...@@@@@T.TTT@@@@@@@@@@@@@@@TT.T..T.T...@@@@@@@
@@@@@@@@@@@@@@@@@@@@.TTT.TT@@@@@..TT@@@@@@@@@@@@@@@@..T...TT....@@@@@@@@
@@@@@@@@@@@@@@@@@@@...T..T@@@@@..TT@@@@@@@@@@@@@@@@.T.......T.T@@@@@@@@@
@@@@@@@@@@@@@@@@@@....T.T@@@@@TT..@@@@@@@@@@@@@@@@T.T...T.T.T.@@@@@@@@@@
@@@@@@@@@@@@@@@@@T.....T@@@@@...T@@@@@@@@@@@@@@@@T.T....TT.TT@@@@@@@@@@@
@@@@@@@@@@@@@@@TT.T..TT@@.TTT.T.@@@@@@@@@@@@@@@@T.TTT..T.T.T@@@@@@@@@@@@
@@@@@@@@@@@@@@.T...T.T.TTTTTTTT@@@@@@@@@@@@@@@@T..TT.TTTT..@@@@@@@@@@@@@
@@@@@@@@@@@@@@T.....TTTTTT....@@@@@@@@@@@@@@@@..T.T.TTT.TT@@@@@@@@@@@@@@
@@@@@@@@@@@@@@@.T....@@...TTT.@@@@@@@@@@@@@@@T.T.TTT.TTTT@@@@@@@@@@@@@@@
@@@@@@@@@@@@@@@@T.@@@@@@T....@@@@@@@@@@@@@@@TTT..TT.TTTT@@@@@@@@@@@@@@@@
@@@@@@@@@@@@@@@@@@@@@@@@@TTTT.T@@@@@@@@@@@@T.TTT...TT.T@@@@@@@@@@@@@@@@@
@@@@@@@@@@@@@@@@@@@@@@@@@@.T.T.@@@@@@@@@@@T..T.TT.TT.T@@@@@@@@@@@@@@@@@@
@@@@@@@@@@@@@@@@@@@@@@@@@@@...T@@@@@@@@@@.......T..T.@@@@@@@@@@@@@@@@@@@
@@@@@@@@@@@@@@@@@@@@@@@@@@@@.T..@@@@@@@T.TT.TT..TTTT@@@@@@@@@@@@@@@@@@@@
@@@@@@@@@@@@@@@@@@@@@@@@@@@@T.TT@@@@@@T..TT.T.TT.TT@@@@@@@@@@@@@@@@@@@@@
@@@@@@@@@@@@@@@@@@@@@@@@@@@@@.T.T@@@@TT.TT.TT...TT@@@@@@@@@@@@@@@@@@@@@@
@@@@@@@@@@@@@@@@@@@@@@@@@@@@@.TT.@@@.TTTTT...TT..@@@@@@@@@@@@@@@@@@@@@@@
@@@@@@@@@@@@@@@@@@@@@@@@@@@@@T...@@.TT.T....TT.T@@@@@@@@@@@@@@@@@@@@@@@@
@@@@@@@@@@@@@@@@@@@@@@@@@@@@@@..TTT.TT.....T..T@@@@@@@@@@@@@@@@@@@@@@@@@
@@@@@@@@@@@@@@@@@@@@@@@@@@@@@@.T....T.TTTT..TT@@@@@@@@@@@@@@@@@@@@@@@@@@
@@@@@@@@@@@@@@@@@@@@@@@@@@@@@@@TTT.....TTT.TT@@@@@@@@@@@@@@@@@@@@@@@@@@@
@@@@@@@@@@@@@@@@@@@@@@@@@@@@@@@@@....TT..TT.@@@@@@@@@@@@@@@@@@@@@@@@@@@@
@@@@@@@@@@@@@@@@@@@@@@@@@@@@@@@@@@.T.T..TTT@@@@@@@@@@@@@@@@@@@@@@@@@@@@@
@@@@@@@@@@@@@@@@@@@@@@@@@@@@@@@@@@@..TT..T@@@@@@@@@@@@@@@@@@@@@@@@@@@@@@
@@@@@@@@@@@@@@@@@@@@@@@@@@@@@@@@@@@@.TT.T@@@@@@@@@@@@@@@@@@@@@@@@@@@@@@@
@@@@@@@@@@@@@@@@@@@@@@@@@@@@@@@@@@@@.T..@@@@@@@@@@@@@@@@@@@@@@@@@@@@@@@@
@@@@@@@@@@@@@@@@@@@@@@@@@@@@@@@@@@@@@@@@@@@@@@@@@@@@@@@@@@@@@@@@@@@@@@@@
@@@@@@@@@@@@@@@@@@@@@@@@@@@@@@@@@@@@@@@@@@@@@@@@@@@@@@@@@@@@@@@@@@@@@@@@
@@@@@@@@@@@@@@@@@@@@@@@@@@@@@@@@@@@@@@@@@@@@@@@@@@@@@@@@@@@@@@@@@@@@@@@@
@@@@@@@@@@@@@@@@@@@@@@@@@@@@@@@@@@@@@@@@@@@@@@@@@@@@@@@@@@@@@@@@@@@@@@@@
@@@@@@@@@@@@@@@@@@@@@@@@@@@@@@@@@@@@@@@@@@@@@@@@@@@@@@@@@@@@@@@@@@@@@@@@
