type octile
height 112
width 100
map
@@@@@@@@@@@@@@@@@@@@@@@@@@@@@@@@@@@@@@@@@@@@@@@@@@@@@@@@@@@@@@@@@@@@@@@@@@@@@@@@@@@@@@@@@@@@@@@@@@@@
@@@@@@@@@@@@@@@@@@@@@@@@@@@@@@@@@@@@@@@@@@@@@@@@@@@@@@@@@@@@@@@@@@@@@@@@@@@@@@@@@@@@@@@@@@@@@@@@@@@@
@@@@@@@@@@@@@@@@@@@@@@@@@@@@@@@@@@@@@@@@@@@@@@@@@@@@@@@@@@@@@@@@@@@@@@@@@@@@@@@@@@@@@@@@@@@@@@@@@@@@
@T....@@@@@@@@@@@@@@@@@@@@@@@@@@@@@@@@@@@@@@@@@@@@@@@@@@@@@@@@@@@@@@@@@@@@@@@@@@@@@@@@@@@@@@@@@@@@@@
@T....@@@@@@@@@@@@@@@@@@@@@@@@@@@@@@@@@@@@@@@@@@@@@@@@@@@@@@@@@@@@@@@@@@@@@@@@@@@@@@@@@@@@@@@@@@@@@@
@TTTT.@@@@@@@@@@@@@@@@@@@@@@@@@@@@@@@@@@@@@@@@@@@@@@@@@@@@@@@@@@@@@@@@@@@@@@@@@@@@@@@@@@@@@@@@@@@@@@
@.T.TT@@@@@@@@@@@@@@@@@@@@@@@@@@@@@@@@@@@@@@@@@@@@@@@@@@@@@@@@@@@@@@@@@@@@@@@@@@@@@@@@@@@@@@@@@@@@@@
@TTTTT@@@@@@@@@@@@@@@@@@@@@@@@@@@@@@@@@@@@@@@@@@@@@@@@@@@@@@@@@@@@@@@@@@@@@@@@@@@@@@@@@@@@@@@@@@@@@@
@@@@@@@@@@@@@@@@@@@@@@@@@@@@@@@@@@@@@@@@@@@@@@@@@@@@@@@@@@@@@@@@@@@@@@@@@@@@@@@@@@@@@@@@@@@@@@@@@@@@
@@@@@@@@@@@@@@@@@@@@@@@@@@@@@@@@@@@@@@@@@@@@@@@@@@@@@@@@@@@@@@@@@@@@@@@@@@@@@@@@@@@@@@@@@@@@@@@@@@@@
@@@@@@@@@@@@@@@@@@@@@@@@@@@@@@@@@@@@@@@@@@@@@@@@@@@@@@@@@@@@@@@@@@@@@@@@@@@@@@@@@@@@@@@@@@@@@@@@@@@@
@@@@@@@@@@@@@@@@@@@@@@@@@@@@@@@@@@@@@@@@@@@@@@@@@@@@@@@@@@@@@@@@@@@@@@@@@@@@@@@@@@@@@@@@@@@@@@@@@@@@
@@@@@@@@@@@@@@@@@@@@@@@@@@@@@@@@@@@@@@@@@@@@@@@@@@@@@@@@@@@@@@@@@@@@@@@@@@@@@@@@@@@@@@@@@@@@@@@@@@@@
@@@@@@@@@@@@@@@@@@@@@@@@@@@@@@@@@@@@@@@@@@@@@@@@@@@@@@@@@@@@@@@@@@@@@@@@@@@@@@@@@@@@@@@@@@@@@@@@@@@@
@@@@@@@@@@@@@@@@@@@@@@@@@@@@@@@@@@@@@@@@@@@@@@@@@@@@@@@@@@@@@@@@@@@@@@@@@@@@@@@@@@@@@@@@@@@@@@@@@@@@
@@@@@@@@@@@@@@@@@@@@@@@@@@@@@@@@@@@@@@@@@@@@@@@@@@@@@@@@@@@@@@@@@@@@@@@@@@@@@@@@@@@@@@@@@@@@@@@@@@@@
@@@@@@@@@@@@@@@@@@@@@@@@@@@@@@@@@@@@@@@@@@@@@@@@@@@@@@@@@@@@@@@@@@@@@@@@@@@@@@@@@@@@@@@@@@@@@@@@@@@@
@@@@@@@@@@@@@@@@@@@@@@@@@@@@@@@@@@@@@@@@@@@@@@@@@@@@@@@@@@@@@@@@@@@@@@@@@@@@@@@@@@@@@@@@@@@@@@@@@@@@
@@@@@@@@@@@@@@@@@@@@@@@@@@@@@@@@@@@@@@@@@@@@@@@@@@@@@@@@@@@@@@@@@@@@@@@@@@@@@@@@@@@@@@@@@@@@@@@@@@@@
@@@@@@@@@@@@@@@@@@@@@@@@@@@@@@@@@@@@@@@@@@@@@@@@@@@@@@@@@@@@@@@@@@@@@@@@@@@@@@@@@@@@@@@@@@@@@@@@@@@@
@@@@@@@@@@@@@@@@@@@@@@@@@@@@@@@@@@@@@@@@@@@@@@@@@@@@@@@@@@@@@@@@@@@@@@@@@@@@@@@@@@@@@@@@@@@@@@@@@@@@
@@@@@@@@@@@@@@@@@@@@@@@@@@@@@@@@@@@@@@@@@@@@@@@@@@@@@@@@@@@@@@@@@@@@@@@@@@@@@@@@@@@@@@@@@@@@@@@@@@@@
@@@@@@@@@@@@@@@@@@@@@@@@@@@@@@@@@@@@@@@@@@@@@@@@@@@@@@@@@@@@@@@@@@@@@@@@@@@@@@@@@@@@@@@@@@@@@@@@@@@@
@@@@@@@@@@@@@@@@@@@@@@@@@@@@@@@@@@@@@@@@@@@@@@@@@@@@@@@@@@@@@@@@@@@@@@@@@@@@@@@@@@@@@@@@@@@@@@@@@@@@
@@@@@@@@@@@@@@@@@@@@@@@@@@@@@@@@@@@@@@@@@@@@@@@@@@@@@@@@@@@@@@@@@@@@@@@@@@@@@@@@@@@@@@@@@@@@@@@@@@@@
@@@@@@@@@@@@@@@@@@@@@@@@@@@@@@@@@@@@@@@@@@@@@@@@@@@@@@@@@@@@@@@@@@@@@@@@@@@@@@@@@@@@@@@@@@@@@@@@@@@@
@@@@@@@@@@@@@@@@@@@@@@@@@@@@@@@@@@@@@@@@@@.@@@@@@@@@@@@@@@@@@@@@@@@@@@@@@@@@@@@@@@@@@@@@@@@@@@@@@@@@
@@@@@@@@@@@@@@@@@@@@@@@@@@@@@@@@@@@@.T@@@T.T@@@@@@@@@@@@@@@@@@@@@@@@@@@@@@@@@@@@@@@@@@@@@@@@@@@@@@@@
@@@@@@@@@@@@@@@@@@@@@@@@@@@@@@@@@@@.T..TTT.T.@@@@@@@@@@@@@@@@@@@@@@@@@@@@@@@@@@@@@@@@@@@@@@@@@@@@@@@
@@@@@@@@@@@@@@@@@@@@@@@@@@@@@@@@@@T.T..T.....T@@@@@@@@@@@@@@@@@@@@@@@@@@@@@@@@@@@@@@@@@@@@@@@@@@@@@@
@@@@@@@@@@@@@@@@@@@@@@@@@@@@@@@@@...T...TT.TT...TTT.@@@@@@@@@@@@@@@@@@@@@@@@@@@@@@@@@@@@@@@@@@@@@@@@
@@@@@@@@@@@@@@@@@@@@@@@@@@@@@@@@TTT.T........T.T..TTT@@@@@@@@@@@@@@@@@@@@@@@@@@@@@@@@@@@@@@@@@@@@@@@
@@@@@@@@@@@@@@@@@@@@@@@@@@@@@@@@@T...TTTTT....T..T.T.T@@@@@@@@@@@@@@@@TTTT..@@@@@@@@@@@@@@@@@@@@@@@@
@@@@@@@@@@@@@@@@@@@@@@@@@@@@@@@@@.......T.TTTT...TT.T..@@@@@@@@@@@@@@.TTTT.T.@@@@@@@@@@@@@@@@@@@@@@@
@@@@@@@@@@@@@@@@@@@@@@@@@@@@@@@@T........@@@T.T...TTT..@@@@@@@@@@@@T..TT.@@@.T@@@@@@@@@@@@@@@@@@@@@@
@@@@@@@@@@@@@@@@@@@@@@@@@@@@@@@T.TT.@@.TT@@@.T.TT....TT@@@@@@@@@@@TT.TT.@@@@.TT@@@@@@@@@@@@@@@@@@@@@
@@@@@@@@@@@@@@@@@@@@@@@@@@..@@....TT@@@@@@@@.....T.T..@@@@@@@@@@@..T..T.@@@@..T.@@@@@@@@@@@@@@@@@@@@
@@@@@@@@@@@@@@@@@@@@@@@@@@TT.T.TT...@@T@@@@T.TT..T....T@@@@@@@@@..TTT.TT@@@..TTT@@@@@@@@@@@@@@@@@@@@
@@@@@@@@@@@@@@@@@@@@@@@@@TTTT......T.T.@@@@.T.T..T..TT.T@@@@@@@@@....TT.T....T..@@@@@@@@@@@@@@@@@@@@
@@@@@@@@@@@@@@@@@@@@@@@@TTTTTT@@@.TTTT..@@@..T..T.T.TTTTT....@@@@..TTTT.T@@@TTTT@@@@@@@@@@@@@@@@@@@@
@@@@@@@@@@@@@@@@@@@@@@@TTTTT.@@@@@TTT....@@T..TT....TT.T..T.T@@@T..T.TT.@@@@@T.T@@@@@@@@@@@@@@@@@@@@
@@@@@@@@@@@@@@@@@@@@@@@T.TTT@@@@@@@.....TT@@@T..TTT..T.TT.TTT.....T.TT..@@@@@.T.@@@@@@@@@@@@@@@@@@@@
@@@@@@@@@@@@@@@@@@@@@@@TTT.@@@@@@@@.T..T.T@@@.T.TT..TT.TTT.TT.T..T.T.T.T@@@@@T.@@@@@@@@@@@@@@@@@@@@@
@@@@@@@@@@@@@@@@@@@@@@@TT.@@@@@@@@@TT..TTTT..TT.TT.TTTTTT.TTTTTT....T.T..@@@TT@@@@@@@@@@@@@@@@@@@@@@
@@@@@@@@@@@@@@@@@@@@@@T..@@@@@@@@@@T..TT.TT.TTT.T..TTTT.T.T..TTTT.TT.T.T.TTTT@@@@@@@@@@@@@@@@@@@@@@@
@@@@@@@@@@@@@@@@@@@@@...@@@@@@@@@@.TT..T.T..TT.....T.T.TT...T.TTTTTT.TT.T.TT@@@@@@@@@@@@@@@@@@@@@@@@
@@@@@@@@@@@@@@@@@@@@...@@@@@@@@@@@.TTTTT.TT..TTT.T.....T.TT...TT..TTTTT.TTT@@@@@@@@@@@@@@@@@@@@@@@@@
@@@@@@@@@@@@@@@@...T.TT@@@@@@@@@@@.T..TT.T.TT.T..TT@@@@.T.TTT.TTT......TT.@@@@@@@@@@@@@@@@@@@@@@@@@@
@@@@@@@@@@@@@@@T.....TT.@@@@@@@@@@@TTTT.T.T..TT.TT@@@@@@..TT..TT.....T.T.@@@@@@@@@@@@@@@@@@@@@@@@@@@
@@@@@@@@@@@@@T.T.T.TT....@@@@@@@@@T....T...TT.T..@@@@@@@.TT.TT........TT@@@@@@@@@@@@@@@@@@@@@@@@@@@@
@@@@@@@@@@@@..TTT.@@@T..T.@@@T.@@.TTTTT..@@TT.T.@@@T.@@..T....TTTTT.T....@@@@@@@@@@@@@@@@@@@@@@@@@@@
@@@@@@@@@@@@@T.TT.@@@..TTTT@.TTT..T...T.@@@.TT.@@@TT..TT..TT.T.TTTT..TTT..@@@@@@@@@@@@@@@@@@@@@@@@@@
@@@@@@@@@@@@@.T..T.@@..T...TTTTT...TTT.@@@.TT.@@@.T.T..T...TTT.TT...TT..T..@@@@@@@@@@@@@@@@@@@@@@@@@
@@@@@@@@@@@@@T..TTT@@TTTTTTT......TTT.T@@....@@@...TTTT.T.T....TTT.TTT.T..@@@@@@@@@@@@@@@@@@@@@@@@@@
@@@@@@@@@@@@.TT.T..@@.TT..T.T.....T.T@.@.TTT@@@T.TTT.TT....T..TT.TTTT..T..@@@@@@@@@@@@@@@@@@@@@@@@@@
@@@@@@@.@@@T.TT.T.T@@@@.TTT.TT..TTT.@@.TTT.@@@.....T.....TTT....T..T..T...@@@@@@@@@@@@@@@@@@@@@@@@@@
@@@@@@T..@TT....T..@@@@@..T.T.T..TT@@@T.TT@@.TT..TT.TT.TT..TTTTT.@.TTT.TTT.@@@@@@@@@@@@@@@@@@@@@@@@@
@@@@@..TT.TT.TT.TTT.@@@@TTTT.T.TT.@@@..T.@@T.T.TTTT..TT.T....T..@@.....T.TT.@@@@@@@@@@@@@@@@@@@@@@@@
@@@@@@T.TT...T....@@@@@@@@@.T..TT@@@TTTT@@TTT..TT....TT.T..T...@@@@..T...TT.......@@@@@@@@@@@@@@@@@@
@@@@@@@TTT.TT.T...@@@..T@@@T..T..@@T..T@@TT.TTT....TTT.TT..T.TT@@@..TTT.TT.TTTTT..T@@@@@@@@@@@@@@@@@
@@@@@@@@.TTT.TT.T........T...T...T.TT.@@TTT....TTT.TT.T.T..T.T.T@@TTTT..T.T..T...TT.@@@@@@@@@@@@@@@@
@@@@@@@@@T.T......TT...TT.....TT.T.TT@@..TTTTTTTTTTT.TT..T.T.TT@@..TT...TT..TT......@@@@@@@@@@@@@@@@
@@@@@@@@@@T.TT..T.TTT..TTTTT.TTTT.TT@@.T..TT..T...T..TTT.TTTT.@@TTTT.TTTTT..T.......@@@@@@@@@@@@@@@@
@@@@@@@@@@@.TT...T.TTT...TT..TT..TT@@T.TTTTT..T....TT..T..T.T@@T...TT......T...TT...@@@@@@@@@@@@@@@@
@@@@@@@@@@@@T..TT.......T.T.....T.@@.T..TTT...TT.....TTTTT..@@TT.TT@T.TTTTT.T.TT..TT@@@@@@@@@@@@@@@@
@@@@@@@@@@@@@T..T.TT.T..T..TT....@@.TT..T..T.T.TT.T...TTTTT@@TT..T@@@T.TT.T.TT.TTT...@@@@@@@@@@@@@@@
@@@@@@@@@@@@@@TTTT.TT..TTT.T...T@@T.T.T.TT..TTTT.TTTTT.TT.@@T.T..@@@@@..TTTTTT.TT..TTT@@@T@@@@@@@@@@
@@@@@@@@@@@@@@@TT..TT.TTTTTTT.T.@..TTT.TT.T.TT..T.T.TT.TT@@T.T..@@@@@T.TTT...T.T...T.TT..TT@@@@@@@@@
@@@@@@@@@@@@@@@@TT....T..T...T.@@@.T.T.TT.TT....TT...TTT@@TT..T@@@@@.T.@T..TTTT...TT.TTTT.@@@@@@@@@@
@@@@@@@@@@@@@@@@@.T.TT...T...T.T..TTT.TT.T...TTT..TTTT.@@TT.TT@@@@@T.T@@@T...T.......TTT.@@@@@@@@@@@
@@@@@@@@@@@@@@@@@.TTTT.T.TTTTT.TTT.TT.T..TT...TT.TTT..@@..TT.T.@@@TT.@@@@@...T.TT.TT....@@@@@@@@@@@@
@@@@@@@@@@@@@@@@@@T.....TTT.TTTT.TT.TT..TTT.TTT...TTT@@.T.T@@@..@T.T@@@@@@@T..T.T.T..T.@@@@@@@@@@@@@
@@@@@@@@@@@@@@@@@@@TT.....T..T..TT..TT.TTT.TT.TTTTT.@@TTTT@@@@@T..T@@@@@@@@@TT..TT..TT@@@@@@@@@@@@@@
@@@@@@@@@@@@@@@@@@@@TTT.T.TT.T.T.TTTTTTTTTT.TTTTTT.@@.T...@@@@TTT.T.@@@@@@@T.......TT@@@@@@@@@@@@@@@
@@@@@@@@@@@@@@@@@@@@@....TTTTTT.TT.TT.TTTTT.....TT@@T.TTT@@@@T.TTT.TT@@@@@...TTT.TT.@@@@@@@@@@@@@@@@
@@@@@@@@@@@@@@@@@@@@.T......TTT.T....T.TT..T..T.T@@.....@@@@..T.@.T.TT@@@.TTT.T.TTT@@@@@@@@@@@@@@@@@
@@@@@@@@@@@@@@@@@@@..T.T.T.T.TT...T.T..TT..TTTT.@@.TT..@@@@T.T.@@@TTTTT.T.......TT@@@@@@@@@@@@@@@@@@
@@@@@@@@@@@@@@@@@@.TT.TTTTT.TTTT.TT..TT.T....T.@@.T.TT..@@T.TT@@@@@..TTT..T...TTT@@@@@@@@@@@@@@@@@@@
@@@@@@@@@@@@@@@@@TTT....T....TT..TTTTT.T...@T.@@.T...@@T...TT@@@@@@@.TTTTT...T.T@@@@@@@@@@@@@@@@@@@@
@@@@@@@@@@@@@@@@@T.TTTT..TTT.T.T.T.TT.T...@@@@@..T..@@@@.TTT@@@@@@@@@.......T.@@@@@@@@@@@@@@@@@@@@@@
@@@@@@@@@@@@@@@@@TT...T.TT..T..T..TT.TT...TTTT.T..T@@@@.TTT.@@@@@@@@.T..T.TTT@@@@@@@@@@@@@@@@@@@@@@@
@@@@@@@@@@@@@@@@@@T....TT....TT.TTT.TTTT..T.T.TT..@@@@TTTT.TT@@@@@@...TTTT..@@@@@@@@@@@@@@@@@@@@@@@@
@@@@@@@@@@@@@@@@@@@T.TTT..TT...TTTTTT.TTTTT.TT...@@@@T..@@..TT@@@@TTT.T.TT.@@@@@@@@@@@@@@@@@@@@@@@@@
@@@@@@@@@@@@@@@@@@@@TT.T.T.TT.TTT.T..TTT.T...TT.@@@@.T.@@@@.TTT.TT.TTTT.T.@@@@@@@@@@@@@@@@@@@@@@@@@@
@@@@@@@@@@@@@@@@@@@@@.TT..TT.TT.TT...TT.TTT.T.T..@@TTT@@@@@@...T....T.TT.@@@@@@@@@@@@@@@@@@@@@@@@@@@
@@@@@@@@@@@@@@@@@@@@@@.TT.....TT.TTT.T.T.....T...TT..@@@@@@@@.....TTTT.T@@@@@@@@@@@@@@@@@@@@@@@@@@@@
@@@@@@@@@@@@@@@@@@@@@@@T.TTT.T..T..TT..T.TTT.TTT..T.@@@@@@@@@...TTTT...@@@@@@@@@@@@@@@@@@@@@@@@@@@@@
@@@@@@@@@@@@@@@@@@@@@@@@T.T.TTTTT.TT..TTT..T...TT.T..@@@@@@@...T.T.TT.@@@@@@@@@@@@@@@@@@@@@@@@@@@@@@
@@@@@@@@@@@@@@@@@@@@@@@@@TTTTTT.T@@@.T...TT.T..TTTT...@@@@@..TT....TT@@@@@@@@@@@@@@@@@@@@@@@@@@@@@@@
@@@@@@@@@@@@@@@@@@@@@@@@@@.TT..T@@@@@T.TTTT.TT.T.T...T.@@@T.TT..T.T.@@@@@@@@@@@@@@@@@@@@@@@@@@@@@@@@
@@@@@@@@@@@@@@@@@@@@@@@@@@@.T.T@@@@@@@@.T..TT..TT.T.TTT....TTT.T..T@@@@@@@@@@@@@@@@@@@@@@@@@@@@@@@@@
@@@@@@@@@@@@@@@@@@@@@@@@@@@@@@@@@@@@@@@@TTTT..TT.TTT....T...T.TT..@@@@@@@@@@@@@@@@@@@@@@@@@@@@@@@@@@
@@@@@@@@@@@@@@@@@@@@@@@@@@@@@@@@@@@@@@@@@T..TTT.T.T.T.T.TT..T...T@@@@@@@@@@@@@@@@@@@@@@@@@@@@@@@@@@@
@@@@@@@@@@@@@@@@@@@@@@@@@@@@@@@@@@@@@@@@@@..TT..T...TTT.T.TTT..T@@@@@@@@@@@@@@@@@@@@@@@@@@@@@@@@@@@@
@@@@@@@@@@@@@@@@@@@@@@@@@@@@@@@@@@@@@@@@@@@.TTT..TTTT.T.T.T.TTT@@@@@@@@@@@@@@@@@@@@@@@@@@@@@@@@@@@@@
@@@@@@@@@@@@@@@@@@@@@@@@@@@@@@@@@@@@@@@@@@@@T.TTTTT..T...T...T@@@@@@@@@@@@@@@@@@@@@@@@@@@@@@@@@@@@@@
@@@@@@@@@@@@@@@@@@@@@@@@@@@@@@@@@@@@@@@@@@@@@.T..T......TT...@@@@@@@@@@@@@@@@@@@@@@@@@@@@@@@@@@@@@@@
@@@@@@@@@@@@@@@@@@@@@@@@@@@@@@@@@@@@@@@@@@@@@@@.T.TTTTTTTT..@@@@@@@@@@@@@@@@@@@@@@@@@@@@@@@@@@@@@@@@
@@@@@@@@@@@@@@@@@@@@@@@@@@@@@@@@@@@@@@@@@@@@@@@@TTT.T...T.T@@@@@@@@@@@@@@@@@@@@@@@@@@@@@@@@@@@@@@@@@
@@@@@@@@@@@@@@@@@@@@@@@@@@@@@@@@@@@@@@@@@@@@@@@@@T.TTT.TTT@@@@@@@@@@@@@@@@@@@@@@@@@@@@@@@@@@@@@@@@@@
@@@@@@@@@@@@@@@@@@@@@@@@@@@@@@@@@@@@@@@@@@@@@@@@@@TTT.T.T@@@@@@@@@@@@@@@@@@@@@@@@@@@@@@@@@@@@@@@@@@@
@@@@@@@@@@@@@@@@@@@@@@@@@@@@@@@@@@@@@@@@@@@@@@@@@@@.....@@@@@@@@@@@@@@@@@@@@@@@@@@@@@@@@@@@@@@@@@@@@
@@@@@@@@@@@@@@@@@@@@@@@@@@@@@@@@@@@@@@@@@@@@@@@@@@@@T..@@@@@@@@@@@@@@@@@@@@@@@@@@@@@@@@@@@@@@@@@@@@@
@@@@@@@@@@@@@@@@@@@@@@@@@@@@@@@@@@@@@@@@@@@@@@@@@@@@@@@@@@@@@@@@@@@@@@@@@@@@@@@@@@@@@@@@@@@@@@@@@@@@
@@@@@@@@@@@@@@@@@@@@@@@@@@@@@@@@@@@@@@@@@@@@@@@@@@@@@@@@@@@@@@@@@@@@@@@@@@@@@@@@@@@@@@@@@@@@@@@@@@@@
@@@@@@@@@@@@@@@@@@@@@@@@@@@@@@@@@@@@@@@@@@@@@@@@@@@@@@@@@@@@@@@@@@@@@@@@@@@@@@@@@@@@@@@@@@@@@@@@@@@@
@@@@@@@@@@@@@@@@@@@@@@@@@@@@@@@@@@@@@@@@@@@@@@@@@@@@@@@@@@@@@@@@@@@@@@@@@@@@@@@@@@@@@@@@@@@@@@@@@@@@
@@@@@@@@@@@@@@@@@@@@@@@@@@@@@@@@@@@@@@@@@@@@@@@@@@@@@@@@@@@@@@@@@@@@@@@@@@@@@@@@@@@@@@@@@@@@@@@@@@@@
@@@@@@@@@@@@@@@@@@@@@@@@@@@@@@@@@@@@@@@@@@@@@@@@@@@@@@@@@@@@@@@@@@@@@@@@@@@@@@@@@@@@@@@@@@@@@@@@@@@@
@@@@@@@@@@@@@@@@@@@@@@@@@@@@@@@@@@@@@@@@@@@@@@@@@@@@@@@@@@@@@@@@@@@@@@@@@@@@@@@@@@@@@@@@@@@@@@@@@@@@
@@@@@@@@@@@@@@@@@@@@@@@@@@@@@@@@@@@@@@@@@@@@@@@@@@@@@@@@@@@@@@@@@@@@@@@@@@@@@@@@@@@@@@@@@@@@@@@@@@@@
@@@@@@@@@@@@@@@@@@@@@@@@@@@@@@@@@@@@@@@@@@@@@@@@@@@@@@@@@@@@@@@@@@@@@@@@@@@@@@@@@@@@@@@@@@@@@@@@@@@@
