type octile
height 54
width 52
map
@@@@@@@@@@@@@@@@@@@@@@@@@@@@@@@@@@@@@@@@@@@@@@@@@@@@
@@@@@@@@@@@@@@@@@@@@@@@@@@@@@@@@@@@@@@@@@@@@@@@@@@@@
@@@@@@@@@@@@@@@@@@@@@@@@@@@@@@@@@@@@@@@@@@@@@@@@@@@@
@@@@@@@@@@@@@@@@@@@@@@@@@@@@@@@@@@@@@@@@@@@@@@@@@@@@
@@@@@@@@@@@@@@@@@@@@@@@@@@@@@@@@@@@@@@@@@@@@@@@@@@@@
@@@@@@@@@@@@@@@@@@@@@@@@@@@@@@@@@@@@@@@@@@@@@@@@@@@@
@@@@@@@@@@@@@@@@@@@@@@@@@@@@@@@@@@@@@@@@@@@@@@@@@@@@
@@@@@@@@@@@@@@@@@@@@@@@@@@@@@@@@@@@@@@@@@@@@@@@@@@@@
@@@@@@@@@@@@@@@@@@@@@@@@@@@@@@@@@@@@@@@@@@@@@@@@@@@@
@@@@@@@@@@@@@@@@@@@@@@@@@@@@@@@@@@@@@@@@@@@@@@@@@@@@
@@@@@@@@@@@@@@@@@@@@@@@@@@@@@@@@@@@@@@@@@@@@@@@@@@@@
@@@@@@@@@@@@@@@@@@@@@@@@@@@@@@@@@@@@@@@@@@@@@@@@@@@@
@@@@@@@@@@@@@@@@@@@@@@@@@@@@@@@@@@@@@@@@@@@@@@@@@@@@
@@@@@@@@@@@@@@@@@@@@@@@@@@@@@.@@@@@@@@@@@@@@@@@@@@@@
@@@@@@@@@@@@@@@@@@@@@@@@@@@@.....@@@@@@@@@@@@@@@@@@@
@@@@@@@@@@@@@@@@@@@@@@@@@@@....TT.@@@@@@@@@@@@@@@@@@
@@@@@@@@@@@@@@@@@@@@@@@@@@........@@@@@@@@@@@@@@@@@@
@@@@@@@@@@@@@@@@@@@@@@@@@@.......@@@@@@@@@@@@@@@@@@@
@@@@@@@@@@@@@@@@@@@@@@@@........@@@@@@@@@@@@@@@@@@@@
@@@@@@@@@@@@@@@@@@@@@@@@.........@@@@@@@@@@@@@@@@@@@
@@@@@@@@@@@@@@@@@@@@@@@.......@@..@@@@@.@@@@@@@@@@@@
@@@@@@@@@@@@@@@@@@@@@@........@@T..@@@..T@@@@@@@@@@@
@@@@@@@@@@@@@@@@@@@@@@............@@@.......@@@@@@@@
@@@@@@@@@@@@@@@@@@@@@@..T........@@@.........@@@@@@@
@@@@@@@@@@@@@@@@@@@@@T............@@..........@@@@@@
@@@@@@@@@@@@@@@@@@@@...T....T..T..............@@@@@@
@@@@@@@@@@@@@@@@@@@....T..@@................T@@@@@@@
@@@@@@@@@@@@@@@.@@.......@@@@...............@@@@@@@@
@@@@@@@@@@@@@@@.......T................T...@@@@@@@@@
@@@@@@@@@@@@T@.......@@@.@@@..............@@@@@@@@@@
@@@@@@@@@@@@.........@@@.@@@...........T.@@@@@@@@@@@
@@@@@@@@@@@...T.T.T.......@......TT..T..@@@@@@@@@@@@
@@@@@@@@@...................@..T.......@@@@@@@@@@@@@
@@@@@@@@.................T@@@.........@@@@@@@@@@@@@@
@@@@@@@........T..........@@.........@@@@@@@@@@@@@@@
@@@@@@.......@@.....T...............@@@@@@@@@@@@@@@@
@@@@@@@.....@@@...........T........@@@@@@@@@@@@@@@@@
@@@@@@@@...@@@@@..................@@@@@@@@@@@@@@@@@@
@@@@@@@@@.@@@@@@@................@@@@@@@@@@@@@@@@@@@
@@@@@@@@@@@@@@@@@@..............@@@@@@@@@@@@@@@@@@@@
@@@@@@@@@@@@@@@@@@@............@@@@@@@@@@@@@@@@@@@@@
@@@@@@@@@@@@@@@@@@@.......T...@@@@@@@@@@@@@@@@@@@@@@
@@@@@@@@@@@@@@@@@@@..........@@@@@@@@@@@@@@@@@@@@@@@
@@@@@@@@@@@@@@@@@@........T.@@@@@@@@@@@@@@@@@@@@@@@@
@@@@@@@@@@@@@@@@@..........@@@@@@@@@@@@@@@@@@@@@@@@@
@@@@@@@@@@@@@@@@.....T....@@@@@@@@@@@@@@@@@@@@@@@@@@
@@@@@@@@@@@@@@@@@........@@@@@@@@@@@@@@@@@@@@@@@@@@@
@@@@@@@@@@@@@@@@@@......@@@@@@@@@@@@@@@@@@@@@@@@@@@@
@@@@@@@@@@@@@@@@@@@....@@@@@@@@@@@@@@@@@@@@@@@@@@@@@
@@@@@@@@@@@@@@@@@@@@@@@@@@@@@@@@@@@@@@@@@@@@@@@@@@@@
@@@@@@@@@@@@@@@@@@@@@@@@@@@@@@@@@@@@@@@@@@@@@@@@@@@@
@@@@@@@@@@@@@@@@@@@@@@@@@@@@@@@@@@@@@@@@@@@@@@@@@@@@
@@@@@@@@@@@@@@@@@@@@@@@@@@@@@@@@@@@@@@@@@@@@@@@@@@@@
@@@@@@@@@@@@@@@@@@@@@@@@@@@@@@@@@@@@@@@@@@@@@@@@@@@@
