type octile
height 86
width 80
map
@@@@@@@@@@@@@@@@@@@@@@@@@@@@@@@@@@@@@@@@@@@@@@@@@@@@@@@@@@@@@@@@@@@@@@@@@@@@@@@@
@@@@@@@@@@@@@@@@@@@@@@@@@@@@@@@@@@@@@@@@@@@@@@@@@@@@@@@@@@@@@@@@@@@@@@@@@@@@@@@@
@@@@@@@@@@@@@@@@@@@@@@@@@@@@@@@@@@@@@@@@@@@@@@@@@@@@@@@@@@@@@@@@@@@@@@@@@@@@@@@@
@@@@@@@@@@@@@@@@@@@@@@@@@@@@@@@@@@@@@@@@@@@@@@@@@@@@@@@@@@@@@@@@@@@@@@@@@@@@@@@@
@@@@@@@@@@@@@@@@@@@@@@@@@@@@@@@@@@@@@@@@@@@@@@@@@@@@@@@@@@@@@@@@@@@@@@@@@@@@@@@@
@@@@@@@@@@@@@@@@@@@@@@@@@@@@@@@@@@@@@@@@@@@@@@@@@@@@@@@@@@@@@@@@@@@@@@@@@@@@@@@@
@@@@@@@@@@@@@@@@@@@@@@@@@@@@@@@@@@@@@@@@@@@@@@@@@@@@@@@@@@@@@@@@@@@@@@@@@@@@@@@@
@@@@@@@@@@@@@@@@@@@@@@@@@@@@@@@@@@@@@@@@@@@@@@@@@@@@@@@@@@@@@@@@@@@@@@@@@@@@@@@@
@@@@@@@@@@@@@@@@@@@@@@@@@@@@@@@@@@@@@@@@@@@@@@@@@@@@@@@@@@@@@@@@@@@@@@@@@@@@@@@@
@@@@@@@@@@@@@@@@@@@@@@@@@@@@@@@@@@@@@@@@@@@@@@@@@@@@@@@@@@@@@@@@@@@@@@@@@@@@@@@@
@@@@@@@@@@@@@@@@@@@@@@@@@@@@@@@@@@@@@@@@@@@@@@@@@@@@@@@@@@@@@@@@@@@@@@@@@@@@@@@@
@@@@@@@@@@@@@@@@@@@@@@@@@@@@@@@@@@@@@@@@@@@@@@@@@@@@@@@@@@@@@@@@@@@@@@@@@@@@@@@@
@@@@@@@@@@@@@@@@@@@@@@@@@@@@@@@@@@@@@@@@@@@@@@@@@@@@@@@@@@@@@@@@@@@@@@@@@@@@@@@@
@@@@@@@@@@@@@@@@@@@@@@@@@@@@@@@@@@@@@@@@@@@@@@@@@@@@@@@@@@@@@@@@@@@@@@@@@@@@@@@@
@@@@@@@@@@@@@@@@@@@@@@@@@@@@@@@@@@@@@@@@@@@@@@@@@@@@@@@@@@@@@@@@@@@@@@@@@@@@@@@@
@@@@@@@@@@@@@@@@@@@@@@@@@@@@@@@@@@@@@@@@@@@@@@@@@@@@@@@@@@@@.@@@@@@@@@@@@@@@@@@@
@@@@@@@@@@@@@@@@@@@@@@@@@@@@@@@@@@@@@@@@@@@@@@@@@@@@@@@@@@@@..@@@@@@@@@@@@@@@@@@
@@@@@@@@@@@@@@@@@@@@@@@@@@@@@@@@@@@@@@@@@@@@@@@@@@@@@@@@@@@...@@@@@@@@@@@@@@@@@@
@@@@@@@@@@@@@@@@@@@@@@@@@@@@@@@@@@@@@@..@@@@@@@@@@@@@@@@@@...@@@@@@@@@@@@@@@@@@@
@@@@@@@@@@@@@@@@@@@@@@@@@@@@@@@@@@@...............T...@@@....@@@@@@@@@@@@@@@@@@@
@@@@@@@@@@@@@@@@@@@@@@@@@@@@@@@@@@..T..................T@...@@@@@@@@@@@@@@@@@@@@
@@@@@@@@@@@@@@@@@@@@@@@@@@......@@......T..............@@...@@@@@@@@@@@@@@@@@@@@
@@@@@@@@@@@@@@@@@@@@@@@@.T.......................T.....@....@@T@@@@@@@@@@@@@@@@@
@@@@@@@@@@@@@@@@@@@@@@................................T@T.TT@..@@@@@@@@@@@@@@@@@
@@@@@@@@@@@@@@@@@@@@@.................................@@..T@@T.@@@@@@@@@@@@@@@@@
@@@@@@@@@@@@@@@@@.@@@........T........................@....@@..@@@@@@@@@@@@@@@@@
@@@@@@@@@@@@@@.@@.T@@.................................@....@@...@@@@@@@@@@@@@@@@
@@@@@@@@@@@@@@.......................................@@...@@@....@@@@@@@@@@@@@@@
@@@@@@@@@@@@@........T...............T...............@....@@@.....@@@@@@@@@@@@@@
@@@@@@@@@@@@@.T...T...............T.......T.....T..@@@....@@.......@@@@@@@@@@@@@
@@@@@@@@@@@@................T......T..........T....@@@...@@@.T......@@@@@@@@@@@@
@@@@@@@@@@@@......................................@@@....@@.........T@@@@@@@@@@@
@@@@@@@@@@@.........T..............T...T.........T.......@@...........@@@@@@@@@@
@@@@@@@@@@............T................T...T............@@@......T.....@@@@@@@@@
@@@@@@@@@..............................................@@@@@...........@@@@@@@@@
@@@@@@@@@..................T......T.................T..................@@@@@@@@@
@@@@@@@@@.............T.................T................T.............@@@@@@@@@
@@@@@@@@@@..............................................................@@@@@@@@
@@@@@.@@@@T............................T.................T..............@@@@@@@@
@@@@@...........T..T.............................T.......................@@@@@@@
@@@@@...........T..T.......T..............................T......T.......@@@@@@@
@@@@@.............T.......................................................@@@@@@
@@@@@..T............................@@@@@@@.....T..............T...........@@@@@
@@@@@..T..T...................T...@@@@@@@@@@........T...................T..@@@@@
@@@@@.............T...T.T.........@@@@@@@@@@........T.T...................T.@@@@
@@@@@..............T......T......@@@@@..@@@@....@@.........T.T...............@@@
@@@@@....T...T................T..@@@....@@@....@@@...........T...............@@@
@@@@@.T........T.........T....................@@@@..............T...........T@@@
@@@@@........T............T..@@..............@@@@@@.....................T....@@@
@@@@@TT............T......@@.@@@.............@@@@@@..........................@@@
@@@@@.....................@@@@@@@........T...@@@@@@........T.................@@@
@@@@@.T.....................@@@@@..........T.T@@@@@@.........................@@@
@@@@@..T....................@@@@@...............@@@@........T................@@@
@@@@@.TT..............T.....@@@@.......T.........@@@.T...............T.......@@@
@@@@@....T..................@@@@........T.......@@@@........T................@@@
@@@@@........T.....T........@@@................@@@@@............T............@@@
@@@@@.........T.............@@@...............@@@@@T................T........@@@
@@@@@................T......@@@@@..............@@@@T.........................@@@
@@@@@.....T.........T...T....@@@@T..T....T......@@@..........................@@@
@@@@@.............T..........@@@@@@..................................T.......@@@
@@@@@.........................@@@@....T.......@.......T.....T................@@@
@@@@@..............T........T...............@@@..T......................T....@@@
@@@@@.T.........T.....................@@@@@@@@@@@...T..........T.............@@@
@@@@@................................@@@@@@@@@@@@...............T............@@@
@@@@@............T.................@@@@@@@@@@@...........T.....T.............@@@
@@@@@.T........T...................@@@@@@@@@@......T...........T..........T..@@@
@@@@@T..........................T............................................@@@
@@@@@............................T.T...................T.T..........T........@@@
@@@@@.T......................T....T..........................T........T......@@@
@@@@@............T....................................T...T..........T......@@@@
@@@@@..........TT.T.........T..................T..............T.........T...@@@@
@@@@@@............T......T..T.......T......T...............................@@@@@
@@@@@@....................................T......T.....................T...@@@@@
@@@@@@@.......TT.T.............T..........................T...............@@@@@@
@@@@@@@@..................................T...........T.................@@@@@@@@
@@@@@@@@@.......T..........................T.........T.......T.........@@@@@@@@@
@@@@@@@@@@@................................TT.............T..........@@@@@@@@@@@
@@@@@@@@@@@@@@..................................T..................@@@@@@@@@@@@@
@@@@@@@@@@@@@@@@T........T..T....................................@@@@@@@@@@@@@@@
@@@@@@@@@@@@@@@@@@@T....T...........................T..........@@@@@@@@@@@@@@@@@
@@@@@@@@@@@@@@@@@@@@@.........................T....T........@@@@@@@@@@@@@@@@@@@@
@@@@@@@@@@@@@@@@@@@@@@@@........................TT...T....@@@@@@@@@@@@@@@@@@@@@@
@@@@@@@@@@@@@@@@@@@@@@@@@@..............................@@@@@@@@@@@@@@@@@@@@@@@@
@@@@@@@@@@@@@@@@@@@@@@@@@@@@.........................T@@@@@@@@@@@@@@@@@@@@@@@@@@
@@@@@@@@@@@@@@@@@@@@@@@@@@@@@@@@@@@@@@@@@@@@@@@@@@@@@@@@@@@@@@@@@@@@@@@@@@@@@@@@
@@@@@@@@@@@@@@@@@@@@@@@@@@@@@@@@@@@@@@@@@@@@@@@@@@@@@@@@@@@@@@@@@@@@@@@@@@@@@@@@
