type octile
height 59
width 52
map
@@@@@@@@@@@@@@@@@@@@@@@@@@@@@@@@@@@@@@@@@@@@@@@@@@@@
@@@@@@@@@@@@@@@@@@@@@@@@@@@@@@@@@@@@@@@@@@@@@@@@@@@@
@@@@@@@@@@@@@@@@@@@@@@@@@@@@@@@@@@@@@@@@@@@@@@@@@@@@
@@@@@@@@@@@@@@@@@@@@@@@@@@@@@@@@@@@@@@@@@@@@@@@@@@@@
@@@@@@@@@@@@@@@@@@@@@@@@@@@@@@@@.@@@@@@@@@@@@@@@@@@@
@@@@@@@@@@@@@@@@@@@@@@@@@@@@@@@...@@@@@@@@@@@@@@@@@@
@@@@@@@@@@@@@@@@@@@@@@@@@@@@@@....@@@@@@@@@@@@@@@@@@
@@@@@@@@@@@@@@@@@@@@@@@@@@@@@.....@@@@@@@@@@@@@@@@@@
@@@@@@@@@@@@@@@@@@@@@@@@@@@@@.....@@@@@@@@@@@@@@@@@@
@@@@@@@@@@@@@@@@@@@@@@@@@@@@.....@@@@@@@@@@@@@@@@@@@
@@@@@@@@@@@@@@@@@@@@@@@@@@@.....@@@@@@@@@@@@@@@@@@@@
@@@@@@@@@@@@@@@@@@@@@@@@@@@....@@@@@@@@@@@@@@@@@@@@@
@@@@@@@@@@@@@@@@@@@@@@@@@@...@@@@@@@@@@@@@@@@@@@@@@@
@@@@@@@@@@@@@@@@@@@@@@@..T..@@@@@@@@@@@@@@@@@@@@@@@@
@@@@@@@@@@@@@@@@@@@@@@@.....@@@@@@@@@@@@@@@@@@@@@@@@
@@@@@@@@@@@@@@@@@@@@@@@....@@@@@@@@@@@@@@@@@@@@@@@@@
@@@@@@@@@@@@@@@@@@@@@@@....@@@@@@@@@@@@@@@@@@@@@@@@@
@@@@@@@@@@@@@@@@@@@@@@@....@@@@@@@@@@@@@@@@@@@@@@@@@
@@@@@@@@@@@@@@@@@@@@@@@....@@@@@@@@@@@@@@@@@@@@@@@@@
@@@@@@@@@@@@@@@@..@@@@@....@@@@@@@@@@@@@@@@@@@@@@@@@
@@@@@@@@@@@@@@@..T.@@@.T...@@@@@@@@@@@@@@@@@@@@@@@@@
@@@@@@@@@@@@@@@.....@.......@@@@@@@@@@@@@@@@@@@@@@@@
@@@@@@@@@@@@@@T.............@@@@@@@@@@@@@@@@@@@@@@@@
@@@@@@@@@@@@@.................T.....@@@@@@@@@@@@@@@@
@@@@@@@@@@@@@........T...........T...@@@@@@@@@@@@@@@
@@@@@@@@@@@@..............@@@@@.T....TT.@@@@@@@@@@@@
@@@@@@@@@@@@..............@@@@@@...T.....@@@@@@@@@@@
@@@@@@@@@@@@.T..@@............@@@..T......@@@@@@@@@@
@@@@@@@@@@@....@@..............@@@.........@@@@@@@@@
@@@@@@@@@@..T..@@.....T..........@@........@@@@@@@@@
@@@@@@@@..T...@@..................@@@......T@@@@@@@@
@@@@@@@@......@@...................@@...T...@@@@@@@@
@@@@@@@.......@@.................T..@@........@@@@@@
@@@@@@@......@@........T....T.T......@T.......@@@@@@
@@@@@@@.....T@@.........@@@@.........@.......T@@@@@@
@@@@@@@......@@....T...@@@@@@........@@T......@@@@@@
@@@@@@@......@@@.....T.@@@@@@........@@.....T.@@@@@@
@@@@@@@......@@@.......@@@@@@...T....@@........@@@@@
@@@@@@@......@@@........@@@@.........@@........@@@@@
@@@@@@@......@@@..............T..T..@@@.........@@@@
@@@@@@@.......@@@...................@@@.........@@@@
@@@@@@@.......@@@..................@@@@....T....@@@@
@@@@@@@........@@T.................@@@..........@@@@
@@@@@@@........@@@................@@@T..........@@@@
@@@@@@@..T......@@@...T..........@@@............@@@@
@@@@@@@..........@@@............@@@.............@@@@
@@@@@@@..........@@@@@........@@@@.............@@@@@
@@@@@@@...........@@@@@@@@@@@@@@@..............@@@@@
@@@@@@@.T.......T...@@@@@@@@@@@@...............@@@@@
@@@@@@@@......................T...............@@@@@@
@@@@@@@@@....T...............T...............@@@@@@@
@@@@@@@@@@..............T...................@@@@@@@@
@@@@@@@@@@@@................T............@@@@@@@@@@@
@@@@@@@@@@@@@@@.................T......@@@@@@@@@@@@@
@@@@@@@@@@@@@@@@.T.................@@@@@@@@@@@@@@@@@
@@@@@@@@@@@@@@@@@@@.............@@@@@@@@@@@@@@@@@@@@
@@@@@@@@@@@@@@@@@@@@@@@@@@@@@@@@@@@@@@@@@@@@@@@@@@@@
@@@@@@@@@@@@@@@@@@@@@@@@@@@@@@@@@@@@@@@@@@@@@@@@@@@@
@@@@@@@@@@@@@@@@@@@@@@@@@@@@@@@@@@@@@@@@@@@@@@@@@@@@
