type octile
height 70
width 56
map
@@@@@@@@@@@@@@@@@@@@@@@@@@@@@@@@@@@@@@@@@@@@@@@@@@@@@@@@
@@@@@@@@@@@@@@@@@@@@@@@@@@@@@@@@@@@@@@@@@@@@@@@@@@@@@@@@
@@@@@@@@@@@@@@@@@@@@@@@@@@@@@@@@@@@@@@@@@@@@@@@@@@@@@@@@
@@@@@@@@@@@@@@@@@@@@@@@@@@@@@@@@@@@@@@@@@@@@@@@@@@@@@@@@
@@@@@@@@@@@@@@@@@@@@@@@@@@@@@@@@@@@@@@@@@@@@@@@@@@@@@@@@
@@@@@@@@@@@@@@@@@@@@@@@@@@@@@@@@@@@@@@@@@@@@@@@@@@@@@@@@
@@@@@@@@@@@@@@@@@@@@@@@@@@@@@@@@@@@@@@@@@@@@@@@@@@@@@@@@
@@@@@@@@@@@@@@@@@@@@@@@@@@@@@@@@@@@@@@@@@@@@@@@@@@@@@@@@
@@@@@@@@@@@@@@@@@@@@@@@@@@@@@@@@@@@@@@@@@@@@@@@@@@@@@@@@
@@@@@@@@@@@@@@@@@@@@@@@@@@@@@@@@@@@@@@@@@@@@@@@@@@@@@@@@
@@@@@@@@@@@@@@@@@@@@@@@@@@@@@@@@@@@@@.@@@@@@@@@@@@@@@@@@
@@@@@@@@@@@@@@@@@@@@@@@@@@@@@@@@@@@@@..@@@@@@@@@@@@@@@@@
@@@@@@@@@@@@@@@@@@@@@@@@@@@@@@@@@@@@@...@@@@@@@@@@@@@@@@
@@@@@@@@@@@@@@@@@@@@@@@@@@@@@@@@@@@....T.@@@@@@@@@@@@@@@
@@@@@@@@@@@@@@@@@@@@@@@@@@@@@@@@@@@.......@@@@@@@@@@@@@@
@@@@@@@@@@@@@@@@@@@@@@@@@@@@@@@@@.T.....T.@@@@@@@@@@@@@@
@@@@@@@@@@@@@@@@@@@@@@@@@@@@@@@@@.......T@@@@@@@@@@@@@@@
@@@@@@@@@@@@@@@@@@@@@@@@@@@@@@@@@.T....@@@@@@@@@@@@@@@@@
@@@@@@@@@@@@@@@@@@@@@@@@@@@@@@........@@@@@@@@@@@@@@@@@@
@@@@@@@@@@@@@@@@@@@@@@@@@@.@@@......@@@@@@@@@@@@@@@@@@@@
@@@@@@@@@@@@@@@@@@@@@@@.....@@@....@@@@@@@@@@@@@@@@@@@@@
@@@@@@@@@@@@@@@@@@@@@@...........@@@@@@@@@@@@@@@@@@@@@@@
@@@@@@@@@@@@@@@@@@@@@@@......T...@@@@@@@@@@@@@@@@@@@@@@@
@@@@@@@@@@@@@@@@@@@@@@@@.........@@@@@@@@@@@@@@@@@@@@@@@
@@@@@@@@@@@@@@@@@@@@@@@@@........@@@@@@@@@@@@@@@@@@@@@@@
@@@@@@@@@@@@@@@@@@.@@@@@@@.T...@@@@@@@@@@@@@@@@@@@@@@@@@
@@@@@@@@@@@@@@@@....@@@@@@@...@@@@@@@@@@@@@@@@@@@@@@@@@@
@@@@@@@@@@@@@@@@.....@@@@@.T..@@@@@@@@@@@@@@@@@@@@@@@@@@
@@@@@@@@@@@@@@@@......@@@.....@@@@@@.@@@@@@@@@@@@@@@@@@@
@@@@@@@@@@@@@@@.T....T....T...T@@@@...@@@@@@@@@@@@@@@@@@
@@@@@@@@@@@@@@@@..............@@@@.....@@@@@@@@@@@@@@@@@
@@@@@@@@@@@@@@@@@............@@@@.......@@@@@@@@@@@@@@@@
@@@@@@@@@@@@@@@@@@......T......@@.......@@@@@@@@@@@@@@@@
@@@@@@@@@@@@@@@@@.T............@@.......@@@@@@@@@@@@@@@@
@@@@@@@@@@@@@@@@........@.......@@..@....@@@@@@@@@@@@@@@
@@@@@@@@@@@@.@@........@@@.......@@@@....@@@@@@@@@@@@@@@
@@@@.@@@@@@...........@@@@@.........T.....@@@@@@@@@@@@@@
@@@..................@@@@@@@..............@@@@@@@@@@@@@@
@@................T..@@@@@@@....T.........@@@@@@@@@@@@@@
@@@......T..........T.@@@@@@@...T..T.......@@@@@@@@@@@@@
@@@....................@@@@@@@.@@...........@@@@@@@@@@@@
@@@@..........@@.......@@@@@@@@@@..........T...@@@@@@@@@
@@@@@........@@@@......T@@@@@@@@@...............@@@@@@@@
@@@@@@......@@@@@........@@@@@@@@................@@@@@@@
@@@@@@@....@@@@.@@........@@@@@@@....@@@@T........@@@@@@
@@@@@@@@..@@@@...@.........@@@@@..T..@@@@@@.........@@@@
@@@@@@@@@@@@@@...@@.........@@@@T...@@@@@@@............@
@@@@@@@@@@@@@@....@................@@@@@@@............@@
@@@@@@@@@@@@@@@...@@..........T....@@@@@@@.......T...@@@
@@@@@@@@@@@@@@@....@@..................@@@...T......@@@@
@@@@@@@@@@@@@@@@T..@@@........T....................@@@@@
@@@@@@@@@@@@@@@@....@...T..........T..............@@@@@@
@@@@@@@@@@@@@@@@@...@......T...T....T...........T@@@@@@@
@@@@@@@@@@@@@@@@@...@@...............T..........@@@@@@@@
@@@@@@@@@@@@@@@@@@..........T.......T.......T..@@@@@@@@@
@@@@@@@@@@@@@@@@@@@.T.....T...................@@@@@@@@@@
@@@@@@@@@@@@@@@@@@..................T........@@@@@@@@@@@
@@@@@@@@@@@@@@@@@....T...........T.........@@@@@@@@@@@@@
@@@@@@@@@@@@@@@@@.................T.......@@@@@@@@@@@@@@
@@@@@@@@@@@@@@@@@@......................T@@@@@@@@@@@@@@@
@@@@@@@@@@@@@@@@@@@...........T..T....T.@@@@@@@@@@@@@@@@
@@@@@@@@@@@@@@@@@@@@..T................@@@@@@@@@@@@@@@@@
@@@@@@@@@@@@@@@@@@@@@....T............@@@@@@@@@@@@@@@@@@
@@@@@@@@@@@@@@@@@@@@@@....T..........@@@@@@@@@@@@@@@@@@@
@@@@@@@@@@@@@@@@@@@@@@@.............@@@@@@@@@@@@@@@@@@@@
@@@@@@@@@@@@@@@@@@@@@@@@..........@@@@@@@@@@@@@@@@@@@@@@
@@@@@@@@@@@@@@@@@@@@@@@@@........@@@@@@@@@@@@@@@@@@@@@@@
@@@@@@@@@@@@@@@@@@@@@@@@@@@...T.@@@@@@@@@@@@@@@@@@@@@@@@
@@@@@@@@@@@@@@@@@@@@@@@@@@@@@@@@@@@@@@@@@@@@@@@@@@@@@@@@
@@@@@@@@@@@@@@@@@@@@@@@@@@@@@@@@@@@@@@@@@@@@@@@@@@@@@@@@
