type octile
height 59
width 56
map
@@@@@@@@@@@@@@@@@@@@@@@@@@@@@@@@@@@@@@@@@@@@@@@@@@@@@@@@
@@@@@@@@@@@@@@@@@@@@@@@@@@@@@@@@@@@@@@@@@@@@@@@@@@@@@@@@
@@@@@@@@@@@@@@@@@@@@@@@@@@@@@@@@@@@@@@@@@@@@@@@@@@@@@@@@
@@@@@@@@@@@@@@@@@@@@@@@@@@@@@@@@@@@@@@@@@@@@@@@@@@@@@@@@
@@@@@@@@@@@@@@@@@@@@@@@@@@@@@@@@@@@@@@@@@@@@@@@@@@@@@@@@
@@@@@@@@@@@@@@@@@@@@@@@@@@@@@@@@@@@@@@@@@@@@@@@@@@@@@@@@
@@@@@@@@@@@@@@@@@@@@@@@@@@@@@@@@@@@@@@@@@@@@@@@@@@@@@@@@
@@@@@@@@@@@@@@@@@@@@@@@@@@@@@@@@@@@@@@@@@@@@@@@@@@@@@@@@
@@@@@@@@@@@@@@@@@@@@@@@@@@@@@@@@@@@@@@@@@@@@@@@@@@@@@@@@
@@@@@@@@@@@@@@@@@@@@@@@@@@@@@@@@@@@@@@@@@@@@@@@@@@@@@@@@
@@@@@@@@@@@@@@@@@@@@@@@@@@@@@@@@@@@@@@@@@@@@@@@@@@@@@@@@
@@@@@@@@@@@@@@@@@@@@@@@@@@@@@@@@@@@@@@@@@@@@@@@@@@@@@@@@
@@@@@@@@@@@@@@@@@@@@@@@...T.......@@@@@@@@@@@@@@@@@@@@@@
@@@@@@@@@@@@@@@@@@@@......T..........@@@@@@@@@@@@@@@@@@@
@@@@@@@@@@@@@@@@@T....@@@@@@@T.........@@@@@@@@@@@@@@@@@
@@@@@@@@@@@@@@@@@....@@@@@@@@@.........@@@@@@@@@@@@@@@@@
@@@@@@@@@@@@@@@@@....@@@@@@@@@@.......@@@@@@@@@@@@@@@@@@
@@@@@@@@@@@@@@@@....@@@@@@@@...........@@@@@@@@@@@@@@@@@
@@@@@@@@@@@@@@@@@...@@@@@................@@@@@@@@@@@@@@@
@@@@@@@@@@@@@@@@@@..@@@.......T...........@@@@@@@@@@@@@@
@@@@@@@@@@@@@@@@@@....@@@..........T..T...@@@@@@@@@@@@@@
@@@@@@@@@@@@@..@@...........T..........T...@@@@@@@@@@@@@
@@@@@@@@@@@............T....T..............@@@@@@@@@@@@@
@@@@@@@@@@....T....T........................@@@@@@@@@@@@
@@@@@@@@@..........T.......T...................@@@@@@@@@
@@@@@@@@@...T...................T..............@@@@@@@@@
@@@@@@@@@..............T...@@@@@@@@@...T.......@@@@@@@@@
@@@@@@@@@................@@@@@@@@@@@@.....T....@@@@@@@@@
@@@@@@@@@@............@@@@@@@@@@@@@@@@T........@@@@@@@@@
@@@@@@@@@@@@.......@@@@@@@@@@@@@@@@@@@..T.........@@@@@@
@@@@@@@@@@@@@.....@@@@@@@@@@@@@@@@@@@@............@@@@@@
@@@@@@@@@@@@@.....@@@@@@@@@@@@@@@@@@@@@....@@@....@@@@@@
@@@@@@@@@@@@@.....@@@@@@@@@@@@@@@@@@@@@....@@@@@..@@@@@@
@@@@@@@@@@..@@..T.@@@@@@@@@@@@@@@@@@@@@@..@@@@@@@T@@@@@@
@@@@@@@@@....@...@@@@@@@@@@@@@@@@@@@@@@@..@@@@@.T.@@@@@@
@@@@@@@@@........@@@@@@@@@@@@@@@@@@@@@@@T....@@...@@@@@@
@@@T.............@@@@@@@@@@@@@@@@@@@@@@@...........@@@@@
@@@..........T..T@@@@@@@@@@@@@@@@@@@@@@@............@@@@
@@@......T........@@@@@@@@@@@@@@@@@@@@.......T.@@@..T..@
@@@.......T........@@@@@@@@@@@@@@@@@@@.........@@@.....@
@@@.T..@@...........@@@@@@@@@@@@@@@@@..........@@@.T...@
@@@@...@@............@@@@@@@@@@@@@@@@@...T..T...T......@
@@@@T.........T.T.....@@@@@@@@@@@@@@@@.T...............@
@@@@T..................@@@@@@@@@@@@@@@.................@
@@@@T..............T......@@@@@@@@@@@......T...T.......@
@@@@........................@@@@@@@@T..................@
@@@@.............T................T........T...........@
@@@@@..........................T.......................@
@@@@@.............T...............T....................@
@@@@@@.................................................@
@@@@@@@............................@@...............T..@
@@@@@@@@...........@@.........T....@@..T..T..T.........@
@@@@@@@@@..........@@..................................@
@@@@@@@@@@T...T......................T.....T.T........@@
@@@@@@@@@@@........T.......T.........................@@@
@@@@@@@@@@@@.........................T.T..........@@@@@@
@@@@@@@@@@@@@......................T.....T....T..@@@@@@@
@@@@@@@@@@@@@@@......T........................T@@@@@@@@@
@@@@@@@@@@@@@@@@@@@@@@@@@@@@@@@@@@@@@@@@@@@@@@@@@@@@@@@@
