type octile
height 70
width 64
map
@@@@@@@@@@@@@@@@@@@@@@@@@@@@@@@@@@@@@@@@@@@@@@@@@@@@@@@@@@@@@@@@
@@@@@@@@@@@@@@@@@@@@@@@@@@@@@@@@@@@@@@@@@@@@@@@@@@@@@@@@@@@@@@@@
@@@@@@@@@@@@@@@@@@@@@@@@@@@@@@@@@@@@@@@@@@@@@@@@@@@@@@@@@@@@@@@@
@@@@@@@@@@@@@@@@@@@@@@@@@@@@@@@@@@@@@@@@@@@@@@@@@@@@@@@@@@@@@@@@
@@@@@@@@@@@@@@@@@@@@@@@@@@@@@@@@@@@@@@@@@@@@@@@@@@@@@@@@@@@@@@@@
@@@@@@@@@@@@@@@@@@@@@@@@@@@@@@@@@@@@@@@@@@@@@@@@@@@@@@@@@@@@@@@@
@@@@@@@@@@@@@@@@@@@@@@@@@@@@@@@@@@@@@@@@@@@@@@@@@@@@@@@@@@@@@@@@
@@@@@@@@@@@@@@@@@@@@@@@@@@@@@@@@@@@@@@@@@@@@@@@@@@@@@@@@@@@@@@@@
@@@@@@@@@@@@@@@@@@@@@@@@@@@@@@@@@@@@@@@@@@@@@@@@@@@@@@@@@@@@@@@@
@@@@@@@@@@@@@@@@@@@@@@@@@@@@@@@@@@@@@@@@@@@@@@@@@@@@@@@@@@@@@@@@
@@@@@@@@@@@@@@@@@@@@@@@@@@@@@@@@@@@@@@@@@@@@@@@@@@@@@@@@@@@@@@@@
@@@@@@@@@@@@@@@@@@@@@@@@@@@@@@@@@@@@@@@@@@@@@@@@@@@@@@@@@@@@@@@@
@@@@@@@@@@@@@@@@@@@@@@@@@@@@@@@@@@@@@@@@@@@@@@@@@@@@@@@@@@@@@@@@
@@@@@@@@@@@@@@@@@@@@@@@@@@@@@@@@@@@@@@@@@@@@@@@@@@@@@@@@@@@@@@@@
@@@@@@@@@@@@@@@@@@@@@@@@@@@@@@@@@@@@@@@@@@@@@@@@@@@@@@@@@@@@@@@@
@@@@@@@@@@@@@@@@@@@@@@@@@@@@@@@@@.@@@@@@@@@@@@@@@@@@@@@@@@@@@@@@
@@@@@@@@@@@@@@@@@@@@@@@@@@@@@@@@...@@@@@@@@@@@@@@@@@@@@@@@@@@@@@
@@@@@@@@@@@@@@@@@@@@@@@@@@@@@@@@@...@@@@@@..@@@@@@@@@@@@@@@@@@@@
@@@@@@@@@@@@@@@@@@@@@@@@@@@@@@@@@@...@@@@....@@@@@@@@@@@@@@@@@@@
@@@@@@@@@@@@@@@@@@@@@@@@@@@@@@@@@@@...@@.....@@@@@@@@@@@@@@@@@@@
@@@@@@@@@@@@@@@@@@@@@@@@@@@@.@@..@@@.........@@@@@@@@@@@@@@@@@@@
@@@@@@@@@@@@@@@@@@@@@@@@@@@@T.@T.@@@@...........@@@@@@@@@@@@@@@@
@@@@@@@@@@@@@@@@@@@@@@@@@@@@.........T...........@@@@@@@@@@@@@@@
@@@@@@@@@@@@@@@@@@@@@@@@@@@@@.....................@@@@@@@@@@@@@@
@@@@@@@@@@@@@@@@@@@@@@@@@@@@@@.......T.....T.......@@@@@@@@@@@@@
@@@@@@@@@@@@@@@@@@@@@@@@@@@@@@@....................@@@@@@@@@@@@@
@@@@@@@@@@@@@@@@@@@@@@@@@@@@@@@@...................@@@@@@@@@@@@@
@@@@@@@@@@@@@@@@@@@@@@@..@@@@@@.T.............T.T......@@@@@@@@@
@@@@@@@@@@@@@@@@@@@@@@@@..@@@@..T..T....................@@@@@@@@
@@@@@@@@@@@@@@@@@@@@@@@@@T.@@.......T..T.@.............@@@@@@@@@
@@@@@@@@@@@@@@@@@@@@@@@@@@.......T......@@@.T....T....@@@@@@@@@@
@@@@@@@@@@@@@@@@@@@@@@@@@@@....T...T....@@@....T.....@@@@@@@@@@@
@@@@@@@@@@@@@@@@@@@@@@@@@@..............@@@....T....@@@@@@@@@@@@
@@@@@@@@@@@@@@@@@.@@@@@@@..........T...T..........@..@@@@@@@@@@@
@@@@@@@@@@@@@@@@..@@@@.@.....................T..T@@@..@@@@@@@@@@
@@@@@@@@@@@@T@@....@@@...........................@@@@..@@@@@@@@@
@@@@@@@@@@@..@@.....T.....T.....................@@@@@@..@@@@@@@@
@@@@@@@@@@..T.................T............T.......@@@@..@@@@@@@
@@@@@@@@@.....................T................T...@@@@@.@@@@@@@
@@@@@@@@..........................T.....T...@......@@@@@@@@@@@@@
@@@@@@@......@..............@.T...T.....T..@@@TT....@@@@@@@@@@@@
@@@@@@......@@@..T....T....@@@.T..........@@@@@......@@@@@@@@@@@
@@@@@.....T.@@@@...........@@@...........@@@@@@@.....@@@@@@@@@@@
@@@@.......T.@@@@..........@@@...........@@@@@@@@....@@@@@@@@@@@
@@@..........@@@@@@@T....TT...............@@@@@@@@..@@@@@@@@@@@@
@@@..........T@@@@@@..................@@.T.@@@@@@@@@@@@@@@@@@@@@
@@@@....@.....@@@@@@T..T.............@@@@...@@@@@@@@@@@@@@@@@@@@
@@@@@..@@@....@@@@T............T...@@@@@@@...@@@@@@@@@@@@@@@@@@@
@@@@@@...@@..@@@@..T..........T.TT@@@@@@@@@..@@@@@@@@@@@@@@@@@@@
@@@@@@@..@@@@@@@.T...............@@@@@@@@@@@@@@@@@@@@@@@@@@@@@@@
@@@@@@@@...@@@@..................@@@@@@@@@@@@@@@@@@@@@@@@@@@@@@@
@@@@@@@@@T.@@@........@@.......T...@@@@@@@@@@@@@@@@@@@@@@@@@@@@@
@@@@@@@@@@.T..........@@@@@@.......@@@@@@@@@@@@@@@@@@@@@@@@@@@@@
@@@@@@@@@@@...........@@@@@@.........@@@@@@@@@@@@@@@@@@@@@@@@@@@
@@@@@@@@@@@@.T.......T@@@@@@..........@@@@@@@@@@@@@@@@@@@@@@@@@@
@@@@@@@@@@@@@........@@@@@@@......T....@@@@@@@@@@@@@@@@@@@@@@@@@
@@@@@@@@@@@@@@.....@@@@@@@@.........T..@@@@@@@@@@@@@@@@@@@@@@@@@
@@@@@@@@@@@@@@@....@@@.T...............@@@@@@@@@@@@@@@@@@@@@@@@@
@@@@@@@@@@@@@@@@......................@@@@@@@@@@@@@@@@@@@@@@@@@@
@@@@@@@@@@@@@@@@@....................@@@@@@@@@@@@@@@@@@@@@@@@@@@
@@@@@@@@@@@@@@@@@@..................@@@@@@@@@@@@@@@@@@@@@@@@@@@@
@@@@@@@@@@@@@@@@@@@................@@@@@@@@@@@@@@@@@@@@@@@@@@@@@
@@@@@@@@@@@@@@@@@@@@..........T...@@@@@@@@@@@@@@@@@@@@@@@@@@@@@@
@@@@@@@@@@@@@@@@@@@@@.........T..@@@@@@@@@@@@@@@@@@@@@@@@@@@@@@@
@@@@@@@@@@@@@@@@@@@@@@........T.@@@@@@@@@@@@@@@@@@@@@@@@@@@@@@@@
@@@@@@@@@@@@@@@@@@@@@@@.....T..@@@@@@@@@@@@@@@@@@@@@@@@@@@@@@@@@
@@@@@@@@@@@@@@@@@@@@@@@@......@@@@@@@@@@@@@@@@@@@@@@@@@@@@@@@@@@
@@@@@@@@@@@@@@@@@@@@@@@@@....@@@@@@@@@@@@@@@@@@@@@@@@@@@@@@@@@@@
@@@@@@@@@@@@@@@@@@@@@@@@@@..@@@@@@@@@@@@@@@@@@@@@@@@@@@@@@@@@@@@
@@@@@@@@@@@@@@@@@@@@@@@@@@@@@@@@@@@@@@@@@@@@@@@@@@@@@@@@@@@@@@@@
