type octile
height 80
width 80
map
@@@@@@@@@@@@@@@@@@@@@@@@@@@@@@@@@@@@@@@@@@@@@@@@@@@@@@@@@@@@@@@@@@@@@@@@@@@@@@@@
@@@@@@@@@@@@@@@@@@@@@@@@@@@@@@@@@@@@@@@@@@@@@@@@@@@@@@@@@@@@@@@@@@@@@@@@@@@@@@@@
@@@@@@@@@@@@@@@@@@@@@@@@@@@@@@@@@@@@@@@............T.T........................@@
@@@@@@@@@@@@@@@@@@@@@@@@@@@@@@@@@@@@@............T..........T.........T...T...@@
@@@@@@@@@@@@@@@@@@@@@@@@@@@@@@@@@@@@..............T.........................T@@@
@@@@@@@@@@@@@@@@@@@@@@@@@@@@@@@@@@.T.........................................@@@
@@@@@@@@@@@@@@@@@@@@@@@@@@@@@@@@@............................................@@@
@@@@@@@@@@@@@@@@@@@@@@@@@@@@@@@@......................................T.....@@@@
@@@@@@@@@@@@@@@@@@@@@@@@@@@@@@@....T........................................@@@@
@@@@@@@@@@@@@@@@@@@@@@@@@@@@@@..............................T........T.T...@@@@@
@@@@@@@@@@@@@@@@@@@@@@@@@@@@@.................................T............@@@@@
@@@@@@@@@@@@@@@@@@@@@@@@@@@@.....................................T.........@@@@@
@@@@@@@@@@@@@@@@@@@@@@@@@@@.................TT............T......T........@@@@@@
@@@@@@@@@@@@@@@@@@@@@@@@@@.....T@@@.............T....T..................T.@@@@@@
@@@@@@@@@@@@@@@@@@@@@@@@@......@@@@@........T.................T..........@@@@@@@
@@@@@@@@@@@@@@@@@@@@@@@@......@@@@@@.....................................@@@@@@@
@@@@@@@@@@@@@@@@@@@@@@@........@@@@@......T.TT.T.............T..........@@@@@@@@
@@@@@@@@@@@@@@@@@@@@@@....T............................T.T.T............@@@@@@@@
@@@@@@@@@@@@@@@@@@@@@...........T.................T.....T...............@@@@@@@@
@@@@@@@@@@@@@@@@@@@@@..T..................T...............T............@@@@@@@@@
@@@@@@@@@@@@@@@@@@@@@..................................................@@@@@@@@@
@@@@@@@@@@@@@@@@@@@@...T..T@@@@...............T................T....T.@@@@@@@@@@
@@@@@@@@@@@@@@@@@@@@.......@@@@..................T..T.................@@@@@@@@@@
@@@@@@@@@@@@@@@@@@@@.......@@@@T.............T..T...............T.T...@@@@@@@@@@
@@@@@@@@@@@@@@@@@@@....T...@@@@...T.........T..........T....T....T....@@@@@@@@@@
@@@@@@@@@@@@@@@@@@@..T..........................................T.....@@@@@@@@@@
@@@@@@@@@@@@@@@@@@..............T........T.................TT.........@@@@@@@@@@
@@@@@@@@@@@@@@@@@@...................................................T@@@@@@@@@@
@@@@@@@@@@@@@@@@@@.............T......................................@@@@@@@@@@
@@@@@@@@@@@@@@@@@.....T...............T......T..T.T.......T...........@@@@@@@@@@
@@@@@@@@@@@@@@@@@..........T.............T..............T.............@@@@@@@@@@
@@@@@@@@@@@@@@@@@..T..........T.......T...........................T...@@@@@@@@@@
@@@@@@@@@@@@@@@@..........T...........................................@@@@@@@@@@
@@@@@@@@@@@@@@@@......................................................@@@@@@@@@@
@@@@@@@@@@@@@@@..........T.......................T...T..T............T@@@@@@@@@@
@@@@@@@@@@@@@@@...........................................T.......T...@@@@@@@@@@
@@@@@@@@@@@@@@.....................................T.......T.........@@@@@@@@@@@
@@@@@@@@@@@@@.....................................T..................@@@@@@@@@@@
@@@@@@@@@@@@..T....T......T..............T.....T.....................@@@@@@@@@@@
@@@@@@@@@@@.T...........................T.....T.T....................@@@@@@@@@@@
@@@@@@@@@...............T....................T...................T...@@@@@@@@@@@
@@@@@@@....T......T...........T....T...T.T.........................@@@@@@@@@@@@@
@@@@@..............T..................T......T.....T...T.......T..T@@@@@@@@@@@@@
@@@@@@.......T....................................................@@@@@@@@@@@@@@
@@@@@@@..@@@@@..........................T...........T........T...@@@@@@@@@@@@@@@
@@@@@@@.@@@@@@.............T........T...........................@@@@@@@@@@@@@@@@
@@@@@@..@@@@@@@.................T.........T.T..T...............@@@@@@@@@@@@@@@@@
@@@@@@..T@@@@@@.....................T.........................@@@@@@@@@@@@@@@@@@
@@.......@@@@@@......................T...TT.T.........T..T..@@@@@@@@@@@@@@@@@@@@
@@..................................T.....................@@@@@@@@@@@@@@@@@@@@@@
@@..........T.....T...............T......................@@@@@@@@@@@@@@@@@@@@@@@
@@.T......T............................................@@@@@@@@@@@@@@@@@@@@@@@@@
@@.........................T.....................T...@@@@@@@@@@@@@@@@@@@@@@@@@@@
@@...........T.....................................@@@@@@@@@@@@@@@@@@@@@@@@@@@@@
@@......T........................................T@@@@@@@@@@@@@@@@@@@@@@@@@@@@@@
@@....................T..........................@@@@@@@@@@@@@@@@@@@@@@@@@@@@@@@
@@..T....T.....T..............................T.@@@@@@@@@@@@@@@@@@@@@@@@@@@@@@@@
@@.T........T.T................................@@@@@@@@@@@@@@@@@@@@@@@@@@@@@@@@@
@@.................................T..........@@@@@@@@@@@@@@@@@@@@@@@@@@@@@@@@@@
@@.....T..TT.................................@@@@@@@@@@@@@@@@@@@@@@@@@@@@@@@@@@@
@@.................TT.....T.....T.......T...@@@@@@@@@@@@@@@@@@@@@@@@@@@@@@@@@@@@
@@...................T.........T........T...@@@@@@@@@@@@@@@@@@@@@@@@@@@@@@@@@@@@
@@............................T........T.T.@@@@@@@@@@@@@@@@@@@@@@@@@@@@@@@@@@@@@
@@.............T.T................T........@@@@@@@@@@@@@@@@@@@@@@@@@@@@@@@@@@@@@
@@....T.................T...T.............@@@@@@@@@@@@@@@@@@@@@@@@@@@@@@@@@@@@@@
@@...........T..........T................@@@@@@@@@@@@@@@@@@@@@@@@@@@@@@@@@@@@@@@
@@.T.........T.....T.........T....TT.....@@@@@@@@@@@@@@@@@@@@@@@@@@@@@@@@@@@@@@@
@@..................T..T.................@@@@@@@@@@@@@@@@@@@@@@@@@@@@@@@@@@@@@@@
@@........T.............................@@@@@@@@@@@@@@@@@@@@@@@@@@@@@@@@@@@@@@@@
@@......T..T............................@@@@@@@@@@@@@@@@@@@@@@@@@@@@@@@@@@@@@@@@
@@................................T.....@@@@@@@@@@@@@@@@@@@@@@@@@@@@@@@@@@@@@@@@
@@......T.........T....................@@@@@@@@@@@@@@@@@@@@@@@@@@@@@@@@@@@@@@@@@
@@........................T............@@@@@@@@@@@@@@@@@@@@@@@@@@@@@@@@@@@@@@@@@
@@..TT.........TT.....T................@@@@@@@@@@@@@@@@@@@@@@@@@@@@@@@@@@@@@@@@@
@@...T..T.............................T@@@@@@@@@@@@@@@@@@@@@@@@@@@@@@@@@@@@@@@@@
@@...T.............................T...@@@@@@@@@@@@@@@@@@@@@@@@@@@@@@@@@@@@@@@@@
@@..........T..............T...........@@@@@@@@@@@@@@@@@@@@@@@@@@@@@@@@@@@@@@@@@
@@.....................................@@@@@@@@@@@@@@@@@@@@@@@@@@@@@@@@@@@@@@@@@
@@@@@@@@@@@@@@@@@@@@@@@@@@@@@@@@@@@@@@@@@@@@@@@@@@@@@@@@@@@@@@@@@@@@@@@@@@@@@@@@
@@@@@@@@@@@@@@@@@@@@@@@@@@@@@@@@@@@@@@@@@@@@@@@@@@@@@@@@@@@@@@@@@@@@@@@@@@@@@@@@
