type octile
height 75
width 72
map
@@@@@@@@@@@@@@@@@@@@@@@@@@@@@@@@@@@@@@@@@@@@@@@@@@@@@@@@@@@@@@@@@@@@@@@@
@@@@@@@@@@@@@@@@@@@@@@@@@@@@@@@@@@@@@@@@@@@@@@@@@@@@@@@@@@@@@@@@@@@@@@@@
@@@@@@@@@@@@@@@@@@@@@@@@@@@@@@@@@@@@@@@@@@@@@@@@@@@@@@@@@@@@@@@@@@@@@@@@
@@@@@@@@@@@@@@@@@@@@@@@@@@@@@@@@@@@@@@@@@@@@@@@@@@@@@@@@@@@@@@@@@@@@@@@@
@@@@@@@@@@@@@@@@@@@@@@@@@@@@@@@@@@@@@@@@@@@@@@@@@@@@@@@@@@@@@@@@@@@@@@@@
@@@@@@@@@@@@@@@@@@@@@@@@@@@@@@@@@@@@@@@@@@@@@@@@@@@@@@@@@@@@@@@@@@@@@@@@
@@@@@@@@@@@@@@@@@@@@@@@@@@@@@@@@@@@@@@@@@@@@@@@@@@@@@@@@@@@@@@@@@@@@@@@@
@@@@@@@@@@@@@@@@@@@@@@@@@@@@@@@@@@@@@@@@@@@@@@@@@@@@@@@@@@@@@@@@@@@@@@@@
@@@@@@@@@@@@@@@@@@@@@@@@@@@@@@@@@@@@@@@@@@@@@@@@@@@@@@@@@@@@@@@@@@@@@@@@
@@@@@@@@@@@@@@@@@@@@@@@@@@@@@@@@@@@@@@@@@@@@@@@@@@@@@@@@@@@@@@@@@@@@@@@@
@@@@@@@@@@@@@@@@@@@@@@@@@@@@@@@@@@@@@@@@@@@@@@@@@@@@@@@@@@@@@@@@@@@@@@@@
@@@@@@@@@@@@@@@@@@@@@@@@@@@@@@@@@@@@@@@@@@@@@@@@@@@@@@@@@@@@@@@@@@@@@@@@
@@@@@@@@@@@@@@@@@@@@@@@@@@@@@@@@@@@@@@@@@.@@@@@@@@@@@@@@@@@@@@@@@@@@@@@@
@@@@@@@@@@@@@@@@@@@@@@@@@@@@@@@@@@@@@@@@@.@@@@@@@@@@@@@@@@@@@@@@@@@@@@@@
@@@@@@@@@@@@@@@@@@@@@@@@@@@@@@@@@@@@@@@@@..@@@@@@...@@@@@@@@@@@@@@@@@@@@
@@@@@@@@@@@@@@@@@@@@@@@@@@@@@@@@@@@@@@@@.....@@@@...@@@@@@@@@@@@@@@@@@@@
@@@@@@@@@@@@@@@@@@@@@@@@@@@@@@@@@..@@@@T...........@@@@@@@@@@@@@@@@@@@@@
@@@@@@@@@@@@@@@@@@@@@@@@@@@@@@@@@...@@@...T.......@@@@@@@@@@@@@@@@@@@@@@
@@@@@@@@@@@@@@@@@@@@@@@@@@@@@@@@@...@@............@@@@@@@@@@@@@@@@@@@@@@
@@@@@@@@@@@@@@@@@@@@@@@@@@@@@@@@@@...@..............@@@@@@@@@@@@@@@@@@@@
@@@@@@@@@@@@@@@@@@@@@@@@@@@@@@@@@@...@@..............@@@@@@@@@@@@@@@@@@@
@@@@@@@@@@@@@@@@@@@@@@@@@@@@@@@@@@@...@@....T......T..@@@@@@@@@@@@@@@@@@
@@@@@@@@@@@@@@@@@@@@@@@@@@@@@.@@@@@...@@@......T...T..@@@@..@@@@@@@@@@@@
@@@@@@@@@@@@@@@@@@@@@@@@@@@....@@@@@...@@@............@@.....@@@.@@@@@@@
@@@@@@@@@@@@@@@@@@@@@@@@@@.......@@@...@@@@..T.............T...@..@@@@@@
@@@@@@@@@@@@@@@@@@@@@@@@@.........@@@....@@@@@.....................@@@@@
@@@@@@@@@@@@@@@@@@@@@@@@.T...@@@@..@@.....@@@..........T......T.....@@@@
@@@@@@@@@@@@@@@@@@@@@@@@...@@@@@@@...............T...TT..............@@@
@@@@@@@@@@@@@@@@@@@@@@@....@@@@@@@.............@@@...................@@@
@@@@@@@@@@@@@@@@@@@@@@.......@@@@........@@.....@@@@............T...@@@@
@@@@@@@@@@@@@@@@@@@@@...@@@..@@@@.......@@@@.....@@@@@@..........T.@@@@@
@@@@@@@@@@@@@@@@@@@@@..@@@@....@@.......@@@@@@.....@@@@@@.........@@@@@@
@@@@@@@@@@@@@@@@@@@@@T.@@@@@............@@@@@@....T..@@@@@@.......@@@@@@
@@@@@@@@@@@@@@@@@@@@...T@@@@....T.......@@@@@...........@@@@T....@@@@@@@
@@@@@@@@@@@@@@@@@@@@....@@@@............@@@@T.....T.......@@@@@@@@@@@@@@
@@@@@@@@@@@@@@@@@@@....@@@@...@@@@@@....@@...........T......@@@@@@@@@@@@
@@@@@@@@@@@@@@@@@@....@@@@@...@@@@@@..........T..............@@@@@@@@@@@
@@@@@@@@@@@@@@@@....@@@@@@@...@@@@@.....T...................@@@@@@@@@@@@
@@@@@@@@@@@@@@...@@@@@@@@@....@@@@@..........@@@@@.........@@@@@@@@@@@@@
@@@@@@@@@@@@@@..T@@@@@@@.....@@@@@@.......T.@@@@@@.T......@@@@@@@@@@@@@@
@@@@@@@@@@@@@@@...@@@@@@.....@@@..........T@@@@@@........@@@@@@@@@@@@@@@
@@@@@@@@@@@@@@@....T.........T...........T.@@@@@@.......@@@@@@@@@@@@@@@@
@@@@@@@@@@@@@@..............T.............T@@@@@@.T.....@@@@@@@@@@@@@@@@
@@@@@@@@@@@@...@@@@.......................@@@@@@.......@@@@@@@@@@@@@@@@@
@@@@@@@@@@@...@@@@@T.......................@@@@.......@@@@@@@@@@@@@@@@@@
@@@@@@@@@@....@@@@@................T.........@@..T...@@@@@@@@@@@@@@@@@@@
@@@@@@@@@....T@@@@@......@@@@...........T.........T.@@@@@@@@@@@@@@@@@@@@
@@@@@@@@.......@@.T....T@@@@@@........@@........T..T.@@@@@@@@@@@@@@@@@@@
@@@@@@@.................@@@@@@@@......@@@.............@@@@@@@@@@@@@@@@@@
@@@@@@@@@................@@@@@@@.......@@@..T.T........@@@@@@@@@@@@@@@@@
@@@@@@@@@@@..............@@@@@...........@............@@@@@@@@@@@@@@@@@@
@@@@@@@@@@@@.............@@...........................@@@@@@@@@@@@@@@@@@
@@@@@@@@@@@@@@.....................T...........T.....@@@@@@@@@@@@@@@@@@@
@@@@@@@@@@@@@@@@..T....T........@@@@.......T........@@@@@@@@@@@@@@@@@@@@
@@@@@@@@@@@@@@@@@@@............@@@@@............TT.@@@@@@@@@@@@@@@@@@@@@
@@@@@@@@@.....@@@@@...........@@@@@@..........@...@@@@@@@@@@@@@@@@@@@@@@
@@@@@@@@@....T..@@@...........@@@@@@......T..@@@.@@@@@@@@@@@@@@@@@@@@@@@
@@@@@@@@............@@@.......@@@@@@..T.....@@@@@@@@@@@@@@@@@@@@@@@@@@@@
@@@@@@@.........T...@@@@@T......@@@......T.@@@@@@@@@@@@@@@@@@@@@@@@@@@@@
@@@@@@@...@@.T.....@@@@@@@@.....@@T.T.....@@@@@@@@@@@@@@@@@@@@@@@@@@@@@@
@@@@@@@..@@@@...T..@@@@@@@@@.T...........@@@@@@@@@@@@@@@@@@@@@@@@@@@@@@@
@@@@@@...@@@@......@@@@@@@@@@@......T...@@@@@@@@@@@@@@@@@@@@@@@@@@@@@@@@
@@@@@@..@@@@.......@@@@.T@@@@@@@........@@@@@@@@@@@@@@@@@@@@@@@@@@@@@@@@
@@@@@@@@@@@@...............@@@@@@......@@@@@@@@@@@@@@@@@@@@@@@@@@@@@@@@@
@@@@@@@@@@......T.........@@@@@@@@....@@@@@@@@@@@@@@@@@@@@@@@@@@@@@@@@@@
@@@@@@@@@.....T...........@@@@@@@@@@.@@@@@@@@@@@@@@@@@@@@@@@@@@@@@@@@@@@
@@@@@@@@.................@@@@@@@@@@@@@@@@@@@@@@@@@@@@@@@@@@@@@@@@@@@@@@@
@@@@@@@@................@@@@@@@@@@@@@@@@@@@@@@@@@@@@@@@@@@@@@@@@@@@@@@@@
@@@@@@@@@.......T......@@@@@@@@@@@@@@@@@@@@@@@@@@@@@@@@@@@@@@@@@@@@@@@@@
@@@@@@@@@@............@@@@@@@@@@@@@@@@@@@@@@@@@@@@@@@@@@@@@@@@@@@@@@@@@@
@@@@@@@@@@@..........@@@@@@@@@@@@@@@@@@@@@@@@@@@@@@@@@@@@@@@@@@@@@@@@@@@
@@@@@@@@@@@@@.......@@@@@@@@@@@@@@@@@@@@@@@@@@@@@@@@@@@@@@@@@@@@@@@@@@@@
@@@@@@@@@@@@@@@@...@@@@@@@@@@@@@@@@@@@@@@@@@@@@@@@@@@@@@@@@@@@@@@@@@@@@@
@@@@@@@@@@@@@@@@@@@@@@@@@@@@@@@@@@@@@@@@@@@@@@@@@@@@@@@@@@@@@@@@@@@@@@@@
@@@@@@@@@@@@@@@@@@@@@@@@@@@@@@@@@@@@@@@@@@@@@@@@@@@@@@@@@@@@@@@@@@@@@@@@
