type octile
height 144
width 148
map
@@@@@@@@@@@@@@@@@@@@@@@@@@@@@@@@@@@@@@@@@@@@@@@@@@@@@@@@@@@@@@@@@@@@@@@@@@@@@@@@@@@@@@@@@@@@@@@@@@@@@@@@@@@@@@@@@@@@@@@@@@@@@@@@@@@@@@@@@@@@@@@@@@@@
@@@@@@@@@@@@@@@@@@@@@@@@@@@@@@@@@@@@@@@@@@@@@@@@@@@@@@@@@@@@@@@@@@@@@@@@@@@@@@@@@@@@@@@@@@@@@@@@@@@@@@@@@@@@@@@@@@@@@@@@@@@@@@@@@@@@@@@@@@@@@@@@@@@@
@@@@@@@@@@@@@@@@@@@@@@@@@@@@@@@@@@@@@@@@@@@@@@@@@@@@@@@@@@@@@@@@@@@@@@@@@@@@@@@@@@@@@@@@@@@@@@@@@@@@@@@@@@@@@@@@@@@@@@@@@@@@@@@@@@@@@@@@@@@@@@@@@@@@
@@@@@@@@@@@@@@@@@@@@@@@@@@@@@@@@@@@@@@@@@@@@@@@@@@@@@@@@@@@@@@@@@@@@@@@@@@@@@@@@@@@@@@@@@@@@@@@@@@@@@@@@@@@@@@@@@@@@@@@@@@@@@@@@@@@@@@@@@@@@@@@@@@@@
@@@@@@@@@@@@@@@@@@@@@@@@@@@@@@@@@@@@@@@@@@@@@@@@@@@@@@@@@@@@@@@@@@@@@@@@@@@@@@@@@@@@@@@@@@@@@@@@@@@@@@@@@@@@@@@@@@@@@@@@@@@@@@@@@@@@@@@@@@@@@@@@@@@@
@@@@@@@@@@@@@@@@@@@@@@@@@@@@@@@@@@@@@@@@@@@@@@@@@@@@@@@@@@@@@@@@@@@@@@@@@@@@@@@@@@@@@@@@@@@@@@@@@@@@@@@@@@@@@@@@@@@@@@@@@@@@@@@@@@@@@@@@@@@@@@@@@@@@
@@@@@@@@@@@@@@@@@@@@@@@@@@@@@@@@@@@@@@@@@@@@@@@@@@@@@@@@@@@@@@@@@@@@@@@@@@@@@@@@@@@@@@@@@@@@@@@@@@@@@@@@@@@@@@@@@@@@@@@@@@@@@@@@@@@@@@@@@@@@@@@@@@@@
@@@@@@@@@@@@@@@@@@@@@@@@@@@@@@@@@@@@@@@@@@@@@@@@@@@@@@@@@@@@@@@@@@@@@@@@@@@@@@@@@@@@@@@@@@@@@@@@@@@@@@@@@@@@@@@@@@@@@@@@@@@@@@@@@@@@@@@@@@@@@@@@@@@@
@@@@@@@@@@@@@@@@@@@@@@@@@@@@@@@@@@@@@@@@@@@@@@@@@@@@@@@@@@@@@@@@@@@@@@@@@@@@@@@@@@@@@@@@@@@@@@@@@@@@@@@@@@@@@@@@@@@@@@@@@@@@@@@@@@@@@@@@@@@@@@@@@@@@
@@@@@@@@@@@@@@@@@@@@@@@@@@@@@@@@@@@@@@@@@@@@@@@@@@@@@@@@@@@@@@@@@@@@@@@@@@@@@@@@@@@@@@@@@@@@@@@@@@@@@@@@@@@@@@@@@@@@@@@@@@@@@@@@@@@@@@@@@@@@@@@@@@@@
@@@@@@@@@@@@@@@@@@@@@@@@@@@@@@@@@@@@@@@@@@@@@@@@@@@@@@@@@@@@@@@@@@@@@@@@@@@@@@@@@@@@@@@@@@@@@@@@@@@@@@@@@@@@@@@@@@@@@@@@@@@@@@@@@@@@@@@@@@@@@@@@@@@@
@@@@@@@@@@@@@@@@@@@@@@@@@@@@@@@@@@@@@@@@@@@@@@@@@@@@@@@@@@@@@@@@@@@@@@@@@@@@@@@@@@@@@@@@@@@@@@@@@@@@@@@@@@@@@@@@@@@@@@@@@@@@@@@@@@@@@@@@@@@@@@@@@@@@
@@@@@@@@@@@@@@@@@@@@@@@@@@@@@@@@@@@@@@@@@@@@@@@@@@@@@@@@@@@@@@@@@@@@@@@@@@@@@@@@@@@@@@@@@@@@@@@@@@@@@@@@@@@@@@@@@@@@@@@@@@@@@@@@@@@@@@@@@@@@@@@@@@@@
@@@@@@@@@@@@@@@@@@@@@@@@@@@@@@@@@@@@@@@@@@@@@@@@@@@@@@@@@@@@@@@@@@@@@@@@@@@@@@@@@@@@@@@@@@@@@@@@@@@@@@@@@@@@@@@@@@@@@@@@@@@@@@@@@@@@@@@@@@@@@@@@@@@@
@@@@@@@@@@@@@@@@@@@@@@@@@@@@@@@@@@@@@@@@@@@@@@@@@@@@@@@@@@@@@@@@@@@@@@@@@@@@@@@@@@@@@@@@@@@@@@@@@@@@@@@@@@@@@@@@@@@@@@@@@@@@@@@@@@@@@@@@@@@@@@@@@@@@
@@@@@@@@@@@@@@@@@@@@@@@@@@@@@@@@@@@@@@@@@@@@@@@@@@@@@@@@@@@@@@@@@@@@@@@@@@@@@@@@@@@@@@@@@@@@@@@@@@@@@@@@@@@@@@@@@@@@@@@@@@@@@@@@@@@@@@@@@@@@@@@@@@@@
@@@@@@@@@@@@@@@@@@@@@@@@@@@@@@@@@@@@@@@@@@@@@@@@@@@@@@@@@@@@@@@@@..@@@@@@@@@@@@@@@@@@@@@@@@@@@@@@@@@@@@@@@@@@@@@@@@@@@@@@@@@@@@@@@@@@@@@@@@@@@@@@@@@
@@@@@@@@@@@@@@@@@@@@@@@@@@@@@@@@@@@@@@@@@@@@@@@@@@@@@@@@@@@@@@@TT..T@@@@@@@@@@@@@@@@@@@@@@@@@@@@@@@@@@@@@@@@@@@@@@@@@@@@@@@@@@@@@@@@@@@@@@@@@@@@@@@@
@@@@@@@@@@@@@@@@@@@@@@@@@@@@@@@@@@@@@@@@@@@@@@@@@@@@@@@@@@@@@@...T...@@@@@@@@@@@@@@@@@@@@@@@@@@@@@@@@@@@@@@@@@@@@@@@@@@@@@@@@@@@@@@@@@@@@@@@@@@@@@@@
@@@@@@@@@@@@@@@@@@@@@@@@@@@@@@@@@@@@@@@@@@@@@@@@@@@@@@@@@@@@@...TT..T.@@@@@@@@@@@@@@@@@@@@@@@@@@@@@@@@@@@@@@@@@@@@@@@@@@@@@@@@@@@@@@@@@@@@@@@@@@@@@@
@@@@@@@@@@@@@@@@@@@@@@@@@@@@@@@@@@@@@@@@@@@@@@@@@@@@@@@@@@@@....T..T..@@@@@@@@@@@@@@@@@@@@@@@@@@@@@@@@@@@@@@@@@@@@@@@@@@@@@@@@@@@@@@@@@@@@@@@@@@@@@@
@@@@@@@@@@@@@@@@@@@@@@@@@@@@@@@@@@@@@@@@@@@@@@@@@@@@@@@@@@T...@@@..T...@@@@@@@@@@@@@@@@@@@@@@@@@@@@@@@@@@@@@@@@@@@@@@@@@@@@@@@@@@@@@@@@@@@@@@@@@@@@@
@@@@@@@@@@@@@@@@@@@@@@@@@@@@@@@@@@@@@@@@@@@@@@@@@@@@@@@@@.....@@@...T...@@@@@@@@@@@@@@@@@@@@@@@@@@@@@@@@@@@@@@@@@@@@@@@@@@@@@@@@@@@@@@@@@@@@@@@@@@@@
@@@@@@@@@@@@@@@@@@@@@@@@@@@@@@@@@@@@@@@@@@@@@@@@@@@@@@@@.........T....T.@@@@@@@@@@@@@@@@@@@@@@@@@@@@@@@@@@@@@@@@@@@@@@@@@@@@@@@@@@@@@@@@@@@@@@@@@@@@
@@@@@@@@@@@@@@@@@@@@@@@@@@@@@@@@@@@@@@@@@@@@@@@@@@@@@@@@@...T.T....@@.TT.@@@@@@@@@@@@@@@@@@@@@@@@@@@@@@@@@@@@@@@@@@@@@@@@@@@@@@@@@@@@@@@@@@@@@@@@@@@
@@@@@@@@@@@@@@@@@@@@@@@@@@@@@@@@@@@@@@@@@@@@@@@@@@@@@@@@@@....TT...@@@.T..@@@@@@@@@@@@@@@@@@@@@@@@@@@@@@@@@@@@@@@@@@@@@@@@@@@@@@@@@@@@@@@@@@@@@@@@@@
@@@@@@@@@@@@@@@@@@@@@@@@@@@@@@@@@@@@@@@@@@@@@@@@@@@@@@@@@@....T..T.@@@@..T.@@@@@@@@@@@@@@@@@@@@@@@@@@@@@@@@@@@@@@@@@@@@@@@@@@@@@@@@@@@@@@@@@@@@@@@@@
@@@@@@@@@@@@@@@@@@@@@@@@@@@@@@@@@@@@@@@@@@@@@@@@@@@@@T.@@@@T.T......@@@@@TT..@@@@@@@@@@@@@@@@@@@@@@@@@@@@@@@@@@@@@@@@@@@@@@@@@@@@@@@@@@@@@@@@@@@@@@@
@@@@@@@@@@@@@@@@@@@@@@@@@@@@@@@@@@@@@@@@@@@@@@@@@@@T....@@@@@T........@@@@.TT.@@@@@@@@@@@@@@@@@@@@@@@@@@@@@@@@@@@@@@@@@@@@@@@@@@@@@@@@@@@@@@@@@@@@@@
@@@@@@@@@@@@@@@@@@@@@@@@@@@@@@@@@@@@@@@@@@@@@@@@@@......T@@@@@T.TTT....@@@...T.@@@@@@@@@@@@@@@@@@@@@@@@@@@@@@@@@@@@@@@@@@@@@@@@@@@@@@@@@@@@@@@@@@@@@
@@@@@@@@@@@@@@@@@@@@@@@@@@@@@@@@@@@@@@@@@@@@@@@@@@T.....T.@@@@.....T..T@@@T.......@@@@@@@@@@@@@@@@@@@@@@@@@@@@@@@@@@@@@@@@@@@@@@@@@@@@@@@@@@@@@@@@@@
@@@@@@@@@@@@@@@@@@@@@@@@@@@@@@@@@@@@@@@@@@@@@@@@@@@T.......@@@@.........@@T........@@@@@@@@@@@@@@@@@@@@@@@@@@@@@@@@@@@@@@@@@@@@@@@@@@@@@@@@@@@@@@@@@
@@@@@@@@@@@@@@@@@@@@@@@@@@@@@@@@@@@@@@@@@@@@@@@@@@@@T..T....@@@@@T.T.........T......@@@@@@@@@@@@@@@@@@@@@@@@@@@@@@@@@@@@@@@@@@@@@@@@@@@@@@@@@@@@@@@@
@@@@@@@@@@@@@@@@@@@@@@@@@@@@@@@@@@@@@@@@@@@@@@@@@@@@@.T...TT.@@@@@.TT..T.TT.TTT......@@@@@@@@@@@@@@@@@@@@@@@@@@@@@@@@@@@@@@@@@@@@@@@@@@@@@@@@@@@@@@@
@@@@@@@@@@@@@@@@@@@@@@@@@@@@@@@@@@@@@@@@@@@@@@@@@@@@@@.T....T.@@@@...T..T.TT........T.@@@@@@@@@@@@@@@@@@@@@@@@@@@@@@@@@@@@@@@@@@@@@@@@@@@@@@@@@@@@@@
@@@@@@@@@@@@@@@@@@@@@@@@@@@@@@@@@@@@@@@@@@@@@..@@@@@@@@.TT.....@@@@....T...T.TT.T......@@@@@@@@@@@@@@@@@@@@@@@@@@@@@@@@@@@@@@@@@@@@@@@@@@@@@@@@@@@@@
@@@@@@@@@@@@@@@@@@@@@@@@@@@@@@@@@@@@@@@@@@@.T.T@@@@@@@@@TTT.TT..@@@.T.T......TT@@@.....@@@@@@@@@@@@@@@@@@@@@@@@@@@@@@@@@@@@@@@@@@@@@@@@@@@@@@@@@@@@@
@@@@@@@@@@@@@@@@@@@@@@@@@@@@@@@@@@@@@@@@@@T.T..@@@@@@@@@@...T...T.TTT@....T...T@@@@.T.TTT@@@@@@@@@@@@@@@@@@@@@@@@@@@@@@@@@@@@@@@@@@@@@@@@@@@@@@@@@@@
@@@@@@@@@@@@@@@@@@@@@@@@@@@@@@@@@@@@@@@@@@...T@@@@@@@@@@@.TTT....T..@@@.T.TT...@@@@@T.TT..@@@@@@@@@@@@@@@@@@@@@@@@@@@@@@@@@@@@@@@@@@@@@@@@@@@@@@@@@@
@@@@@@@@@@@@@@@@@@@@@@@@@@@@@@@@@@@@@@@@@.....@@@@T@@@@@@..T..T.....@@@@@......T@@@@@......@@@@@@@@@@@@@@@@@@@@@@@@@@@@@@@@@@@@@@@@@@@@@@@@@@@@@@@@@
@@@@@@@@@@@@@@@@@@@@@@@@@@@@@@@@@@@@@@@TT...TT.@@@.T@@@@@@T.T..T.....@@@@@..T.T...@@@@......@@@@@@@@@@@@@@@@@@@@@@@@@@@@@@@@@@@@@@@@@@@@@@@@@@@@@@@@
@@@@@@@@@@@@@@@@@@@@@@@@@@@@@@@@@@@@@@............TT..@@@T............@@@@.T..T....@@@@......@@@@@@@@@@@@@@@@@@@@@@@@@@@@@@@@@@@@@@@@@@@@@@@@@@@@@@@
@@@@@@@@@@@@@@@@@@@@@@@@@@@@@@@@@@@@@@.........T.TT...........TTT@@..@@@@@@T....T...@@@..T.TT.@@@@@@@@@@@@@@@@@@@@@@@@@@@@@@@@@@@@@@@@@@@@@@@@@@@@@@
@@@@@@@@@@@@@@@@@@@@@@@@@@@@@@@@@@@@@@@...T.T..T......T..T..T.T.@@@@@@@@@@@@.T......T@@T.TT...T@@@@@@@@@@@@@@@@@@@@@@@@@@@@@@@@@@@@@@@@@@@@@@@@@@@@@
@@@@@@@@@@@@@@@@@@@@@@@@@@@@@@@@@@@@@@@@..T..TT.T.....T.......T@@@@@@@@@@@@@@@...T.....T....T..T@@@@@@@@@@@@@@@@@@@@@@@@@@@@@@@@@@@@@@@@@@@@@@@@@@@@
@@@@@@@@@@@@@@@@@@@@@@@@@@@@@@@@@.@@@@@@@TTTTT...T..T.T..T..T...@@@@@@@@@@@@@@@T.T........TT...T.@@@@@@@@@@@@@@@@@@@@@@@@@@@@@@@@@@@@@@@@@@@@@@@@@@@
@@@@@@@@@@@@@@@@@@@@@@@@@@@@@@@@@..@@@@@@@...........T..........T@@@@@@@@@T..@@@.........T.@......@@@@@@@@@@@@@@@@@@@@@@@@@@@@@@@@@@@@@@@@@@@@@@@@@@
@@@@@@@@@@@@@@@@@@@@@@@@@@@@@@@@...@@@@@@@@T.T..T.......TT.......@@@@@@@@TT..@@@@......T..@@@......@@@@@@@@@@@@@@@@@@@@@@@@@@@@@@@@@@@@@@@@@@@@@@@@@
@@@@@@@@@@@@@@@@@@@@@@@@@@@@@@.....@@@@@@@@@.....T........TT..T.@@@@@@@@....@@@@@@..T.T.TT@@@@@T.....@@@@@@@@@@@@@@@@@@@@@@@@@@@@@@@@@@@@@@@@@@@@@@@
@@@@@@@@@@@@@@@@@@@@@@@@@@@@@.....@@@@@@@@@@@T.....T...........@@@@@@@@...T@@@@@@@@T....TT@@@@@@T..T.@@@@@@@@@@@@@@@@@@@@@@@@@@@@@@@@@@@@@@@@@@@@@@@
@@@@@@@@@@@@@@@@@@@@@@@@@@@@@TT...@@@@..@@@@@@.T.T..T.....T....@@@@@@@T..T@@@@@@@@@..T......T@@@@....@@@@@@@@@@@@@@@@@@@@@@@@@@@@@@@@@@@@@@@@@@@@@@@
@@@@@@@@@@@@@@@@@@@@@@@@@@@@T......T@.T..@@@@@......T...TT....T@@@@@@....@@@@@@@@@@@..T.T..T..@@@@.T.T..@@@@@@@@@@@@@@@@@@@@@@@@@@@@@@@@@@@@@@@@@@@@
@@@@@@@@@@@@@@@@@@@@@@@@@@T......T.TT..TTT@@@@.................@@@@@TT.T@@@@@@@@.T@@@@......T..@@@T.T....@@@@@@@@@@@@@@@@@@@@@@@@@@@@@@@@@@@@@@@@@@@
@@@@@@@@@@@@@@@@@@@@@@@@@@@T....T....T.....TT...T..T...T...T...@@@....T@@@@@@@@TT..@@@@T......TT@@....T..T@@@@@@@@@@@@@@@@@@@@@@@@@@@@@@@@@@@@@@@@@@
@@@@@@@@@@@@@@@@@@@@@@@@@@@@.TTT.T....T....T....@@@@T.TT.TT..TT.......@@@@@@@@@TT.T..@@@.T......T.T.TT...T.@@@@@@@@@@@@@@@@@@@@@@@@@@@@@@@@@@@@@@@@@
@@@@@@@@@@@@@@@@@@@@@@@@@@@@@T.TT.T.....TT.T...@@@@@.............T.T.@@@@@@@@@@@.T...@@@@.T.......T.......T.@@@@@@@@@@@@@@@@@@@@@@@@@@@@@@@@@@@@@@@@
@@@@@@@@@@@@@@@@@@@@@@..@@@@@@T.T..T.T........@@@@@@..@@..T.....T....@@@@@@T@@@@....@@@@@@....T..T..T.TTT..T.@@@@@@@@@@@@@@@@@@@@@@@@@@@@@@@@@@@@@@@
@@@@@@@@@@@@@@@@@@@@@...@@@@@@@T.T......T..T.@@@@@@..@@@.T..T.T......@@@@@T..@@....@@@@@@@@.TT.......TT...T...@@@@@@@@@@@@@@@@@@@@@@@@@@@@@@@@@@@@@@
@@@@@@@@@@@@@@@@@@@@@T..@@@@@@@@.T.....T..T..@@@@@T.@@@@...T.T......T@@@@@.......T@@@@@@@@@....T......@@.......@@@@@@@@@@@@@@@@@@@@@@@@@@@@@@@@@@@@@
@@@@@@@@@@@@@@@@@@@@T..@@@@@@@@@@........T..T.@@@T.@@@@TTT..T.T.T...T@@..T.....T.@@@@@@@@@@@.T........@@@@...T..@@@@@@@@@@@@@@@@@@@@@@@@@@@@@@@@@@@@
@@@@@@@@@@@@@@@@@@..TT.@@@@@@@@@@@TT.T..T..TT..@..@@@@.T......T...TTT..T........@@@@@@@@TT@@@........T@@@@@T.T...@@@@@@@@@@@@@@@@@@@@@@@@@@@@@@@@@@@
@@@@@@@@@@@@@@@@@.T.....@@@T.@@@@@@TT......T.....@@@@.T.@@...T.......T.TTTT..T.@@@@@@@@T...@.T.......T..@@@@T.....@@@@@@@@@@@@@@@@@@@@@@@@@@@@@@@@@@
@@@@@@@@@@@@@@@@@..T.....@....@@@@@.....T.T.....@@@@...@@@@..T...T...TT.T...T.@@@@@@@@@@......@@T.T..T.TT@@@@TT....@@@@@@@@@@@@@@@@@@@@@@@@@@@@@@@@@
@@@@@@@@@@@@@@@@@@......T.....T@@@T....T.T.T....@@@.T.@@@@@@T.....T.T........@@@@@@@@@@@@...T.@@@@TT...T.T@@@@....T..@@@@@@@@@@@@@@@@@@@@@@@@@@@@@@@
@@@@@@@@@@@@@@@@@@@@...T.......TT....T...T.....T@@...@@@@@@@..@@.T.....T..T..@@@@@@@.@@@@.TTT.T@@@@.T...TT@@@@........@@@@@@@@@@@@@@@@@@@@@@@@@@@@@@
@@@@@@@@@@@@@@@@@@@@@T..TTT.....T.T.........T...T.TTT@@@@@@..@@@@T.....T.....@@@@@@..@@@.TT.T..T@@@@...T..TT..T.......@@@@@@@@@@@@@@@@@@@@@@@@@@@@@@
@@@@@@@@@@@@@@.@@@@@@T.......T....TT.T.........T...TT@@@@@..@@@@@T......T.@@..@@@@@TT.@.....@...T@@@@......TT..T...TTT@@@@@@@@@@@@@@@@@@@@@@@@@@@@@@
@@@@@@@@@@@@@@..@@@@@@......TTTT....T....@.T....T..T..@@@TT@@@@..T.......@@@@..@@@........T@@@@TT@@@@@......TT.........@@@@@@@@@@@@@@@@@@@@@@@@@@@@@
@@@@@@@@@@.TT....@@@@@@@.......T........@@@.....T.........@@@@....T.....@@@.@@....TT..T...@@@@@@@@@@@@@T......T.TT..TT..T.@@@@@@@@@@@@@@@@@@@@@@@@@@
@@@@@@@@@T.TT.....@@@@@@@T.....TT@@@T..@@@@@...T...TT....@@@@T..@@@....@@@...@@T.....T.T.T@@@@@@@@@@@@@@...TT.T....T.TT....@@@@@@@@@@@@@@@@@@@@@@@@@
@@@@@@@@@....T.....@@@@@@......T@@@@T.@@@@@@.....T......@@@@T..@@@@.T.@@@.....@@..T..T....T@@@@@@@@@@@@@@...TT..TTT@@.T....T@@@@@@@@@@@@@@@@@@@@@@@@
@@@@@@@@....T......@@@@@@@.T..TT@@@..@@@@@@.T.TT........@@@..@@@@@@@.@@@...T...@@...T...T..@@@@@@@@@@T@@@@.T.......@@@@....T.@@@@@@@@@@@@@@@@@@@@@@@
@@@@@@......T.....T..@@@@@@.....@@..@@@@@@@.T...T.....TT@@.T.@@@@@@@@@@.T.......@@T......T.@@@@@@@@@...@@@@.TT..T.T@@@@@...T..@@@@@@@@@@@@@@@@@@@@@@
@@@@@@@TTT.T.T.@@......@@@@...T.T..@@@@@@@@......T..T........@@@@@@@@...T...T.T.T@@....T..@@@@@@@@@T..@@@@@....TT...T@@@@...T..@@@@@@@@@@@@@@@@@@@@@
@@@@@@@@...TTT@@@@......@@....@@..@@@@@@@@TTT.....TTT....T.T..@@@@@@TT..T.TTT..T.@@.T.....@@@@@@@@...@@@@@@@..T.......@@@.......@@@@@@@@@@@@@@@@@@@@
@@@@@@@@@...T.@@@@@@.TT....TT@@@@@@@@@@@@.....@@@@........TTTT.@@@@.......@T.TT..T@@T..T..@@@@@@TT.T@@@@@@@@@@..TT...T.@@@.T...T..@@@@@@@@@@@@@@@@@@
@@@@@@@@@@.T....@@@@@....T..@@@@@@@@@@@@..T..@@@@@TT........T.T@@@T....T.@@@T.TT...@@....@@@@@@....@@@@@@@@@@@@...TT..T@@@@..T..T..@@@@@@@@@@@@@@@@@
@@@@@@@@@@@..T.T.T@@@@T..T.@@@@@@@@@@@@....T@@@@@@.....T..T...T@@T..T....@@@@TT.TT.@@@T..@@@@@@...@@@@@@@@@T@@@@TT.TT..T@@@....T.T..@@@@@@@@@@@@@@@@
@@@@@@@@@@@@T..TT..@@@..T.T.@@@@@@@@@@...TT@@@@@@@..TT.T......@@@@...TT....@@@..T..@@@.TT@@@@T...@@@@@@@@@...@@@@..T...TT.TT..TT..T.@@@@@@@@@@@@@@@@
@@@@@@@@@@@@@TT..T.@@@@......@@@@@@@@.....@@@@@@@....T...T...@@@@@.......T..@@...T..@@..T.TT....@@@@@@@@@@@T..@@@@@TT.........T......T@@@@@@@@@@@@@@
@@@@@@@@@@@@@@T.T..T@@@.T.T...@@@@@@@....@@@@@@@...TT..T.....@@@@@@...T.....@@.T......T......T.@@@@@@@@@@@@T.T.@@@@@...T......T..TT..T.@@@@@@@@@@@@@
@@@@@@@@@@@@@@@.....T...T..T...@@@@@@@..@@@@@@@@.....T....TT.@@@@@@@@.T....@@@@..T....T.TT......@@@@@@@@@@@T...@@@@@....T......T....TT..@@@@@@@@@@@@
@@@@@@@@@@@@@@@@.TTTTTT.........@@@@@@@@@@@@@@@@@.......@...T.@@@@@@@@@@@@@@@@@T..TT.T...T.T....@@@@@@.@@@....@@@@@@@...T.TT...T.@@T...T@@@@@@@@@@@@
@@@@@@@@@@@@@@@@@...T.....T.T..TT@@@@@@@@@@@@@@@@...T.T@@@.T..T@@@@@@@@@@@@@@@@.T...............@@@@....@....@@@@@@@@@...T.T...T.@@@.....@@@@@@@@@@@
@@@@@@@@@@@@@@@@@@....T.....T....@@@@@@@@@@@@@@@@T...T@@@@@T...TT@@@@@@@@@..@@@T..T....T....T.T.@@.T........@@@@@@@@@@@...T....TT@@@@......@@@@@@@@@
@@@@@@@@@@@@@@@@@@@@..T..T..@.T....@@@@@@@@@@T@@....T@@@@@..T..T..@@@@@@@...T@@.T.T...T.............T...TT.@@@@@@@@@@@...T.....T..@@@@@.....@@@@@@@@
@@@@@@@@@@@@@@@@@@@@@T...T.@@@@TT.T.@@@@@@@@.......T@@@@@@.TT..TT.@@@@@@T..T.....T.....TT.............T....@@@@@@@@.TT.TT....T......@@@@....@@@@@@@@
@@@@@@@@@@@@@@@@@@@@@@...TT@@@@@....T@@@@@@@@..T.T.@@@@@@@.........@@@@@T.T........T.T@@@T.TTT.TT.........@@@@@@@@@..T..@@@.T........@@@.....@@@@@@@
@@@@@@@@@@@@@@@@@@@@@@@...T.@@@@@....T@@@@@@@@....@@@@@@@@TTT..T.....@@@@..T......T.@@@@@@T....T.T.....T.@@@@@@@@@@...T.@@@@.........@@@@...@@@@@@@@
@@@@@@@@@@@@@@@@@@@@@@@@......@@@@T..T.@@@@@@@@..@@@@@@@@..............@@@.....TT..@@@@@@@.....TT..T.T..@@@@@@@@@@@TT...T@@@@TT.......T@T..@@@@@@@@@
@@@@@@@@@@@@@@@@@@@@@@@@@...T..@@@@T....@@@@@@@@@@@@@@@@@T.T....T..T....@@TT....TT.@@@@@@@....TT@......T@@@@@@..@@@T.....T@@@@.TT.....T...@@@@@@@@@@
@@@@@@@@@@@@@@@@@@@@@@@@@@T....@@@@@..TT.@@@@@@@@@@@@@@@@@....T......TT....T...TT..@@@@@@.T..T.@@@.....T@@@@@...T@.T..T.T..@@@@.T....TT..@@@@@@@@@@@
@@@@@@@@@@@@@@@@@@@@@@@@@@@....T@@@@.T..T.@@@@@@@@@@@@@@@@.....T...@@.....T...TTT.@@@@@@T..TT..T@@@.T.T...@@@............T..@@@@..T.T...@@@@@@@@@@@@
@@@@@@@@@@@@@@@@@@@@@@@@@@@@.T..............@@@@@@@@@.T@@T.T..TT..@@@@..T.T.T.TT..@@@@@........T.@@..T...T......T.....T....T.@@@@....TT@@@@@@@@@@@@@
@@@@@@@@@@@@@@@@@@@@@@@@@@@@@T.T......T.T.TT.@@@@@@@........@@...@@@@@T..TTT.T.TTT.@@@@...T..TT............T..TT.T.T...T...TT.@@@@....@@@@@@@@@@@@@@
@@@@@@@@@@@@@@@@@@@@@@@@@@@@@@.T..TTT..@..T.T@@@@@@@.....T.@@@@.@@@@@.....T..TT.....@T..............T.............T....T.T.T...@@@@TT@@@@@@@@@@@@@@@
@@@@@@@@@@@@@@@@@@@@@@@@@@@@@@@.....T.@@@@.T.@@@@@@@@T....@@@@@@@@@@@...TT.T..T.......T.T.....TT.T.T...T......TT...@@......T..T.@@@@@@@@@@@@@@@@@@@@
@@@@@@@@@@@@@@@@@@@@@@@@@@@@@@@@@T....@@@@@T.TT.@@@@@@....@@@@@@@@@@@@...T.TTT....TTTT...T..T..T.TTTT....T..T..T.T@@@@..T..TT..T.@@@@@@@@@@@@@@@@@@@
@@@@@@@@@@@@@@@@@@@@@@@@@@@@@@@@@@..T.@@@@@@...TT@@@@...TT.@@@@@@@@@@T..T..TT.......TT..T.T.T......T....T.TTT.....@@@@@...........@@@@@@@@@@@@@@@@@@
@@@@@@@@@@@@@@@@@@@@@@@@@@@@@@@@@@@...T.@@@@@.TT..@@T..@...@@@@@@@@@T.TT.@.....T..TT..TT..T.T.TT.....T.TT..T...T...@@@@@T.T....T.@@@@@@@@@@@@@@@@@@@
@@@@@@@@@@@@@@@@@@@@@@@@@@@@@@@@@@@@T....@@@@....T.T..@@@@@@@@@@@@@T....@@@@@TTT...T.....TT.........TTT....T...T...@@@@@@T.T....@@@@@@@@@@@@@@@@@@@@
@@@@@@@@@@@@@@@@@@@@@@@@@@@@@@@@@@@@@.....@@@@....TT.@@@@@@@@@@@@@....T@@@@@@TT..TT.TTT....T...T....TT.T..T....T...T@@@@@@.....@@@@@@@@@@@@@@@@@@@@@
@@@@@@@@@@@@@@@@@@@@@@@@@@@@@@@@@@@@@@.....@@@T......@@@@@@@@@@@@..T..@@@@@@@.T.....T@@.....T...T..@..T......T...T.T.@@@@@@...@@@@@@@@@@@@@@@@@@@@@@
@@@@@@@@@@@@@@@@@@@@@@@@@@@@@@@@@@@@@@@.T..T@@........@@@@@@@@@@TT.T.@@@@@@@...T.TT..@@@.TT...T.TT@@@....T......T...@@@@@@@@.@@@@@@@@@@@@@@@@@@@@@@@
@@@@@@@@@@@@@@@@@@@@@@@@@@@@@@@@@@@@@@@@............T..T@@@@@@@@@T..@@@@@@@...TT......@@..T..T.T.@@@..T....T..T.T..@@@@@@@@@@@@@@@@@@@@@@@@@@@@@@@@@
@@@@@@@@@@@@@@@@@@@@@@@@@@@@@@@@@@@@@@@@@...T.T...T......@@@@@@@@@.@@@@@@@...TT.T....T..TT.....T..@.T.......T......@@@@@@@@@@@@@@@@@@@@@@@@@@@@@@@@@
@@@@@@@@@@@@@@@@@@@@@@@@@@@@@@@@@@@@@@@@@@...T.T.T..T.T.T.@@@@@@@@@@@@@@@@@..TT..T.........TT....T..T.T...T..T.TT..T@@@@@@@@@@@@@@@@@@@@@@@@@@@@@@@@
@@@@@@@@@@@@@@@@@@@@@@@@@@@@@@@@@@@@@@@@@@@....TTT.@@....T@@@@@@@@@@@@@@@@@.TT....@@.......T........T.....@T.T...T.T.T@@@@@@@@@@@@@@@@@@@@@@@@@@@@@@
@@@@@@@@@@@@@@@@@@@@@@@@@@@@@@@@@@@@@@@@@@@@.T....@@@@.T.T@@@@@@@@@@@@@@@@@TT.TT@@@@.....T..T.TT......@@@@@@...TTT....T@@@@@@@@@@@@@@@@@@@@@@@@@@@@@
@@@@@@@@@@@@@@@@@@@@@@@@@@@@@@@@@@@@@@@@@@@@@T....@@@@@..T.T.@@@@@@@@@@@@......@@@@@@.T......T....T...@@@@@@@..T..T..T@@@@@@@@@@@@@@@@@@@@@@@@@@@@@@
@@@@@@@@@@@@@@@@@@@@@@@@@@@@@@@@@@@@@@@@@@@@@@.....@@@@@T.....@@@@@@@@@..T....@@@@@@@@.T..T.......T...@@@@@@@@..T..T.@@@@@@@@@@@@@@@@@@@@@@@@@@@@@@@
@@@@@@@@@@@@@@@@@@@@@@@@@@@@@@@@@@@@@@@@@@@@@@@T.T.T.@@@@T.....@@@@@@@@@.....@@@@@@@@@...TTT..T....T.T..@@@@@@@....T@@@@@@@@@@@@@@@@@@@@@@@@@@@@@@@@
@@@@@@@@@@@@@@@@@@@@@@@@@@@@@@@@@@@@@@@@@@@@@@@@T.....@@@@.T..T.@@@@@@@@@...@@@@@@@@..T.T........T.....T.@@@@@@@...@@@@@@@@@@@@@@@@@@@@@@@@@@@@@@@@@
@@@@@@@@@@@@@@@@@@@@@@@@@@@@@@@@@@@@@@@@@@@@@@@@@....T.@@@.......@@@@@@@@@.@@@@@@@@....T.....T.........TT@@@@@@@@.@@@@@@@@@@@@@@@@@@@@@@@@@@@@@@@@@@
@@@@@@@@@@@@@@@@@@@@@@@@@@@@@@@@@@@@@@@@@@@@@@@@@@...TT@@@TT...TT.@@@@@@@@@@@@@@@@...T..T....T.....T..T.T@@@@@@@@@@@@@@@@@@@@@@@@@@@@@@@@@@@@@@@@@@@
@@@@@@@@@@@@@@@@@@@@@@@@@@@@@@@@@@@@@@@@@@@@@@@@@@@T...........T.TT@@@@@@@@@@@@@@@@.T..TT...T...TT..T.T.@@@@@@@@@@@@@@@@@@@@@@@@@@@@@@@@@@@@@@@@@@@@
@@@@@@@@@@@@@@@@@@@@@@@@@@@@@@@@@@@@@@@@@@@@@@@@@@@@........TTT...TT@@@@@@@@@@@@@@@@..T.....T...TT.TT...@@@@@@@@@@@@@@@@@@@@@@@@@@@@@@@@@@@@@@@@@@@@
@@@@@@@@@@@@@@@@@@@@@@@@@@@@@@@@@@@@@@@@@@@@@@@@@@@@@@.........TTT.T.@@@@@@@@@@@@@@......T..T@.....TT.....@@@@@@@@@@@@@@@@@@@@@@@@@@@@@@@@@@@@@@@@@@
@@@@@@@@@@@@@@@@@@@@@@@@@@@@@@@@@@@@@@@@@@@@@@@@@@@@@@@..TT...T...TT..@@@@@@@@TT@@.T.......T@@@....T.......@@@@@@@@@@@@@@@@@@@@@@@@@@@@@@@@@@@@@@@@@
@@@@@@@@@@@@@@@@@@@@@@@@@@@@@@@@@@@@@@@@@@@@@@@@@@@@@@@@T.T.....@...T..@@@@@@TT.TT.....T...T@@@@..TT........@@@@@@@@@@@@@@@@@@@@@@@@@@@@@@@@@@@@@@@@
@@@@@@@@@@@@@@@@@@@@@@@@@@@@@@@@@@@@@@@@@@@@@@@@@@@@@@@@@.T.T..@@@TTTTT.@@@@@@T.TT..T.......@@@@@@.T.......@@@@@@@@@@@@@@@@@@@@@@@@@@@@@@@@@@@@@@@@@
@@@@@@@@@@@@@@@@@@@@@@@@@@@@@@@@@@@@@@@@@@@@@@@@@@@@@@@@@@.....@@@@T.T.T@@@@@@@..T.T...T....@@@@@@@..TT.T.@@@@@@@@@@@@@@@@@@@@@@@@@@@@@@@@@@@@@@@@@@
@@@@@@@@@@@@@@@@@@@@@@@@@@@@@@@@@@@@@@@@@@@@@@@@@@@@@@@@@@@T...@@@@@@.....@@@@@..T.....TT....@@@@@@@...T.@@@@@@@@@@@@@@@@@@@@@@@@@@@@@@@@@@@@@@@@@@@
@@@@@@@@@@@@@@@@@@@@@@@@@@@@@@@@@@@@@@@@@@@@@@@@@@@@@@@@@@@@.T...@@@@@..T..@@@TT........T.T...@@@@@@@T.T@@@@@@@@@@@@@@@@@@@@@@@@@@@@@@@@@@@@@@@@@@@@
@@@@@@@@@@@@@@@@@@@@@@@@@@@@@@@@@@@@@@@@@@@@@@@@@@@@@@@@@@@@@.....@@@@.T.........@@..T.T......@@@@@@@@T@@@@@@@@@@@@@@@@@@@@@@@@@@@@@@@@@@@@@@@@@@@@@
@@@@@@@@@@@@@@@@@@@@@@@@@@@@@@@@@@@@@@@@@@@@@@@@@@@@@@@@@@@@@@.....@@@@.......TT@@@@.......T.@@@@@@@@@@@@@@@@@@@@@@@@@@@@@@@@@@@@@@@@@@@@@@@@@@@@@@@
@@@@@@@@@@@@@@@@@@@@@@@@@@@@@@@@@@@@@@@@@@@@@@@@@@@@@@@@@@@@@@@.....@@@........@@@@@@T......T@@@@@@@@@@@@@@@@@@@@@@@@@@@@@@@@@@@@@@@@@@@@@@@@@@@@@@@
@@@@@@@@@@@@@@@@@@@@@@@@@@@@@@@@@@@@@@@@@@@@@@@@@@@@@@@@@@@@@@@@T....TTTT..T.T..@@@@@@.T......@@@@@@@@@@@@@@@@@@@@@@@@@@@@@@@@@@@@@@@@@@@@@@@@@@@@@@
@@@@@@@@@@@@@@@@@@@@@@@@@@@@@@@@@@@@@@@@@@@@@@@@@@@@@@@@@@@@@@@@@..TTT..T........@@@@@@...T....@@@@@@@@@@@@@@@@@@@@@@@@@@@@@@@@@@@@@@@@@@@@@@@@@@@@@
@@@@@@@@@@@@@@@@@@@@@@@@@@@@@@@@@@@@@@@@@@@@@@@@@@@@@@@@@@@@@@@@@@....T...T.......@@@@@@..T......@@@@@@@@@@@@@@@@@@@@@@@@@@@@@@@@@@@@@@@@@@@@@@@@@@@
@@@@@@@@@@@@@@@@@@@@@@@@@@@@@@@@@@@@@@@@@@@@@@@@@@@@@@@@@@@@@@@@@@@@TT...T.........@@@@@@TT.....@@@@@@@@@@@@@@@@@@@@@@@@@@@@@@@@@@@@@@@@@@@@@@@@@@@@
@@@@@@@@@@@@@@@@@@@@@@@@@@@@@@@@@@@@@@@@@@@@@@@@@@@@@@@@@@@@@@@@@@@@@T..T.T.T@TT....@@@@@@.....@@@@@@@@@@@@@@@@@@@@@@@@@@@@@@@@@@@@@@@@@@@@@@@@@@@@@
@@@@@@@@@@@@@@@@@@@@@@@@@@@@@@@@@@@@@@@@@@@@@@@@@@@@@@@@@@@@@@@@@@@@@@.TT.TT@@@....TT@@@@@@.T.@@@@@@@@@@@@@@@@@@@@@@@@@@@@@@@@@@@@@@@@@@@@@@@@@@@@@@
@@@@@@@@@@@@@@@@@@@@@@@@@@@@@@@@@@@@@@@@@@@@@@@@@@@@@@@@@@@@@@@@@@@@@@@...TT@@@@..TTT.@@@@@@T@@@@@@@@@@@@@@@@@@@@@@@@@@@@@@@@@@@@@@@@@@@@@@@@@@@@@@@
@@@@@@@@@@@@@@@@@@@@@@@@@@@@@@@@@@@@@@@@@@@@@@@@@@@@@@@@@@@@@@@@@@@@@@@@T.T.@@@@@@T.T..@@@@@@@@@@@@@@@@@@@@@@@@@@@@@@@@@@@@@@@@@@@@@@@@@@@@@@@@@@@@@
@@@@@@@@@@@@@@@@@@@@@@@@@@@@@@@@@@@@@@@@@@@@@@@@@@@@@@@@@@@@@@@@@@@@@@@@@...T.@@@@@.....@@@@@@@@@@@@@@@@@@@@@@@@@@@@@@@@@@@@@@@@@@@@@@@@@@@@@@@@@@@@
@@@@@@@@@@@@@@@@@@@@@@@@@@@@@@@@@@@@@@@@@@@@@@@@@@@@@@@@@@@@@@@@@@@@@@@@@@TT..T@@@@T...TT@@@@@@@@@@@@@@@@@@@@@@@@@@@@@@@@@@@@@@@@@@@@@@@@@@@@@@@@@@@
@@@@@@@@@@@@@@@@@@@@@@@@@@@@@@@@@@@@@@@@@@@@@@@@@@@@@@@@@@@@@@@@@@@@@@@@@@@...T.@@@@T...@@@@@@@@@@@@@@@@@@@@@@@@@@@@@@@@@@@@@@@@@@@@@@@@@@@@@@@@@@@@
@@@@@@@@@@@@@@@@@@@@@@@@@@@@@@@@@@@@@@@@@@@@@@@@@@@@@@@@@@@@@@@@@@@@@@@@@@@@.....@@@T..@@@@@@@@@@@@@@@@@@@@@@@@@@@@@@@@@@@@@@@@@@@@@@@@@@@@@@@@@@@@@
@@@@@@@@@@@@@@@@@@@@@@@@@@@@@@@@@@@@@@@@@@@@@@@@@@@@@@@@@@@@@@@@@@@@@@@@@@@@@...T.@@..@@@@@@@@@@@@@@@@@@@@@@@@@@@@@@@@@@@@@@@@@@@@@@@@@@@@@@@@@@@@@@
@@@@@@@@@@@@@@@@@@@@@@@@@@@@@@@@@@@@@@@@@@@@@@@@@@@@@@@@@@@@@@@@@@@@@@@@@@@@@@.....T.@@@@@@@@@@@@@@@@@@@@@@@@@@@@@@@@@@@@@@@@@@@@@@@@@@@@@@@@@@@@@@@
@@@@@@@@@@@@@@@@@@@@@@@@@@@@@@@@@@@@@@@@@@@@@@@@@@@@@@@@@@@@@@@@@@@@@@@@@@@@@@@T....@@@@@@@@@@@@@@@@@@@@@@@@@@@@@@@@@@@@@@@@@@@@@@@@@@@@@@@@@@@@@@@@
@@@@@@@@@@@@@@@@@@@@@@@@@@@@@@@@@@@@@@@@@@@@@@@@@@@@@@@@@@@@@@@@@@@@@@@@@@@@@@@@..T@@@@@@@@@@@@@@@@@@@@@@@@@@@@@@@@@@@@@@@@@@@@@@@@@@@@@@@@@@@@@@@@@
@@@@@@@@@@@@@@@@@@@@@@@@@@@@@@@@@@@@@@@@@@@@@@@@@@@@@@@@@@@@@@@@@@@@@@@@@@@@@@@@@T@@@@@@@@@@@@@@@@@@@@@@@@@@@@@@@@@@@@@@@@@@@@@@@@@@@@@@@@@@@@@@@@@@
