type octile
height 59
width 56
map
@@@@@@@@@@@@@@@@@@@@@@@@@@@@@@@@@@@@@@@@@@@@@@@@@@@@@@@@
@@@@@@@@@@@@@@@@@@@@@@@@@@@@@@@@@@@@@@@@@@@@@@@@@@@@@@@@
@@@@@@@@@@@@@@@@@@@@@@@@@@@@@@@@@@@@@@@@@@@@@@@@@@@@@@@@
@@@@@@@@@@@@@@@@@@@@@@@@@@@@@@@@@@@@@@@@@@@@@@@@@@@@@@@@
@@@@@@@@@@@@@@@@@@@@@@@@@@@@@@@@@@@@@@@@@@@@@@@@@@@@@@@@
@@@@@@@@@@@@@@@@@@@@@@@@@@@@@@@@@@@@@@@@@@@@@@@@@@@@@@@@
@@@@@@@@@@@@@@@@@@@@@@@@@@@@@@@@@@@@@@@@@@@@@@@@@@@@@@@@
@@@@@@@@@@@@@@@@@@@@@@@@@@@@@@@@@@@@@@@@@@@@@@@@@@@@@@@@
@@@@@@@@@@@@@@@@@@@@@@@@@@@@@@@@@@@@@@@@@@@@@@@@@@@@@@@@
@@@@@@@@@@@@@@@@@@@@@@@@@@@@@@@@@@@@@@@@@@@@@@@@@@@@@@@@
@@@@@@@@@@@@@@@@@@@@@@@@@@@@@T.@@@@@@@@@@@@@@@@@@@@@@@@@
@@@@@@@@@@@@@@@@@@@@@@@@@@@@@@..@@@@@@@@@@@@@@@@@@@@@@@@
@@@@@@@@@@@@@@@@@@@@@@@@@@@@@@@..@@@@@@@@@@@@@@@@@@@@@@@
@@@@@@@@@@@@@@@@@@@@@@@@@@@@@@@@....@@@@@@@@@@@@@@@@@@@@
@@@@@@@@@@@@@@@@@@@@@@@@@@@@@@@@@.T..@@@@@@@@@@@@@@@@@@@
@@@@@@@@@@@@@@@@@@@@@@@@@@@@@@@@@@....@@@@@T@@@@@@@@@@@@
@@@@@@@@@@@@@@@@@@@@@@@..@@@@@@@@@.....@@@...@@@@@@@@@@@
@@@@@@@@@@@@@@@@@@@@@@...@@@@@@@@@..T..T@T..@@@@@@@@@@@@
@@@@@@@@@@@@@@@@@@@@@..T...@@@@@@..T.TT.TTT@@@@@@@@@@@@@
@@@@@@@@@@@@@@@@@@@@.....T@@@@@@..TT.....T.@@@@@@@@@@@@@
@@@@@@@@@@@@@@@@@@@@@.T.T.@@@@@.........T...@@@@@@@@@@@@
@@@@@@@@@@@@@@@@@@@@@@...T.@@@T.TT.........T.@@@@@@@@@@@
@@@@@@@@@@@@@@@@@@@@@@@......T.TTT.T....T....@@@@@@@@@@@
@@@@@@@@@@@@@@@@@@@@@@@@.T....T.......T..@@@@@@@@@@@@@@@
@@@@@@@@@@@@@@@@@@@@@@@@@....T....T......@@@@@@@@@@@@@@@
@@@@@@@@@@@@@@@@@@@@@@@@@..T....T...T.T..@.T.T.@@@@@@@@@
@@@@@@@@@@@@@@@T.@@@@@@.......T..T....T..@.TT.T.T.@@@@@@
@@@@@@@@@@@@.TTT.@@@@@@...T.T.TT.....TTT......@@@.T@@@@@
@@@@@@@@@@@......@@@@.T.T.T...T.....T.T.....T.@@@@.T@@@@
@@@@@@@@@@T......@@@@.T.TT.T.....TT.T.T.@@T...@@@@..@@@@
@@@@@@@@@@.T..TT.....T.T.TT.T....T...T..@@...@@@@@T@@@@@
@@@@@@@@@@@.T..TT..T..T...T..T......T...@@...@@@@@@@@@@@
@@@@@@@@@@@@@...T..T..T.T.....TTT.....T.@@TT..@@@@@@@@@@
@@@@@@@@@@@@@@.T..T..T.TTT.......T.....T@@..T...@@@@@@@@
@@@@.@@@@@@@@@@T.....TTTT.....T..T..TT.@@T..T...@@@@@@@@
@@@T..@@@@@@@@@...TT....T......TT.T....@@@T....@@@@@@@@@
@@.TTT.@@@@@@.......T..........T..T.....@@.T..@@@@@@@@@@
@@.....@@@@@............T..TT...@@..T....@.TT@@@@@@@@@@@
@@......@@.....T....T..T..T..T..@@.T.T..T.T.@@@@@@@@@@@@
@@.T..........T...........TT...@@@@....T.TT@@@@@@@@@@@@@
@@@...TTT...TTTTT.....TT.T...@@@@@@@@T...T@@@@@@@@@@@@@@
@@@@...T..TT....T...TT.......@@@@@@@@T.T.@@@@@@@@@@@@@@@
@@@@@T....T....T...T...TT..T.@@@@@@@..T.@@@@@@@@@@@@@@@@
@@@@@@......T.T.....T.....T...T@@@@TT.@@@@@@@@@@@@@@@@@@
@@@@@@@T..T....TT.....T....T......T..@@@@@@@@@@@@@@@@@@@
@@@@@@@@T.....T.T.....T@@TT.T....T..@@@@@@@@@@@@@@@@@@@@
@@@@@@@@@....TT.......T@@@.....T...@@@@@@@@@@@@@@@@@@@@@
@@@@@@@@@@......T.....@@@@T.......@@@@@@@@@@@@@@@@@@@@@@
@@@@@@@@@@@..T..T.T.@@@@@@TTT..TT@@@@@@@@@@@@@@@@@@@@@@@
@@@@@@@@@@@@....T...@@@@@@@..T..@@@@@@@@@@@@@@@@@@@@@@@@
@@@@@@@@@@@@@T...TT.T.@@@@@.TT.@@@@@@@@@@@@@@@@@@@@@@@@@
@@@@@@@@@@@@@@T...T....@@@@T.T@@@@@@@@@@@@@@@@@@@@@@@@@@
@@@@@@@@@@@@@@@.......TT.....@@@@@@@@@@@@@@@@@@@@@@@@@@@
@@@@@@@@@@@@@@@@.T..T....T..@@@@@@@@@@@@@@@@@@@@@@@@@@@@
@@@@@@@@@@@@@@@@@....TT....@@@@@@@@@@@@@@@@@@@@@@@@@@@@@
@@@@@@@@@@@@@@@@@@.TTT...T@@@@@@@@@@@@@@@@@@@@@@@@@@@@@@
@@@@@@@@@@@@@@@@@@@T.....@@@@@@@@@@@@@@@@@@@@@@@@@@@@@@@
@@@@@@@@@@@@@@@@@@@@T.T.@@@@@@@@@@@@@@@@@@@@@@@@@@@@@@@@
@@@@@@@@@@@@@@@@@@@@@@@@@@@@@@@@@@@@@@@@@@@@@@@@@@@@@@@@
