type octile
height 80
width 72
map
@@@@@@@@@@@@@@@@@@@@@@@@@@@@@@@@@@@@@@@@@@@@@@@@@@@@@@@@@@@@@@@@@@@@@@@@
@@@@@@@@@@@@@@@@@@@@@@@@@@@@@@@@@@@@@@@@@@@@@@@@@@@@@@@@@@@@@@@@@@@@@@@@
@@@@@@@@@@@@@@@@@@@@@@@@@@@@@@@@@@@@@@@@@@@@@@@@@@@@@@@@@@@@@@@@@@@@@@@@
@@@@@@@@@@@@@@@@@@@@@@@@@@@@@@@@@@@@@@@@@@@@@@@@@@@@@@@@@@@@@@@@@@@@@@@@
@@@@@@@@@@@@@@@@@@@@@@@@@@@@@@@@@@@@@@@@@@@@@@@@@@@@@@@@@@@@@@@@@@@@@@@@
@@@@@@@@@@@@@@@@@@@@@@@@@@@@@@@@@@@@@@@@@@@@@@@@@@@@@@@@@@@@@@@@@@@@@@@@
@@@@@@@@@@@@@@@@@@@@@@@@@@@@@@@@@@@@@@@@@@@@@@@@@@@@@@@@@@@@@@@@@@@@@@@@
@@@@@@@@@@@@@@@@@@@@@@@@@@@@@@@@@@@@@@@@@@@@@@@@@@@@@@@@@@@@@@@@@@@@@@@@
@@@@@@@@@@@@@@@@@@@@@@@@@@@@@@@@@@@@@@@@@@@@@@@@@@@@@@@@@@@@@@@@@@@@@@@@
@@@@@@@@@@@@@@@@@@@@@@@@@@@@@@@@@@@@@@@@@@@@@@@@@@@@@@@@@@@@@@@@@@@@@@@@
@@@@@@@@@@@@@@@@@@@@@@@@@@@@@@@@@@@@@@@@@@@@@@@@@@@@@@@@@@@@@@@@@@@@@@@@
@@@@@@@@@@@@@@@@@@@@@@@@@@@@@@@@@@@@@@@@@@@@@@@@@@@@@@@@@@@@@@@@@@@@@@@@
@@@@@@@@@@@@@@@@@@@@@@@@@@@@@@@@@@@@@@@@@@@@@@@@@@@@@@@@@@@@@@@@@@@@@@@@
@@@@@@@@@@@@@@@@@@@@@@@@@@@@@@@@@@@@@@@@@@@@@@@@@@@@@@@@@@@@@@@@@@@@@@@@
@@@@@@@@@@@@@@@@@@@@@@@@@@@@@@@@@@@@@@@@@@@@@@@@@@@@@@@@@@@@@@@@@@@@@@@@
@@@@@@@@@@@@@@@@@@@@@@@@@@@@@@@@@@@@@@@@@@@@@@@@@@@@@@@@@@@@@@@@@@@@@@@@
@@@@@@@@@@@@@@@@@@@@@@@@@@@@@@@@@@@@@@@@@@@@@@@@@@@@@@@@@@@@@@@@@@@@@@@@
@@@@@@@@@@@@@@@@@@@@@@@@@@@@@@@@@@@@@@@@@@@@@@@@@@@@@@@@@@@@@@@@@@@@@@@@
@@@@@@@@@@@@@@@@@@@@@@@@@@@@@@@@@@@@@@@@@@@@@@@@@@@@@@@@@@@@@@@@@@@@@@@@
@@@@@@@@@@@@@@@@@@@@@@@@@@@@@@@@@@@@@@@@@@@@@@@@@@@@@@@@@@@@@@@@@@@@@@@@
@@@@@@@@@@@@@@@@@@@@@@@@@@@@@@@@@@@@@@@@@@@@@@@@@@@@@@@@@@@@@@@@@@@@@@@@
@@@@@@@@@@@@@@@@@@@@@@@@@@@@@@@@@@@@@@@@@@@@@@@@@@@@@@@@@@@@@@@@@@@@@@@@
@@@@@@@@@@@@@@@@@@@@@@@@@@@@@@@@@@@@@@@@@@@@@@@@@@@@@@@@@@@@@@@@@@@@@@@@
@@@@@@@@@@@@@@@@@@@@@@@@@@@@@@@@@@@@@@@@@@@@@@@@@@@@@@@@@@@@@@@@@@@@@@@@
@@@@@@@@@@@@@@@@@@@@@@@@@@@@@@@@@@@@@@@@@@@@@@@.T@@@@@@@@@@@@@@@@@@@@@@@
@@@@@@@@@@@@@@@@@@@@@@@@@@@@@@@@@@@@@@@@@@@@@@...T@@@@@@@@@@@@@@@@@@@@@@
@@@@@@@@@@@@@@@@@@@@@@@@@@@@@@@@@@@@@@@@@@@@@......@@@..@@@@@@@@@@@@@@@@
@@@@@@@@@@@@@@@@@@@@@@@@@@@@@@@@@@@@@@@@@@@......T...T...@@@@@@@@@@@@@@@
@@@@@@@@@@@@@@@@@@@@@@@@@@@@@@@@@@@@@@@@@@.......T.....T..@@@@@@@@@@@@@@
@@@@@@@@@@@@@@@@@@@@@@@@@@@@@@@@@@@@@@@@@......T.......TT..@@@@@@@@@@@@@
@@@@@@@@@@@@@@@@@@@@@@@@@@@@@@@@@@@@@@@@TTTT.....@@@@.T.....@@@@@@@@@@@@
@@@@@@@@@@@@@@@@@@@@@@@@@@@@@@@@@@@@@@@T....TT.@@@@@@@.T.T...@@@@@@@@@@@
@@@@@@@@@@@@@@@@@@@@@@@@@@@@@@@@@@@@@@.T.T.@@@@@@@@@@@@.TT..T@@@@@@@@@@@
@@@@@@@@@@@@@@@@@@@@@@@@@@@@@@@@@@@@@...T.@@@@@@@@@@@@@@@TT.T.@@@@@@@@@@
@@@@@@@@@@@@@@@@@@@@@@@@@@@@@@@@@@@@...T.@@@@@@@@@@@@@@@@..T..@@@@@@@@@@
@@@@@@@@@@@@@@@@@@@@@@@@@@@@@@@@@@@T....@@@@@@@@@@@@@@@@@@T...@@@@@@@@@@
@@@@@@@@@@@@@@@@@@@@@@@@@@@@@@@@@@T....@@@@@@@@@@@@@@@@@@@....T@@@@@@@@@
@@@@@@@@@@@@@@@@@@@@@@@@@@@@@@@@@...T.@@@@@@@@@@@@@@@@@@@@@....@@@T@@@@@
@@@@@@@@@@@@@@@@@@@@@@@@@@@@@@@@TTTTT@@@@@@@@@@@@@@@@@@@@@@.....@@..@@@@
@@@@@@@@@@@@@@@@@@@@@@@@@@@@@@@.....@@@@@@@@@@@@@@@@@@@@@@@@...T.@T.@@@@
@@@@@@@@@@@@@@@@@@@@@@@@@@@@@@....T.@@@@@@@@@@@@@@@@@@@@@@@@TT..T..T@@@@
@@@@@@@@@@@@@@@@@@@@@@@@@@@@@T....T.@@..@@@@@@@@@@@@@@@@@@@@.T..T...@@@@
@@@@@@@@@@@@@@@@@@@@@@@@@@@@...TT..@@.T..@@@@@@@@@@@@@@@@@@@.........@@@
@@@@@@@@@@@@@@@@@@@@@@@@@@@...T...@@@....T@@@@@@@@@@@@@@@@@@.......T..@@
@@@@@@@@@@@@@@@@@@@@@@@@@@.T.T..T@@@@T....@@@@@@@@@@@@@@@@T...T.T.T...@@
@@@@@@@@@@@@@@@@@@@@@@@@@.T.TT..@@@@T....@@@@@@@@@@@@@@@@T...........@@@
@@@@@@@@@@@@@@@@@@@@@@@@T....TT@@@@@TT...@@@@@@@@@@@@@@@T...T..T..T.@@@@
@@@@@@@@@@@@@@@@@@@@@@@T.T...T@@@@@@.....@@@@@@@@@@@@@@T...T.T.....@@@@@
@@@@@@@@@@@@@@@@@@@@@@.T.TT.T@@@@@@TT...@@@@@@@@@@@@@@......T.....@@@@@@
@@@@@@@@@@@@@@@@@@@@@...T...@@@@@T....@@@@@@@@@@@@@@@...T.....T..@@@@@@@
@@@@@@@@@@@@@@@@@@@@T.T....@@@@@....@@@@@@@@@@@@@@@@...T........@@@@@@@@
@@@@@@@@@@@@@@@@@@@.......@@@@@....@@@@@@@@@@@@@@@@.TT..TTT.TTT@@@@@@@@@
@@@@@@@@@@@@@@@@@@.T.T..T@@@@@....@@@@@@@@@@@@@@@@...........T@@@@@@@@@@
@@@@@@@@@@@@@@@@@T...TT.@@@@@TT..@@@@@@@@@@@@@@@@.....T.T....@@@@@@@@@@@
@@@@@@@@@@@@@@@.......T@@T......@@@@@@@@@@@@@@@@T.....T.....@@@@@@@@@@@@
@@@@@@@@@@@@@@.....TT....T....T@@@@@@@@@@@@@@@@T..T.T......@@@@@@@@@@@@@
@@@@@@@@@@@@@@....T..TT.T..T..@@@@@@@@@@@@@@@@...TTT.TT.T.@@@@@@@@@@@@@@
@@@@@@@@@@@@@@@...T..@@.T..TTT@@@@@@@@@@@@@@@..TTT.......@@@@@@@@@@@@@@@
@@@@@@@@@@@@@@@@.T@@@@@@T...T@@@@@@@@@@@@@@@.........T..@@@@@@@@@@@@@@@@
@@@@@@@@@@@@@@@@@@@@@@@@@..T...@@@@@@@@@@@@T.......T.T.@@@@@@@@@@@@@@@@@
@@@@@@@@@@@@@@@@@@@@@@@@@@..TTT@@@@@@@@@@@T..T...TT...@@@@@@@@@@@@@@@@@@
@@@@@@@@@@@@@@@@@@@@@@@@@@@T...@@@@@@@@@@...T.TT.....@@@@@@@@@@@@@@@@@@@
@@@@@@@@@@@@@@@@@@@@@@@@@@@@.T..@@@@@@@.T.T...TT....@@@@@@@@@@@@@@@@@@@@
@@@@@@@@@@@@@@@@@@@@@@@@@@@@....@@@@@@..T......T.TT@@@@@@@@@@@@@@@@@@@@@
@@@@@@@@@@@@@@@@@@@@@@@@@@@@@T..T@@@@.T.....TT....@@@@@@@@@@@@@@@@@@@@@@
@@@@@@@@@@@@@@@@@@@@@@@@@@@@@....@@@.....TT...T..@@@@@@@@@@@@@@@@@@@@@@@
@@@@@@@@@@@@@@@@@@@@@@@@@@@@@..T.@@....T.TT...T.@@@@@@@@@@@@@@@@@@@@@@@@
@@@@@@@@@@@@@@@@@@@@@@@@@@@@@@.....T.T..TT.....@@@@@@@@@@@@@@@@@@@@@@@@@
@@@@@@@@@@@@@@@@@@@@@@@@@@@@@@.............T..@@@@@@@@@@@@@@@@@@@@@@@@@@
@@@@@@@@@@@@@@@@@@@@@@@@@@@@@@@...T..T.......@@@@@@@@@@@@@@@@@@@@@@@@@@@
@@@@@@@@@@@@@@@@@@@@@@@@@@@@@@@@@......T....@@@@@@@@@@@@@@@@@@@@@@@@@@@@
@@@@@@@@@@@@@@@@@@@@@@@@@@@@@@@@@@..T.TT...@@@@@@@@@@@@@@@@@@@@@@@@@@@@@
@@@@@@@@@@@@@@@@@@@@@@@@@@@@@@@@@@@......T@@@@@@@@@@@@@@@@@@@@@@@@@@@@@@
@@@@@@@@@@@@@@@@@@@@@@@@@@@@@@@@@@@@.....@@@@@@@@@@@@@@@@@@@@@@@@@@@@@@@
@@@@@@@@@@@@@@@@@@@@@@@@@@@@@@@@@@@@T...@@@@@@@@@@@@@@@@@@@@@@@@@@@@@@@@
@@@@@@@@@@@@@@@@@@@@@@@@@@@@@@@@@@@@@@@@@@@@@@@@@@@@@@@@@@@@@@@@@@@@@@@@
@@@@@@@@@@@@@@@@@@@@@@@@@@@@@@@@@@@@@@@@@@@@@@@@@@@@@@@@@@@@@@@@@@@@@@@@
@@@@@@@@@@@@@@@@@@@@@@@@@@@@@@@@@@@@@@@@@@@@@@@@@@@@@@@@@@@@@@@@@@@@@@@@
@@@@@@@@@@@@@@@@@@@@@@@@@@@@@@@@@@@@@@@@@@@@@@@@@@@@@@@@@@@@@@@@@@@@@@@@
@@@@@@@@@@@@@@@@@@@@@@@@@@@@@@@@@@@@@@@@@@@@@@@@@@@@@@@@@@@@@@@@@@@@@@@@
