type octile
height 139
width 148
map
@@@@@@@@@@@@@@@@@@@@@@@@@@@@@@@@@@@@@@@@@@@@@@@@@@@@@@@@@@@@@@@@@@@@@@@@@@@@@@@@@@@@@@@@@@@@@@@@@@@@@@@@@@@@@@@@@@@@@@@@@@@@@@@@@@@@@@@@@@@@@@@@@@@@
@@@@@@@@@@@@@@@@@@@@@@@@@@@@@@@@@@@@@@@@@@@@@@@@@@@@@@@@@@@@@@@@@@@@@@@@@@@@@@@@@@@@@@@@@@@@@@@@@@@@@@@@@@@@@@@@@@@@@@@@@@@@@@@@@@@@@@@@@@@@@@@@@@@@
@@@@@@@@@@@@@@@@@@@@@@@@@@@@@@@@@@@@@@@@@@@@@@@@@@@@@@@@@@@@@@@@@@@@@@@@@@@@@@@@@@@@@@@@@@@@@@@@@@@@@@@@@@@@@@@@@@@@@@@@@@@@@@@@@@@@@@@@@@@@@@@@@@@@
@@@@@@@@@@@@@@@@@@@@@@@@@@@@@@@@@@@@@@@@@@@@@@@@@@@@@@@@@@@@@@@@@@@@@@@@@@@@@@@@@@@@@@@@@@@@@@@@@@@@@@@@@@@@@@@@@@@@@@@@@@@@@@@@@@@@@@@@@@@@@@@@@@@@
@@@@@@@@@@@@@@@@@@@@@@@@@@@@@@@@@@@@@@@@@@@@@@@@@@@@@@@@@@@@@@@@@@@@@@@@@@@@@@@@@@@@@@@@@@@@@@@@@@@@@@@@@@@@@@@@@@@@@@@@@@@@@@@@@@@@@@@@@@@@@@@@@@@@
@@@@@@@@@@@@@@@@@@@@@@@@@@@@@@@@@@@@@@@@@@@@@@@@@@@@@@@@@@@@@@@@@@@@@@@@@@@@@@@@@@@@@@@@@@@@@@@@@@@@@@@@@@@@@@@@@@@@@@@@@@@@@@@@@@@@@@@@@@@@@@@@@@@@
@@@@@@@@@@@@@@@@@@@@@@@@@@@@@@@@@@@@@@@@@@@@@@@@@@@@@@@@@@@@@@@@@@@@@@@@@@@@@@@@@@@@@@@@@@@@@@@@@@@@@@@@@@@@@@@@@@@@@@@@@@@@@@@@@@@@@@@@@@@@@@@@@@@@
@@@@@@@@@@@@@@@@@@@@@@@@@@@@@@@@@@@@@@@@@@@@@@@@@@@@@@@@@@@@@@@@@@@@@@@@@@@@@@@@@@@@@@@@@@@@@@@@@@@@@@@@@@@@@@@@@@@@@@@@@@@@@@@@@@@@@@@@@@@@@@@@@@@@
@@@@@@@@@@@@@@@@@@@@@@@@@@@@@@@@@@@@@@@@@@@@@@@@@@@@@@@@@@@@@@@@@@@@@@@@@@@@@@@@@@@@@@@@@@@@@@@@@@@@@@@@@@@@@@@@@@@@@@@@@@@@@@@@@@@@@@@@@@@@@@@@@@@@
@@@@@@@@@@@@@@@@@@@@@@@@@@@@@@@@@@@@@@@@@@@@@@@@@@@@@@@@@@@@@@@@@@@@@@@@@@@@@@@@@@@@@@@@@@@@@@@@@@@@@@@@@@@@@@@@@@@@@@@@@@@@@@@@@@@@@@@@@@@@@@@@@@@@
@@@@@@@@@@@@@@@@@@@@@@@@@@@@@@@@@@@@@@@@@@@@@@@@@@@@@@@@@@@@@@@@@@@@@@@@@@@@@@@@@@@@@@@@@@@@@@@@@@@@@@@@@@@@@@@@@@@@@@@@@@@@@@@@@@@@@@@@@@@@@@@@@@@@
@@@@@@@@@@@@@@@@@@@@@@@@@@@@@@@@@@@@@@@@@@@@@@@@@@@@@@@@@@@@@@@@@@@@@@@@@@@@@@@@@@@@@@@@@@@@@@@@@@@@@@@@@@@@@@@@@@@@@@@@@@@@@@@@@@@@@@@@@@@@@@@@@@@@
@@@@@@@@@@@@@@@@@@@@@@@@@@@@@@@@@@@@@@@@@@@@@@@@@@@@@@@@@@@@@@@@@@@@@@@@@@@@@@@@@@@@@@@@@@@@@@@@@@@@@@@@@@@@@@@@@@@@@@@@@@@@@@@@@@@@@@@@@@@@@@@@@@@@
@@@@@@@@@@@@@@@@@@@@@@@@@@@@@@@@@@@@@@@@@@@@@@@@@@@@@@@@@@@@@@@@@@@@@@@@@@@@@@@@@@@@@@@@@@@@@@@@@@@@@@@@@@@@@@@@@@@@@@@@@@@@@@@@@@@@@@@@@@@@@@@@@@@@
@@@@@@@@@@@@@@@@@@@@@@@@@@@@@@@@@@@@@@@@@@@@@@@@@@@@@@@@@@@@@@@@@@@@@@@@@@@@@@@@@@@@@@@@@@@@@@@@@@@@@@@@@@@@@@@@@@@@@@@@@@@@@@@@@@@@@@@@@@@@@@@@@@@@
@@@@@@@@@@@@@@@@@@@@@@@@@@@@@@@@@@@@@@@@@@@@@@@@@@@@@@@@@@@@@@@@@@@@@@@@@@@@@@@@@@@@@@@@@@@@@@@@@@@@@@@@@@@@@@@@@@@@@@@@@@@@@@@@@@@@@@@@@@@@@@@@@@@@
@@@@@@@@@@@@@@@@@@@@@@@@@@@@@@@@@@@@@@@@@@@@@@@@@@@@@@@@@@@@@@@..@@@@@@@@@@@@@@@@@@@@@@@@@@@@@@@@@@@@@@@@@@@@@@@@@@@@@@@@@@@@@@@@@@@@@@@@@@@@@@@@@@@
@@@@@@@@@@@@@@@@@@@@@@@@@@@@@@@@@@@@@@@@@@@@@@@@@@@@@@@@@@@@@..T..@@@@@@@@@@@@@@@@@@@@@@@@@@@@@@@@@@@@@@@@@@@@@@@@@@@@@@@@@@@@@@@@@@@@@@@@@@@@@@@@@@
@@@@@@@@@@@@@@@@@@@@@@@@@@@@@@@@@@@@@@@@@@@@@@@@@@@@@@@@@@@@.....TT@@@@@@@@@@@@@@@@@@@@@@@@@@@@@@@@@@@@@@@@@@@@@@@@@@@@@@@@@@@@@@@@@@@@@@@@@@@@@@@@@
@@@@@@@@@@@@@@@@@@@@@@@@@@@@@@@@@@@@@@@@@@@@@@@@@@@@@@@@@@...T......@@@@@@@@@@@@@@@@@@@@@@@@@@@@@@@@@@@@@@@@@@@@@@@@@@@@@@@@@@@@@@@@@@@@@@@@@@@@@@@@
@@@@@@@@@@@@@@@@@@@@@@@@@@@@@@@@@@@@@@@@@@@@@@@@@@@@@@@@@.T.TT.T.....@@@@@@@@@@@@@@@@@@@@@@@@@@@@@@@@@@@@@@@@@@@@@@@@@@@@@@@@@@@@@@@@@@@@@@@@@@@@@@@
@@@@@@@@@@@@@@@@@@@@@@@@@@@@@@@@@@@@@@@@@@@@@@@@@@@@@@@@..T.T........T@@@@@@@@@@@@@@@@@@@@@@@@@@@@@@@@@@@@@@@@@@@@@@@@@@@@@@@@@@@@@@@@@@@@@@@@@@@@@@
@@@@@@@@@@@@@@@@@@@@@@@@@@@@@@@@@@@@@@@@@@@@@@@@@@@@@@@T...@@..T..T...T@@@@@@@@@@@@@@@@@@@@@@@@@@@@@@@@@@@@@@@@@@@@@@@@@@@@@@@@@@@@@@@@@@@@@@@@@@@@@
@@@@@@@@@@@@@@@@@@@@@@@@@@@@@@@@@@@@@@@@@@@@@@@@@@@@@@.T.@@@@TT...T....@@@@@@@@@@@@@@@@@@@@@@@@@@@@@@@@@@@@@@@@@@@@@@@@@@@@@@@@@@@@@@@@@@@@@@@@@@@@@
@@@@@@@@@@@@@@@@@@@@@@@@@@@@@@@@@@@@@@@@@@@@@@@@@@@@@.T.@@@@T..T.T.T....@@@@@@@@@@@@@@@@@@@@@@@@@@@@@@@@@@@@@@@@@@@@@@@@@@@@@@@@@@@@@@@@@@@@@@@@@@@@
@@@@@@@@@@@@@@@@@@@@@@@@@@@@@@@@@@@@@@@@@@@@@@@@@@@@T..@@@@.T..@@@T......@@@@@@@@@@@@@@@@@@@@@@@@@@@@@@@@@@@@@@@@@@@@@@@@@@@@@@@@@@@@@@@@@@@@@@@@@@@
@@@@@@@@@@@@@@@@@@@@@@@@@@@@@@@@@@@@@@@@@@@@@@@@@@@.TT@@@@@@..T.@@....T....@@@@@@@@@@@@@@@@@@@@@@@@@@@@@@@@@@@@@@@@@@@@@@@@@@@@@@@@@@@@@@@@@@@@@@@@@
@@@@@@@@@@@@@@@@@@@@@@@@@@@@@@@@@@@@@@@@@@@@@@@@@....@@@@@@@@....T......TTT..@@@@@@@@@@@@@@@@@@@@@@@@@@@@@@@@@@@@@@@@@@@@@@@@@@@@@@@@@@@@@@@@@@@@@@@
@@@@@@@@@@@@@@@@@@@@@@@@@@@@@@@@@@@@@@@@@@@@@@@@.T.T.@@@@@@@@.@......T.T..TT.@@@@@@@@@@@@@@@@@@@@@@@@@@@@@@@@@@@@@@@@@@@@@@@@@@@@@@@@@@@@@@@@@@@@@@@
@@@@@@@@@@@@@@@@@@@@@@@@@@@@@@@@@@@@@@@@@@@@@@@T.T..T.@.@@@@T.@@.T.....T....T..@@@@@@@@@@@@@@@@@@@@@@@@@@@@@@@@@@@@@@@@@@@@@@@@@@@@@@@@@@@@@@@@@@@@@
@@@@@@@@@@@@@@@@@@@@@@@@@@@@@@@@@@@@@@@@@@@@@@....@@@...@@@.T@@@.....T...T......@@@@@@@@@@@@@@@@@@@@@@@@@@@@@@@@@@@@@@@@@@@@@@@@@@@@@@@@@@@@@@@@@@@@
@@@@@@@@@@@@@@@@@@@@@@@@@@@@@@@@@@@@@@@@@@@@@@...T@@@....@..@@@T..T......T..T.T.@@@@@@@@@@@@@@@@@@@@@@@@@@@@@@@@@@@@@@@@@@@@@@@@@@@@@@@@@@@@@@@@@@@@
@@@@@@@@@@@@@@@@@@@@@@@@@@@@@@@@@@@@@@@@@@@@........TT.T...@@@..T.T......T...T..T.@@@@@@@@@@@@@@@@@@@@@@@@@@@@@@@@@@@@@@@@@@@@@@@@@@@@@@@@@@@@@@@@@@
@@@@@@@@@@@@@@@@@@@@@@@@@@@@@@@@@@@@@@@@@@@@..TT....T.....@@@................T.T.T@@@@@@@@@@@@@@@@@@@@@@@@@@@@@@@@@@@@@@@@@@@@@@@@@@@@@@@@@@@@@@@@@@
@@@@@@@@@@@@@@@@@@@@@@@@@@@@@@@@@@@@@@@@@@@..T.....TT.@@@..@.TTT........TT.TT......@@@@@@@@@@@@@@@@@@@@@@@@@@@@@@@@@@@@@@@@@@@@@@@@@@@@@@@@@@@@@@@@@
@@@@@@@@@@@@@@@@@@@@@@@@@@@@@@@@@@@@@@@@@@@.T....T....@@@@.T...T.TTT.T.TTT...T.....T.@@@@@@@@@@@@@@@@@@@@@@@@@@@@@@@@@@@@@@@@@@@@@@@@@@@@@@@@@@@@@@@
@@@@@@@@@@@@@@@@@@@@@@@@@@@@@@@@@@@@@@@@@@@@......T....@@@.T.TT...@@..T.....T..T.T..T@@@@@@@@@@@@@@@@@@@@@@@@@@@@@@@@@@@@@@@@@@@@@@@@@@@@@@@@@@@@@@@
@@@@@@@@@@@@@@@@@@@@@@@@@@@@@@@@@@@@@@@@@@@@@..............T..T..@@@@.............TT@@@@@@@@@@@@@@@@@@@@@@@@@@@@@@@@@@@@@@@@@@@@@@@@@@@@@@@@@@@@@@@@
@@@@@@@@@@@@@@@@@@@@@@@@@@@@@@@@@@@@@@@@@@@@@........T..T...T...@@@@@TTTT...T.....@@@@@@@@@@@@@@@@@@@@@@@@@@@@@@@@@@@@@@@@@@@@@@@@@@@@@@@@@@@@@@@@@@
@@@@@@@@@@@@@@@@@@@@@@@@@@@@@@@@@@@@@@@@@@@@@@...TT......TTT...@@@@@@.......T....@@@@@@@@@@@@@@@@@@@@@@@@@@@@@@@@@@@@@@@@@@@@@@@@@@@@@@@@@@@@@@@@@@@
@@@@@@@@@@@@@@@@@@@@@@@@@@@@@@@..@@@@@@T@@@@@@@....T..T.......@@@@@@@@T....T...T@@@@@..@@.@@@@@@@@@@@@@@@@@@@@@@@@@@@@@@@@@@@@@@@@@@@@@@@@@@@@@@@@@@
@@@@@@@@@@@@@@@@@@@@@@@@@@@@@@@..@@@.......@@@@@.T.T.........@@@@@@@@...TTT..T.@@@@@T..@@.@@@@@@@@@@@@@@@@@@@@@@@@@@@@@@@@@@@@@@@@@@@@@@@@@@@@@@@@@@
@@@@@@@@@@@@@@@@@@@@@@@@@@@@@@@TT@@T...TT...@@@@@..T.T......@@@@@@@@..T.T...@@@@@@@......T.@@@@@@@@@@@@@@@@@@@@@@@@@@@@@@@@@@@@@@@@@@@@@@@@@@@@@@@@@
@@@@@@@@@@@@@@@@@@@@@@@@@@@@@@@..T..TT.T.....@@@@T...T..T.T@@@@@@@@....T.T..@@@@@@@..TT.T..T@@@@@@@@@@@@@@@@@@@@@@@@@@@@@@@@@@@@@@@@@@@@@@@@@@@@@@@@
@@@@@@@@@@@@@@@@@@@@@@@@@@@@@@@...T.....TTT.TT@@@....TT.T.T@@@@@@@..T....T.@@@@@@TT..T.....T@@@@@@@@@@@@@@@@@@@@@@@@@@@@@@@@@@@@@@@@@@@@@@@@@@@@@@@@
@@@@@@@@@@@@@@@@@@@@@@@@@@@@@@TT...T..T.T....@@@@..TT.....@@@@@@@.....T...@@@@@@.......T..T.T@@@@@@@@@@@@@@@@@@@@@@@@@@@@@@@@@@@@@@@@@@@@@@@@@@@@@@@
@@@@@@@@@@@@@@@@@@@@@@@@@@@@@.T.....T.......@@@@T....TT...@@@@@@..T.....T@@@@@@.....@@T...T..T.@@@@@@@@@@@@@@@@@@@@@@@@@@@@@@@@@@@@@@@@@@@@@@@@@@@@@
@@@@@@@@@@@@@@@@@@@@@@@@@@@@@..T....T...T..@@@..TT.T..TT...@..@T...T....@@@@@@.....@@@@....T..T.@@@@@@@@@@@@@@@@@@@@@@@@@@@@@@@@@@@@@@@@@@@@@@@@@@@@
@@@@@@@@@@@@@@@@@@@@@@@@@@@@TT..T.......TT@@@.TTT.T............T.T..TT.@@@@@@.....@@@@@..T.T.....@@@@@@@@@@@@@@@@@@@@@@@@@@@@@@@@@@@@@@@@@@@@@@@@@@@
@@@@@@@@@@@@@@@@@@@@@@@@@@.......T...T...@@@.......TTTTT..T..........@@@@@@...T..@@@@.....T.....T.@@@@@@@@@@@@@@@@@@@@@@@@@@@@@@@@@@@@@@@@@@@@@@@@@@
@@@@@@@@@@@@@@@@@@@@@@@@@@.....T.T..T..T@@@TT.TT.......TT...T..T.T...@@@@@@.....@@@@....TT.....TTT.@@@@@@@@@@@@@@@@@@@@@@@@@@@@@@@@@@@@@@@@@@@@@@@@@
@@@@@@@@@@@@@@@@@@@@@@@@.T.T....T.TT...@@@..TT.T.T.T.T..T.T..T.T....@@@@@@....T@@@@........T..T.....@@@@@@@@@@@@@@@@@@@@@@@@@@@@@@@@@@@@@@@@@@@@@@@@
@@@@@@@@@@@@@@@@@@@@@@@@...T..T........@@TT..T..TTTTTTT............@@@@@@T...T@@@@T.........TT.T....T@@@@@@@@@@@@@@@@@@@@@@@@@@@@@@@@@@@@@@@@@@@@@@@
@@@@@@@@@@@@@@@@@@@@@@@..TT....TT.T...T..T...T.@@..T.TTT..T.TTT.T.@@@@@@TT...@@@@...@@@..TT.......TT.T@@@@@@@@@@@@@@@@@@@@@@@@@@@@@@@@@@@@@@@@@@@@@@
@@@@@@@@@@@@@@@@@@@@@......T....T.@@@.......T.@@@@T....T.........@@@@@@@TT.T@@@@..T@@@@@....TT@...T..T.@@@@@@@@@@@@@@@@@@@@@@@@@@@@@@@@@@@@@@@@@@@@@
@@@@@@@@@@@@@@@@@@@@@...T.T...T..@@@@@.....T.@@@@@@TT.....TTTT..@@@@@.T....@@@@..T@@@@@@.@...@@@.....T.T@@@@@@@@@@@@@@@@@@@@@@@@@@@@@@@@@@@@@@@@@@@@
@@@@@@@@@@@@@@@@@@@@..TT.T..T.T.@@@@@..TT...@@@@@@@......T...T.@@@@@......@@@@...@@@@@@@@@..@@@@...T.....@@@@@@@@@@@@@@@@@@@@@@@@@@@@@@@@@@@@@@@@@@@
@@@@@@@@@@@@@@@@@@@@@....T..T..@@@@@TT.....@@@@@@@@..T..T......@@@@T..T..@@@@.T..@@@@@@@@.T@@@@.........T.@@@@@@@@@@@@@@@@@@@@@@@@@@@@@@@@@@@@@@@@@@
@@@@@@@@@@@@@@@@@@@@@...TT....@@@@@.T.....@@@@@@@@@T........TT.T@@@......T@@T....@@@@@@@..@@@@...T..T.T....T@@@@@@@@@@@@@@@@@@@@@@@@@@@@@@@@@@@@@@@@
@@@@@@@@@@@@@@@@@@@@@@....T..@@@@@.TT...T@@@@@@@@..T.......T....T@@........TT.T...T@@.@.T@@@@T.T............@@@@@@@@@@@@@@@@@@@@@@@@@@@@@@@@@@@@@@@@
@@@@@@@@@@@@@@@@@@@@@@@T..T.@@@@@TT.....@@@@@@@@..........@.T.TT......T..TTTT...TTT....T@@@@..........TTT.T...@@@@@@@@@@@@@@@@@@@@@@@@@@@@@@@@@@@@@@
@@@@@@@@@@@@@@@@@@@@@@@@..T@@@@@.TT..T..@@@@@@@.....TTTT.@@@...T........T....TT.....TT.@@@@.T@@......T....T..T@@@@@@@@@@@@@@@@@@@@@@@@@@@@@@@@@@@@@@
@@@@@@@@@@@@@@@...@@@@@@@.T@@@@......T..@@@@@@...TT..T..@@@@@T....TT........T...TTT.T.@@@@..@@@@..T...@T.T...TT@@@@@@@@@@@@@@@@@@@@@@@@@@@@@@@@@@@@@
@@@@@@@@@@@@@@@TT..@@@@@@@@@@@...T...TT.@@@@@.....T.TT.@@@@@@..T....T.......T........@@@@..@@@@@@.T..@@@.......T@@@@@@@@@@@@@@@@@@@@@@@@@@@@@@@@@@@@
@@@@@@@@@@@@@@@T...T.@@@@@@@@.......T..T.@@@..........@@@@@@@.....T.......TTTT...T..@@@@..@@@@@@@...@@@@.T.......@@@@@@@@@@@@@@@@@@@@@@@@@@@@@@@@@@@
@@@@@@@@@@@@@@@@..TT..@@@@@@........T....T..........T@@@@@@..TT...TT...........T.T.@@@@T.@@@@@@@T..@@@@.......T.T.@@@@@@@@@@@@@@@@@@@@@@@@@@@@@@@@@@
@@@@@@@@@@@@@@@@.......@@@@@@@....T.T..T.T.T..T.TTTT@@@@@@..T..TTT......T....T@@.TT@@@....@@@@@...@@@@........T.T.T@@@@@@@@@@@@@@@@@@@@@@@@@@@@@@@@@
@@@@@@@@@@@@@@@....T.TT.@@@@@@...T.T.T.......T..T..@@@@@@.TT........T........@@@@...@T...T.@@@...@@@@.TTT....TT...T..@@@@@@@@@@@@@@@@@@@@@@@@@@@@@@@
@@@@@@@@..@@@@.....@...T.@@@@@@........T....T..TT.@@@@@@......T.T...........@@@@@@TT....T...T...@@@@..T..T...T.TT.T...@@@@@@@@@@@@@@@@@@@@@@@@@@@@@@
@@@@@@@.T..@@.....@@@..T..@@@@@...T...T...T.T...T@@@@@@@TT.T...T@.@@...T.T.@@@TT@@@.......TT...@@@@.T@@@T...T.T..TT...TT@@@@@@@@@@@@@@@@@@@@@@@@@@@@
@@@@@@@@.T.......@@@@@.T...@@@@..........T.T..T.@@@@@.....T....@@@@@@.....@@@....@@@.T......TT@@@@@@@@@@@........T.....TT@@@@@@@@@@@@@@@@@@@@@@@@@@@
@@@@@@@@@TT.TT...@@@@@@T.T..@...T.T..T..T.TT.TT@@@@@..T....T...@@@@@@..T.@@@...T..@@@...T...T@@@@@@@@@@@@T.TT..T@TT.......@@@@@@@@@@@@@@@@@@@@@@@@@@
@@@@@@@@@@.TT.....@@@@@@......TT@@@.TTT.......@@@@@...T....T.T@@@@@@T..T@@@TT.T.T..@@@...TT.@@@@.@@@@@@@@@.....@@@.....T..T@@@@@@@@@@@@@@@@@@@@@@@@@
@@@@@@@@@@@....T..T@@@@@T.......@@@@.........@@@@@@T.T..T.T..T.@@@@...T@@@T.....T...@@@....@@@@T.@.@@@@@@@..T.@@@@...T......@@@@@@@@@@@@@@@@@@@@@@@@
@@@@@@@@@@@@TT.T.T..@@@TT@.T....@@@@@......T@@@@@@@........T.T..@@T.T.@@@.T..T..T...T@@@..T@@@TTT..@@@@@@.TT.@@@@.TT.T.T..T..@@@@@@@@@@@@@@@@@@@@@@@
@@@@@@@@@@@@@.T.....T@.T@@@..T.T..@@@@....T@@@@@@@@@.T......T........@@@.T.TTTTT....TT@@T.T.@...TT..@@@@....@@@@T.T.....T....@@@@@@@@@@@@@@@@@@@@@@@
@@@@@@@@@@@@@@.T.......@@@@@...TT..@@@@TTT@@@@@@@@...T..T......T.....@@.T..T.T....T.T.@@@....T.T.T...@@...T@@@@......T.....T@@@@@@@@@@@@@@@@@@@@@@@@
@@@@@@@@@@@@@@@......TT@@@@@@T...T.T@@@@T@@@@@@@@....T..TTT....T....@@..T.T....@@T.T...@@@...TT..T.....T..@@@@T.........T..@@@@@@@@@@@@@@@@@@@@@@@@@
@@@@@@@@@@@@@@@@T...T..T.@@@@...T..T@@@@@@@@@@@@....T....TT.......T@@@TTT...T..@@@T....@@@....T.....T.T..@@@@T.T..T...T...@@@@@@@.@@@@@@@@@@@@@@@@@@
@@@@@@@@@@@@@@@@@..T......@@TT.T..T@@@@@@@@@@@@.T...T@@.....T.T.T.@@@@....T.T...@@....TT@T..T........T.T@@@@..T........T.@@@@@@....@@@@@@@@@@@@@@@@@
@@@@@@@@@@@@@@@@@@..T...T..TT.....@@@@@@@@@@@@......@@@@..TT...T.@@@@@@.......TT@@T.TT...T.T..T........@@@@.....T......T@@@@@@@...@@@@@@@@@@@@@@@@@@
@@@@@@@@@@@@@@@@@@@....T.........@@@@@@@@@@@@......@@@@@@T....T.T@@@@@@@..TT..T.@@@TT...@@....T......T@@@@TT...T..T....@@@@@@@@..T@@@@@@@@@@@@@@@@@@
@@@@@@@@@@@@@@@@@@@@.T.....T....@@@@@@@@@@@@@.T...@@@@@@@@@...TT.@@@@@@@@@@.T..@@@@..TT.@@..T.....TT.@@@@.TTT.........@@@@@@@@@T...@@@@@@@@@@@@@@@@@
@@@@@@@@@@@@@@@@@@@@@..........@@@@@@@@@@@@@@..T.@@@@@@@@@@@..TTT.@@@@@@@@@@@@@@T.@@T.........TT...T.@@@T.TT...T....T@@@@@@@@....T..@@@@@@@@@@@@@@@@
@@@@@@@@@@@@@@@@@@@@@@........@@@@@@@@@@@@.TT.@@@@@@@@@@@@@@@......@@@@@@@@@@...T.@@...T..TT..........@....T.TTTT...@@@@@@@@.........@@@@@@@@@@@@@@@
@@@@@@@@@@@@@@@@@@@@@@@......@@@@@@@@@@@@..T..@@@@@@@@@@@@@@@....T..@@@@@@@@.......@TT.T..T....T........T...T..TTT.@@@@@@@@@..T......T@@@@@@@@@@@@@@
@@@@@@@@@@@@@@@@@@@@@@@@....@@@@@@@@@@@@.T....@@@@@@@@@@@@@@....T..TTT@@@@@.T..TT..........TT.TTT....T.........TT.@@@@@@@@T..T.........@@@@@@@@@@@@@
@@@@@@@@@@@@@@@@@@@@@@@@@..@@@@@@@@@.@@......T.@@@@@@@@@@@@..........T.@@@...............T..T...T...T.TT......T..@@@@@@@@T...T....TT....@@@@@@@@@@@@
@@@@@@@@@@@@@@@@@@@@@@@@@@@@@@@@@@@@..T....T.T..@@@@@@@@@@...T.@@T.....T@T.T................T...........T..TT.T.@@@@@@@@T.T..............@@@@@@@@@@@
@@@@@@@@@@@@@@@@@@@@@@@@@@@@@@@@@@@@T......T...T@@@@@@@@@.....@@@@@..TT.....TT..T...T...T......T...T...T.......@@@@@@@@...T...T.T.T...T...@@@@@@@@@@
@@@@@@@@@@@@@@@@@@@@@@@@@@@@@@@@@@T.T.....T.T....@@@@@@T.TTT.@@@@@@@.T....T......T...TT...T.TT.T......TT...TT.@@@@@@@@.........TTTT......T.@@@@@@@@@
@@@@@@@@@@@@@@@@@@@@@@@@@@@@@@@@@..T.T.T.....T.T@@@@@@@...TT@@@@@@@@@.T.TT..T........TT...T............T..T..@@@@@@@@T.T.T.....@T..TT.TTTT..@@@@@@@@
@@@@@@@@@@@@@@@@@@@@@@@@@@@@@@@@T.....T.....T..@@@@@@@@T...@@@@@@@@@@@..T.T..T......T.............TT.......T@@@@@@@@.........T@@@.T...T......@@@@@@@
@@@@@@@@@@@@@@@@@@@@@@@@@@@@@@@T..........T...@@@@@@@@@T..T@@@@@@@@@@@@.....T..TTT...T..T......TT....T..T..@@@@@@@@....T.TTT.@@@@@...T.T......@@@@@@
@@@@@@@@@@@@@@@@@@@@@@@@@@@@@@@@...TT....T.T.@@@@@@@.....@@@@@@@@@@@@@@@..T.TTT.....TT............TT.T.T..@@@@@@@@.TT...TTTT..@@@@.......TT..@@@@@@@
@@@@@@@@@@@@@@@@@@@@@@@@@@@@@@@@@..T..T.....@@@@@@@.....@@@@@@@@@@@@@@@....T..T.T....TT.....T...T.TTT..T.@@@@@@@@.T..TT.T.TT..T@@.......TT..@@@@@@@@
@@@@@@@@@@@@@@@@@@@@@@@@@@@@@@@@@@T.......T@@@@@@@@...T..@@@@@@@@@@@@......TT..T.T...T....TTT....T.T.....@@@@@@@.T.T......T......TTT.T..T..@@@@@@@@@
@@@@@@@@@@@@@@@@@@@@@@@@@@@@@@@@@@@..T...@@@@@@.T..T...T..@@@@@@@@@@.....@@....TT.T.T..T.TTT.....T.TT...T.@@.@@@.....@....T....T.T.T...TT.@@@@@@@@@@
@@@@@@@@@@@@@@@@@@@@@@@@@@@@@@@@@@@@...T@@@@@@@.TT.T......@@@@@@@@@....T@@@@.TT.....TT.T.TTT...TT..TT.....T@....T.T.@@@......TT..T.T....T@@@@@@@@@@@
@@@@@@@@@@@@@@@@@@@@@@@@@@@@@@@@@@@@@.T@@@@@@@.....T.......@@@@@@@.....@@@@@@.........T..T......T.T....T.T..T.....T@@@@@....TT..........@@@@@@@@@@@@
@@@@@@@@@@@@@@@@@@@@@@@@@@@@@@@@@@@@@@@@@@@@@..T.TT..TT.TT.@@@@@@.....@@@@@@@@.......TT.TTT...T.T...T.T...T.........@@@@@......T....T..@@@@@@@@@@@@@
@@@@@@@@@@@@@@@@@@@@@@@@@@@@@@@@@@@@@@@@@@@...T..T.T.T....@@@@@@@.TTT@@@@@@@@@@.TT...TT...TT.T.T..TTT.....T.TT.T...T.@@@@@.....TT.T.T.@@@@@@@@@@@@@@
@@@@@@@@@@@@@@@@@@@@@@@@@@@@@@@@@@@@@@@@@@T....T....T..T.@@@@@@@@T..@@@@@@@@@@@@................T..T.T..TTT......TT...@@@@@..T....T.T@@@@@@@@@@@@@@@
@@@@@@@@@@@@@@@@@@@@@@@@@@@@@@@@@@@@@@@@@.........TT....@@@@@@@.T.T@@@@@@@@@@@@@@.T.............T.T...T............T.T.@@@@@......T.@@@@@@@@@@@@@@@@
@@@@@@@@@@@@@@@@@@@@@@@@@@@@@@@@@@@@@@@@@@............@@@@@@@..T...@@@@@@@@@@@@@@T........TT.....T....T.T.TT...T.@T..T..@@@@@.....T@@@@@@@@@@@@@@@@@
@@@@@@@@@@@@@@@@@@@@@@@@@@@@@@@@@@@@@@@@@@@.TT.....T.@@@@@@@@.....@@@@@@@@@@@@@@.....T..T.T..@...T.T........TT...@@..TTT.@@@@@....@@@@@@@@@@@@@@@@@@
@@@@@@@@@@@@@@@@@@@@@@@@@@@@@@@@@@@@@@@@@@@@.T...T.@@@@@@.@@@T..T..@@@@@@@@@@@@T.T.T........@@@..T.T....T.T...T...@@..T...@@@@@.T@@@@@@@@@@@@@@@@@@@
@@@@@@@@@@@@@@@@@@@@@@@@@@@@@@@@@@@@@@@@@@@@@T...T@@@@@@@T.T...TTT..@@@@@@@@@@T.TT....T....@@@@@.TT........TTTTTT.T@@..T...@@@@@@@@@@@@@@@@@@@@@@@@@
@@@@@@@@@@@@@@@@@@@@@@@@@@@@@@@@@@@@@@@@@@@@@@..T@@@@@@@@.TTT.T.....@@@@@@@@@.....T..T...T@@@@@@..T.......T@@..T...T@...TT.T@@@@@@@@@@@@@@@@@@@@@@@@
@@@@@@@@@@@@@@@@@@@@@@@@@@@@@@@@@@@@@@@@@@@@@@@.@@@@@@@...TT.T..T...@@@@@@@@..T........T.@@@@@@@...T..TT..@@@@.......T..TT.T@@@@@@@@@@@@@@@@@@@@@@@@
@@@@@@@@@@@@@@@@@@@@@@@@@@@@@@@@@@@@@@@@@@@@@@@@@@@@@@.......T.T...@@@@@@@@......T..T..T@@@@@@..T....T....@@@@...TT.....T..@@@@@@@@@@@@@@@@@@@@@@@@@
@@@@@@@@@@@@@@@@@@@@@@@@@@@@@@@@@@@@@@@@@@@@@@@@@@@@@..T..T....T..@@@@@@@@@.TT..T..T.T.@@@@@@T...TT.......T@@TT.TTT.T....T@@@@@@@@@@@@@@@@@@@@@@@@@@
@@@@@@@@@@@@@@@@@@@@@@@@@@@@@@@@@@@@@@@@@@@@@@@@@@@T.T.T.....T..T@@@@@@@@@@......T....@@@@@@@..T..........T.TT......TT...@@@@@@@@@@@@@@@@@@@@@@@@@@@
@@@@@@@@@@@@@@@@@@@@@@@@@@@@@@@@@@@@@@@@@@@@@@@@@@@T.TTT.T..T...@@@@@@@@..T..@TTT..T.@@@@@@@@..TT.T..T.......TT.TTT.....@@@@@@@@@@@@@@@@@@@@@@@@@@@@
@@@@@@@@@@@@@@@@@@@@@@@@@@@@@@@@@@@@@@@@@@@@@@@@@@@@.T....TTT..@@@@@@@@T.....@@T..T.@@@@@@@@...........@@....T.T.TT..TT@@@@@@@@@@@@@@@@@@@@@@@@@@@@@
@@@@@@@@@@@@@@@@@@@@@@@@@@@@@@@@@@@@@@@@@@@@@@@@@@@@@.......T.@@@@@@@@..T....@@@..T@@@@@@@@..T.T........@@T.T..T..TT..T.@@@@@@@@@@@@@@@@@@@@@@@@@@@@
@@@@@@@@@@@@@@@@@@@@@@@@@@@@@@@@@@@@@@@@@@@@@@@@@@@@@@T......@@@@@@.T.TT......@@@@@@@@@@@@T...TT......T..@@.T...T........@@@@@@@@@@@@@@@@@@@@@@@@@@@
@@@@@@@@@@@@@@@@@@@@@@@@@@@@@@@@@@@@@@@@@@@@@@@@@@@@@@@..T.@@@@@@@@.T.........@@@@@@@@@@@.TT...T@@..T.....@@...T........T@@@@@@@@@@@@@@@@@@@@@@@@@@@
@@@@@@@@@@@@@@@@@@@@@@@@@@@@@@@@@@@@@@@@@@@@@@@@@@@@@@@@.T@@@@@@@@.T...T..T...@@@@@@@@@@..T....@@@@...T....@..........T.@@@@@@@@@@@@@@@@@@@@@@@@@@@@
@@@@@@@@@@@@@@@@@@@@@@@@@@@@@@@@@@@@@@@@@@@@@@@@@@@@@@@@@@@@@@@@@@...T...T..T@@@@@@@@@@@........@@@@T.T.....TT.T.......@@@@@@@@@@@@@@@@@@@@@@@@@@@@@
@@@@@@@@@@@@@@@@@@@@@@@@@@@@@@@@@@@@@@@@@@@@@@@@@@@@@@@@@@@@@@@@@T...T......@@@@@@@@@.......T..T.@@@@T....T..TT....T..@@@@@@@@@@@@@@@@@@@@@@@@@@@@@@
@@@@@@@@@@@@@@@@@@@@@@@@@@@@@@@@@@@@@@@@@@@@@@@@@@@@@@@@@@@@@@@@...TT...TT.@@@@@@@@@.....T..T.....@@@@T...T......T...@@@@@@@@@@@@@@@@@@@@@@@@@@@@@@@
@@@@@@@@@@@@@@@@@@@@@@@@@@@@@@@@@@@@@@@@@@@@@@@@@@@@@@@@@@@@@@@TT.....T..T@@@@@@@@@.........T..T...@@@@TT.T.T.....TT@@@@@@@@@@@@@@@@@@@@@@@@@@@@@@@@
@@@@@@@@@@@@@@@@@@@@@@@@@@@@@@@@@@@@@@@@@@@@@@@@@@@@@@@@@@@@@T..TTT......@@@@@@@@....T....TT.T....TT@@@@......@@@@.@@@@@@@@@@@@@@@@@@@@@@@@@@@@@@@@@
@@@@@@@@@@@@@@@@@@@@@@@@@@@@@@@@@@@@@@@@@@@@@@@@@@@@@@@@@@@@@@..........@@@@@@@@T.T....T......TT.....@@@@TT..T@@@@@@@@@@@@@@@@@@@@@@@@@@@@@@@@@@@@@@
@@@@@@@@@@@@@@@@@@@@@@@@@@@@@@@@@@@@@@@@@@@@@@@@@@@@@@@@@@@@@@@.....T..@@@@@@@@.T.T..T.T....T.......T.@@@@T..@@@@@@@@@@@@@@@@@@@@@@@@@@@@@@@@@@@@@@@
@@@@@@@@@@@@@@@@@@@@@@@@@@@@@@@@@@@@@@@@@@@@@@@@@@@@@@@@@@@@@@@@..TT..@@@@@@@@T.TT.TT.T.T..TT..TT.....T@@@@.@@@@@@@@@@@@@@@@@@@@@@@@@@@@@@@@@@@@@@@@
@@@@@@@@@@@@@@@@@@@@@@@@@@@@@@@@@@@@@@@@@@@@@@@@@@@@@@@@@@@@@@@@@.T..@@@@@@@@@..T..TTT....T.T.....T....T@@@@@@@@@@@@@@@@@@@@@@@@@@@@@@@@@@@@@@@@@@@@
@@@@@@@@@@@@@@@@@@@@@@@@@@@@@@@@@@@@@@@@@@@@@@@@@@@@@@@@@@@@@@@@@@T..@@@@@.@@..T.TTTTT..@@@T.....T.......@@@@@@@@@@@@@@@@@@@@@@@@@@@@@@@@@@@@@@@@@@@
@@@@@@@@@@@@@@@@@@@@@@@@@@@@@@@@@@@@@@@@@@@@@@@@@@@@@@@@@@@@@@@@@@@.@@@@@....T.T.....T.@@@@@....T........@@@@@@@@@@@@@@@@@@@@@@@@@@@@@@@@@@@@@@@@@@@
@@@@@@@@@@@@@@@@@@@@@@@@@@@@@@@@@@@@@@@@@@@@@@@@@@@@@@@@@@@@@@@@@@@@@@@@T..T.T..T..T.TT@@@@.T.TTT......@@@@@@@@@@@@@@@@@@@@@@@@@@@@@@@@@@@@@@@@@@@@@
@@@@@@@@@@@@@@@@@@@@@@@@@@@@@@@@@@@@@@@@@@@@@@@@@@@@@@@@@@@@@@@@@@@@@@@.....T.T......T.T@@T....T.......@@@@@@@@@@@@@@@@@@@@@@@@@@@@@@@@@@@@@@@@@@@@@
@@@@@@@@@@@@@@@@@@@@@@@@@@@@@@@@@@@@@@@@@@@@@@@@@@@@@@@@@@@@@@@@@@@@@@.......T.....T..T..T............@@@@@@@@@@@@@@@@@@@@@@@@@@@@@@@@@@@@@@@@@@@@@@
@@@@@@@@@@@@@@@@@@@@@@@@@@@@@@@@@@@@@@@@@@@@@@@@@@@@@@@@@@@@@@@@@@@@@@@T...........T.....T.T...TT....@@@@@@@@@@@@@@@@@@@@@@@@@@@@@@@@@@@@@@@@@@@@@@@
@@@@@@@@@@@@@@@@@@@@@@@@@@@@@@@@@@@@@@@@@@@@@@@@@@@@@@@@@@@@@@@@@@@@@@@@TT......T.TT...............T@@@@@@@@@@@@@@@@@@@@@@@@@@@@@@@@@@@@@@@@@@@@@@@@
@@@@@@@@@@@@@@@@@@@@@@@@@@@@@@@@@@@@@@@@@@@@@@@@@@@@@@@@@@@@@@@@@@@@@@@@@........T...T..T..TT.T....@@@@@@@@@@@@@@@@@@@@@@@@@@@@@@@@@@@@@@@@@@@@@@@@@
@@@@@@@@@@@@@@@@@@@@@@@@@@@@@@@@@@@@@@@@@@@@@@@@@@@@@@@@@@@@@@@@@@@@@@@@@@............T.....T..TT.@@@@@@@@@@@@@@@@@@@@@@@@@@@@@@@@@@@@@@@@@@@@@@@@@@
@@@@@@@@@@@@@@@@@@@@@@@@@@@@@@@@@@@@@@@@@@@@@@@@@@@@@@@@@@@@@@@@@@@@@@@@@@@..T...T........TT.....@@@@@@@@@@@@@@@@@@@@@@@@@@@@@@@@@@@@@@@@@@@@@@@@@@@
@@@@@@@@@@@@@@@@@@@@@@@@@@@@@@@@@@@@@@@@@@@@@@@@@@@@@@@@@@@@@@@@@@@@@@@@@@@@T.T...............T.@@@@@@@@@@@@@@@@@@@@@@@@@@@@@@@@@@@@@@@@@@@@@@@@@@@@
