type octile
height 54
width 56
map
@@@@@@@@@@@@@@@@@@@@@@@@@@@@@@@@@@@@@@@@@@@@@@@@@@@@@@@@
@@@@@@@@@@@@@@@@@@@@@@@@@@@@@@@@@@@@@@@@@@@@@@@@@@@@@@@@
@@@@@@@@@@@@@@@@@@@@@@@@@@@@@@@@@@@@@@@@@@@@@@@@@@@@@@@@
@@@@@@@@@@@@@@@@@@@@@@@@@@@@@@@@@@@@@@@@@@@@@@@@@@@@@@@@
@@@@@@@@@@@@@@@@@@@@@@@@@@@@@@@@@@@@@@@@@@@@@@@@@@@@@@@@
@@@@@@@@@@@@@@@@@@@@@@@@@@@@@@@@@@@@@@@@@@@@@@@@@@@@@@@@
@@@@@@@@@@@@@@@@@@@@@@@@@@@@@@@@@@@@@@@@@@@@@@@@@@@@@@@@
@@@@@@@@@@@@@@@@@@@@@@@@@@@@@@@@@@@@@@@@@@@@@@@@@@@@@@@@
@@@@@@@@@@@@@@@@@@@@@@@@@@@@@@@@@@@@@@@@@@@@@@@@@@@@@@@@
@@@@@@@@@@@@@@@@@@@@@@@@@@@@@@@@@@@@@@@@@@@@@@@@@@@@@@@@
@@@@@@@@@@@@@@@@@@@@@@@@@@@@@@@@@@@@@@@@@@@@@@@@@@@@@@@@
@@@@@@@@@@@@@@@@@@@@@@@@@@@@@@@@@@@@@@@@@@@@@@@@@@@@@@@@
@@@@@@@@@@@@@@@@@@@@@@@@@@@@@@@@@@@@@@@@@@@@@@@@@@@@@@@@
@@@@@@@@@@@@@@@@@@@@@@@@@@@@@@@@@@@@@@@@@@@@@@@@@@@@@@@@
@@@@@@@@@@@@@@@@@@@@@@@@@@.@@@@@@@@@@@@@@@@@@@@@@@@@@@@@
@@@@@@@@@@@@@@@@@@@@@@@@@..@@@@@@@@@@@@@@@@@@@@@@@@@@@@@
@@@@@@@@@@@@@@@@@@@@@@@@@...@T@@@@@@@@@@@@@@@@@@@@@@@@@@
@@@@@@@@@@@@@@@@@@@@@@@@T.TT.T..@@@@@@@@@@@@@@@@@@@@@@@@
@@@@@@@@@@@@@@@@@@@@@@@......T...@@@@@@@@@@@@@@@@@@@@@@@
@@@@@@@@@@@@@@@@@@@@@@.........T@@@@@@@@@@@@@@@@@@@@@@@@
@@@@@@@@@@@@@@@@@@@@@@....T.....@@@@@@@@@@@@@@@@@@@@@@@@
@@@@@@@@@@@@@@@@@@@@@....TT.TT.T.@@@@@@@@@@@@@@@@@@@@@@@
@@@@@@@@@@@@@@@@@@@@..@@........T@@@@@@@@@@@@@@@@@@@@@@@
@@@@@@@@@@@@@@@@@@@@.@@@..T.T.TT@@@@@@@@@@@@@@@@@@@@@@@@
@@@@@@@@@@@@@@@@@@@......T.T.TTT.@TT@@@@@@@@@@@@@@@@@@@@
@@@@@@@@@@@@@@@@@@.....T.T.T..........@@@@@@@@@@@@@@@@@@
@@@@@@@@@@@@@@@@@T..TT...T..T....T..TTT@@.@@@@@@@@@@@@@@
@@@@@@@@@@@@@@@@@......T..T...T.......T@@T.@@@.@@@@@@@@@
@@@@@@@@@@@@@@@@.TTT....T.....T....T...@@T..@...@@@@@@@@
@@@@@@@@@@@@@@@@@@..T..T.T..T..T..T..TT@@..TT.....@@@@@@
@@@@@@@@@@@@@@@.@@...T.........@T......TT....T....@@@@@@
@@@@@@@@@@@@@@..@@.....T..T...@@@..T.T........T...@@@@@@
@@@@@@@@@@@@@T.TT.T.....TT.....T@@@T....T..TT....T@@@@@@
@@@@@@@@@@@@.T.T...T......TTT....@@..............@@@@@@@
@@@@@@@@@@@@.....T..TT..T....T.T..T........T....@@@@@@@@
@@@@@@@@@@@.T..T........T.....TT.......T.T.T@@T.@@@@@@@@
@@@@@@@@@@....T...T.T.T...T...TTT.......T...@@@@@@@@@@@@
@@@@@@@@@T.@@......T............T.T..T....T.T@@@@@@@@@@@
@@@@@@@@@.@@@TT.T.T...........T........T.....@@@@@@@@@@@
@@@@@@@@.T@@...T.....T....T..T...T....T.T.T..@@@@@@@@@@@
@@@@@@@.....TTT.....TT.....TT...T....T..T....@@@@@@@@@@@
@@@@@@..T.......TT.......T.......T....TT....@@@@@@@@@@@@
@@@@@@@@..TTT.....T.T.......T.....TT..T....@@@@@@@@@@@@@
@@@@@@@@@T.....T....T....TT.....T.TTT..@@..@@@@@@@@@@@@@
@@@@@@@@@@@...T...T..T.T.T.T.TTTT..T...@@@@@@@@@@@@@@@@@
@@@@@@@@@@@@........T..T...T.......T...T@@@@@@@@@@@@@@@@
@@@@@@@@@@@@@@.......TTT.......T....T...@@@@@@@@@@@@@@@@
@@@@@@@@@@@@@@@TTTT..T.T....TT.TT.......@@@@@@@@@@@@@@@@
@@@@@@@@@@@@@@@@...TT.......TTT.....T.T@@@@@@@@@@@@@@@@@
@@@@@@@@@@@@@@@@@@....T...TT........TT.@@@@@@@@@@@@@@@@@
@@@@@@@@@@@@@@@@@@@.....TT....T.TTT.T.@@@@@@@@@@@@@@@@@@
@@@@@@@@@@@@@@@@@@@@@..T..T.T....@@..@@@@@@@@@@@@@@@@@@@
@@@@@@@@@@@@@@@@@@@@@@@...T.....T@@@@@@@@@@@@@@@@@@@@@@@
@@@@@@@@@@@@@@@@@@@@@@@@@@@@@@@@@@@@@@@@@@@@@@@@@@@@@@@@
