type octile
height 64
width 60
map
@@@@@@@@@@@@@@@@@@@@@@@@@@@@@@@@@@@@@@@@@@@@@@@@@@@@@@@@@@@@
@@@@@@@@@@@@@@@@@@@@@@@@@@@@@@@@@@@@@@@@@@@@@@@@@@@@@@@@@@@@
@@@@@@@@@@@@@@@@@@@@@@@@@@@@@@@@@@@@@@@@@@@@@@@@@@@@@@@@@@@@
@@@@@@@@@@@@@@@@@@@@@@@@@@@@@@@@@@@@@@@@@@@@@@@@@@@@@@@@@@@@
@@@@@@@@@@@@@@@@@@@@@@@@@@@@@@@@@@@@@@@@@@@@@@@@@@@@@@@@@@@@
@@@@@@@@@@@@@@@@@@@@@@@@@@@@@@@@@@@@@@@@@@@@@@@@@@@@@@@@@@@@
@@@@@@@@@@@@@@@@@@@@@@@@@@@@@@@@@@@@@@@@@@@@@@@@@@@@@@@@@@@@
@@@@@@@@@@@@@@@@@@@@@@@@@@@@@@@@@@@@@@@@@@@@@@@@@@@@@@@@@@@@
@@@@@@@@@@@@@@@@@@@@@@@@@@@@@@@@@@@@@@@@@@@@@@@@@@@@@@@@@@@@
@@@@@@@@@@@@@@@@@@@@@@@@@@@@@@@@@@@@@@@@@@@@@@@@@@@@@@@@@@@@
@@@@@@@@@@@@@@@@@@@@@@@@@@@@@@@@@@@@@@@@@@@@@@@@@@@@@@@@@@@@
@@@@@@@@@@@@@@@@@@@@@@@@@@@@@@@@@@@@@@@@@@@@@@@@@@@@@@@@@@@@
@@@@@@@@@@@@@@@@@@@@@@@@@@@@@@@@@@@@@@@@@@@@@@@@@@@@@@@@@@@@
@@@@@@@@@@@@@@@@@@@@@@@@@@@@@@@@@@@@@@@@@@@@@@@@@@@@@@@@@@@@
@@@@@@@@@@@@@@@@@@@@@@@@@@@@@@@@@@@@@@@@@@@@@@@@@@@@@@@@@@@@
@@@@@@@@@@@@@@@@@@@@@@@@@@@@@@@@@@@@@@@@@@@@@@@@@@@@@@@@@@@@
@@@@@@@@@@@@@@@@@@@@@@@@@@@@@@@@@@@@T.@@@@@@@@@@@@@@@@@@@@@@
@@@@@@@@@@@@@@@@@@@@@@@@@@@@@@@@@@@@.TTT.T@@@@@@@@@@@@@@@@@@
@@@@@@@@@@@@@@@@@@@@@@@@@@@@@@@@@@@..T.TT.@@@@@@@@@@@@@@@@@@
@@@@@@@@@@@@@@@@@@@@@@@@@@@@@@@@@@.T.T.....@@@@@@@@@@@@@@@@@
@@@@@@@@@@@@@@@@@@@@@@@@@@@@@@@@@.TT.T....T.T@@@@@@@@@@@@@@@
@@@@@@@@@@@@@@@@@@@@@@@@@@@@@@@@...T.....T.T..@@@@@@@@@@@@@@
@@@@@@@@@@@@@@@@@@@@@@@@@@@@@@@@@.@@TT.........@@@@@@@@@@@@@
@@@@@@@@@@@@@@@@@@@@@@@@@@@@@@@@@.@@T.....T...T.@@@@@@@@@@@@
@@@@@@@@@@@@@@@@@@@@@@@@@@@@@@@@..T.T....@@....T@@@@@@@@@@@@
@@@@@@@@@@@@@@@@@@@@@@@@@@@.@@...T..T....@@.TTT..@@@TT@@@@@@
@@@@@@@@@@@@@@@@@@@@@@@@@@.TT.TT.T.T.....@T....T..@@...@@@@@
@@@@@@@@@@@@@@@@@@@@@@@@@@...TTT.T..TT..TT...T..T....T.@@@@@
@@@@@@@@@@@@@@@@@@@@@@@@@...TT......T.....TT..T.T...T.TT@@@@
@@@@@@@@@@@@@@@@@@@@@@@@.TT.........TTT..T.TT..T......T.@@@@
@@@@@@@@@@@@@@@@@@@@@T..T....@T..............T.....T...@@@@@
@@@@@@@@@@@@@@@@@@@@@@@..T..@@@..T.................TT.@@@@@@
@@@@@@@@@@@@@@@@@@@@@@@@..T@@@@@......T....T..T.T...T@@@@@@@
@@@@@@@@@@@@@@@@@@@@@@@@.T@@@@@@@....T...........TT.@@@@@@@@
@@@@@@@@@@@@@@@@@@@@@@@..T@@@@@@@@.......T...T.T...@@@@@@@@@
@@@@@@@@@@@@@@@@@@@@@..T...@@@@@@@@..TT......T.T.T@@@@@@@@@@
@@@@@@@@@@@@@@@@@@@@TTT.T...@@@@@@@TT.TT...T.....@@@@@@@@@@@
@@@@@@@@@@@@@@@@@@@T.T.......@@@@@.T.......T..T.@@@@@@@@@@@@
@@@@@@@@@@@@@@@@@@....TTT.....@@@........T....T@@@@@@@@@@@@@
@@@@@@@@@@@@@@@@@T.T............T.T....T.....T@@@@@@@@@@@@@@
@@@@@@@@@@@@@@@@T.T..TT.......T.T...T.....T..@@@@@@@@@@@@@@@
@@@@@@@@@@@@@@@T.@@@.T.T..T.T.T.............@@@@@@@@@@@@@@@@
@@@@@@.@@@@@@@@.@@@@@TT..T.T....TT.T.......@@@@@@@@@@@@@@@@@
@@@@@..T@@@@@@.T@@@@@@.TT.T......T...T..TT@@@@@@@@@@@@@@@@@@
@@@@......@@@.T..@@@@@@.........T...TT...@@@@@@@@@@@@@@@@@@@
@@@T.......@...T..@@@@@..T.T...T...T..T.@@@@@@@@@@@@@@@@@@@@
@@......T.TTT..T...@@@T.....TTT.TTTT..T@@@@@@@@@@@@@@@@@@@@@
@@..TT..........T....TT.T....T..T...T.@@@@@@@@@@@@@@@@@@@@@@
@@@T......TT.TT..T..................T@@@@@@@@@@@@@@@@@@@@@@@
@@@@T....TT......T...T..T....T...T..@@@@@@@@@@@@@@@@@@@@@@@@
@@@@@TT...T....T...........TT.....T@@@@@@@@@@@@@@@@@@@@@@@@@
@@@@@@T....T...T.T....T.T.........@@@@@@@@@@@@@@@@@@@@@@@@@@
@@@@@@@..TT.T....T....T.T..TTTT..@@@@@@@@@@@@@@@@@@@@@@@@@@@
@@@@@@@@...........T.......T....@@@@@@@@@@@@@@@@@@@@@@@@@@@@
@@@@@@@@@..TT....T.TT..T..T....@@@@@@@@@@@@@@@@@@@@@@@@@@@@@
@@@@@@@@@@T.T..T...TTT.T......@@@@@@@@@@@@@@@@@@@@@@@@@@@@@@
@@@@@@@@@@@TTT.T....T....T..@@@@@@@@@@@@@@@@@@@@@@@@@@@@@@@@
@@@@@@@@@@@@.T..TT........T@@@@@@@@@@@@@@@@@@@@@@@@@@@@@@@@@
@@@@@@@@@@@@@............T@@@@@@@@@@@@@@@@@@@@@@@@@@@@@@@@@@
@@@@@@@@@@@@@@......T.T..@@@@@@@@@@@@@@@@@@@@@@@@@@@@@@@@@@@
@@@@@@@@@@@@@@@T......T.@@@@@@@@@@@@@@@@@@@@@@@@@@@@@@@@@@@@
@@@@@@@@@@@@@@@@TT...T.@@@@@@@@@@@@@@@@@@@@@@@@@@@@@@@@@@@@@
@@@@@@@@@@@@@@@@@@@@@@@@@@@@@@@@@@@@@@@@@@@@@@@@@@@@@@@@@@@@
@@@@@@@@@@@@@@@@@@@@@@@@@@@@@@@@@@@@@@@@@@@@@@@@@@@@@@@@@@@@
