type octile
height 70
width 64
map
@@@@@@@@@@@@@@@@@@@@@@@@@@@@@@@@@@@@@@@@@@@@@@@@@@@@@@@@@@@@@@@@
@@@@@@@@@@@@@@@@@@@@@@@@@@@@@@@@@@@@@@@@@@@@@@@@@@@@@@@@@@@@@@@@
@@@@@@@@@@@@@@@@@@@@@@@@@@@@@@@@@@@@@@@@@@@@@@@@@@@@@@@@@@@@@@@@
@@@@@@@@@@@@@@@@@@@@@@@@@@@@@@@@@@@@@@@@@@@@@@@@@@@@@@@@@@@@@@@@
@@@@@@@@@@@@@@@@@@@@@@@@@@@@@@@@@@@@@@@@@@@@@@@@@@@@@@@@@@@@@@@@
@@@@@@@@@@@@@@@@@@@@@@@@@@@@@@@@@@@@@@@@@@@@@@@@@@@@@@@@@@@@@@@@
@@@@@@@@@@@@@@@@@@@@@@@@@@@@@@@@@@@@@@@@@@@@@@@@@@@@@@@@@@@@@@@@
@@@@@@@@@@@@@@@@@@@@@@@@@@@@@@@@@@@@@@@@@@@@@@@@@@@@@@@@@@@@@@@@
@@@@@@@@@@@@@@@@@@@@@@@@@@@@@@@@@@@@@@@@@@@@@@@@@@@@@@@@@@@@@@@@
@@@@@@@@@@@@@@@@@@@@@@@@@@@@@@@@@@@@@@@@@@@@@@@@@@@@@@@@@@@@@@@@
@@@@@@@@@@@@@@@@@@@@@@@@@@@@@@@@@@@@@@@@@@@@@@@@@@@@@@@@@@@@@@@@
@@@@@@@@@@@@@@@@@@@@@@@@@@@@@@@@@@@@@@@@@@@@@@@@@@@@@@@@@@@@@@@@
@@@@@@@@@@@@@@@@@@@@@@@@@@@@@@@@@@@@@@@@@@@@@@@@@@@@@@@@@@@@@@@@
@@@@@@@@@@@@@@@@@@@@@@@@@@@@@@@@@@@@@@@@@@@@@@@@@@@@@@@@@@@@@@@@
@@@@@@@@@@@@@@@@@@@@@@@@@@@@@@@@@@@@@@@@@@@@@@@@@@@@@@@@@@@@@@@@
@@@@@@@@@@@@@@@@@@@@@@@@@@@@@@@@@.@@@@@@@@@@@@@@@@@@@@@@@@@@@@@@
@@@@@@@@@@@@@@@@@@@@@@@@@@@@@@@@..T@@@@@@@@@@@@@@@@@@@@@@@@@@@@@
@@@@@@@@@@@@@@@@@@@@@@@@@@@@@@@@@...@@@@@@..@@@@@@@@@@@@@@@@@@@@
@@@@@@@@@@@@@@@@@@@@@@@@@@@@@@@@@@...@@@@T...@@@@@@@@@@@@@@@@@@@
@@@@@@@@@@@@@@@@@@@@@@@@@@@@@@@@@@@T..@@..TT.@@@@@@@@@@@@@@@@@@@
@@@@@@@@@@@@@@@@@@@@@@@@@@@@.@@.T@@@......TT.@@@@@@@@@@@@@@@@@@@
@@@@@@@@@@@@@@@@@@@@@@@@@@@@..@..@@@@T...T.TTT..@@@@@@@@@@@@@@@@
@@@@@@@@@@@@@@@@@@@@@@@@@@@@T.................T.T@@@@@@@@@@@@@@@
@@@@@@@@@@@@@@@@@@@@@@@@@@@@@....TTT...........T.T@@@@@@@@@@@@@@
@@@@@@@@@@@@@@@@@@@@@@@@@@@@@@.TT.....TT........T..@@@@@@@@@@@@@
@@@@@@@@@@@@@@@@@@@@@@@@@@@@@@@.TT........TT.T.T...@@@@@@@@@@@@@
@@@@@@@@@@@@@@@@@@@@@@@@@@@@@@@@.TT........T...T...@@@@@@@@@@@@@
@@@@@@@@@@@@@@@@@@@@@@@..@@@@@@T....T..T...T...T.T.....@@@@@@@@@
@@@@@@@@@@@@@@@@@@@@@@@@..@@@@....TT.....T.T..TT.TT.TT..@@@@@@@@
@@@@@@@@@@@@@@@@@@@@@@@@@.T@@.T......TT..@.........T..T@@@@@@@@@
@@@@@@@@@@@@@@@@@@@@@@@@@@......T.....T.@@@...T.T.TTT.@@@@@@@@@@
@@@@@@@@@@@@@@@@@@@@@@@@@@@TTT....TT...T@@@......T...@@@@@@@@@@@
@@@@@@@@@@@@@@@@@@@@@@@@@@TTT..TT..T....@@@........T@@@@@@@@@@@@
@@@@@@@@@@@@@@@@@.@@@@@@@T.TT.....T.........T.....@T.@@@@@@@@@@@
@@@@@@@@@@@@@@@@T.@@@@T@........T.........T..TT.T@@@..@@@@@@@@@@
@@@@@@@@@@@@T@@....@@@T.....T.T..TT.......T.T.TT.@@@@..@@@@@@@@@
@@@@@@@@@@@..@@T.T....T......T..T..TTTT...TT....@@@@@@..@@@@@@@@
@@@@@@@@@@...TT..T.........T..TT........T...T......@@@@..@@@@@@@
@@@@@@@@@.....T.T...........T.....T......T..TTT..T.@@@@@.@@@@@@@
@@@@@@@@..TT....T..T...T......T.T..T....TT..@......@@@@@@@@@@@@@
@@@@@@@..TT.T@..T...........@.T.....T...T..@@@T.TT..@@@@@@@@@@@@
@@@@@@..T..T@@@TT..........@@@.TT......T..@@@@@.T.T..@@@@@@@@@@@
@@@@@T....T.@@@@T...TT.TT..@@@.....T..TT.@@@@@@@.....@@@@@@@@@@@
@@@@.....T...@@@@.T..T...TT@@@.T.........@@@@@@@@...T@@@@@@@@@@@
@@@TTT...TT.T@@@@@@@...T......T.....T..T..@@@@@@@@.T@@@@@@@@@@@@
@@@.T..TTT....@@@@@@....TT.TT.T.T....T@@.T.@@@@@@@@@@@@@@@@@@@@@
@@@@.T..@.....@@@@@@.T....T..T..T....@@@@.TT@@@@@@@@@@@@@@@@@@@@
@@@@@T.@@@.T..@@@@TT..T....T...T...@@@@@@@..T@@@@@@@@@@@@@@@@@@@
@@@@@@...@@TT@@@@..TT.......T..T..@@@@@@@@@..@@@@@@@@@@@@@@@@@@@
@@@@@@@T.@@@@@@@...T.T...T..T.T.T@@@@@@@@@@@@@@@@@@@@@@@@@@@@@@@
@@@@@@@@TT.@@@@..T.T.T.T...T.....@@@@@@@@@@@@@@@@@@@@@@@@@@@@@@@
@@@@@@@@@..@@@...T..TT@@T.TT.T.T.T.@@@@@@@@@@@@@@@@@@@@@@@@@@@@@
@@@@@@@@@@T...T.TT.T..@@@@@@.....T.@@@@@@@@@@@@@@@@@@@@@@@@@@@@@
@@@@@@@@@@@...TTT....T@@@@@@....T.T..@@@@@@@@@@@@@@@@@@@@@@@@@@@
@@@@@@@@@@@@.TT......T@@@@@@TT...TT..T@@@@@@@@@@@@@@@@@@@@@@@@@@
@@@@@@@@@@@@@.......T@@@@@@@...T.T.....@@@@@@@@@@@@@@@@@@@@@@@@@
@@@@@@@@@@@@@@.....@@@@@@@@TT.........T@@@@@@@@@@@@@@@@@@@@@@@@@
@@@@@@@@@@@@@@@....@@@TTT.T....T...TT.T@@@@@@@@@@@@@@@@@@@@@@@@@
@@@@@@@@@@@@@@@@...T...TT..T...T.T.T..@@@@@@@@@@@@@@@@@@@@@@@@@@
@@@@@@@@@@@@@@@@@.........T..T...TTTT@@@@@@@@@@@@@@@@@@@@@@@@@@@
@@@@@@@@@@@@@@@@@@.T....TT....TT...T@@@@@@@@@@@@@@@@@@@@@@@@@@@@
@@@@@@@@@@@@@@@@@@@........TT..TT..@@@@@@@@@@@@@@@@@@@@@@@@@@@@@
@@@@@@@@@@@@@@@@@@@@TT.T........T.@@@@@@@@@@@@@@@@@@@@@@@@@@@@@@
@@@@@@@@@@@@@@@@@@@@@.T.....TT...@@@@@@@@@@@@@@@@@@@@@@@@@@@@@@@
@@@@@@@@@@@@@@@@@@@@@@.T.T......@@@@@@@@@@@@@@@@@@@@@@@@@@@@@@@@
@@@@@@@@@@@@@@@@@@@@@@@.TT.....@@@@@@@@@@@@@@@@@@@@@@@@@@@@@@@@@
@@@@@@@@@@@@@@@@@@@@@@@@......@@@@@@@@@@@@@@@@@@@@@@@@@@@@@@@@@@
@@@@@@@@@@@@@@@@@@@@@@@@@...T@@@@@@@@@@@@@@@@@@@@@@@@@@@@@@@@@@@
@@@@@@@@@@@@@@@@@@@@@@@@@@.T@@@@@@@@@@@@@@@@@@@@@@@@@@@@@@@@@@@@
@@@@@@@@@@@@@@@@@@@@@@@@@@@@@@@@@@@@@@@@@@@@@@@@@@@@@@@@@@@@@@@@
