type octile
height 64
width 64
map
@@@@@@@@@@@@@@@@@@@@@@@@@@@@@@@@@@@@@@@@@@@@@@@@@@@@@@@@@@@@@@@@
@@@@@@@@@@@@@@@@@@@@@@@@@@@@@@@@@@@@@@@@@@@@@@@@@@@@@@@@@@@@@@@@
@@@@@@@@@@@@@@@@@@@@@@@@@@@@@@@@@@@@@@@@@@@@@@@@@@@@@@@@@@@@@@@@
@@@@@@@@@@@@@@@@@@@@@@@@@@@@@@@@@@@@@@@@@@@@@@@@@@@@@@@@@@@@@@@@
@@@@@@@@@@@@@@@@@@@@@@@@@@@@@@@@@@@@@@@@@@@@@@@@@@@@@@@@@@@@@@@@
@@@@@@@@@@@@@@@@@@@@@@@@@@@@@@@@@@@@@@@@@@@@@@@@@@@@@@@@@@@@@@@@
@@@@@@@@@@@@@@@@@@@@@@@@@@@@@@@@@@@@@@@@@@@@@@@@@@@@@@@@@@@@@@@@
@@@@@@@@@@@@@@@@@@@@@@@@@@@@@@@@@@@@@@@@@@@@@@@@@@@@@@@@@@@@@@@@
@@@@@@@@@@@@@@@@@@@@@@@@@@@@@@@@@@@@@@@@@@@@@@@@@@@@@@@@@@@@@@@@
@@@@@@@@@@@@@@@@@@@@@@@@@@@@@@@@@@@@.@@@@@@@@@@@@@@@@@@@@@@@@@@@
@@@@@@@@@@@@@@@@@@@@@@@@@@@@@@@@@@@TTT@@@@@@@@@@@@@@@@@@@@@@@@@@
@@@@@@@@@@@@@@@@@@@@@@@@@@@@@@@@@@.TT.T@@@@@@@@@@@@@@@@@@@@@@@@@
@@@@@@@@@@@@@@@@@@@@@@@@@@@@@@@@@T......@@@@@@@@@@@@@@@@@@@@@@@@
@@@@@@@@@@@@@@@@@@@@@@@@@@@@@@@@...T...T.@@@@@@@@@@@@@@@@@@@@@@@
@@@@@@@@@@@@@@@@@@@@@@@@@@@@@@@....TT.T...@@@@@@@@@@@@@@@@@@@@@@
@@@@@@@@@@@@@@@@@@@@@@@@@@@@@@T........TT..@@@@@@@@@@@@@@@@@@@@@
@@@@@@@@@@@@@@@@@@@@@@@@@@@@@.....T...TTTT.@@@@@@@@@@@@@@@@@@@@@
@@@@@@@@@@@@@@@@@@@@@@@@@@@@....@@.TT...TT@@T@@@@@@@@@@@@@@@@@@@
@@@@@@@@@@@@@@@@@@@@@@@@@@@...TT.@@T.....@@...@@@@@@@@@@@@@@@@@@
@@@@@@@@@@@@@@@@@@@@@@@@@...T.....@@..TT@@....T@@@@@@@@@@@@@@@@@
@@@@@@@@@@@@@@@@@@@@@@@@@........T.@@..@@...T...@@@@@@@@@@@@@@@@
@@@@@@@@@@@@@@@@@@@@@@@@@T.......T..@@@@T........@@@@@@@@@@@@@@@
@@@@@@@@@@@@@@@@@@@@@@@@@@T.T.......T@@..TT...TTTT.@@@@@@@@@@@@@
@@@@@@@@@@@@@@@@@@@@@@@@@@@......T............TT.T..@@@@@@@@@@@@
@@@@@@@@@@@@@@@@@@@@@@@@@@@@.....T.T...T....TTT.....T@@@@@@@@@@@
@@@@@@@@@@@@@@@@@@@@@@@@@@@@@..T...T....T.T...TTT.....@@@@@@@@@@
@@@@@@@@@@@@@@@@@@@@@@@@@@@@@@...T....T.T...T.T....T.T.@@@@@@@@@
@@@@@@@@@@@@@@@@@@@@@@@@@@.@@@@TT.T.............T.......@@@@@@@@
@@@@@@@@@@@@@@@@@@@T@@@@@...@@@@.T..T......TT.......TT...@@@@@@@
@@@@@@@@@@@@@@@@@@..T@@@...T.@@@@.....T.......T....T.TT...@@@@@@
@@@@@@@@@@@@@@@@@@.T..TT......@@@@.TT.T...T.....T..T...TT..@@@@@
@@@@@@@@@@@@@@@@@@@T.TTTT...T.T@@.T...T.T..........T.TTT.TT.@@@@
@@@@@@@@@@@@@@@@@@@@T....TT.TT.....T.T..T..T..T.T.T..T....T..@@@
@@@@@@@@@@@@@@@@@@@@...TT.T..T.T...T@TTT..TT.T..T..T..T.....@@@@
@@@@@@@@@@@@..@@@@T..........T....T@@@..TT.T..........T....@@@@@
@@@@@@@@@@@....@@..TTT...TT..@TT..T@@@@......T...T...T....@@@@@@
@@@@@@@@@@@..TT.........T.T.@@.....T@@@@..T.T.TTT.T.T....@@@@@@@
@@@@@@@@@@@@.T....TT.......@@@@.....T@@@@T..............@@@@@@@@
@@@@@.@@@@@@@.TT.TTTT.....@@@@@@......@@@@.T.TT...TT.T.@@@@@@@@@
@@@@.T.@@@@@@.TTTTT..T...@@@@@@@TT...TT@@@@T..T.T..T.T@@@@@@@@@@
@@@.TT..@@@@.T..T.T.....@@@@@@@@.....T..T@@@.T.......@@@@@@@@@@@
@@@T.....@@.....TTT.....@@@@@@@..T...T..@@@@@@T.....@@@@@@@@@@@@
@@@@..T..........T....T@@@@@@@...T..TT.@@@@@@@@....@@@@@@@@@@@@@
@@@@@......T..TTTT..@.T@@@@@@....T....@@@@@@@@@@..@@@@@@@@@@@@@@
@@@@@@.......T.....@@@..@@.T......T.TT@@@@@@@@@@@@@@@@@@@@@@@@@@
@@@@@@@....TT.....@@@@@T.......TTTT...@@@@@@@@@@@@@@@@@@@@@@@@@@
@@@@@@@@T.T......@@@@@@@...........T.T.@@@@@@@@@@@@@@@@@@@@@@@@@
@@@@@@@@@..TTTT.@@@@@@@@T.........@@.T.T@@@@@@@@@@@@@@@@@@@@@@@@
@@@@@@@@@@......T@@@@@@....T..T..@@@@....@@@@@@@@@@@@@@@@@@@@@@@
@@@@@@@@@@@TT.TT..@@@@....T.....@@@@@@TT.T@@@@@@@@@@@@@@@@@@@@@@
@@@@@@@@@@@@....T..@@.....TT...@@@@@@@@..T.@@@@@@@@@@@@@@@@@@@@@
@@@@@@@@@@@@@.....TT............@@@@@@@@..@@@@@@@@@@@@@@@@@@@@@@
@@@@@@@@@@@@@@T.T..T..T.TT.TT...T@@@@@@@@@@@@@@@@@@@@@@@@@@@@@@@
@@@@@@@@@@@@@@@T.....TT...T@@....T@@@@@@@@@@@@@@@@@@@@@@@@@@@@@@
@@@@@@@@@@@@@@@@TT..TT..T.@@@@.T...@@@@@@@@@@@@@@@@@@@@@@@@@@@@@
@@@@@@@@@@@@@@@@@TT....T.@@@@@@.....@@@@@@@@@@@@@@@@@@@@@@@@@@@@
@@@@@@@@@@@@@@@@@@TT.TTT@@@@@@@@TT...@@@@@@@@@@@@@@@@@@@@@@@@@@@
@@@@@@@@@@@@@@@@@@@....T.@@@@@@@@..T@@@@@@@@@@@@@@@@@@@@@@@@@@@@
@@@@@@@@@@@@@@@@@@@@T..T..@@@@@@@@.@@@@@@@@@@@@@@@@@@@@@@@@@@@@@
@@@@@@@@@@@@@@@@@@@@@.T.TT.@@@@@@@@@@@@@@@@@@@@@@@@@@@@@@@@@@@@@
@@@@@@@@@@@@@@@@@@@@@@......@@@@@@@@@@@@@@@@@@@@@@@@@@@@@@@@@@@@
@@@@@@@@@@@@@@@@@@@@@@@......@@@@@@@@@@@@@@@@@@@@@@@@@@@@@@@@@@@
@@@@@@@@@@@@@@@@@@@@@@@@.T.T..@@@@@@@@@@@@@@@@@@@@@@@@@@@@@@@@@@
@@@@@@@@@@@@@@@@@@@@@@@@@@@@@@@@@@@@@@@@@@@@@@@@@@@@@@@@@@@@@@@@
