type octile
height 54
width 52
map
@@@@@@@@@@@@@@@@@@@@@@@@@@@@@@@@@@@@@@@@@@@@@@@@@@@@
@@@@@@@@@@@@@@@@@@@@@@@@@@@@@@@@@@@@@@@@@@@@@@@@@@@@
@@@@@@@@@@@@@@@@@@@@@@@@@@@@@@@@@@@@@@@@@@@@@@@@@@@@
@@@@@@@@@@@@@@@@@@@@@@@@@@@@@@@@@@@@@@@@@@@@@@@@@@@@
@@@@@@@@@@@@@@@@@@@@@@@@@@@@@@@@@@@@@@@@@@@@@@@@@@@@
@@@@@@@@@@@@@@@@@@@@@@@@@@@@@@@@@@@@@@@@@@@@@@@@@@@@
@@@@@@@@@@@@@@@@@@@@@@@@@@@@@@@@@@@@@@@@@@@@@@@@@@@@
@@@@@@@@@@@@@@@@@@@@@@@@@@@@@@@@@@@@@@@@@@@@@@@@@@@@
@@@@@@@@@@@@@@@@@@@@@@@@@@@@@@@@@@@@@@@@@@@@@@@@@@@@
@@@@@@@@@@@@@@@@@@@@@@@@@@@@@@@@@@@@@@@@@@@@@@@@@@@@
@@@@@@@@@@@@@@@@@@@@@@@@@@@@@@@@@@@@@@@@@@@@@@@@@@@@
@@@@@@@@@@@@@@@@@@@@@@@@@@@@@@@@@@@@@@@@@@@@@@@@@@@@
@@@@@@@@@@@@@@@@@@@@@@@@@@@@@@@@@@@@@@@@@@@@@@@@@@@@
@@@@@@@@@@@@@@@@@@@@@@@@@@@@@.@@@@@@@@@@@@@@@@@@@@@@
@@@@@@@@@@@@@@@@@@@@@@@@@@@@...T.@@@@@@@@@@@@@@@@@@@
@@@@@@@@@@@@@@@@@@@@@@@@@@@.......@@@@@@@@@@@@@@@@@@
@@@@@@@@@@@@@@@@@@@@@@@@@@..T.T..T@@@@@@@@@@@@@@@@@@
@@@@@@@@@@@@@@@@@@@@@@@@@@....T..@@@@@@@@@@@@@@@@@@@
@@@@@@@@@@@@@@@@@@@@@@@@TT.T...T@@@@@@@@@@@@@@@@@@@@
@@@@@@@@@@@@@@@@@@@@@@@@T.......T@@@@@@@@@@@@@@@@@@@
@@@@@@@@@@@@@@@@@@@@@@@.T.....@@.T@@@@@T@@@@@@@@@@@@
@@@@@@@@@@@@@@@@@@@@@@....T...@@...@@@...@@@@@@@@@@@
@@@@@@@@@@@@@@@@@@@@@@............@@@T...T.T@@@@@@@@
@@@@@@@@@@@@@@@@@@@@@@...T.....T.@@@T.T.T..TT@@@@@@@
@@@@@@@@@@@@@@@@@@@@@T.T.T.T.TT.T.@@T..T..T...@@@@@@
@@@@@@@@@@@@@@@@@@@@.......TT....T..TT...T.T..@@@@@@
@@@@@@@@@@@@@@@@@@@.......@@T..TTT...T.T..T.T@@@@@@@
@@@@@@@@@@@@@@@.@@.......@@@@.T.TT.....T....@@@@@@@@
@@@@@@@@@@@@@@@..TT.T........T...T...T.T..T@@@@@@@@@
@@@@@@@@@@@@.@.......@@@.@@@T...T...TT....@@@@@@@@@@
@@@@@@@@@@@@T.TT.T..T@@@.@@@...........T.@@@@@@@@@@@
@@@@@@@@@@@....T.........T@..T...T....T.@@@@@@@@@@@@
@@@@@@@@@.....T....T.T.T.TT.@TT....TT..@@@@@@@@@@@@@
@@@@@@@@.TT..T..T.....T...@@@....T....@@@@@@@@@@@@@@
@@@@@@@.TT.T..T.TT......T.@@TT..T.TTT@@@@@@@@@@@@@@@
@@@@@@TTT....@@TT.T...T.T...T.....T.@@@@@@@@@@@@@@@@
@@@@@@@.....@@@....T.T.............@@@@@@@@@@@@@@@@@
@@@@@@@@T..@@@@@.T...T...T..T.T...@@@@@@@@@@@@@@@@@@
@@@@@@@@@.@@@@@@@....T..T.......T@@@@@@@@@@@@@@@@@@@
@@@@@@@@@@@@@@@@@@T.....T.T...T.@@@@@@@@@@@@@@@@@@@@
@@@@@@@@@@@@@@@@@@@TT.T...T....@@@@@@@@@@@@@@@@@@@@@
@@@@@@@@@@@@@@@@@@@...T.......@@@@@@@@@@@@@@@@@@@@@@
@@@@@@@@@@@@@@@@@@@...T.T.T..@@@@@@@@@@@@@@@@@@@@@@@
@@@@@@@@@@@@@@@@@@....T.....@@@@@@@@@@@@@@@@@@@@@@@@
@@@@@@@@@@@@@@@@@...T....TT@@@@@@@@@@@@@@@@@@@@@@@@@
@@@@@@@@@@@@@@@@TTT.T..T..@@@@@@@@@@@@@@@@@@@@@@@@@@
@@@@@@@@@@@@@@@@@T.......@@@@@@@@@@@@@@@@@@@@@@@@@@@
@@@@@@@@@@@@@@@@@@.T...T@@@@@@@@@@@@@@@@@@@@@@@@@@@@
@@@@@@@@@@@@@@@@@@@..T.@@@@@@@@@@@@@@@@@@@@@@@@@@@@@
@@@@@@@@@@@@@@@@@@@@@@@@@@@@@@@@@@@@@@@@@@@@@@@@@@@@
@@@@@@@@@@@@@@@@@@@@@@@@@@@@@@@@@@@@@@@@@@@@@@@@@@@@
@@@@@@@@@@@@@@@@@@@@@@@@@@@@@@@@@@@@@@@@@@@@@@@@@@@@
@@@@@@@@@@@@@@@@@@@@@@@@@@@@@@@@@@@@@@@@@@@@@@@@@@@@
@@@@@@@@@@@@@@@@@@@@@@@@@@@@@@@@@@@@@@@@@@@@@@@@@@@@
