type octile
height 80
width 80
map
@@@@@@@@@@@@@@@@@@@@@@@@@@@@@@@@@@@@@@@@@@@@@@@@@@@@@@@@@@@@@@@@@@@@@@@@@@@@@@@@
@@@@@@@@@@@@@@@@@@@@@@@@@@@@@@@@@@@@@@@@@@@@@@@@@@@@@@@@@@@@@@@@@@@@@@@@@@@@@@@@
@@@@@@@@@@@@@@@@@@@@@@@@@@@@@@@@@@@@@@@@@@@@@@@@@@@@@@@@@@@@@@@@@@@@@@@@@@@@@@@@
@@@@@@@@@@@@@@@@@@@@@@@@@@@@@@@@@@@@@@@@@@@@@@@@@@@@@@@@@@@@@@@@@@@@@@@@@@@@@@@@
@@@@@@@@@@@@@@@@@@@@@@@@@@@@@@@@@@@@@@@@@@@@@@@@@@@@@@@@@@@@@@@@@@@@@@@@@@@@@@@@
@@@@@@@@@@@@@@@@@@@@@@@@@@@@@@@@@@@@@@@@@@@@@@@@@@@@@@@@@@@@@@@@@@@@@@@@@@@@@@@@
@@@@@@@@@@@@@@@@@@@@@@@@@@@@@@@@@@@@@@@@@@@@@@@@@@@@@@@@@@@@@@@@@@@@@@@@@@@@@@@@
@@@@@@@@@@@@@@@@@@@@@@@@@@@@@@@@@@@@@@@@@@@@@@@@@@@@@@@@@@@@@@@@@@@@@@@@@@@@@@@@
@@@@@@@@@@@@@@@@@@@@@@@@@@@@@@@@@@@@@@@@@@@@@@@@@@@@@@@@@@@@@@@@@@@@@@@@@@@@@@@@
@@@@@@@@@@@@@@@@@@@@@@@@@@@@@@@@@@@@@@@@@@@@@@@@@@@@@@@@@@@@@@@@@@@@@@@@@@@@@@@@
@@@@@@@@@@@@@@@@@@@@@@@@@@@@@@@@@@@@@@@@@@@@@@@@@@@@@@@@@@@@@@@@@@@@@@@@@@@@@@@@
@@@@@@@@@@@@@@@@@@@@@@@@@@@@@@@@@@@@@@@@@@@@@@@@@@@@@@@@@@@@@@@@@@@@@@@@@@@@@@@@
@@@@@@@@@@@@@@@@@@@@@@@@@@@@@@@@@@@@@@@@@@@@@@@@@@@@@@@@@@@@@@@@@@@@@@@@@@@@@@@@
@@@@@@@@@@@@@@@@@@@@@@@@@@@@@@@@@@@@@@@@@@@@@@@@@@@@@@@@@@@@@@@@@@@@@@@@@@@@@@@@
@@@@@@@@@@@@@@@@@@@@@@@@@@@@@@@@@@@@@@@@@@@@@@@@@@@@@@@@@@@@@@@@@@@@@@@@@@@@@@@@
@@@@@@@@@@@@@@@@@@@@@@@@@@@@@@@@@@@@@@@@@@@@@@@@@@@@@@@@@@@@@@@@@@@@@@@@@@@@@@@@
@@@@@@@@@@@@@@@@@@@@@@@@@@@@@@@@@@@@@@@@@@@@@@@@@@@@@@@@@@@@@@@@@@@@@@@@@@@@@@@@
@@@@@@@@@@@@@@@@@@@@@@@@@@@@@@@@@@@@@@@@@@@@@@@@@@@@@@@@@@@@@@@@@@@@@@@@@@@@@@@@
@@@@@@@@@@@@@@@@@@@@@@@@@@@@@@@@@@@@@@@@@@@@@@@@@@@@@@@@@@@@@@@@@@@@@@@@@@@@@@@@
@@@@@@@@@@@@@@@@@@@@@@@@@@@@@@@@@@@@@@@@@@@@@@@@@@@@@@@@@@@@@T.@@@@@@@@@@@@@@@@@
@@@@@@@@@@@@@@@@@@@@@@@@@@@@@@@@@@@@@@@@@@@@@@@@@@@@@@@@@@@@....@@@@@@@@@@@@@@@@
@@@@@@@@@@@@@@@@@@@@@@@@@@@@@@@@@@@@@@@@@@@@@@@@@@@@@@@@@@@@T.T..@@@@@@@@@@@@@@@
@@@@@@@@@@@@@@@@@@@@@@@@@@@@@@@@@@@@@@@@@@@@@@@@@@@@@@@@@@@.....T.@@@@@@@@@@@@@@
@@@@@@@@@@@@@@@@@@@@@@@@@@@@@@@@@.@@@@@@@@@@@@@@@@@@@@@@@@.....T...@@@@@@@@@@@@@
@@@@@@@@@@@@@@@@@@@@@@@@@@@@@@@@TTT@@@@@@@@@@@@@@@@@@@@@@...T...TT..@@@@@@@@@@@@
@@@@@@@@@@@@@@@@@@@@@@@@@@@@@@T.....@@@@@@@@@@@@@@@@@@@@.....T...T.TT@@@@@@@@@@@
@@@@@@@@@@@@@@@@@@@@@@@@@@@@.T.T...T@@@@@@@@@@@@@@@@@@@.T.T..T.......@@@@@@@@@@@
@@@@@@@@@@@@@@@@@@@@@@@@@@T..T...T..@@@@@@@@@@@@@@@@@@T.....T...T..T@@@@@@@@@@@@
@@@@@@@@@@@@@@@@@@@@@@@@@@@.T....TT.T@@@@@..@@@@@@@@@.TT..T........@@@@@@@@@@@@@
@@@@@@@@@@@@@@@@@@@@@@@@@@@...T.......@@@....@@@@@@@T.TTT..TT.....@@@@@@@@@@@@@@
@@@@@@@@@@@@@@@@@@@@@@@@@@..TT..TTT..T.T....T.@@@@@...TT.TT....T.@@@@@@@@@@@@@@@
@@@@@@@@@@@@@@@@@@@@@@@@@..........T.T.T..@@@@@@@@.T.TT.T....T.T@@@@@@@@@@@@@@@@
@@@@@@@@@@@@@@@@@@@@@@@@...T...T..TT.....@@@@@@@T.....T..TT.....@@@@@@@@@@@@@@@@
@@@@@@@@@@@@@@@@@@@@@@@..........T.@@......T..TT.T.......TT.T..@@@@@@@@@@@@@@@@@
@@@@@@@@@@@@@@@@@@@@@@T.....@.TT@@T@@.......T.T..T.T....T......@@@@@@@@@@@@@@@@@
@@@@@@@@@@@@@@@@@@@@@...T..@@..@@@@@T...T......T........T..TT.@@@@@@@@@@@@@@@@@@
@@@@@@@@@@@@@@@@@@@@.T...TTT.T@@@@@@.......TT.T.........T.T...@@@@@@@@@@@@@@@@@@
@@@@@@@@@@@@@@.@@@@......T...@@@@@@@....T..TT..T.TTT....T..T.@@@@@@@@@@@@@@@@@@@
@@@@@@@@@@@@@.T@@@.....T...T@@@@@@@.......T.T.........T.....@@@@@@@@@@@@@@@@@@@@
@@@@@@@@@@@@@..@@......T...@@@@@@@..T....T.T.T...T.........@@@@@@@@@@@@@@@@@@@@@
@@@@@@@@@@@@@..@T..T..T...@@@@@@@.T...T..........TT.TT.T...@@@@@@@@@@@@@@@@@@@@@
@@@@@@@@@@@@@..T....@....@@.@@@@..........T.....T...TT...T@@@@@@@@@@@@@@@@@@@@@@
@@@@@@@@@@@@@T..T..@@@..T...T@@@................TTT..TT...@..@@@@@@@@@@@@@@@@@@@
@@@@@@@@@@@@T..T.T.@@T..T...@@T..T.TT..TTT.T...T.TTT.T...@@T..@@@@@@@@@@@@@@@@@@
@@@@@@@@@@@@T..T...@@....T...T....TTTT...TT......T..T...T@...T.@@@@@@@@@@@@@@@@@
@@@@@@@@@@@@.....T...T.TT..T.....T....T...TTTT..T..TT....T.....@@@@@@@@@@@@@@@@@
@@@@@@@@@@@T....T......T.TT..T..T.......T...T..T..TT..TT....T..@@@@@@@@@@@@@@@@@
@@@@@@@@@@T.T....T..T..TT...T..........T.TT.....T..TT...T.....@@@@@@@@@@@@@@@@@@
@@@@@@@@@@.TT.T..T..............T..TTT..................TT.T.@@@@@@@@@@@@@@@@@@@
@@@@@@@@@.TT...TT..T.T....T...T.......T...T..T..............@@@@@@@@@@@@@@@@@@@@
@@@@@@@@@......T.TT..T.T....T..TTT.............T........T.T@@@@@@@@@@@@@@@@@@@@@
@@@@@@@@@...TT...T....T..T..T..TTT...T.....T.TT........T.T@@@@@@@@@@@@@@@@@@@@@@
@@@@@@@@@@.....T.@@@@@@@@@T.....T......T....TT.......TT.T@@@@@@@@@@@@@@@@@@@@@@@
@@@@@@@@@@@.T...@@@@@@@@@@@@..TT..T.TT...T........T.T...@@@@@@@@@@@@@@@@@@@@@@@@
@@@@@@@@@@@@..T.@@@@@@@@@@@@@..............TTT.TT......@@@@@@@@@@@@@@@@@@@@@@@@@
@@@@@@@@@@@@...T@@@@@@@@@@@@...T...T.....T...T..TT.TT.@@@@@@@@@@@@@@@@@@@@@@@@@@
@@@@@@@@@@.T...T@@@@@@@@@@@@...T..................T@@@@@@@@@@@@@@@@@@@@@@@@@@@@@
@@@@@@@@@@@T.......@@@@@@@@...T..T.....TTT..T....@@@@@@@@@@@@@@@@@@@@@@@@@@@@@@@
@@@@@@@@@@@.........@@@@@@@T..T.T.TT.TT.........T@@@@@@@@@@@@@@@@@@@@@@@@@@@@@@@
@@@@@@@@@@@...TT..TT.T..@@@T.....TT.....T..TT...@@@@@@@@@@@@@@@@@@@@@@@@@@@@@@@@
@@@@@@@@@@T...T.T...T...........T.T..TTT....T.T@@@@@@@@@@@@@@@@@@@@@@@@@@@@@@@@@
@@@@@@@@TT.T..T......TT.....TTT.TT.T.....T..T.@@@@@@@@@@@@@@@@@@@@@@@@@@@@@@@@@@
@@@@@@@@.T.....T...T...T....TTT....T..T.....@@@@@@@@@@@@@@@@@@@@@@@@@@@@@@@@@@@@
@@@@TTT...T...T.....T.T..T...T.....T..T....@@@@@@@@@@@@@@@@@@@@@@@@@@@@@@@@@@@@@
@@@@.......T.....T....T..........T...TTT..@@@@@@@@@@@@@@@@@@@@@@@@@@@@@@@@@@@@@@
@@@@@...@@......T......T...T..TT.....T...@@@@@@@@@@@@@@@@@@@@@@@@@@@@@@@@@@@@@@@
@@@@@...@@TT...T......T...T......T..T...@@@@@@@@@@@@@@@@@@@@@@@@@@@@@@@@@@@@@@@@
@@@@............T...T...T....T.T.T..T.@@@@@@@@@@@@@@@@@@@@@@@@@@@@@@@@@@@@@@@@@@
@@@..........T...T.....T.........T...@@@@@@@@@@@@@@@@@@@@@@@@@@@@@@@@@@@@@@@@@@@
@@@@....T..TT..T.TT........T...T....@@@@@@@@@@@@@@@@@@@@@@@@@@@@@@@@@@@@@@@@@@@@
@@@@@T.T..............T......TT..T.@@@@@@@@@@@@@@@@@@@@@@@@@@@@@@@@@@@@@@@@@@@@@
@@@@@@...T....T..TT..T.....T......@@@@@@@@@@@@@@@@@@@@@@@@@@@@@@@@@@@@@@@@@@@@@@
@@@@@....TTTTTTT....T.....T..T...@@@@@@@@@@@@@@@@@@@@@@@@@@@@@@@@@@@@@@@@@@@@@@@
@@@@T........TT.....T..........T@@@@@@@@@@@@@@@@@@@@@@@@@@@@@@@@@@@@@@@@@@@@@@@@
@@@@@..T.............TT....T.T.@@@@@@@@@@@@@@@@@@@@@@@@@@@@@@@@@@@@@@@@@@@@@@@@@
@@@@@@TTT...T.....TT....T.@....@@@@@@@@@@@@@@@@@@@@@@@@@@@@@@@@@@@@@@@@@@@@@@@@@
@@@@@.T..T.......T.......T@@.@@@@@@@@@@@@@@@@@@@@@@@@@@@@@@@@@@@@@@@@@@@@@@@@@@@
@@@@...T...T......T...T......@@@@@@@@@@@@@@@@@@@@@@@@@@@@@@@@@@@@@@@@@@@@@@@@@@@
@@@@@@@@@@@@@@@@@@@@@@@@@@@@@@@@@@@@@@@@@@@@@@@@@@@@@@@@@@@@@@@@@@@@@@@@@@@@@@@@
@@@@@@@@@@@@@@@@@@@@@@@@@@@@@@@@@@@@@@@@@@@@@@@@@@@@@@@@@@@@@@@@@@@@@@@@@@@@@@@@
