type octile
height 118
width 112
map
@@@@@@@@@@@@@@@@@@@@@@@@@@@@@@@@@@@@@@@@@@@@@@@@@@@@@@@@@@@@@@@@@@@@@@@@@@@@@@@@@@@@@@@@@@@@@@@@@@@@@@@@@@@@@@@@
@@@@@@@@@@@@@@@@@@@@@@@@@@@@@@@@@@@@@@@@@@@@@@@@@@@@@@@@@@@@@@@@@@@@@@@@@@@@@@@@@@@@@@@@@@@@@@@@@@@@@@@@@@@@@@@@
@@@@@@@@@@@@@@@@@@@@@@@@@@@@@@@@@@@@@@@@@@@@@@@@@@@@@@@@@@@@@@@@@@@@@@@@@@@@@@@@@@@@@@@@@@@@@@@@@@@@@@@@@@@@@@@@
@@@@@@@@@@@@@@@@@@@@@@@@@@@@@@@@@@@@@@@@@@@@@@@@@@@@@@@@@@@@@@@@@@@@@@@@@@@@@@@@@@@@@@@@@@@@@@@@@@@@@@@@@@@@@@@@
@@@@@@@@@@@@@@@@@@@@@@@@@@@@@@@@@@@@@@@@@@@@@@@@@@@@@@@@@@@@@@@@@@@@@@@@@@@@@@@@@@@@@@@@@@@@@@@@@@@@@@@@@@@@@@@@
@@@@@@@@@@@@@@@@@@@@@@@@@@@@@@@@@@@@@@@@@@@@@@@@@@@@@@@@@@@@@@@@@@@@@@@@@@@@@@@@@@@@@@@@@@@@@@@@@@@@@@@@@@@@@@@@
@@@@@@@@@@@@@@@@@@@@@@@@@@@@@@@@@@@@@@@@@@@@@@@@@@@@@@@@@@@@@@@@@@@@@@@@@@@@@@@@@@@@@@@@@@@@@@@@@@@@@@@@@@@@@@@@
@@@@@@@@@@@@@@@@@@@@@@@@@@@@@@@@@@@@@@@@@@@@@@@@@@@@@@@@@@@@@@@@@@@@@@@@@@@@@@@@@@@@@@@@@@@@@@@@@@@@@@@@@@@@@@@@
@@@@@@@@@@@@@@@@@@@@@@@@@@@@@@@@@@@@@@@@@@@@@@@@@@@@@@@@@@@@@@@@@@@@@@@@@@@@@@@@@@@@@@@@@@@@@@@@@@@@@@@@@@@@@@@@
@@@@@@@@@@@@@@@@@@@@@@@@@@@@@@@@@@@@@@@@@@@@@@@@@@@@@@@@@@@@@@@@@@@@@@@@@@@@@@@@@@@@@@@@@@@@@@@@@@@@@@@@@@@@@@@@
@@@@@@@@@@@@@@@@@@@@@@@@@@@@@@@@@@@@@@@@@@@@@@@@@@@@@@@@@@@@@@@@@@@@.T@@@@@@@@@@@@@@@@@@@@@@@@@@@@@@@@@@@@@@@@@@
@@@@@@@@@@@@@@@@@@@@@@@@@@@@@@@@@@@@@@@@@@@@@@@@@@@@@@@@@@@@@@@@@@@....@@@@@@@@@@@@@@@@@@@@@@@@@@@@@@@@@@@@@@@@@
@@@@@@@@@@@@@@@@@@@@@@@@@@@@@@@@@@@@@@@@@@@@@@@@@@@@@@@@@@@@@@@@@@T..T.T@@@@@@@@@@@@@@@@@@@@@@@@@@@@@@@@@@@@@@@@
@@@@@@@@@@@@@@@@@@@@@@@@@@@@@@@@@@@@@@@@@@@@@@@@@@@@@@@@@@@@@@@@@.....TT.@@@@@@@@@@@@@@@@@@@@@@@@@@@@@@@@@@@@@@@
@@@@@@@@@@@@@@@@@@@@@@@@@@@@@@@@@@@@@@@@@@@@@@@@@@@@@@@@@@@@@@@@.....T..T.@@@@@@@@@@@@@@@@@@@@@@@@@@@@@@@@@@@@@@
@@@@@@@@@@@@@@@@@@@@@@@@@@@@@@@@@@@@@@@@@@@@@@@@@@@@@@@@@@@@@@@TT....T.T..T@@@@@@@@@@@@@@@@@@@@@@@@@@@@@@@@@@@@@
@@@@@@@@@@@@@@@@@@@@@@@@@@@@@@@@@@@@@@@@@@@@@@@@@@@@@@@@@@@@@@.T.T..@.....T.@@@@@@@@@@@@@@@@@@@@@@@@@@@@@@@@@@@@
@@@@@@@@@@@@@@@@@@@@@@@@@@@@@@@@@@@@@@@@@@@@@@@@@@@@@@@@@@@@@...T..@@@.......@@@@@@@@@@@@@@@@@@@@@@@@@@@@@@@@@@@
@@@@@@@@@@@@@@@@@@@@@@@@@@@@@@@@@@@@@@@@@@@@@@@@@@@@@@@@@@@@.T....@@@@@.....T.@@@@@@@@@@@@@@@@@@@@@@@@@@@@@@@@@@
@@@@@@@@@@@@@@@@@@@@@@@@@@@@@@@@@@@@@@@@@@@@@@@@@@@@@@@@@@@......@@@@@@@.....T.@@@@@@@@@@@@@@@@@@@@@@@@@@@@@@@@@
@@@@@@@@@@@@@@@@@@@@@@@@@@@@@@@@@@@@@@@@@@@@@@@@@@@@@@@@@@..T...@@@@@@@@@.......@@@@@@@@@@@@@@@@@@@@@@@@@@@@@@@@
@@@@@@@@@@@@@@@@@@@@@@@@@@@@@@@@@@@@@@@@@@@@@@@@@@@@@@@@@T.....@@@@@@@@@@@.......T@@@@@@@@@@@@@@@@@@@@@@@@@@@@@@
@@@@@@@@@@@@@@@@@@@@@@@@@@@@@@@@@@@@@@@@@@@@@@@@@@@@@@@@...T..@@@@@@@@@@@@@...T....@@@@@@@@@@@@@@@@@@@@@@@@@@@@@
@@@@@@@@@@@@@@@@@@@@@@@@@@@@@@@@@@@@@@@@@@@@@@@@@@@@@@@.TTT..@@@@@@@@..@@@@@...T....@@@@@@@@@@@@@@@@@@@@@@@@@@@@
@@@@@@@@@@@@@@@@@@@@@@@@@@@@@@@@@@@@@@@@@@@@@@@@@@@@@@....TT@@@@@@@..T.@@@@@@...T....@@@@@@@@@@@@@@@@@@@@@@@@@@@
@@@@@@@@@@@@@@@@@@@@@@@@@@@@@@@@@@@@@@@@@@@@@@@@@@@@@.TT...@@@@@@@.....T@@@@@@T..T.T..@@@@@@@@@@@@@@@@@@@@@@@@@@
@@@@@@@@@@@@@@@@@@@@@@@@@@@@@@@@@@@@@@@@@@@@@@@@@@@@T.TT..@@@@@@@......T.@@@@@@...TTT..@@@@@@@@@@@@@@@@@@@@@@@@@
@@@@@@@@@@@@@@@@@@@@@@@@@@@@@@@@@@@@@@@@@@@@@@@@@@.......@@@@@@@@..T...T..@@@@@@........@@@@@@@@@@@@@@@@@@@@@@@@
@@@@@@@@@@@@@@@@@@@@@@@@@@@@@@@@@@@@@@@@@@@@@@@@@......T@@@@@@@@..T..@@.T.TT@@@@@..T.....@@@@@@@@@@@@@@@@@@@@@@@
@@@@@@@@@@@@@@@@@@@@@@@@@@@@@@@@@@@@@@@@@@@@@@@@TT.....@@@@@@@.T..T.@@@@T....@@@@@........@@@@@@@@@@@@@@@@@@@@@@
@@@@@@@@@@@@@@@@@@@@@@@@@@@@@@@@@@@@@@@@@@@@@@@.T.TT..@@@@@.TTTT...@@@@@@..T..@@@@@...T.T..@@@@@@@@@@@@@@@@@@@@@
@@@@@@@@@@@@@@@@@@@@@@@@@@@@@@@@@@@@@@@@@@.@@@T.TT...@@@@@.T.....T@@@@@@@@T...T@@@@@....T...@@@@@@@@@@@@@@@@@@@@
@@@@@@@@@@@@@@@@@@@@@@@@@@@@@@@@@@@@@@@@@..T@@.......T@@@@@T.T...@@@@@@@@@......@@@@@.TTT.TTT@@@@@@@@@@@@@@@@@@@
@@@@@@@@@@@@@@@@@@@@@@@@@@@@@@@@@@@@@@@@.T...@T........@@@@@...T@@@@@@@@.TTTT..T.@@@@@@.T...T.@@@@@@@@@@@@@@@@@@
@@@@@@@@@@@@@@@@@@@@@@@@@@@@@@@@@@@@@@@T....@@.@@@...T..@@@@@T.@@@@@@@@@.T........@@@@@@.TT.T..@@@@@@@@@@@@@@@@@
@@@@@@@@@@@@@@@@@@@@@@@@@T.T......@@@@.....@@@@@@@@..T..T@@@@@@@@@@@@@@@T.TT.T.T...@@@@@@T...T..@@@@@@@@@@@@@@@@
@@@@@@@@@@@@@@@@@@@@@@.T....T.....T@@@.....@@@@@@@..T.....@@@@@@@@@@@.........@@T..@@@@@@@T..T...@@@@@@@@@@@@@@@
@@@@@@@@@@@@@@@@@@@@..........TT...@@@..T.@@@@.@@..........@@@@@@@@@TTTTTT...@@@@.T..@@@@@@T.T....@@@@@@@@@@@@@@
@@@@@@@@@@@@@@@@@@@.T.T..TTT.T...T@@@@TT..@@@@..TT.....T....@@@@@@@..T.T....@@@@@T.TTT.@@@@@....T..@@@@@@@@@@@@@
@@@@@@@@@@@@@@@@@@T...T.T..T.......@@....@@@@@......@TTT..T..@@@@@@T.......@@@@@@......T@@@@T.....T.@@@@@@@@@@@@
@@@@@@@@@@@@@@@@@.TT.....T.TT.TT..T......@@@@@.....@@@.T......@@@@@@..T.T.@@@@@@@T.T.....@@@@.......T@@@@@@..@@@
@@@@@@@@@@@@@@@@..TTT.T..........TT.T.T..@@@@@...T....TT..T...T@@@@@@....@@@@@@@@T....T...@@@@T.......@@@@.T.@@@
@@@@@@@@@@@@@@@.....T.............T.TT..@@@@@TT......T.@@@TTTT..@@@@@@T.@@@@@@@@..T......T@@@@@........@@....@@@
@@@@@@@@@@@@@@.T.T..TT...TT....TT....T.@@@@@.T..T.....@@@@@T.....@@@@@@@@@@@@@T....T..T...T@@@@@.T....TT....@@@@
@@@@@@@@@@@@@@...T..T..@@@@@@@..........@@@.......T....@@@@T.T...T@@@@@@@@@@@..T..T...@@@.TT@@@@@..TT.TT...@@@@@
@@@@@@@@@@@@@..T....T.@@@@@@@@@T..T.T..T.@@.....T...T...@@..T......@@@@@@@@T.TT..T.T.@@@@..T@@@@@@..T......@@@@@
@@@@@@@@@@@@@T.T....T.@@@@@@@@@@...T.T..TT@.......TT.T..........T..T@@@@@@TTT...T..T@@@@@@..T@@@@@@...T.....@@@@
@@@@@@@@@@@@@.TTT..T.T@@@@@T..@@@T.T..T.TT@.T..TT..........T@@.......@@@@@@.....T..@@@@@@@...T.@@@@@@.T..T...@@@
@@@@@@@@@@@@@..T......@@@@@@.TT@@@....T.TT@@....T..T.......@@@TT......@@@@@@T..T..@@@@@@@@.....T@@@@@..T...TT@@@
@@@@@@@@@@@@@@....T.T.@@@@@@....@@@T.......@@..T..T...T....T....TT.....@@@@@@TTTT@@@@@@@@.......@@@@.T...TTTT@@@
@@@@@@@@@@@@@@TT...TT..@@@@@.....@@@.....TTT@TT@@T....T..T......@@.......@@@@@.T@@@@@@@@.T.....@@@@.T.....T.@@@@
@@@@@@@@@@@@@@@..T...T.@@@@T......@@@.T.T.T.@..@@@.TT......T...@@@@.......@@@@@@@@@@@@@..T....@@@@..TT..T.T@@@@@
@@@@@@@@@@@@@@@.TT......@@@......TT@@@.T..T....@@@...T...T....T@@@@....TTTT@@@@@@@@@@@......T.@@@.TT..T...@@@@@@
@@@@@@@@@@@@@@@@.....T..@@@.......T.@@....T.TTT........TT...T...@@...T.T....@@@@@@@..TTT....TT@@.........@@@@@@@
@@@@@@@@@@@@@@@@....T..TT.@@...T...T.@@.T...T..T....T..T...T..T.....TT......T@@@@@.......T.....@....T...@@@@@@@@
@@@@@@@@@@@@@@@@@.T........@@.T.....T.@...T...TT..T.........T........@TT.....T@@@@@.T....@@@..T.......T@@@@@@@@@
@@@@@@@@@@@@@@@@@@...TT..T..@@..T....T@@T..TT.T.TTTT...............T@@@....T...@@@@@....@@@@...T......@@@@@@@@@@
@@@@@@@@@@@@@@@@@@@......T.T.@@.T.T.T...TTT....TTT......TT....T..T...T..T.T...T.@@@@@..@@@@@T.T...T..@@@@@@@@@@@
@@@@@@@@@@@@@@@@@@@@.......TT.@..T.T...T.T....T.......T.@@.T........TT..@@@T....T@@@@@@@@@@......T..@@@@@@@@@@@@
@@@@@@@@@@@@@@@@@@@@@T.TT..TT.@T.TT.T...T...TT.........@@@......T..T...@@@@@.....T@@@@@@@@..T......@@@@@@@@@@@@@
@@@@@@@@@@@@@@@@@@@@@@.....T..@@T..TT.....T..T..T......@@@T.....T.......@@@.T....T.@@@@@@...TT...T@@@@@@@@@@@@@@
@@@@@@@@@@@@@@.@@.T@@@@........@.T...........T.TT.........T...TT..T......@..T....T..@@@@T........@@@@@@@@@@@@@@@
@@@@@@@@@@@@@T.....T@@@@T...T..@@....T.T.....T.....T..........TTT...T.T.T.TTT.T..T..T@@.....TT..@@@@@@@@@@@@@@@@
@@@@@@@@@@@@.......T.@@@@.....T.@.TT.T.....T.......T...TTT...........T....T..@@..TT......TT....@@@@@@@@@@@@@@@@@
@@@@@@@@@@@T......TTTT@@@@..T............T......TTT.T....T..TT.T.T.........T@@@...T...T.T...T.@@@@@@@@@@@@@@@@@@
@@@@@@@@@@.T..T......TT@@@...T..TT..TT..T.T.....T.......TTTT........T.....T......T...........@@@@@@@@@@@@@@@@@@@
@@@@@@@@@..T.T...TT....T@@T........TT......T.T..T..T..TT...TT...T@...TTT.......T@@@.........@@@@@@@@@@@@@@@@@@@@
@@@@@@@@.....T..T..TT....@@T.....T......T...TTTT.T........T...TT@@@T...T.....T.@@@@@.....T.@@@@@@@@@@@@@@@@@@@@@
@@@@@@@.T..............T..@...TT.T...TT...T............T.TT.T...@@@T.TT.........@@@@....T.@@@@@@@@@@@@@@@@@@@@@@
@@@@@@.T.T@T......T...........T......T.........T..T..T...T..T.....T........T.....@@T.....@@@@@@@@@@@@@@@@@@@@@@@
@@@@@TT.T@@@......T.......@@..T.T.T....T.......TT.....T.....T.T....T...T...T.T...T...T...@@@@@@@@@@@@@@@@@@@@@@@
@@@@T...@@@@@.T..TT.T....@@@....TT..T............T....T.T..TT.....T.T...TTT.T.TT.T.T....T@@@@@@@@@@@@@@@@@@@@@@@
@@@.....@@@@T...........T@@@@....T.T..TT.....TTT...TT.......T...T..T....TT.......T.T..T.T@@@@@@@@@@@@@@@@@@@@@@@
@@@@..T..@@..T..T.T........TTTTT.T.T.T.T......T.............T.TT.....T..T.T.T....TT.T...@@@@@@@@@@@@@@@@@@@@@@@@
@@@@@.........TT.T...TT.TT....T....T........T..T.T..TT..............T....@@T....T.T...TT@@@@@@@@@@@@@@@@@@@@@@@@
@@@@@@T.T.TT..@...TT.T........T.....T..T..T.......T.T...T.T......T...T..@@@T............@@@@@@@@@@@@@@@@@@@@@@@@
@@@@@@@T..TT.@@@..T.TT.....T.....T......T......T..T...T.T....TT..T.....T@@@@..T.T.......@@@@@@@@@@@@@@@@@@@@@@@@
@@@@@@@@.T.T.T..............T.......T..TT....TT.....T..T.TTTTT.T.......TTT..T...T.T....@@@@@@@@@@@@@@@@@@@@@@@@@
@@@@@@@@@....T...@@@....T..T......@@@T...T.T........TTT...T...T.....T...T......T......@@@@@@@@@@@@@@@@@@@@@@@@@@
@@@@@@@@@@T.....@@@@@T..TT.T...T..@@@T..T.T.....T.T.T.T.T..TTTTT..T..TT.T..TT..TT...@@@@@@@@@@@@@@@@@@@@@@@@@@@@
@@@@@@@@@@@...T..@@@@.T........TT.@@@..TT......TT.T.....T...TT........TT........T..@@@@@@@@@@@@@@@@@@@@@@@@@@@@@
@@@@@@@@@@@@......@@.T.T..TT.T..TT...................T...T.T.TTT...T..T...TT.T..TT@@@@@@@@@@@@@@@@@@@@@@@@@@@@@@
@@@@@@@@@@@@@T...TT....T.T...T..............T.....T...T.T...T....TT....T......T.TT@@@@@@@@@@@@@@@@@@@@@@@@@@@@@@
@@@@@@@@@@@@@@T..TTT..@@T...........T.....T........T...TT.........T...T......TT..@@@@@@@@@@@@@@@@@@@@@@@@@@@@@@@
@@@@@@@@@@@@@@@..TT..T@@..TT.T.TT.....TT......T.TT..T.TTT.....T....TT...T.......T@@@@@@@@@@@@@@@@@@@@@@@@@@@@@@@
@@@@@@@@@@@@@@@@..............TT....T.....TT...T..........T.....T.....T...T...T.@@@@@@@@@@@@@@@@@@@@@@@@@@@@@@@@
@@@@@@@@@@@@@@@@@T.T......@@T.T...TT...TT.T@@..T.TT.........T...T......T....T...@@@@@@@@@@@@@@@@@@@@@@@@@@@@@@@@
@@@@@@@@@@@@@@@@@@....T.T.@@@.TTT.........@@@@.T..........T.T.T.T.TTT.....T.T.T@@@@@@@@@@@@@@@@@@@@@@@@@@@@@@@@@
@@@@@@@@@@@@@@@@@@@........T..T..T...TTT..@@@@T....TT.T....T...TT...T..T.....@@@@@@@@@@@@@@@@@@@@@@@@@@@@@@@@@@@
@@@@@@@@@@@@@@@@@@@@......T.....T..TTT....T.TT.T.T...TT...T.TT....T.T.......@@@@@@@@@@@@@@@@@@@@@@@@@@@@@@@@@@@@
@@@@@@@@@@@@@@@@@@@@@..TT....T.T..T......T.T....T..T...........T......T...T@@@@@@@@@@@@@@@@@@@@@@@@@@@@@@@@@@@@@
@@@@@@@@@@@@@@@@@@@@@@T....T...@....T.T........TT....TT..T...T..T......T..@@@@@@@@@@@@@@@@@@@@@@@@@@@@@@@@@@@@@@
@@@@@@@@@@@@@@@@@@@@@@@..T....@@@....TT..T.T......T.T....T..T.T..TTTTT..T@@@@@@@@@@@@@@@@@@@@@@@@@@@@@@@@@@@@@@@
@@@@@@@@@@@@@@@@@@@@@@@@..T.T.........T...T..T.......T.T................@@@@@@@@@@@@@@@@@@@@@@@@@@@@@@@@@@@@@@@@
@@@@@@@@@@@@@@@@@@@@@@@@@..T......@@@T..T.......TTT.@....TT....T....T..@@@@@@@@@@@@@@@@@@@@@@@@@@@@@@@@@@@@@@@@@
@@@@@@@@@@@@@@@@@@@@@@@@@@..T...T.@@@....T.T..T...T@@@T.......T...T.T@@@@@@@@@@@@@@@@@@@@@@@@@@@@@@@@@@@@@@@@@@@
@@@@@@@@@@@@@@@@@@@@@@@@@@@T........T.T.T.T.....T..@@@T........T.@@@@@@@@@@@@@@@@@@@@@@@@@@@@@@@@@@@@@@@@@@@@@@@
@@@@@@@@@@@@@@@@@@@@@@@@@@@@T......T....T..TT....T....T.........@@@@@@@@@@@@@@@@@@@@@@@@@@@@@@@@@@@@@@@@@@@@@@@@
@@@@@@@@@@@@@@@@@@@@@@@@@@@@@T...T.TT.....TTTTT..........T.....@@@@@@@@@@@@@@@@@@@@@@@@@@@@@@@@@@@@@@@@@@@@@@@@@
@@@@@@@@@@@@@@@@@@@@@@@@@@@@@@TTT..T..T@.T......T.T...TTT....T@@@@@@@@@@@@@@@@@@@@@@@@@@@@@@@@@@@@@@@@@@@@@@@@@@
@@@@@@@@@@@@@@@@@@@@@@@@@@@@@@@T.......@@...T........T..TTT.@@@@@@@@@@@@@@@@@@@@@@@@@@@@@@@@@@@@@@@@@@@@@@@@@@@@
@@@@@@@@@@@@@@@@@@@@@@@@@@@@@@@@T.....T......T....T.T...TT@@@@@@@@@@@@@@@@@@@@@@@@@@@@@@@@@@@@@@@@@@@@@@@@@@@@@@
@@@@@@@@@@@@@@@@@@@@@@@@@@@@@@@@@T...T....@@@T.........T@@@@@@@@@@@@@@@@@@@@@@@@@@@@@@@@@@@@@@@@@@@@@@@@@@@@@@@@
@@@@@@@@@@@@@@@@@@@@@@@@@@@@@@@@@@T.....T.@@@........@@@@@@@@@@@@@@@@@@@@@@@@@@@@@@@@@@@@@@@@@@@@@@@@@@@@@@@@@@@
@@@@@@@@@@@@@@@@@@@@@@@@@@@@@@@@@@@....T......T.TT.@@@@@@@@@@@@@@@@@@@@@@@@@@@@@@@@@@@@@@@@@@@@@@@@@@@@@@@@@@@@@
@@@@@@@@@@@@@@@@@@@@@@@@@@@@@@@@@@@@@...T...T..TT.@@@@@@@@@@@@@@@@@@@@@@@@@@@@@@@@@@@@@@@@@@@@@@@@@@@@@@@@@@@@@@
@@@@@@@@@@@@@@@@@@@@@@@@@@@@@@@@@@@@@@@..........@@@@@@@@@@@@@@@@@@@@@@@@@@@@@@@@@@@@@@@@@@@@@@@@@@@@@@@@@@@@@@@
@@@@@@@@@@@@@@@@@@@@@@@@@@@@@@@@@@@@@@@@...T.T.T@@@@@@@@@@@@@@@@@@@@@@@@@@@@@@@@@@@@@@@@@@@@@@@@@@@@@@@@@@@@@@@@
@@@@@@@@@@@@@@@@@@@@@@@@@@@@@@@@@@@@@@@@@T....@@@@@@@@@@@@@@@@@@@@@@@@@@@@@@@@@@@@@@@@@@@@@@@@@@@@@@@@@@@@@@@@@@
@@@@@@@@@@@@@@@@@@@@@@@@@@@@@@@@@@@@@@@@@@...@@@@@@@@@@@@@@@@@@@@@@@@@@@@@@@@@@@@@@@@@@@@@@@@@@@@@@@@@@@@@@@@@@@
@@@@@@@@@@@@@@@@@@@@@@@@@@@@@@@@@@@@@@@@@@@@@@@@@@@@@@@@@@@@@@@@@@@@@@@@@@@@@@@@@@@@@@@@@@@@@@@@@@@@@@@@@@@@@@@@
@@@@@@@@@@@@@@@@@@@@@@@@@@@@@@@@@@@@@@@@@@@@@@@@@@@@@@@@@@@@@@@@@@@@@@@@@@@@@@@@@@@@@@@@@@@@@@@@@@@@@@@@@@@@@@@@
@@@@@@@@@@@@@@@@@@@@@@@@@@@@@@@@@@@@@@@@@@@@@@@@@@@@@@@@@@@@@@@@@@@@@@@@@@@@@@@@@@@@@@@@@@@@@@@@@@@@@@@@@@@@@@@@
@@@@@@@@@@@@@@@@@@@@@@@@@@@@@@@@@@@@@@@@@@@@@@@@@@@@@@@@@@@@@@@@@@@@@@@@@@@@@@@@@@@@@@@@@@@@@@@@@@@@@@@@@@@@@@@@
@@@@@@@@@@@@@@@@@@@@@@@@@@@@@@@@@@@@@@@@@@@@@@@@@@@@@@@@@@@@@@@@@@@@@@@@@@@@@@@@@@@@@@@@@@@@@@@@@@@@@@@@@@@@@@@@
@@@@@@@@@@@@@@@@@@@@@@@@@@@@@@@@@@@@@@@@@@@@@@@@@@@@@@@@@@@@@@@@@@@@@@@@@@@@@@@@@@@@@@@@@@@@@@@@@@@@@@@@@@@@@@@@
@@@@@@@@@@@@@@@@@@@@@@@@@@@@@@@@@@@@@@@@@@@@@@@@@@@@@@@@@@@@@@@@@@@@@@@@@@@@@@@@@@@@@@@@@@@@@@@@@@@@@@@@@@@@@@@@
@@@@@@@@@@@@@@@@@@@@@@@@@@@@@@@@@@@@@@@@@@@@@@@@@@@@@@@@@@@@@@@@@@@@@@@@@@@@@@@@@@@@@@@@@@@@@@@@@@@@@@@@@@@@@@@@
