type octile
height 54
width 52
map
@@@@@@@@@@@@@@@@@@@@@@@@@@@@@@@@@@@@@@@@@@@@@@@@@@@@
@@@@@@@@@@@@@@@@@@@@@@@@@@@@@@@@@@@@@@@@@@@@@@@@@@@@
@@@@@@@@@@@@@@@@@@@@@@@@@@@@@@@@@@@@@@@@@@@@@@@@@@@@
@@@@@@@@@@@@@@@@@@@@@@@@@@@@@@@@@@@@@@@@@@@@@@@@@@@@
@@@@@@@@@@@@@@@@@@@@@@@@@@@@@@@@@@@@@@@@@@@@@@@@@@@@
@@@@@@@@@@@@@@@@@@@@@@@@@@@@@@@@@@@@@@@@@@@@@@@@@@@@
@@@@@@@@@@@@@@@@@@@@@@@@@@@@@@@@@@@@@@@@@@@@@@@@@@@@
@@@@@@@@@@@@@@@@@@@@@@@@@@@@@@@@@@@@@@@@@@@@@@@@@@@@
@@@@@@@@@@@@@@@@@@@@@@@@@@@@@@@@@@@@@@@@@@@@@@@@@@@@
@@@@@@@@@@@@@@@@@@@@@@@@@@@@@@@@@@@@@@@@@@@@@@@@@@@@
@@@@@@@@@@@@@@@@@@@@@@@@@@@@@@@@@@@@@@@@@@@@@@@@@@@@
@@@@@@@@@@@@@@@@@@@@@@@@@@@@@@@@@@@@@@@@@@@@@@@@@@@@
@@@@@@@@@@@@@@@@@@@@@@@@@@@@@@@@@@@@@@@@@@@@@@@@@@@@
@@@@@@@@@@@@@@@@@@@@@@@@@@@@@@@@@@@@@@@@@@@@@@@@@@@@
@@@@@@@@@@@@@@@@@@@@@@@@@@@@@@@@@@@@@@@@@@@@@@@@@@@@
@@@@@@@@@@@@@@@@@@@@@@@@@@@@@@@@@@@@@@@@@@@@@@@@@@@@
@@@@@@@@@@@@@@@@@@@@@@@@@@@@.@@@@TT@@@@@@@@@@@@@@@@@
@@@@@@@@@@@@@@@@@@@@@@@@@@@T.T@@.TTT.@@@@@@@@@@@@@@@
@@@@@@@@@@@@@@@@@@@@@@@@@@....T.......@@@@@@@@@@@@@@
@@@@@@@@@@@@@@@@@@@@@@@@@@TTT.......TT.@@@@@@@@@@@@@
@@@@@@@@@@@@@@@@@@@@@@@@@....T..@@......@@@@@@@@@@@@
@@@@@@@@@@@@@@@@@@@@@@@.T..T...@@@@@T...T@@@@@@@@@@@
@@@@@@@@@@@@@@@@@@@@@@...TT.T.T@@@@@@@....@@@@@@@@@@
@@@@@@@@@@@@@@@@@@@@@..T..T....@@@@@@@...@@@@@@@@@@@
@@@@@@@@@@@@@@@@@@@@@@......T.T@@@@T.T..@@@@@@@@@@@@
@@@@@@@@@@@@@@@@@@@@@@@.T...T...@.....T@@@@@@@@@@@@@
@@@@@@@@@@@@@@@@@@@@@@@@....TT..T.....T@@@@@@@@@@@@@
@@@@@@@@@@@@@@@@@..@@@@@@....TT..T.....@@@@@@@@@@@@@
@@@@@@@@@@@@@@@@.TT.@@@@@...T....T....TT@@@@@@@@@@@@
@@@@@@@@@@@@@@@..T...@@@@.......T....TT..@@@@@@@@@@@
@@@@@@@@@@@@@@@@T..T.@@@..T..T........T...@@@@@@@@@@
@@@@@@@@@@@@@@@@@..T.T.....T.TT..T.T.T...@@@@@@@@@@@
@@@@@@@@@@@@@@@@@@...T..T.....T.T.T.T..T@@@@@@@@@@@@
@@@@@@@@@@@@@@@@@@@......T....TT.......@@@@@@@@@@@@@
@@@@@@@@@@@@T@@@@@@.......T.TT...T....@@@@@@@@@@@@@@
@@@@@@@@.@@..T@@@@@..T...T..T....T.TT@@@@@@@@@@@@@@@
@@@@@@@T.TTTT..@@@.....T....T.......@@@@@@@@@@@@@@@@
@@@@@@T..TT....TT..TTT....T..T..T..@@@@@@@@@@@@@@@@@
@@@@@@.......T....TT.@@........T..@@@@@@@@@@@@@@@@@@
@@@@@@@..T...T...TT.@@@....TT.T.T@@@@@@@@@@@@@@@@@@@
@@@@@@@@..T........@@.TT...T...T@@@@@@@@@@@@@@@@@@@@
@@@@@@@@@........T@@T......T.T.@@@@@@@@@@@@@@@@@@@@@
@@@@@@@@@@.T...TT@@..T.....T..@@@@@@@@@@@@@@@@@@@@@@
@@@@@@@@@@@....T@@T.....TT...@@@@@@@@@@@@@@@@@@@@@@@
@@@@@@@@@@@@.T.@@.TT......T.@@@@@@@@@@@@@@@@@@@@@@@@
@@@@@@@@@@@@@.@@......T..TT@@@@@@@@@@@@@@@@@@@@@@@@@
@@@@@@@@@@@@@@@..T.T..T..T@@@@@@@@@@@@@@@@@@@@@@@@@@
@@@@@@@@@@@@@@@TT...T..T.@@@@@@@@@@@@@@@@@@@@@@@@@@@
@@@@@@@@@@@@@@@@...T....@@@@@@@@@@@@@@@@@@@@@@@@@@@@
@@@@@@@@@@@@@@@@@.T....@@@@@@@@@@@@@@@@@@@@@@@@@@@@@
@@@@@@@@@@@@@@@@@@....@@@@@@@@@@@@@@@@@@@@@@@@@@@@@@
@@@@@@@@@@@@@@@@@@@T.@@@@@@@@@@@@@@@@@@@@@@@@@@@@@@@
@@@@@@@@@@@@@@@@@@@@@@@@@@@@@@@@@@@@@@@@@@@@@@@@@@@@
@@@@@@@@@@@@@@@@@@@@@@@@@@@@@@@@@@@@@@@@@@@@@@@@@@@@
