type octile
height 91
width 104
map
@@@@@@@@@@@@@@@@@@@@@@@@@@@@@@@@@@@@@@@@@@@@@@@@@@@@@@@@@@@@@@@@@@@@@@@@@@@@@@@@@@@@@@@@@@@@@@@@@@@@@@@@
@@@@@@@@@@@@@@@@@@@@@@@@@@@@@@@@@@@@@@@@@@@@@@@@@@@@@@@@@@@@@@@@@@@@@@@@@@@@@@@@@@@@@@@@@@@@@@@@@@@@@@@@
@@@@@@@@@@@@@@@@@@@@@@@@@@@@@@@@@@@@@@@@@@@@@@@@@@@@@@@@@@@@@@@@@@@@@@@@@@@@@@@@@@@@@@@@@@@@@@@@@@@@@@@@
@@@@@@@@@@@@@@@@@@@@@@@@@@@@@@@@@@@@@@@@@@@@@@@@@@@@@@@@@@@@@@@@@@@@@@@@@@@@@@@@@@@@@@@@@@@@@@@@@@@@@@@@
@@@@@@@@@@@@@@@@@@@@@@@@@@@@@@@@@@@@@@@@@@@@@@@@@@@@@@@@@@@@@@@@@@@@@@@@@@@@@@@@@@@@@@@@@@@@@@@@@@@@@@@@
@@@@@@@@@@@@@@@@@@@@@@@@@@@@@@@@@@@@@@@@@@@@@@@@@@@@@@@@@@@@@@@@@@@@@@@@@@@@@@@@@@@@@@@@@@@@@@@@@@@@@@@@
@@@@@@@@@@@@@@@@@@@@@@@@@@@@@@@@@@@@@@@@@@@@@@@@@@@@@@@@@@@@@@@@@@@@@@@@@@@@@@@@@@@@@@@@@@@@@@@@@@@@@@@@
@@@@@@@@@@@@@@@@@@@@@@@@@@@@@@@@@@@@@@@@@@@@@@@@@@@@@@@@@@@@@@@@@@@@@@@@@@@@@@@@@@@@@@@@@@@@@@@@@@@@@@@@
@@@@@@@@@@@@@@@@@@@@@@@@@@@@@@@@@@@@@@@@@@@@@@@@@@@@@@@@@@@@@@@@@@@@@@@@@@@@@@@@@@@@@@@@@@@@@@@@@@@@@@@@
@@@@@@@@@@@@@@@@@@@@@@@@@@@@@@@@@@@@@@@@@@@@@@@@@@@@@@@@@@@@@@@@@@@@@@@@@@@@@@@@@@@@@@@@@@@@@@@@@@@@@@@@
@@@@@@@@@@@@@@@@@@@@@@@@@@@@@@@@@@@@@@@@@@@@@@@@@@@@@@@@@@@@@@@@@@@@@@@@@@@@@@@@@@@@@@@@@@@@@@@@@@@@@@@@
@@@@@@@@@@@@@@@@@@@@@@@@@@@@@@@@@@@@@@@@@@@@@@@@@@@@@@@@@@@@@@@@@@@@@@@@@@@@@@@@@@@@@@@@@@@@@@@@@@@@@@@@
@@@@@@@@@@@@@@@@@@@@@@@@@@@@@@@@@@@@@@@@@@@@@@@@@@@@@@@@@@@@@@@@@@@@@@@@@@@@@@@@@@@@@@@@@@@@@@@@@@@@@@@@
@@@@@@@@@@@@@@@@@@@@@@@@@@@@@@@@@@@@@@@@@@@@@@@@@@@@@@@@@@@@@@@@@@@@@@@@@@@@@@@@@@@@@@@@@@@@@@@@@@@@@@@@
@@@@@@@@@@@@@@@@@@@@@@@@@@@@@@@@@@@@@@@@@@@@@@@@@@@@@@@@@@@@@@@@@@@@@@@@@@@@@@@@@@@@@@@@@@@@@@@@@@@@@@@@
@@@@@@@@@@@@@@@@@@@@@@@@@@@@@@@@@@@@@@@@@@@@@@@@@@@@@@@@@@@@@@@@@@@@@@@@@@@@@@@@@@@@@@@@@@@@@@@@@@@@@@@@
@@@@@@@@@@@@@@@@@@@@@@@@@@@@@@@@@@@@@@@@@@@@@@@@@@@@@@@@@@@@@@@@@@@@@@@@@@@@@@@@@@@@@@@@@@@@@@@@@@@@@@@@
@@@@@@@@@@@@@@@@@@@@@@@@@@@@@@@@@@@@@@@@@@@@@@@@@@@@@@@@@@@@@@@@@@@@@@@@@@@@@@@@@@@@@@@@@@@@@@@@@@@@@@@@
@@@@@@@@@@@@@@@@@@@@@@@@@@@@@@@@@@@@@@@@@@@@@@@@@@@@@@@@@@@@@@@@@@@@@@@@@@@@@@@@@@@@@@@@@@@@@@@@@@@@@@@@
@@@@@@@@@@@@@@@@@@@@@@@@@@@@@@@@@@@@@@@@@@@@@@@@@@@@@@@@@@@@@@@@@@@@@@@@@@@@@@@@@@@@@@@@@@@@@@@@@@@@@@@@
@@@@@@@@@@@@@@@@@@@@@@@@@@@@@@@@@@@@@@@@@@@@@@@@@@@@@@@@@@@@@@@@@@@@@@@@@@@@@@@@@@@@@@@@@@@@@@@@@@@@@@@@
@@@@@@@@@@@@@@@@@@@@@@@@@@@@@@@@@@@@@@@@@@@@@@@@@@@@@@@@@@@@@@@@@@@@@@@@@@@@@@@@@@@@@@@@@@@@@@@@@@@@@@@@
@@@@@@@@@@@@@@@@@@@@@@@@@@@@@@@@@@@@@.@@@@@@@@@@@@@@@@@@@@@@@@@@@@@@@@@@@@@@@@@@@@@@@@@@@@@@@@@@@@@@@@@@
@@@@@@@@@@@@@@@@@@@@@@@@@@@@@@@@@..@...@@@@@@@@@@@@@@@@@@@@@@@@@@@@@@@@@@@@@@@@@@@@@@@@@@@@@@@@@@@@@@@@@
@@@@@@@@@@@@@@@@@@@@@@@@@@@@@@@@........@@@@@@@@@@@@@@@@@@@@@@@@@@@@@@@@@@@@@@@@@@@@@@@@@@@@@@@@@@@@@@@@
@@@@@@@@@@@@@@@@@@@@@@@@@@@@@@@TTT..T....@@@@@@@@@@@@@@@@@@@@@@@@@@@@@@@@@@@@@@@@@@@@@@@@@@@@@@@@@@@@@@@
@@@@@@@@@@@@.@@@@@@@@@@@@@@@@@....TTT..T..@@@@@@@@@@@@@@@@@@@@@@@@@@@@@@@@@@@@@@@@@@@T..@@@@@@@@@@@@@@@@
@@@@@@@@@@@..@@@@@@@@@@@@@@@@@@.........T..@.@@@@@@@@@@@@@@@@@@@@@@@@@@@@@@@@@@@@TT@@..T@@@@@@@@@@@@@@@@
@@@@@@@@@@....@@@@@@@@@@@@@@.@@@.......T...T.@@@@@@@@@@@@@@@@@@@@@@@@@@@@@@@@@@@....@.T@@@@@@@@@@@@@@@@@
@@@@@@@@@......@@@@@@@@@@@@....@@.T......T.T.@@@@@@@@@@@@@@@@@@@@@@@@@@@@@@@@@.....T..T@@@@@@@@@@@@@@@@@
@@@@@@@@@@..T..@@@@@@@@@@.....T.@@..T....TTT..@@@@@@@@@@@@@@@@@@@@@@@@@@@@@@@...T......@@@@@@@@@@@@@@@@@
@@@@@@@@@@.....T@@@@@@@@TTT.T...T@@....T.T.....@@@@@@@@@@@@@@@@@@@@@@@@@@@@@T...T..T..T@@@@@@@@@@@@@@@@@
@@@@@@@@@@@..T.T@@@@@@@@@T......T.@@..T........T@@@@@@@@@@@@@@@@@@@@@@@@@@@@@TT.T...T@@@@@@@@@@@@@@@@@@@
@@@@@@@@@@@@....@@@@@@..@@.T.......@T..TT..TT.T@@.T@@@@@@@@@@@@@@@@@@@@@@@@@@@@.TT..@@@@@@@@@@@@@@@@@@@@
@@@@@@@@@@@@TT..T@@@@....@@..T............TT..@@T..@@@@@@@@@@@@@@@@@@@@@@TT..T@@..T.@@@@@@@@@@@@@@@@@@@@
@@@@@@@@@@@@@..T.@@.......@@..............T.T@@....@@@@@@@@@@@@@@@@@@.@@..TT...@@...@@@@@@@@@@@@@@@@@@@@
@@@@@@@@@@@@@@.TT.@@.TT.T.T@@..T.TT...TT..TT@@.T...@@@@@@@@@@@@@@@@@@......T........@@@@@@@@@@@@@@@@@@@@
@@@@@@@@@@@@@@....@@@.T..TT.@@T..T.........@@.T.....@@@@@@@@@@@@@@@@T.......T..T..TT@@@@@@@@@@@@@@@@@@@@
@@@@@@@@@@@@@@@...@@@@TT..T..@@..T.T..T...@@...T...T@@T@@@@@@@@@@@@@.....T.T.T....@@@@@@@@@@@@@@@@@@@@@@
@@@@@@@@@@@@@@@...T@@@@..TT..T@...T....T.@@..TT.T.T.T..@@@@@@@@@@@@@...T...........@@@@@@@@@@@@@@@@@@@@@
@@@@@@@@@@@@@@@@...@@@@@........T...T.T.@@.............@@@@@@@@@@@@@@.....T.....T...@@@@@@@@@@@@@@@@@@@@
@@@@@@@@@@@@@@@@....@@@@@...T..T.T.....T@.....T.T...T...@@@@@@@@@@@@@@......T...TT...@@@@@@@@@@@@@@@@@@@
@@@@@@@@@@@@@....T...@@@@@TT.T.T..T.T...@...@.T........@@@@@@@@@@@@@@@@@........T.....@@@@@@@@@@@@@@@@@@
@@@@@@@@@@@@T.......T@@@@@.T.......T.T.@@.T@@@...T.TT.@@@@@@@@@@@@@@@@@@@T....T..T.T.TT@@@@@@@@@@@@@@@@@
@@@@@@@@@@@TT.........@@@@@.T...T..T.T.@T..@@@@...T..@@@@@@@@@@@@@@@@@@@@@.......T.T..T.@@@@@@@@@@@@@@@@
@@@@@@@@@@....T........T.@@....T......@@T..@@@@@.T..@@@@@@@@@@@@@@@@@@@@@@@@......T...T..@@@@@@@@@@@@@@@
@@@@@@@@@..TT....T.T..T..T..T...T..T..@....@@@@@@T.@@@@@@@@@@@@@@@@@@@@@@@@@@.T....T.....T@@@@@@@@@@@@@@
@@@@@@@@T...............T.....T......@@T..@@@@@@@@@@@@@@@@.@@@@@@@@@@@@@@@@@@@@............@@@@@@@@@@@@@
@@@@@@@@TTT.TT...T.....T....TT.T..T..@...@@@@@@@@@@@@@@@@.T@@@@@@@.@@@@@@@@@@@@@@.T........T@@@@@@@@@@@@
@@@@@@@@@T.T.T............TT.T.T...TT@...@@@@@@@@@@@@@.@...T@@@@@T.@@@@@@@@@@@@@TT.....T.T.TT@@@@@@@@@@@
@@@@@@@@@@.T...TTT.T....TT..T...T...T..T@@@@@@@@@@@@.......@@@@@@T..@@@@@@@.@@@..T..T.T....T.T.@@@@@@@@@
@@@@@@@@@@@..TT............TT.....TT..TT@@@@@@@@@@@..TT..T.@@@@@@....T@@@@TT.@T.T..T...T.T..T.@@@@@@@@@@
@@@@@@@@@@@@TT.T....TT....T.TT.........@@@@@@@@@T@@.T.@@@....T...T...T.@@@......T..TT.......T@@@@@@@@@@@
@@@@@@@@@@@@@..T.T.T.T.........T..T..T@@@@@@@@@...TTT.@@@@........................@.T...T..T@@@@@@@@@@@@
@@@@@@@@@@@@@@.....T.TT..........T..T@@@@@@.@@TTT...T@@@@@.TT....TT.............T@@@T....T@@@@@@@@@@@@@@
@@@@@@@@@@@@@@@.........T...T.......T..@@@.TT.T...T@@@@@@@.T.T......TTT...T.T....@@@@...T@@@@@@@@@@@@@@@
@@@@@@@@@@@@@@@@..TT......TTTT........T.T...T.....@@@@@@@T..T.....T@......T..TTT..@@@@T.@@@@@@@@@@@@@@@@
@@@@@@@@@@@@@@@@@TT....TT.T.T.....@@@.....T....TT@@@@@@@TT.......T@@@.....T........@@@@@@@@@@@@@@@@@@@@@
@@@@@@@@@@@@@@@@@@.TT.T..T.......@@@@..TT..T.....@@.@@....@@..T.@@@@@@.T..T....TT...@@@@@@@@@@@@@@@@@@@@
@@@@@@@@@@@@@@@@@@@....T..T..T.T@@@@T.T.T.......@@@...T.T@@@@T..@@@@@@@....T.........@@@@@@@@@@@@@@@@@@@
@@@@@@@@@@@@@@@@@@@@...T..T..TT@@@@@@.T.TT......@@T....T@@@@@@TT..@@@@@.......T.T...@@@@@@@@@@@@@@@@@@@@
@@@@@@@@@@@@@@@@@@@@@.........@@@@@@@@.T..T....T...TT..@@@@@@@.....@@@@..T.....T..T@@@@@@@@@@@@@@@@@@@@@
@@@@@@@@@@@@@@@@@@@@@@..T....@@@@@@@@@.....T....T..T..@@@@@@@.....T........T...T.T@@@@@@@@@@@@@@@@@@@@@@
@@@@@@@@@@@@@@@@@@@@@@@...T.@@@@@@@@@@@..T.T.........@@@@@@@...........TT......T.@@@@@@@@@@@@@@@@@@@@@@@
@@@@@@@@@@@@@@@@@@@@@@@@...@@@.@@@@@@@@.TT.@.......T@@@@@@@T..T...T...TT.T......@@@@@@@@@@@@@@@@@@@@@@@@
@@@@@@@@@@@@@@@@@@@@@@@@@.@@@...@@@T@@@...@@@..T.T.@@@@@@@...T.TTT.......T.....@@@@@@@@@@@@@@@@@@@@@@@@@
@@@@@@@@@@@@@@@@@@@@@@@@@@@@......T.....T@@.....T.@@@@@@@T......TT.T....TTT...@@@@@@@@@@@@@@@@@@@@@@@@@@
@@@@@@@@@@@@@@@@@@@@@@@@@@@.T.....T.TT.T@@..T..T..@@@@@@...T.......T.TT....TT@@@@@@@@@@@@@@@@@@@@@@@@@@@
@@@@@@@@@@@@@@@@@@@@@@@@@@@@....T..T...@@.......T..@@@@..T.......T...T..T...@@@@@@@@@@@@@@@@@@@@@@@@@@@@
@@@@@@@@@@@@@@@@@@@@@@@@@@@@@T.....TT.@@T....@..T.T.@@..TTTT.T.T...........@@@@@@@@@@@@@@@@@@@@@@@@@@@@@
@@@@@@@@@@@@@@@@@@@@@@@@@@@@@@@T..T..@@T...T@@@T......T..TT.T....TT....T..@@@@@@@@@@@@@@@@@@@@@@@@@@@@@@
@@@@@@@@@@@@@@@@@@@@@@@@@@@@@@@@T...@@.....@@T..T....T..TT.T..TT...T...TT@@@@@@@@@@@@@@@@@@@@@@@@@@@@@@@
@@@@@@@@@@@@@@@@@@@@@@@@@@@@@@@@@.@@@.....@@..T.....T...T.T...T.....T.TT@@@@@@@@@@@@@@@@@@@@@@@@@@@@@@@@
@@@@@@@@@@@@@@@@@@@@@@@@@@@@@@@@@@@@....T@@.......T...TT..T..........T.@@@@@@@@@@@@@@@@@@@@@@@@@@@@@@@@@
@@@@@@@@@@@@@@@@@@@@@@@@@@@@@@@@@@@.....@@......@@...T..T..T.....T.TT.@@@@@@@@@@@@@@@@@@@@@@@@@@@@@@@@@@
@@@@@@@@@@@@@@@@@@@@@@@@@@@@@@@@@@@@..T@@T.T..@@@@@@.TT..T.....T.T.T.@@@@@@@@@@@@@@@@@@@@@@@@@@@@@@@@@@@
@@@@@@@@@@@@@@@@@@@@@@@@@@@@@@@@@@@@@.@@....T@@@@@@@@.T.TT.....TT.T.@@@@@@@@@@@@@@@@@@@@@@@@@@@@@@@@@@@@
@@@@@@@@@@@@@@@@@@@@@@@@@@@@@@@@@@@@@@@...TT..@@@@@@@TT.TTT....T...@@@@@@@@@@@@@@@@@@@@@@@@@@@@@@@@@@@@@
@@@@@@@@@@@@@@@@@@@@@@@@@@@@@@@@@@@@@@@.....T.@@@@@@T....T...TT.T.@@@@@@@@@@@@@@@@@@@@@@@@@@@@@@@@@@@@@@
@@@@@@@@@@@@@@@@@@@@@@@@@@@@@@@@@@@@@@@@T..T...@@@@..............@@@@@@@@@@@@@@@@@@@@@@@@@@@@@@@@@@@@@@@
@@@@@@@@@@@@@@@@@@@@@@@@@@@@@@@@@@@@@@@@@T....T..@.TT.T..T......@@@@@@@@@@@@@@@@@@@@@@@@@@@@@@@@@@@@@@@@
@@@@@@@@@@@@@@@@@@@@@@@@@@@@@@@@@@@@@@@@@@T.T...T.....T.T.T....@@@@@@@@@@@@@@@@@@@@@@@@@@@@@@@@@@@@@@@@@
@@@@@@@@@@@@@@@@@@@@@@@@@@@@@@@@@@@@@@@@@@@.......T...T....TT.@@@@@@@@@@@@@@@@@@@@@@@@@@@@@@@@@@@@@@@@@@
@@@@@@@@@@@@@@@@@@@@@@@@@@@@@@@@@@@@@@@@@@@@..T.T.T...T...T..@@@@@@@@@@@@@@@@@@@@@@@@@@@@@@@@@@@@@@@@@@@
@@@@@@@@@@@@@@@@@@@@@@@@@@@@@@@@@@@@@@@@@@@@@.T.T....T..T..T@@@@@@@@@@@@@@@@@@@@@@@@@@@@@@@@@@@@@@@@@@@@
@@@@@@@@@@@@@@@@@@@@@@@@@@@@@@@@@@@@@@@@@@@@@@T...T.......@@@@@@@@@@@@@@@@@@@@@@@@@@@@@@@@@@@@@@@@@@@@@@
@@@@@@@@@@@@@@@@@@@@@@@@@@@@@@@@@@@@@@@@@@@@@@@T...T.T.T.@@@@@@@@@@@@@@@@@@@@@@@@@@@@@@@@@@@@@@@@@@@@@@@
@@@@@@@@@@@@@@@@@@@@@@@@@@@@@@@@@@@@@@@@@@@@@@@@...T..T.@@@@@@@@@@@@@@@@@@@@@@@@@@@@@@@@@@@@@@@@@@@@@@@@
@@@@@@@@@@@@@@@@@@@@@@@@@@@@@@@@@@@@@@@@@@@@@@@@@......@@@@@@@@@@@@@@@@@@@@@@@@@@@@@@@@@@@@@@@@@@@@@@@@@
@@@@@@@@@@@@@@@@@@@@@@@@@@@@@@@@@@@@@@@@@@@@@@@@@@@@@@@@@@@@@@@@@@@@@@@@@@@@@@@@@@@@@@@@@@@@@@@@@@@@@@@@
@@@@@@@@@@@@@@@@@@@@@@@@@@@@@@@@@@@@@@@@@@@@@@@@@@@@@@@@@@@@@@@@@@@@@@@@@@@@@@@@@@@@@@@@@@@@@@@@@@@@@@@@
