type octile
height 80
width 80
map
@@@@@@@@@@@@@@@@@@@@@@@@@@@@@@@@@@@@@@@@@@@@@@@@@@@@@@@@@@@@@@@@@@@@@@@@@@@@@@@@
@@@@@@@@@@@@@@@@@@@@@@@@@@@@@@@@@@@@@@@@@@@@@@@@@@@@@@@@@@@@@@@@@@@@@@@@@@@@@@@@
@@@@@@@@@@@@@@@@@@@@@@@@@@@@@@@@@@@@@@@@@@@@@@@@@@@@@@...T...T..............T.@@
@@@@@@@@@@@@@@@@@@@@@@@@@@@@@@@@@@@@@@@@@@@@@@@@@@@@@@....TTT.TTT............T@@
@@@@@@@@@@@@@@@@@@@@@@@@@@@@@@@@@@@@@@@@@@@@@@@@@@@@@...TT.........T.....T.T..@@
@@@@@@@@@@@@@@@@@@@@@@@@@@@@@@@@@@@@@@@@@@@@@@@@@@@@T........T...T.TTTTT..TT..@@
@@@@@@@@@@@@@@@@@@@@@@@@@@@@@@@@@@@@@@@@@@@@@@@@@@@.T...T.....................@@
@@@@@@@@@@@@@@@@@@@@@@@@@@@@@@@@@@@@@@@@@@@@@@@@@@@@.........T..T......TT.....@@
@@@@@@@@@@@@@@@@@@@@@@@@@@@@@@@@@@@@@@@@@@@@@@@@@@@@@.TT.T.T.......TT..T.T.T..@@
@@@@@@@@@@@@@@@@@@@@@@@@@@@@@@@@@@@@@@@@@@@@@@@@@@@@@.T..TT...T...T....TT.T..T@@
@@@@@@@@@@@@@@@@@@@@@@@@@@@@@@@@@@@@@@@@@@@@@@@@@@@@@....TTT..TT...T.....TT..T@@
@@@@@@@@@@@@@@@@@@@@@@@@@@@@@@@@@@@@@@@@@@@@@@@@@@@@.....T...T.TT......TT.....@@
@@@@@@@@@@@@@@@@@@@@@@@@@@@@@@@@@@@@@@@@@@@@@@@@@@.......TT....T....T......T..@@
@@@@@@@@@@@@@@@@@@@@@@@@@@@@@@@@@@@@@@@@@@@@@@@@@@@......T..T..............TT.@@
@@@@@@@@@@@@@@@@@@@@@@@@@@@@@@@@@@@@@.T@@@@@@@@@@@@.T........T.T...T......T..T@@
@@@@@@@@@@@@@@@@@@@@@@@@@@@@@@@@@@@@...@@@@@@@@@.T.....T......T....@@....T....@@
@@@@@@@@@@@@@@@@@@@@@@@@@@@@@@@@@@@@T...@@@@@@@...T..T.T..T....T.@@@@..T......@@
@@@@@@@@@@@@@@@@@@@@@@@@@@@@@@@@@@@.....@@T..T.....TT..TT.T..T.@@@@@@@TT..T.T.@@
@@@@@@@@@@@@@@@@@@@@@@@@@@@@@@@@@@.......T..T......T..........@@@@@@@@T.TTT...@@
@@@@@@@@@@@@@@@@@@@@@@@@@@@@@@@@@@.@@.......T..T.TT....T......@@@@@@@@@.T.....@@
@@@@@@@@@@@@@@@@@@@@@@@@@@@@@@@@@@@@@T.T.......T.T.........T...@@@@@@@@T.T....@@
@@@@@@@@@@@@@@@@@@@@@@@@@@@@@@@@@@@@@@..TT....T...T.T...TTTT...@@@@@@@@TT.....@@
@@@@@@@@@@@@@@@@@@@@@@@@@@@@@@@@@@@@...........TT..T.T......T..@@@@@@@...T....@@
@@@@@@@@@@@@@@@@@@@@@@@@@@@@@@@@@@@@T..T.....T.T.TT.T.TT...T.T..@@@@@.T..T..TT@@
@@@@@@@@@@@@@@@@@@@@@@@@@@@@@@@@@@@@T.T...................T.T....@.....TT...T.@@
@@@@@@@@@@@@@@@@@@@@@@@@@@@@@@@@@@T.T...T.T...........T..T........T...T..T.TT.@@
@@@@@@@@@@@@@@@@@@@@@@@@@@@@@@@@@@.TTT......T.........T....TT.T.T....T......T@@@
@@@@@@@@@@@@@@@@@@@@@@@@@@@@@@@@@@T.....TT..T..T..T..T.TTT.....T.....T.....T@@@@
@@@@@@@@@@@@@@@@@@@@@@@@@@@@@@@@@@......TT..T.......TT.....T.....T.....T.T.@@@@@
@@@@@@@@@@@@@@@@@@@@@@.....@@@@@@....T..T...T...T.T..TT.TT.T....T.....T..@@@@@@@
@@@@@@@@@@@@@@@@@@@@@TT....@@@@@@.T.T..T........T....T.T...TT........TT.@@@@@@@@
@@@@@@@@@@@@@@@@T@@@..T.T.T.................T.T.....TT......T.....TT...@@@@@@@@@
@@@@@@@@@@@@@@@....T.T.T.TT.....T.TT.....T...T.T...T.....TT...TT.T.T...@@@@@@@@@
@@@@@@@@@@@@@.....T...T.......T..T..TTT.........T..TT...T.T.T....T.T..@@@@@@@@@@
@@@@@@@@@@@@....T...TT...T...TTTT...T..T....T......T.......T...T.....@@@@@@@@@@@
@@@@@@@@@@@..T.T..T.T..T.......TT....T..T.T.T.T..........TT...T....T@@@@@@@@@@@@
@@@@@@@@@@T.......T.T...T........T....T.....TT....T...TTT...T.....T@@@@@@@@@@@@@
@@@@@@@@@........T......T..T..T.T......TT..T.T...TT.......T.T.....@@@@@@@@@@@@@@
@@@@@@@@T.T....T.T.....T..T...T.......T.TTT....T....TT....T......@@@@@@@@@@@@@@@
@@@@@@.T....T.....@@@@@@@....T..T.T....T.T..T.T.T....T.T....T.T..@@@@@@@@@@@@@@@
@@@@@T..T...TT...@@@@@@@@...T.........T.......T.T.......T.....TT@@@@@@@@@@@@@@@@
@@@@......T......@@@@@@@@....TT.........TT.T......T.T....T.T...@@@@@@@@@@@@@@@@@
@@@.....TTT.....T.@@@@@@@TT..T.TT.....TT.TT....T.....T..TT..T.@@@@@@@@@@@@@@@@@@
@@.TT.....T..TTT..@@@@@T....T.......TTT.TT............T.TT...@@@@@@@@@@@@@@@@@@@
@@...........TTT.T..@@..............TT.....T......T.T..TT.T.@@@@@@@@@@@@@@@@@@@@
@@.....TT...TTT...T...T....TT....T...T...T....TT.TTT...T..T@@@@@@@@@@@@@@@@@@@@@
@@.T...@....T...T..T..TTTT...........T......TT...T.T....T.@@@@@@@@@@@@@@@@@@@@@@
@@....@@@@.T......T......TT....TT......T.........TT.....@@@@@@@@@@@@@@@@@@@@@@@@
@@..@@@@@@@@T......T....T.T..........T..T.T...T.....T..@@@@@@@@@@@@@@@@@@@@@@@@@
@@.@@@@@@@@@@.T....T.......T.T.............T...T..T...@@@@@@@@@@@@@@@@@@@@@@@@@@
@@@@@@@@@@@@@@...TTTT.T.T.T.T.....T.TTT..T.T...T....@@@@@@@@@@@@@@@@@@@@@@@@@@@@
@@@@@@@@@@@@@@@T..T.....T..........T..T..........T.@@@@@@@@@@@@@@@@@@@@@@@@@@@@@
@@@@@@@@@@@@@@@@....TT...T.........T.........TT...@@@@@@@@@@@@@@@@@@@@@@@@@@@@@@
@@@@@@@@@@@@@@@@@.........T.............T...T....@@@@@@@@@@@@@@@@@@@@@@@@@@@@@@@
@@@@@@@@@@@@@@@@@@.....T.T.T.....TT.....T......T@@@@@@@@@@@@@@@@@@@@@@@@@@@@@@@@
@@@@@@@@@@@@@@@@@@@.TT.TTT.T..TT..T.....T...T..@@@@@@@@@@@@@@@@@@@@@@@@@@@@@@@@@
@@@@@@@@@@@@@@@@@@@@.T...T..T.T...T....T.T.T..@@@@@@@@@@@@@@@@@@@@@@@@@@@@@@@@@@
@@@@@@@@@@@@@@@@@@@@@.....T.T.T..TT.......T..T@@@@@@@@@@@@@@@@@@@@@@@@@@@@@@@@@@
@@@@@@@@@@@@@@@@@@@@@@.TT.T.....T....T.....T.@@@@@@@@@@@@@@@@@@@@@@@@@@@@@@@@@@@
@@@@@@@@@@@@@@@@@@@@@@@T.T.....T..T.T.......@@@@@@@@@@@@@@@@@@@@@@@@@@@@@@@@@@@@
@@@@@@@@@@@@@@@@@@@@@@@@...T..........T.T..@@@@@@@@@@@@@@@@@@@@@@@@@@@@@@@@@@@@@
@@@@@@@@@@@@@@@@@@@@@@@@@T..T....TTT...T..@@@@@@@@@@@@@@@@@@@@@@@@@@@@@@@@@@@@@@
@@@@@@@@@@@@@@@@@@@@@@@@@...T......T.....@@@@@@@@@@@@@@@@@@@@@@@@@@@@@@@@@@@@@@@
@@@@@@@@@@@@@@@@@@@@@@@@@.....T....T.T..@@@@@@@@@@@@@@@@@@@@@@@@@@@@@@@@@@@@@@@@
@@@@@@@@@@@@@@@@@@@@@@@@@....T.T.......@@@@@@@@@@@@@@@@@@@@@@@@@@@@@@@@@@@@@@@@@
@@@@@@@@@@@@@@@@@@@@@@@@@@.T.T..T....T@@@@@@@@@@@@@@@@@@@@@@@@@@@@@@@@@@@@@@@@@@
@@@@@@@@@@@@@@@@@@@@@@@@@@@T..........@@@@@@@@@@@@@@@@@@@@@@@@@@@@@@@@@@@@@@@@@@
@@@@@@@@@@@@@@@@@@@@@@@@@@@@..T..T.T.T@@@@@@@@@@@@@@@@@@@@@@@@@@@@@@@@@@@@@@@@@@
@@@@@@@@@@@@@@@@@@@@@@@@@@@@@T........@@@@@@@@@@@@@@@@@@@@@@@@@@@@@@@@@@@@@@@@@@
@@@@@@@@@@@@@@@@@@@@@@@@@@@@@@..TT.....@@@@@@@@@@@@@@@@@@@@@@@@@@@@@@@@@@@@@@@@@
@@@@@@@@@@@@@@@@@@@@@@@@@@@@@@@@.T.....T@@@@@@@@@@@@@@@@@@@@@@@@@@@@@@@@@@@@@@@@
@@@@@@@@@@@@@@@@@@@@@@@@@@@@@@@@@.T.T....@@@@@@@@..@@@@@@@@@@@@@@@@@@@@@@@@@@@@@
@@@@@@@@@@@@@@@@@@@@@@@@@@@@@@@@@@.T......@@@@@@....@@@@@@@@@@@@@@@@@@@@@@@@@@@@
@@@@@@@@@@@@@@@@@@@@@@@@@@@@@@@@@@@T..T....@@@@T...TT@@@@@@@@@@@@@@@@@@@@@@@@@@@
@@@@@@@@@@@@@@@@@@@@@@@@@@@@@@@@@@@@.T.T....@@..TTT.T@@@@@@@@@@@@@@@@@@@@@@@@@@@
@@@@@@@@@@@@@@@@@@@@@@@@@@@@@@@@@@@@@TT....TT..T..T..@@@@@@@@@@@@@@@@@@@@@@@@@@@
@@@@@@@@@@@@@@@@@@@@@@@@@@@@@@@@@@@@@@.......T..T.....@@@@@@@@@@@@@@@@@@@@@@@@@@
@@@@@@@@@@@@@@@@@@@@@@@@@@@@@@@@@@@@@@@@..TTT.TT.T.TT..@@@@@@@@@@@@@@@@@@@@@@@@@
@@@@@@@@@@@@@@@@@@@@@@@@@@@@@@@@@@@@@@@@@@@@@@@@@@@@@@@@@@@@@@@@@@@@@@@@@@@@@@@@
@@@@@@@@@@@@@@@@@@@@@@@@@@@@@@@@@@@@@@@@@@@@@@@@@@@@@@@@@@@@@@@@@@@@@@@@@@@@@@@@
