type octile
height 64
width 60
map
@@@@@@@@@@@@@@@@@@@@@@@@@@@@@@@@@@@@@@@@@@@@@@@@@@@@@@@@@@@@
@@@@@@@@@@@@@@@@@@@@@@@@@@@@@@@@@@@@@@@@@@@@@@@@@@@@@@@@@@@@
@@@@@@@@@@@@@@@@@@@@@@@@@@@@@@@@@@@@@@@@@@@@@@@@@@@@@@@@@@@@
@@@@@@@@@@@@@@@@@@@@@@@@@@@@@@@@@@@@@@@@@@@@@@@@@@@@@@@@@@@@
@@@@@@@@@@@@@@@@@@@@@@@@@@@@@@@@@@@@@@@@@@@@@@@@@@@@@@@@@@@@
@@@@@@@@@@@@@@@@@@@@@@@@@@@@@@@@@@@@@@@@@@@@@@@@@@@@@@@@@@@@
@@@@@@@@@@@@@@@@@@@@@@@@@@@@@@@@@@@@@@@@@@@@@@@@@@@@@@@@@@@@
@@@@@@@@@@@@@@@@@@@@@@@@@@@@@@@@@@@@@@@@@@@@@@@@@@@@@@@@@@@@
@@@@@@@@@@@@@@@@@@@@@@@@@@@@@@@@@@@@@@@@@@@@@@@@@@@@@@@@@@@@
@@@@@@@@@@@@@@@@@@@@@@@@@@@@@@@@@@@@@@@@@@@@@@@@@@@@@@@@@@@@
@@@@@@@@@@@@@@@@@@@@@@@@@@@@@@@@@@@@@@@@@@@@@@@@@@@@@@@@@@@@
@@@@@@@@@@@@@@@@@@@@@@@@@@@@@@@@@@@@@@@@@@@@@@@@@@@@@@@@@@@@
@@@@@@@@@@@@@@@@@@@@@@@@@@@@@@@@@@@@@@@@@@@@@@@@@@@@@@@@@@@@
@@@@@@@@@@@@@@@@@@@@@@@@@@@@@@@@@@@@@...@@@@@@@@@@@@@@@@@@@@
@@@@@@@@@@@@@@@@@@@@@@@@@@@@@@@@@@@@@@@T.@@@@@@@@@@@@@@@@@@@
@@@@@@@@@@@@@@@@@@@@@@@@@@@@@@@@@@.@@@@@..@@@@@@@@@@@@@@@@@@
@@@@@@@@@@@@@@@@@@@@@@@@@@@@@@@@@...@@@@@T.@@@@@@@@@@@@@@@@@
@@@@@@@@@@@@@@@@@@@@@@@@@@@@@@@@T.T..@@@@@..@@@@@@@@@@@@@@@@
@@@@@@@@@@@@@@@@@@@@@@@@@@@@@@@.T....@@@@@...@@@@@@@@@@@@@@@
@@@@@@@@@@@@@@@@@@@@@@@@@@@@@@@@@....@@@@.TT.T..@@@@@@@@@@@@
@@@@@@@@@@@@@@@@@@@@@@@@@@@@@@@@@.....T...T.T.@..@@@@@@@@@@@
@@@@@@@@@@@@@@@@@@@@@@@@@@@@@@@.T.....T.....T@@@T.@@@@@@@@@@
@@@@@@@@@@@@@@@@@@@@@@@@@@@@@@T....T..TT.T..@@@...T@@@@@@@@@
@@@@@@@@@@@@@@@@@@@@@@@@@@@@@T....T.......T@@@@@..TT@@@@@@@@
@@@@@@@@@@@@@@@@@@@@@@@@@@..@@.......T....T@@@@@@@@..@@@@@@@
@@@@@@@@@@@@@@@@@@@@@@@.@@.@@@...T.TTT....@@@@@@@@@...@@@@@@
@@@@@@@@@@@@@@@@@@@@@@@TTTT.T.....T.......@@@.@@.......@@@@@
@@@@@@@@@@@@@@@@@@@@@@..T.....TTTT.@@@.TTTTT..T..T..T...@@@@
@@@@@@@@@@@@@@@@@@@@T.......T.TT...@@@T.......T......TT.@@@@
@@@@@@@@@@@@@@@@@@@....T...........T..T.TT....T..T.....@@@@@
@@@@@@@@@@@@@@@@@@T....@@.......TT.......TT.....T..T.T@@@@@@
@@@@@@@@@@@@@@@@@.....@@@@T.@@......TTT.TT...T.T.T...@@@@@@@
@@@@@@@@@@@@@@@@@TT..@@@@@@@@@..T.T..T.T...T.T......@@@@@@@@
@@@@@@@@@@@@@@@@...@@@@@@@@@...T.T..............TT.@@@@@@@@@
@@@@@@@@@@@@@@@T..@@@@@@@@@@@..@@...TT..T....T.TTT@@@@@@@@@@
@@@@@@@@@@@@@@T....@@@@@@@@@@@@@@...T............@@@@@@@@@@@
@@@@@@@@@@@@@......@@@@@@@@@@@@......T.......T..@@@@@@@@@@@@
@@@@@@@@@@@T........@.T@@@@@@@@@.......T.TT...T@@@@@@@@@@@@@
@@@@@@@@@@@...T..T..T...@@@@@@@@@T.......T...T@@@@@@@@@@@@@@
@@@@@@@@@@@@.T..T.T.....@@@@@@@@@@........TT.@@@@@@@@@@@@@@@
@@@@@@@@@@@...T.....TT..@@@@@@@@..........T.@@@@@@@@@@@@@@@@
@@@@@@@T@@.........TT.T@@@@@@@@T..T.T...T..@@@@@@@@@@@@@@@@@
@@@@@@T.........T.....@@@@@@@@.T.T...T..T.@@@@@@@@@@@@@@@@@@
@@@@@TT.TT...TT.T.T..@@@@@@@@@@T........T@@@@@@@@@@@@@@@@@@@
@@@@.T.TTTT.T.T..T.T@@@@@@@@@@....TT....@@@@@@@@@@@@@@@@@@@@
@@@@TTTT......T....@@@@@@@@....T.......@@@@@@@@@@@@@@@@@@@@@
@@@@@T...T...T.T.T@@@@@@@@@@.T......T.@@@@@@@@@@@@@@@@@@@@@@
@@@@@@.....TT....@@@@@@@@.@.T.....TTT@@@@@@@@@@@@@@@@@@@@@@@
@@@@@@@..T.TT...@@@@@@@@..T.T...T..T@@@@@@@@@@@@@@@@@@@@@@@@
@@@@@@@@.......@@@@@@@@T..T.....T.T@@@@@@@@@@@@@@@@@@@@@@@@@
@@@@@@@@@....T@@@@@@@@@.....T.TT..@@@@@@@@@@@@@@@@@@@@@@@@@@
@@@@@@@@@@...T.@@@@@@@.T.....T.T.@@@@@@@@@@@@@@@@@@@@@@@@@@@
@@@@@@@@@@@T.TTT@@@@...T..T....T@@@@@@@@@@@@@@@@@@@@@@@@@@@@
@@@@@@@@@@@@....T@@.........T..@@@@@@@@@@@@@@@@@@@@@@@@@@@@@
@@@@@@@@@@@@@..TT.T..T..T.T.T.@@@@@@@@@@@@@@@@@@@@@@@@@@@@@@
@@@@@@@@@@@@@@........T.....@@@@@@@@@@@@@@@@@@@@@@@@@@@@@@@@
@@@@@@@@@@@@@@@T.T.........@@@@@@@@@@@@@@@@@@@@@@@@@@@@@@@@@
@@@@@@@@@@@@@@@@......TTT.@@@@@@@@@@@@@@@@@@@@@@@@@@@@@@@@@@
@@@@@@@@@@@@@@@@@T...TT..@@@@@@@@@@@@@@@@@@@@@@@@@@@@@@@@@@@
@@@@@@@@@@@@@@@@@@@.T..T@@@@@@@@@@@@@@@@@@@@@@@@@@@@@@@@@@@@
@@@@@@@@@@@@@@@@@@@@...@@@@@@@@@@@@@@@@@@@@@@@@@@@@@@@@@@@@@
@@@@@@@@@@@@@@@@@@@@@@@@@@@@@@@@@@@@@@@@@@@@@@@@@@@@@@@@@@@@
@@@@@@@@@@@@@@@@@@@@@@@@@@@@@@@@@@@@@@@@@@@@@@@@@@@@@@@@@@@@
@@@@@@@@@@@@@@@@@@@@@@@@@@@@@@@@@@@@@@@@@@@@@@@@@@@@@@@@@@@@
