type octile
height 160
width 160
map
@@@@@@@@@@@@@@@@@@@@@@@@@@@@@@@@@@@@@@@@@@@@@@@@@@@@@@@@@@@@@@@@@@@@@@@@@@@@@@@@@@@@@@@@@@@@@@@@@@@@@@@@@@@@@@@@@@@@@@@@@@@@@@@@@@@@@@@@@@@@@@@@@@@@@@@@@@@@@@@@
@@@@@@@@@@@@@@@@@@@@@@@@@@@@@@@@@@@@@@@@@@@@@@@@@@@@@@@@@@@@@@@@@@@@@@@@@@@@@@@@@@@@@@@@@@@@@@@@@@@@@@@@@@@@@@@@@@@@@@@@@@@@@@@@@@@@@@@@@@@@@@@@@@@@@@@@@@@@@@@@
@@@@@@@@@@@@@@@@@@@@@@@@@@@@@@@@@@@@@@@@@@@@@@@@@@@@@@@@@@@@@@@@@@@@@@@@@@@@@@@@@@@@@@@@@@@@@@@@@@@@@@@@@@@@@@@@@@@@@@@@@@@@@@@@@@@@@@@@@@@@@@@@@@@@@@@@@@@@@@@@
@@@@@@@@@@@@@@@@@@@@@@@@@@@@@@@@@@@@@@@@@@@@@@@@@@@@@@@@@@@@@@@@@@@@@@@@@@@@@@@@@@@@@@@@@@@@@@@@@@@@@@@@@@@@@@@@@@@@@@@@@@@@@@@@@@@@@@@@@@@@@@@@@@@@@@@@@@@@@@@@
@@@@@@@@@@@@@@@@@@@@@@@@@@@@@@@@@@@@@@@@@@@@@@@@@@@@@@@@@@@@@@@@@@@@@@@@@@@@@@@@@@@@@@@@@@@@@@@@@@@@@@@@@@@@@@@@@@@@@@@@@@@@@@@@@@@@@@@@@@@@@@@@@@@@@@@@@@@@@@@@
@@@@@@@@@@@@@@@@@@@@@@@@@@@@@@@@@@@@@@@@@@@@@@@@@@@@@@@@@@@@@@@@@@@@@@@@@@@@@@@@@@@@@@@@@@@@@@@@@@@@@@@@@@@@@@@@@@@@@@@@@@@@@@@@@@@@@@@@@@@@@@@@@@@@@@@@@@@@@@@@
@@@@@@@@@@@@@@@@@@@@@@@@@@@@@@@@@@@@@@@@@@@@@@@@@@@@@@@@@@@@@@@@@@@@@@@@@@@@@@@@@@@@@@@@@@@@@@@@@@@@@@@@@@@@@@@@@@@@@@@@@@@@@@@@@@@@@@@@@@@@@@@@@@@@@@@@@@@@@@@@
@@@@@@@@@@@@@@@@@@@@@@@@@@@@@@@@@@@@@@@@@@@@@@@@@@@@@@@@@@@@@@@@@@@@@@@@@@@@@@@@@@@@@@@@@@@@@@@@@@@@@@@@@@@@@@@@@@@@@@@@@@@@@@@@@@@@@@@@@@@@@@@@@@@@@@@@@@@@@@@@
@@@@@@@@@@@@@@@@@@@@@@@@@@@@@@@@@@@@@@@@@@@@@@@@@@@@@@@@@@@@@@@@@@@@@@@@@@@@@@@@@@@@@@@@@@@@@@@@@@@@@@@@@@@@@@@@@@@@@@@@@@@@@@@@@@@@@@@@@@@@@@@@@@@@@@@@@@@@@@@@
@@@@@@@@@@@@@@@@@@@@@@@@@@@@@@@@@@@@@@@@@@@@@@@@@@@@@@@@@@@@@@@@@@@@@@@@@@@@@@@@@@@@@@@@@@@@@@@@@@@@@@@@@@@@@@@@@@@@@@@@@@@@@@@@@@@@@@@@@@@@@@@@@@@@@@@@@@@@@@@@
@@@@@@@@@@@@@@@@@@@@@@@@@@@@@@@@@@@@@@@@@@@@@@@@@@@@@@@@@@@@@@@@@@@@@@@@@@@@@@@@@@@@@@@@@@@@@@@@@@@@@@@@@@@@@@@@@@@@@@@@@@@@@@@@@@@@@@@@@@@@@@@@@@@@@@@@@@@@@@@@
@@@@@@@@@@@@@@@@@@@@@@@@@@@@@@@@@@@@@@@@@@@@@@@@@@@@@@@@@@@@@@@@@@@@@@@@@@@@@@@@@@@@@@@@@@@@@@@@@@@@@@@@@@@@@@@@@@@@@@@@@@@@@@@@@@@@@@@@@@@@@@@@@@@@@@@@@@@@@@@@
@@@@@@@@@@@@@@@@@@@@@@@@@@@@@@@@@@@@@@@@@@@@@@@@@@@@@@@@@@@@@@@@@@@@@@@@@@@@@@@@@@@@@@@@@@@@@@@@@@@@@@@@@@@@@@@@@@@@@@@@@@@@@@@@@@@@@@@@@@@@@@@@@@@@@@@@@@@@@@@@
@@@@@@@@@@@@@@@@@@@@@@@@@@@@@@@@@@@@@@@@@@@@@@@@@@@@@@@@@@@@@@@@@@@@@@@@@@@@@@@@@@@@@@@@@@@@@@@@@@@@@@@@@@@@@@@@@@@@@@@@@@@@@@@@@@@@@@@@@@@@@@@@@@@@@@@@@@@@@@@@
@@@@@@@@@@@@@@@@@@@@@@@@@@@@@@@@@@@@@@@@@@@@@@@@@@@@@@@@@@@@@@@@@@@@@@@@@@@@@@@@@@@@@@@@@@@@@@@@@@@@@@@@@@@@@@@@@@@@@@@@@@@@@@@@@@@@@@@@@@@@@@@@@@@@@@@@@@@@@@@@
@@@@@@@@@@@@@@@@@@@@@@@@@@@@@@@@@@@@@@@@@@@@@@@@@@@@@@@@@@@@@@@@@@@@@@@@@@@@@@@@@@@@@@@@@@@@@@@@@@@@@@@@@@@@@@@@@@@@@@@@@@@@@@@@@@@@@@@@@@@@@@@@@@@@@@@@@@@@@@@@
@@@@@@@@@@@@@@@@@@@@@@@@@@@@@@@@@@@@@@@@@@@@@@@@@@@@@@@@@@@@@@@@@@@@@@@@@@@@@@@@@@@@@@@@@@@@@@@@@@@@@@@@@@@@@@@@@@@@@@@@@@@@@@@@@@@@@@@@@@@@@@@@@@@@@@@@@@@@@@@@
@@@@@@@@@@@@@@@@@@@@@@@@@@@@@@@@@@@@@@@@@@@@@@@@@@@@@@@@@@@@@@@@@@@@@@@@@@@@@@@@@@@@@@@@@@@@@@@@@.@@T@@@@@@@@@@@@@@@@@@@@@@@@@@@@@@@@@@@@@@@@@@@@@@@@@@@@@@@@@@@
@@@@@@@@@@@@@@@@@@@@@@@@@@@@@@@@@@@@@@@@@@@@@@@@@@@@@@@@@@@@@@@@@@@@@@@@@@@@@@@@@@@@@@@@@@@@@@@@@..TT@@@@@@@@@@@@@@@@@@@@@@@@@@@@@@@@@@@@@@@@@@@@@@@@@@@@@@@@@@@
@@@@@@@@@@@@@@@@@@@@@@@@@@@@@@@@@@@@@@@@@@@@@@@@@@@@@@@@@@@@@@@@@@@@@@@@@@@@@@@@@@@@@@@@@@@@@@@@.TT...@@@@@@@@@@@@@@@@@@@@@@@@@@@@@@@@@@@@@@@@@@@@@@@@@@@@@@@@@@
@@@@@@@@@@@@@@@@@@@@@@@@@@@@@@@@@@@@@@@@@@@@@@@@@@@@@@@@@@@@@@@@@@@@@@@@@@@@@@@@@@@@@@@@@@@@@@@T.......@@@@@@@@@@@@@@@@@@@@@@@@@@@@@@@@@@@@@@@@@@@@@@@@@@@@@@@@@
@@@@@@@@@@@@@@@@@@@@@@@@@@@@@@@@@@@@@@@@@@@@@@@@@@@@@@@@@@@@@@@@@@@@@@@@@@@@@@@@@@@@@@@@@@@@@@T.T..T..T.@@@@@@@@@@@@@@@@@@@@@@@@@@@@@@@@@@@@@@@@@@@@@@@@@@@@@@@@
@@@@@@@@@@@@@@@@@@@@@@@@@@@@@@@@@@@@@@@@@@@@@@@@@@@@@@@@@@@@@@@@@@@@@@@@@@@@@@@@@@@@@@@@@@@@T.......T....@@@@@@@@@@@@@@@@@@@@@@@@@@@@@@@@@@@@@@@@@@@@@@@@@@@@@@@
@@@@@@@@@@@@@@@@@@@@@@@@@@@@@@@@@@@@@@@@@@@@@@@@@@@@@@@@@@@@@@@@@@@@@@@@@@@@@@@@@@@@@@@@@@@...T..T...T....@@@@@@@@@@@@@@@@@@@@@@@@@@@@@@@@@@@@@@@@@@@@@@@@@@@@@@
@@@@@@@@@@@@@@@@@@@@@@@@@@@@@@@@@@@@@@@@@@@@@@@@@@@@@@@@@@@@@@@@@@@@@@@@@@@@@@@@@@@@@@@@@@..TTT.@@@@@..TT..@@@@@@@@@@@@@@@@@@@@@@@@@@@@@@@@@@@@@@@@@@@@@@@@@@@@@
@@@@@@@@@@@@@@@@@@@@@@@@@@@@@@@@@@@@@@@@@@@@@@@@@@@@@@@@@@@@@@@@@@@@@@@@@@@@@@@@@@@@@@@@....T...@@@@@@@@...T@@@@@@@@@@@@@@@@@@@@@@@@@@@@@@@@@@@@@@@@@@@@@@@@@@@@
@@@@@@@@@@@@@@@@@@@@@@@@@@@@@@@@@@@@@@@@@@@@@@@@@@@@@@@@@@@@@@@@@@@@@@@@@@@@@@@@@@@@@@@@....TT.T@@@@@@@@...TT@@@@@@@@@@@@@@@@@@@@@@@@@@@@@@@@@@@@@@@@@@@@@@@@@@@
@@@@@@@@@@@@@@@@@@@@@@@@@@@@@@@@@@@@@@@@@@@@@@@@@@@@@@@@@@@@@@@.@@@@@@@@@@@@@@@@@@@@@@@...T....@@@@@@@@@....T.@@@@@@@@@@@@@@@@@@@@@@@@@@@@@@@@@@@@@@@@@@@@@@@@@@
@@@@@@@@@@@@@@@@@@@@@@@@@@@@@@@@@@@@@@@@@@@@@@@@@@@@@@@@@@@@@@...@@@@@@@@@@@@@@@@@@@@@..T..T..T@@@@@@@@@T...T..@@@@@@@@@@@@@@@@@@@@@@@@@@@@@@@@@@@@@@@@@@@@@@@@@
@@@@@@@@@@@@@@@@@@@@@@@@@@@@@@@@@@@@@@@@@@@@@@@@@@@@@@@@@@@@@@TT..@@@@@@@@@@@@@@@@@@@.T.....T..@@@@@@@@@....T.T.@@@@@@@@@@@@@@@@@@@@@@@@@@@@@@@@@@@@@@@@@@@@@@@@
@@@@@@@@@@@@@@@@@@@@@@@@@@@@@@@@@@@@@@@@@@@@@@@@@@@@@@@@@@@@@.....@@@@@@@@@@@@@@@@@..TT.T...T.T...T.TT......T..T.@@@@@@@@@@@@@@@@@@@@@@@@@@@@@@@@@@@@@@@@@@@@@@@
@@@@@@@@@@@@@@@@@@@@@@@@@@@@@@@@@@@@@@@@@@@@@@@@@@@@@@@@@@@@@..T.@@@@@@@@@@@@@@@@@@@@.T..TT..................T...T@@@@@@@@@@@@@@@@@@@@@@@@@@@@@@@@@@@@@@@@@@@@@@
@@@@@@@@@@@@@@@@@@@@@@@@@@@@@@@@@@@@@@@@@@@@@@@@@@@@@@@@@@@@....T@@@@@@@@@@@@@@@@@@@@@..T...........TTTT..T..T.....@@@@@@@@@@@@@@@@@@@@@@@@@@@@@@@@@@@@@@@@@@@@@
@@@@@@@@@@@@@@@@@@@@@@@@@@@@@@@@@@@@@@@@@@@@@@@@@@@@@@@@@@@@TT..@@@@@@@@@@@@@@@@@@@@@@T.....T.T..T..T....T...T.TT.T@@@@@@@@@@@@@@@@@@@@@@@@@@@@@@@@@@@@@@@@@@@@@
@@@@@@@@@@@@@@@@@@@@@@@@@@@@@@@@@@@@@@@@@@@@@@@@@@@@@@@@@@@@..T.@@@@@@@@@@@@@@@@@@@@@@....TT.T.@....T.T..T..TTT...@@@@@@@@@@@@@@@@@@@@@@@@@@@@@@@@@@@@@@@@@@@@@@
@@@@@@@@@@@@@@@@@@@@@@@@@@@@@@@@@@@@@@@@@@@@@@@@@@@@@@@@@@@..T.T@@@@@@@@@@@@@@.@@@@.T.....T...T@@@@......T.T.T...@@@@@@@@@@@@@@@@@@@@@@@@@@@@@@@@@@@@@@@@@@@@@@@
@@@@@@@@@@@@@@@@@@@@@@@@@@@@@@@@@@@@@@@@@@@@@@@@@@@@@@@@@@@....@@@@@@@@@@@@@@........T.T.T..TT@@@@@@@..T.T....TT@@@@@@@@....@@@@@@@@@@@@@@@@@@@@@@@@@@@@@@@@@@@@
@@@@@@@@@@@@@@@@@@@@@@@@@@@@@@@@@@@@@@@@@@@@@@@@@@@@@@@@@@T...@@@@@@@@..@@@@.....T.TT.T......T@@@@@@@@@......T.@@@@@@@T..T...@@@@@@@@@@@@@@@@@@@@@@@@@@@@@@@@@@@
@@@@@@@@@@@@@@@@@@@@@@@@@@@@@@@@@@@@@@@@@@@@@@@@@@@@@@@@@@...T@@@@@@@..T.@@........T....T.T..@@@@@@@@@@T.T....@@@@@@@..T....@@@@@@@@@@@@@@@@@@@@@@@@@@@@@@@@@@@@
@@@@@@@@@@@@@@@@@@@@@@@@@@@@@@@@@@@@@@@@@@@@@@@@@@@@@@@@@@...@@@@@@@@@......TTT.TT.........TT@@@@@@@@@@T.T.T.@@@@@@@.......@@@@@@@@@@@@@@@@@@@@@@@@@@@@@@@@@@@@@
@@@@@@@@@@@@@@@@@@@@@@@@@@@@@@@@@@@@@@@@@@@@@@@@@@@@@@@@@....@@@@@@@@@@.......TT.T.....T.....T..@@@@@@....TT@@@@@@@T...T.T..@@@@@@@@@@@@@@@@@@@@@@@@@@@@@@@@@@@@
@@@@@@@@@@@@@@@@@@@@@@@@@@@@@@@@@@@@@@@@@@@@@@@@@@@@@@@@T.TT..@@@@@@@@@@..........TT...T...T......T.@@.....@@@@@@@@@.T..T....@@@@@@@@@@@@@@@@@@@@@@@@@@@@@@@@@@@
@@@@@@@@@@@@@@@@@@@@@@@@@@@@@@@@@@@@@@@@@@@@@@@@@@@@@@@..T....T@@@@@@@@@@..........TT.T...@@.T.....T.T..T.@@@@@@@@@@T.....T.T.@@@@@@@@@@@@@@@@@@@@@@@@@@@@@@@@@@
@@@@@@@@@@@@@@@@@@@@@@@@@@@@@@@@@@@@@@@@@@@@@@@@@@@@@@.T..TT...T@@@.@@@@@@...T..........T@@@@T....TT.T..T@@@@@@@@@@.....T.TTT..@@@@@@@@@@@@@@@@@@@@@@@@@@@@@@@@@
@@@@@@@@@@@@@@@@@@@@@@@@@@@@@@@@@@@@@@@@@@@@@@@@@@@@@..T....T....@...@@@@@@.....T...T...@@@@@@.T....T...@@@@@@.@@@......T.......@@@..@@@@@@@@@@@@@@@@@@@@@@@@@@@
@@@@@@@@@@@@@@@@@@@@@@@@@@@@@@@@@@@@@@@@@@@@@@@@@@@@@@.T.....TT..@@...@@@@@@..T..T...T.@@@@@@@..T..T...@@@@@@..T@T...T...............T@@@@@@@@@@@@@@@@@@@@@@@@@@
@@@@@@@@@@@@@@@@@@@@@@@@@@@@@@@@@@@@@@@@@@@@@@@@@@@@@@@........T..@T...@@@@@.......TT.T@@@@@@@@...TTT.@@@@@@@@.....T...T.T.T..TTT.T..@@@@@@@@@@@@@@@@@@@@@@@@@@@
@@@@@@@@@@@@@@@@@@@@@@@@@@@@@@@@@@@@@@@@@@@@@@@@@@@@@@@@.TT.TTTT.T@@....@@@@T...T......@@@@@@@@..TTT@@@@@@@@@@@........@@@T.T.T....TTTTT@@@@@@@@@@@@@@@@@@@@@@@@
@@@@@@@@@@@@@@@@@@@@@@@@@@@@@@@@@@@@@@@@@@@@@@@@@@@@@@@@@......T...@....@@@@TT.....T....@@@@@@@....@@@@@@@@@@@@...T...@@@@@..T..T...T..T@@@@@@@@@@@@@@@@@@@@@@@@
@@@@@@@@@@@@@@@@@@@@@@@@@@@@@@@@@@@@@@@@@@@@@@@@@@@@@@@@@@T.T...T..@@..T@@@TT.@@.T.T.T..T..@@@@T..@@@@@@@.T@@@....@@.@@@@@..TTTT.....T.@@@@@@@@@@@@@@@@@@@@@@@@@
@@@@@@@@@@@@@@@@@@@@@@@@@@@@@@@@@@@@@@@@@@@@@@@@@@@@@@@@@@@.T..T...T@..TTT.T.T@@@.TTTT....T@@@@..@@@@@@@@.....T...@@@@@@@@@......T.T..@@@@@@@@@@@@@@@@@@@@@@@@@@
@@@@@@@@@@@@@@@@@@@@@@@@@@@@@@@@@@@@@@@@@@@@@.T@@@@@@@@@@@@....T....@@.T.T..T@@@@@T.T....T......@@@@@@@@@@.T...T..@@@@@@@......T..T.T@@@@@@@@@@@@@@@@@@@@@@@@@@@
@@@@@@@@@@@@@@@@@@@@@@@@@@@@@@@@@@@@@@@@@@@@.TT.@@@@@@@@@@@@T.T......@T...T.@@@@@@@@T.T.......T@@@@@@@@@@.....T@@T@@@@@@....T..T.T.T@@@@@@@@@@@@@@@@@@@@@@@@@@@@
@@@@@@@@@@@@@@@@@@@@@@@@@@@@@@@@@@@@@@@@@@@...T..@@@@@@@@@@@T.TT..T..@@T..T.@@@@@@@@@.T.......@@@@@@@@@@T.T....@@@@@@@@@@T.T..TT...@@@@@@@.@@@@@@@@@@@@@@@@@@@@@
@@@@@@@@@@@@@@@@@@@@@@@@@@@@@@@@@@@@@@@@@@..T...TT@@@@@@@@@@....TTT...@..TT..T.@@@@@@@T.....T@@@@@@@..@......T.@@@@@@@@@@...T...T.@@@@@@@@T.@@@@@@@@@@@@@@@@@@@@
@@@@@@@@@@@@@@@@@@@@@@@@@@@@@@@@@@.T@@@@@.T.....TT.@@@@@@@@@@.........@@@@T....@@@@@@@@TT.T.@@@@@@@....T.......@@@@@@....T.....T.@@@@@@@@@T..@@@@@@@@@@@@@@@@@@@
@@@@@@@@@@@@@@@@@@@@@@@@@@@@@@@@@@@...T.....T.......@@@@@@@@@.........TT@T..T..@@@@@@@@@T..@@@@@@@TT...T......@@@@@@@..T.....T..@@@@@@@@@@T.T.@@@@@@@@@@@@@@@@@@
@@@@@@@@@@@@@@@@@@@@@@@@@@@@@@@@@@@@@.....TTT.TTTT...@@@@@@@@@T.T.....TT....T.T.T@@@@@@@@@@@@@@@@...TT........@@@@@@@T....T....@@@@@@@@@@.T..T.@@@@@@@@@@@@@@@@@
@@@@@@@@@@@@@@@@@@@@@@@@@@@@@@@@@@@@@@@@...T...T.....@@@@@@@@@....T..T.TT..T.T..@@@@@@@@@@@@@@@@@....TT.....T@@@@@...T......T.@@@@@@@@@@@.T..T..T.@@@@@@@@@@@@@@
@@@@@@@@@@@@@@@@@@@@@@@@@@@@@@@@@@@@@@@@@@....T..T...T@@@@@@@@@T.T............TT.@@@@@@@@@@@@@@@@.........T..@@@@.T..........@@@@@@@@@@..T.....T..@@@@@@@@@@@@@@
@@@@@@@@@@@@@@@@@@@@@@@@@@@@@@@@@@@@@@@@@@@...T.TTT...@@@@@@@@@@......T.....T....T@@@@@@@@@@@@@@T..T..T.T...............T...@@@@@@@@@@T.T.....TT..@@@@@@@@@@@@@@
@@@@@@@@@@@@@@@@@@@@@@@@@@@@@@@@@@@@@@@@@@@@........T..@@@@@@@@@..T..TTT..T.T.TT...T@@@@@@@@@...T.....TTT.T......T...TT...T@@@@@@@@@@..TT..TT.....T@@.@@@@@@@@@@
@@@@@@@@@@@@@@@@@@@@@@@@@@@@@@@@@@@@@@@@@@@@.T..T......@@@@@@@@@.........T....TT..T.T@T@@@@@@@..TT.T.........TT...T.T.....@@@@@.@@@@.......@@T...T....@@@@@@@@@@
@@@@@@@@@@@@@@@@@@@@@@@@@@@@@@@@@@@@@@@@@@@@@.T..T.TT..@@@@@@@........TTT.....T....@.T.@@@@@@@@T..T.....T...T.....T.....T@@@@@@T...TT..T.@@@@@T.T.T..T@@@@@@@@@@
@@@@@@@@@@@@@@@@@@@@@@@@@@@@@@@@@@@@@@@@@@@@@T....T.T...@@@@@.T...T.T..T.....T..T..@@TTT@@@@@@@@...........T...T......T.@@@@@@@TTT....@@..@@@@@T.T...@@@@@@@@@@@
@@@@@@@@@@@@@@@@@@@@@@@@@@@@@@@@@@@@@@@@@@@@@@.....T....@@@@TT..TT....T...........T.....T@@@@@@@@..T...T..TTTT...TTT...@@@@@@@@.T.T.T@@@@T..@@@@..T..@@@@@@@@@@@
@@@@@@@@@@@@@@@@@@@@@@@@@@@@@@@@@@@@@@@@@@@@@@.T.....T.T.@@..........TT.T.........T.....T.@@@@@@@@.T....TTT..TT...T...@@@@@@@@@T.....T@@@@@..@@@.T...T@@@@@@@@@@
@@@@@@@@@@@@@@@@@@@@@@@@@@@@@@@@@@@@@@@@@@@@@@@..T..T.T..@T.T.T....TTT.....T....TT.......T@@@@@@@@T....T......T.T...T@@@@@@@@@T..T.T...@@@@@..@@.T..TT.@@@@@@@@@
@@@@@@@@@@@@@@@@@@@@@@@@@@@@@@@@@@@@@@@@..@@@@@T..T.T............TT............T..T...T..T.@@@@@@@.T.TT.T.T...TT....@@@@@@@@@..TTT.T@@..@@@@T...TTTTT....T@@@@@@
@@@@@@@@@@@@@@@@@@@@@@@@@@@@@@@@@@@@@@@.T.T@@@@@T....TT....TT.T.T.TTT.....T..T......T...T.@@..@@@T...TT.T..T..TTT.@@@@@@@@@@..T....@@@@T.@@..@...T..T..T.T..@@@@
@@@@@@@@@@@@@@@@@@@@@@@@@@@@@@@@@@@@@@...T..@@@@T.T..T....TT..T....T.....T.T.T....T..T....@@..T....T.@TT...T.....@@@@@@@..T.T.T....@@@@@T...@@@..T.T.....TT..@@@
@@@@@@@@@@@@@@@@@@@@@@@@@@@@@@@@@@@@@@..T....@@@..TT....T...T...T..T.........T.............T...T..T.@@@.......T.@@@@@@@@.T.TTT......@@@@@.T@@@@...........T..@@@
@@@@@@@@@@@@@@@@@@@@@@@@@@@@@@@@@@@@@@@.T..TTT@@@......T.......T....T....T.T...........T......T...T.@@@@....T..@@@@@@@...T.....T.TT..@@@@@TT@@....T.T......T@@@@
@@@@@@@@@@@@@@@@@@@@@@@@@@@@@@TT@@@@@@@@..T..T.@@.TT.TT....T.........T.T............T....T.TTT...T.@@@@@@..T..@@@@@@@@T...T..T.....TT.@@@T.......T..T..TT..@@@@@
@@@@@@@@@@@@@@@@@@@@@@@@@@@@@@..T@@@@@@@@.......@@..T.T..T..TT.T.T......@@...TTT.TT..T.........T.TT@@@@@@@T..@@@@@@@@@@...T......TTT....T.T...............@@@@@@
@@@@@@@@@@@@@@@@@@@@@@@@@@@@@@@.TT@@@@@@@@.T.TT.T@@..TT......T...TT.T.@@@@@.TTT.T....TT......T...TT..@@@@@@.@@@@@@@...T.T....@.T...T...T.T.T..TT......TT.@@@@@@@
@@@@@@@@@@@@@@@@@@@@@@@@@@@@@@@@TTT.@@@@@@@...T..@@..T.TT............@@@@@@@....TT.T..T....TT....T...@@@@@@@@@@@@@.....T....@@@.......TTT....TT......TT.@@@@@@@@
@@@@@@@@@@@@@@@@@@@@@@@@@@@@@@@@@@....@@@@@.......T...............TT.@@@@@@@@.......T...T.T.....TT.T..@.@@@@@@@@@T.....T.T..@@@.T...TT.T.....TT........@@@@@@@@@
@@@@@@@@@@@@@@@@@@@@@@@@@@@@@@@@@@....T@@@@T.TTT...T....TT.....T.T.T.T@@@@@@..T..T...T.T.T.T...TT...T....@@@@@@@...T...T..T.T@@T.T....T...............@@@@@@@@@@
@@@@@@@@@@@@@@@@@@@@@@@@@@@@@@@@@@@.TT.@@@@........T.......T.....TT.......T.T.T...T....T.........T.@@T....@@@@@TT.T.....T@@T..T..TT.....T.T.TT....TT.@@@@@@@@@@@
@@@@@@@@@@@@@@@@@@@@@@@.@@T@@@@@@@T....@...TT@@@..T....TT...........T........T.T.TT...T........TT..@@....@@@@@@@...T....@@@@.T.T....................@@@@@@@@@@@@
@@@@@@@@@@@@@@@@@@@@@@..T...@@@@@..T.T..TT..@@@@@..T....T..T..T...TT..........TTTTT...TT..TT...T......T.....@@@@@........@@@T......T..T.TT.........@@@@@@@@@@@@@
@@@@@@@@@@@@@@@@@@@@@@..T.T@@@@..TT..T.......@@@@@....TT...T......T.TT...T.....T.T@@....T.TTTT..T...TT..T.T.@@@@@@@...T...@@.....TT..T............@@@@@@@@@@@@@@
@@@@@@@@@@@@@@@@@@@@@..TT..@@@@T..T.....TTTTT@@@@@@..TTT.....T.....TT.......TT.T.@@@@........T...TTTTT..T...@@@@@@@@T.T......T..TT....T.....T.T.@@@@@@@@@@@@@@@@
@@@@@@@@@@@@@@@@@@@@@@T..T..@@.T...........@@@@@@@@@........T....TT......T.T.....@@@@@.................TT..T@@T@@@@@..............T...........T@@@@@@@@@@@@@@@@@
@@@@@@@@@@@@@@@@@@@@@@@TT.T..T.........T..@@@@@@@@@@@.T.T..T.....T.T.T......T....@@@@@....T..........T..T.@....T@@@..T.............T........T.@@@@@@@@@@@@@@@@@@
@@@@@@@@@@@@@@@@@@@@@@@@...TT.T...T.T.....@@@@@@@@@@@@T..TT.....TTT......TT...T.@@@@@@...T.....T.T...T....@@....@@...@@.T.T.......TTTT..T....@@@@@@@@@@@@@@@@@@@
@@@@@@@@@@@@@@@@@@@@@@@@@...........T.TTT.@@@.@@@@@@@@@..T@@...TTTT...T.T.TT...T@@@@@@@@T.T...........T....T.T..TT...@@@............T....T..@@@@@@@@@@@@@@@@@@@@
@@@@@@@@@@@@@@@@@@@@@@@@@@............T...@T.T@@@@@@@@@@..@@T....TTTT.....T.T..T@@@@@@@@@.....T.T...T..TT.T..T.T...T.@@@@......T...T.T...T.@@@@@@@@@@@@@@@@@@@@@
@@@@@@@@@@@@@.@@T.@@@@@......T.......T....@..@@@@@@@@@@@@....T..TT....T..T...T.@@@@@@@@@@.T..T...T..T......T.T...TT.@@@@@@@..TT..TT.......@@@@@@@@@@@@@@@@@@@@@@
@@@@@@@@@@@@TT...T@@@@@..T...........TT.TT.TT.T.@@@.@@@@@@...T...T..T.T......T.@@@@@@@@@@.TTTT.....T...TT........TT.@@@@@@@@.T.T.T...TT..@@@@@@@@@@@@@@@@@@@@@@@
@@@@@@@@@@@.TT..T@@@@T....TT.....T.......TT.T.TT@@@TT@@@@@@.......TT.......TTT...TT@@......T.T.........TT...T.......TT@@@@@@@..T.....T..@@@@@@@@@@@@@@@@@@@@@@@@
@@@@@@@@@@...T..TT@@@.......T....T.T....@@@....@@@@T.T@@@@@@T.T.......T..TT.....T.....TT..T.T@..........T.....T....TT..@@@@@@@.........@@@@@@@@@@@@@@@@@@@@@@@@@
@@@@@@@@@@@.................T..T......T.@@@.TTT@@@...@@@@@@@@...T@@...TTTTT.T.T.............@@@...TTT.........T.T.TT...@@@@@@@@.....TT@@@@@@@@@@@@@@@@@@@@@@@@@@
@@@@@@@@@@@@TT.T.....TT...T...T.....T.TT.@@...@@@@T.@@@@@@@@@@TT.@@...T........T.TTT..T...T.@@@@.............T....T..T.@@@@@@@@@@.T.@@@@@@@@@@@@@@@@@@@@@@@@@@@@
@@@@@@@@@@@@@.........TT......T..T.T.....@@..T@@.T.@@@@@@@@@@@@..........TTTTT.T....T.....T.@@@@@T.TTT.TT....TTT...T...T..@@@@@@@@.@@@@@@@@@@@@@@@@@@@@@@@@@@@@@
@@@@.@@@@@@@@@T......T..T........T....TT@@T.TT.T.@@@@@@@@@@@@@@@..TT.T....T...........TTT...@@@@@T...T......T.......TT.....@@@@@@@@@@@@@@@@@@@@@@@@@@@@@@@@@@@@@
@@@...@@@@@@@@@@..T.......@@...T.T.....@@@@...T.@@@@@@@@@@T@@@@@@.....T.....TT.....T...T...T@@@@@...T....T....T..T..T..TT....@@@@@@@@@@@@@@@@@@@@@@@@@@@@@@@@@@@
@@T...T@@@@@@@@.T.......T@@@...@@...T.T@@@@....@@@@@@@@@T.TT@@@@@@T.TT...T....TT.........TT.@@@@@....T.T.T.T.T.........T......@@@@@@@@@@@@@@@@@@@@@@@@@@@@@@@@@@
@...T...@@@@@...T....T..@@@@...@@......@@@@...@@@@@@@@@.T@@..@@@@......TT.T...T.T....TT.....@@@..T.T...T...T....T....T........T@@@@@@@@@@@@@@@@@@@@@@@@@@@@@@@@@
@@......@@@T.TT........@@@@@..T.@@....TT.....@@@@@@@@@@.@@@@.@@@@.T@@.......T..T..TT..T.T...T....T..TTT.T...T.....T.......TT.T..@@@@@@@@@@@@@@@@@@@@@@@@@@@@@@@@
@@@......@@.....T....TT@@@@..TT.@@T.T.T..T..@@@@@@@@@.T.@@@T.......@@@.T....T...TT.T.....T....T.T...T....T.T.T.T............T..@@@@@@@@@@@@@@@@@@@@@@@@@@@@@@@@@
@@@@......T.T...T...T.@@@@..@@@....T....T.@@@@@@@@@@..@@@...T.T.T..@@@@..T.@@T......T.....TT......TT..TT..T.T......TTTT.......@@@@@@@@@@@@@@@@@@@@@@@@@@@@@@@@@@
@@@@@..T....T.TT...T.@@@@..@@@@.TT.......@@@@@@@@@@@.@@@@.@@@.T.T.@@@@@@T..@@........T.T.T...T..T.....TTT......T...T.TT.T.T..@@@@@@@@@@@@@@@@@@@@@@@@@@@@@@@@@@@
@@@@@@..T...TTT...T..@@@.T@@@@.TT...T..T@@@@@@@@@....@@@@T@@@.T..@@@@@@@@T...T....T....................T..T....T..T.TT..TT..@@@@@@@@@@@@@@@@@@@@@@@@@@@@@@@@@@@@
@@@@@@@.TTT...T.T........T@@@...T..T...@@@@@@@@@....TT@@@.@@@T...@@@@@@@@@...TT....T....T....TTTT..T..T...T.T......TT....T.@@@@@@@@@@@@@@@@@@@@@@@@@@@@@@@@@@@@@
@@@@@@@@T..T......T..T.T...@..TT...TT.@@@@@@@@@T....T.T.T..T...TT.@@@@@@@@@........TT.T.....T....T....T........TT.T.TT.TT.@@@@@@@@@@@@@@@@@@@@@@@@@@@@@@@@@@@@@@
@@@@@@@@@.TT.........T...T.T.........@@@@@@@@@.T...T..T......T.....@@@@@@@@@.......@@..T....T....T.TT.....T.....TT..T..T.@@@@@@@@@@@@@@@@@@@@@@@@@@@@@@@@@@@@@@@
@@@@@@@@@@T....TT......T..TT....T...@@@@@@@@@.TT.T...T......TT...T.T@@@@@@@@@......@@T.......TT....T.........TT..T......@@@@@@@@@@@@@@@@@@@@@@@@@@@@@@@@@@@@@@@@
@@@@@@@@@@@TT.......T.T..T......T..@@@@@@@@@.T......T...TT...........@@@@@@@@@............T.......TT.TT..TT............@@@@@@@@@@@@@@@@@@@@@@@@@@@@@@@@@@@@@@@@@
@@@@@@@@@@@@.TT..TT...T....T.T....@@@@@@@@@T.T.T.T.TT....T.......T.T.@@@@@@@@@@.....T......T..........T.....T.........@@@@@@@@@@@@@@@@@@@@@@@@@@@@@@@@@@@@@@@@@@
@@@@@@@@@@@@@...T....T....T..TT..@@@@@@@@@.TT..T...T@.T....T....TT..@@@@@@@@@@@@..T.T......T.T........T....T..T......@@@@@@@@@@@@@@@@@@@@@@@@@@@@@@@@@@@@@@@@@@@
@@@@@@@@@@@@@@...TT...T.....T..T@@@@@@@@@....T.T....@@..T....TT....@@@@@@@@.@@@@@.............T..TT..T.........T.T..@@@@@@@@@@@@@@@@@@@@@@@@@@@@@@@@@@@@@@@@@@@@
@@@@@@@@@@@@@@@.............T..@@@@@@@@@@@......TT.@@@.....TT...T.@@@@@@@T.T.@@@@@......T......TTT..T....TT..T.....@@@@@@@@@@@@@@@@@@@@@@@@@@@@@@@@@@@@@@@@@@@@@
@@@@@@@@@@@@@@@@T....T........@@@@@@@@@@@@..T.T..TT.@@@T.TT...T..@@@@@@@@@@@..@@@@@...........TT..T.......T.......@@@@@@@@@@@@@@@@@@@@@@@@@@@@@@@@@@@@@@@@@@@@@@
@@@@@@@@@@@@@@@@@T..T..T.....@@@@@@@@@@@@.......T.@@@@@...T.....@@@@@@@@@@@@..T@@@@T...TT......T.......T.........@@@@@@@@@@@@@@@@@@@@@@@@@@@@@@@@@@@@@@@@@@@@@@@
@@@@@@@@@@@@@@@@@@..........@@@@@@@@@@@@......T.@@@@@@@@.....T.@@@@@@@TTTT......@@.T.TT.TT.....T.T..TTT...T.T.T.@@@@@@@@@@@@@@@@@@@@@@@@@@@@@@@@@@@@@@@@@@@@@@@@
@@@@@@@@@@@@@@@@@@@.T......@@@@@@@@@@@@T.T..T.T..@@@@@@@@.T...@@@@@@@T.T.T..T..T.TT.@@@....TT.T....T.T.T.....T@@@@@@@@@@@@@@@@@@@@@@@@@@@@@@@@@@@@@@@@@@@@@@@@@@
@@@@@@@@@@@@@@@@@@@@..T...@@@@@@@@@@@@@.....T..TT@@@@@@@@....@@@@@@@T.......T..T...@@@@@.T...T.......TT..T..T@@@@@@@@@@@@@@@@@@@@@@@@@@@@@@@@@@@@@@@@@@@@@@@@@@@
@@@@@@@@@@@@@@@@@@@@@..T.@@@@@@@@@@@@@@@.......T.T@@@@.@@.T.@@@@@@@.T.......T......@@@@@@..T....TT..T.....T.@@@@@@@@@@@@@@@@@@@@@@@@@@@@@@@@@@@@@@@@@@@@@@@@@@@@
@@@@@@@@@@@@@@@@@@@@@@..@@@@@@..@@@@@@@@@T.....T..@@@@.....@@@@@@@.........T......TT@@@@@@...TT..T...T...T.@@@@@@@@@@@@@@@@@@@@@@@@@@@@@@@@@@@@@@@@@@@@@@@@@@@@@
@@@@@@@@@@@@@@@@@@@@@@@@@@@@@.T.T@@@@@@@@@.TT......@T.T...@@@@@@@@.....T........TTT.T@@@@@@..TT..T....T.T.@@@@@@@@@@@@@@@@@@@@@@@@@@@@@@@@@@@@@@@@@@@@@@@@@@@@@@
@@@@@@@@@@@@@@@@@@@@@@@@@@@@T....T@@@@@@@@@.....T...T..T.@@@@@@@@.T...T.............T.@@@@@@T.TTT....T...@@@@@@@@@@@@@@@@@@@@@@@@@@@@@@@@@@@@@@@@@@@@@@@@@@@@@@@
@@@@@@@@@@@@@@@@@@@@@@@@@@@.....T..@@@@@@@...TT..T......@@@@@@@@@.TT...T.....TT........@@@@@@T.T...T..T.@@@@@@@@@@@@@@@@@@@@@@@@@@@@@@@@@@@@@@@@@@@@@@@@@@@@@@@@
@@@@@@@@@@@@@@@@@@@@@@@@@@@.......T.@@@@@..TT.T........@@@@@@@.T.T..T.T....T.....T..T...@@@@@@.T.T.TTT.@@@@@@@@@@@@@@@@@@@@@@@@@@@@@@@@@@@@@@@@@@@@@@@@@@@@@@@@@
@@@@@@@@@@@@@@@@@@@@@@@@@@@@..T......@@@TT.....T.T.TT.@@@@@@@@@...TT....T.TTT.....TTT....@@@@@@...T.T.@@@@@@@@@@@@@@@@@@@@@@@@@@@@@@@@@@@@@@@@@@@@@@@@@@@@@@@@@@
@@@@@@@@@@@@@@@@@@@@@@@@@@@@@....TTT..@.....T.......T@@@@@@@@@@@..T@@..T....T.T.T..T..T.T.@@@@@@....@@@@@@@@@@@@@@@@@@@@@@@@@@@@@@@@@@@@@@@@@@@@@@@@@@@@@@@@@@@@
@@@@@@@@@@@@@@@@@@@@@@@@@@@@@@...T.T..T....T....T.T.@@@@@@@@@@@@..T@@......T..T..TT.....TT.@@@@@@..@@@@@@@@@@@@@@@@@@@@@@@@@@@@@@@@@@@@@@@@@@@@@@@@@@@@@@@@@@@@@
@@@@@@@@@@@@@@@@@@@@@@@@@@@@@@@T.......T..T...TT.TT@@@@@@@@@@@@......TT.T..T....T......T....@@@@@@@@@@@@@@@@@@@@@@@@@@@@@@@@@@@@@@@@@@@@@@@@@@@@@@@@@@@@@@@@@@@@
@@@@@@@@@@@@@@@@@@@@@@@@@@@@@@@@........T.........@@@@@@@@@@@@.....T.................T.T.TT.T@@@@@@@@@@@@@@@@@@@@@@@@@@@@@@@@@@@@@@@@@@@@@@@@@@@@@@@@@@@@@@@@@@@
@@@@@@@@@@@@@@@@@@@@@@@@@@@@@@@@@...TT..........T@@@@@@T@@@@@.......TT.TT...................T.@@@@@@@@@@@@@@@@@@@@@@@@@@@@@@@@@@@@@@@@@@@@@@@@@@@@@@@@@@@@@@@@@@
@@@@@@@@@@@@@@@@@@@@@@@@@@@@@@@@@@.....T..TTTT..@@@@@@..T@@@..............T.TT........T......T@@@@@@@@@@@@@@@@@@@@@@@@@@@@@@@@@@@@@@@@@@@@@@@@@@@@@@@@@@@@@@@@@@
@@@@@@@@@@@@@@@@@@@@@@@@@@@@@@@@@@@.TT..T......@@@@@@@@.TT@........T..............T......T..T@@@@@@@@@@@@@@@@@@@@@@@@@@@@@@@@@@@@@@@@@@@@@@@@@@@@@@@@@@@@@@@@@@@
@@@@@@@@@@@@@@@@@@@@@@@@@@@@@@@@@@@@.T..T...T@@@@@@@.@@.TT.T.T.....T.T.T.T.T...T..T..T...T..@@@@@@@@@@@@@@@@@@@@@@@@@@@@@@@@@@@@@@@@@@@@@@@@@@@@@@@@@@@@@@@@@@@@
@@@@@@@@@@@@@@@@@@@@@@@@@@@@@@@@@@@@@T......@@@@@@@@TT.T...T..........TTTT.....TT....T....T@@@@@@@@@@@@@@@@@@@@@@@@@@@@@@@@@@@@@@@@@@@@@@@@@@@@@@@@@@@@@@@@@@@@@
@@@@@@@@@@@@@@@@@@@@@@@@@@@@@@@@@@@@@@.....@@@@@@@@..........T.....T.......T....T......T..@@@@@@@@@@@@@@@@@@@@@@@@@@@@@@@@@@@@@@@@@@@@@@@@@@@@@@@@@@@@@@@@@@@@@@
@@@@@@@@@@@@@@@@@@@@@@@@@@@@@@@@@@@@@@@...@@@@@@@......T@@..T.TT.TT....TTT....TT...T.....@@@@@@@@@@@@@@@@@@@@@@@@@@@@@@@@@@@@@@@@@@@@@@@@@@@@@@@@@@@@@@@@@@@@@@@
@@@@@@@@@@@@@@@@@@@@@@@@@@@@@@@@@@@@@@@@.@@@@@@@..TT..T.@@TT......T..T.T...........TT...@@@@@@@@@@@@@@@@@@@@@@@@@@@@@@@@@@@@@@@@@@@@@@@@@@@@@@@@@@@@@@@@@@@@@@@@
@@@@@@@@@@@@@@@@@@@@@@@@@@@@@@@@@@@@@@@@@@@@@@@....TT...T..TT..T..........T..T..TTTTTT.@@@@@@@@@@@@@@@@@@@@@@@@@@@@@@@@@@@@@@@@@@@@@@@@@@@@@@@@@@@@@@@@@@@@@@@@@
@@@@@@@@@@@@@@@@@@@@@@@@@@@@@@@@@@@@@@@@@@@@@@T......T.TT........T.TT.T..TT.T.T.T.....@@@@@@@@@@@@@@@@@@@@@@@@@@@@@@@@@@@@@@@@@@@@@@@@@@@@@@@@@@@@@@@@@@@@@@@@@@
@@@@@@@@@@@@@@@@@@@@@@@@@@@@@@@@@@@@@@@@@@@@@.......T..TT...T..T...T..T....T.T.......@@@@@@@@@@@@@@@@@@@@@@@@@@@@@@@@@@@@@@@@@@@@@@@@@@@@@@@@@@@@@@@@@@@@@@@@@@@
@@@@@@@@@@@@@@@@@@@@@@@@@@@@@@@@@@@@@@@@@@@@@TT...T.T..TT...TT.......T.T......TTTT..@@@@@@@@@@@@@@@@@@@@@@@@@@@@@@@@@@@@@@@@@@@@@@@@@@@@@@@@@@@@@@@@@@@@@@@@@@@@
@@@@@@@@@@@@@@@@@@@@@@@@@@@@@@@@@@@@@@@@@@@@@@......T.................TT...........@@@@@@@@@@@@@@@@@@@@@@@@@@@@@@@@@@@@@@@@@@@@@@@@@@@@@@@@@@@@@@@@@@@@@@@@@@@@@
@@@@@@@@@@@@@@@@@@@@@@@@@@@@@@@@@@@@@@@@@@@@@@@T.TTT.T...T...T..T..TT..T..TT...TT.@@@@@@@@@@@@@@@@@@@@@@@@@@@@@@@@@@@@@@@@@@@@@@@@@@@@@@@@@@@@@@@@@@@@@@@@@@@@@@
@@@@@@@@@@@@@@@@@@@@@@@@@@@@@@@@@@@@@@@@@@@@@@@@..TT..T..........T.....T......T.@@@@@@@@@@@@@@@@@@@@@@@@@@@@@@@@@@@@@@@@@@@@@@@@@@@@@@@@@@@@@@@@@@@@@@@@@@@@@@@@
@@@@@@@@@@@@@@@@@@@@@@@@@@@@@@@@@@@@@@@@@@@@@@@@@....TTTT.T....T.....T....T.T..@@@@@@@@@@@@@@@@@@@@@@@@@@@@@@@@@@@@@@@@@@@@@@@@@@@@@@@@@@@@@@@@@@@@@@@@@@@@@@@@@
@@@@@@@@@@@@@@@@@@@@@@@@@@@@@@@@@@@@@@@@@@@@@@@@@@TT.TT..TT.............T..T.T@@@@@@@@@@@@@@@@@@@@@@@@@@@@@@@@@@@@@@@@@@@@@@@@@@@@@@@@@@@@@@@@@@@@@@@@@@@@@@@@@@
@@@@@@@@@@@@@@@@@@@@@@@@@@@@@@@@@@@@@@@@@@@@@@@@@@@.TT....T.T.......T....T..T@@@@@@@@@@@@@@@@@@@@@@@@@@@@@@@@@@@@@@@@@@@@@@@@@@@@@@@@@@@@@@@@@@@@@@@@@@@@@@@@@@@
@@@@@@@@@@@@@@@@@@@@@@@@@@@@@@@@@@@@@@@@@@@@@@@@@@@@..T......TT......TT...T.@@@@@@@@@@@@@@@@@@@@@@@@@@@@@@@@@@@@@@@@@@@@@@@@@@@@@@@@@@@@@@@@@@@@@@@@@@@@@@@@@@@@
@@@@@@@@@@@@@@@@@@@@@@@@@@@@@@@@@@@@@@@@@@@@@@@@@@@@@...T......TT.........@@@@@@@@@@@@@@@@@@@@@@@@@@@@@@@@@@@@@@@@@@@@@@@@@@@@@@@@@@@@@@@@@@@@@@@@@@@@@@@@@@@@@@
@@@@@@@@@@@@@@@@@@@@@@@@@@@@@@@@@@@@@@@@@@@@@@@@@@@@@@...T....T.....T.T..@@@@@@@@@@@@@@@@@@@@@@@@@@@@@@@@@@@@@@@@@@@@@@@@@@@@@@@@@@@@@@@@@@@@@@@@@@@@@@@@@@@@@@@
@@@@@@@@@@@@@@@@@@@@@@@@@@@@@@@@@@@@@@@@@@@@@@@@@@@@@@@....T........T.TT@@@@@@@@@@@@@@@@@@@@@@@@@@@@@@@@@@@@@@@@@@@@@@@@@@@@@@@@@@@@@@@@@@@@@@@@@@@@@@@@@@@@@@@@
@@@@@@@@@@@@@@@@@@@@@@@@@@@@@@@@@@@@@@@@@@@@@@@@@@@@@@@@T.....T.TT...T.@@@@@@@@@@@@@@@@@@@@@@@@@@@@@@@@@@@@@@@@@@@@@@@@@@@@@@@@@@@@@@@@@@@@@@@@@@@@@@@@@@@@@@@@@
@@@@@@@@@@@@@@@@@@@@@@@@@@@@@@@@@@@@@@@@@@@@@@@@@@@@@@@@@.T.....T..TTT@@@@@@@@@@@@@@@@@@@@@@@@@@@@@@@@@@@@@@@@@@@@@@@@@@@@@@@@@@@@@@@@@@@@@@@@@@@@@@@@@@@@@@@@@@
@@@@@@@@@@@@@@@@@@@@@@@@@@@@@@@@@@@@@@@@@@@@@@@@@@@@@@@@@@..TTTT....@@@@@@@@@@@@@@@@@@@@@@@@@@@@@@@@@@@@@@@@@@@@@@@@@@@@@@@@@@@@@@@@@@@@@@@@@@@@@@@@@@@@@@@@@@@@
@@@@@@@@@@@@@@@@@@@@@@@@@@@@@@@@@@@@@@@@@@@@@@@@@@@@@@@@@@@.....T..@@@@@@@@@@@@@@@@@@@@@@@@@@@@@@@@@@@@@@@@@@@@@@@@@@@@@@@@@@@@@@@@@@@@@@@@@@@@@@@@@@@@@@@@@@@@@
@@@@@@@@@@@@@@@@@@@@@@@@@@@@@@@@@@@@@@@@@@@@@@@@@@@@@@@@@@@@...TT@@@@@@@@@@@@@@@@@@@@@@@@@@@@@@@@@@@@@@@@@@@@@@@@@@@@@@@@@@@@@@@@@@@@@@@@@@@@@@@@@@@@@@@@@@@@@@@
@@@@@@@@@@@@@@@@@@@@@@@@@@@@@@@@@@@@@@@@@@@@@@@@@@@@@@@@@@@@@@T.@@@@@@@@@@@@@@@@@@@@@@@@@@@@@@@@@@@@@@@@@@@@@@@@@@@@@@@@@@@@@@@@@@@@@@@@@@@@@@@@@@@@@@@@@@@@@@@@
@@@@@@@@@@@@@@@@@@@@@@@@@@@@@@@@@@@@@@@@@@@@@@@@@@@@@@@@@@@@@@@@@@@@@@@@@@@@@@@@@@@@@@@@@@@@@@@@@@@@@@@@@@@@@@@@@@@@@@@@@@@@@@@@@@@@@@@@@@@@@@@@@@@@@@@@@@@@@@@@
@@@@@@@@@@@@@@@@@@@@@@@@@@@@@@@@@@@@@@@@@@@@@@@@@@@@@@@@@@@@@@@@@@@@@@@@@@@@@@@@@@@@@@@@@@@@@@@@@@@@@@@@@@@@@@@@@@@@@@@@@@@@@@@@@@@@@@@@@@@@@@@@@@@@@@@@@@@@@@@@
