type octile
height 75
width 76
map
@@@@@@@@@@@@@@@@@@@@@@@@@@@@@@@@@@@@@@@@@@@@@@@@@@@@@@@@@@@@@@@@@@@@@@@@@@@@
@@@@@@@@@@@@@@@@@@@@@@@@@@@@@@@@@@@@@@@@@@@@@@@@@@@@@@@@@@@@@@@@@@@@@@@@@@@@
@@@@@@@@@@@@@@@@@@@@@@@@@@@@@@@@@@@@@@@@@@@@@@@@@@@@@@@@@@@@@@@@@@@@@@@@@@@@
@@@@@@@@@@@@@@@@@@@@@@@@@@@@@@@@@@@@@@@@@@@@@@@@@@@@@@@@@@@@@@@@@@@@@@@@@@@@
@@@@@@@@@@@@@@@@@@@@@@@@@@@@@@@@@@@@@@@@@@@@@@@@@@@@@@@@@@@@@@@@@@@@@@@@@@@@
@@@@@@@@@@@@@@@@@@@@@@@@@@@@@@@@@@@@@@@@@@@@@@@@@@@@@@@@@@@@@@@@@@@@@@@@@@@@
@@@@@@@@@@@@@@@@@@@@@@@@@@@@@@@@@@@@@@@@@@@@@@@@@@@@@@@@@@@@@@@@@@@@@@@@@@@@
@@@@@@@@@@@@@@@..@@@@@@@@@@@@@@@@@@@@@@@@@@@@@@@@@@@@@@@@@@@@@@@@@@@@@@@@@@@
@@@@@@@@@@@@@..T...T@@@@@@@@@@@@@@@@@@@@@@@@@@@@@@@@@@@@@@@@@@@@@@@@@@@@@@@@
@@@@@@@@@@@..T...TT....@@@@@@@@@@@@@@@@@@@@@@@@@@@@@@@@@@@@@@@@@@@@@@@@@@@@@
@@@@@@@@@@.T..T....T...T@@@@@@@@@@@@@@@@@@@@@@@@@@@@@@@@@@@@@@@@@@@@@@@@@@@@
@@@@@@@@@T....T...TTTT...@@@@@@@@@@@@@@@@@@@@@@@@@@@@@@@@@@@@@@@@@@@@@@@@@@@
@@@@@@@@T.......T.T.T.TTT@@@@@@@@@@@@@@@@@@@@@@@@@@@@@@@@@@@@@@@@@@@@@@@@@@@
@@@@@@@...T..TT...T..TTTT@@@@@@@@@@@@@@@@@@@@@@@@@@@@@@@@@@@@@@@@@@@@@@@@@@@
@@@@@@@..........T.......@@@@@@@@@@@@@@@@@@@@@@@@@@@@@@@@@@@@@@@@@@@@@@@@@@@
@@@@@@@..TT.T..T.T.TT....@@@@@@@@@@@@@@@@@@@@@@@@@@@@@@@@@@@@@@@@@@@@@@@@@@@
@@@@@@@..T.TT..@@T...T.T..@@@@@@@@@@@@@@@@@@@@@@@@@@@@@@@@@@@@@@@@@@@@@@@@@@
@@@@@@..T.....@@@@....T...@@@@@@@@@@@@@@@@@@@@@@@@@@@@@@@@@@@@@@@@@@@@@@@@@@
@@@@@@.....T...@@.T.......@@@@@@@@@@@@@@@@@@@@@@@@@@@@@@@@@@@@@@@@@@@@@@@@@@
@@@@@@.TT.....TTT..T...TT@@@@@@@@@@@@@@@@@@@@@@@@@@@@@@@@@@@@@@@@@@@@@@@@@@@
@@@@@@@T.....T.TT....T...@@@@@@@@@@@@@@@@@@@@@@@@@@@@@@@@@@@@@@@@@@@@@@@@@@@
@@@@@@@@.T.T...T..T......T@@@@@@@@@@@@@@@@@@@@@@@@@@@@@@@@@@@@@@@@@@@@@@@@@@
@@@@@@@@@@...T.....TT.....@@@@@@@@@@@.T@@@@@@@@@@@@@@@@@@@@@@@@@@@@@@@@@@@@@
@@@@@@@@@@@T..TTTT.@@..T...@@@@@@@@@....@@@@@@@@@@@@@@@@@@@@@@@@@@@@@@@@@@@@
@@@@@@@@@@@@@@@@@@@@@@..T..@@@@@@@@...TT.@@@@@@@@@@@@@@@@@@@@@@@@@@@@@@@@@@@
@@@@@@@@@@@@@@@@@@@@@@.T....@@@@@@@T.T....@@@@@@@@@@@@@@@@@@@@@@@@@@@@@@@@@@
@@@@@@@@@@@@@@@@@@@@@@.TT...@@@@@.......TT.T@@@@@@@@@@@@@@@@@@@@@@@@@@@@@@@@
@@@@@@@@@@@@@@@@@@@@@@@T....T@@@@.T.......T.@@@@@@@@@@@@@@@@@@@@@@@@@@@@@@@@
@@@@@@@@@@@@@@@@@@@@@@@.T....@@@@....T.....T@@@@@@@@@@@@@@@@@@@@@@@@@@@@@@@@
@@@@@@@@@@@@@@@@@@@@@@@@TT.T..@@@TT..T......@@..@@@@@@@@@@@@@@@@@@@@@@@@@@@@
@@@@@@@@@@@@@@@@@@@@@@@@T.....@@@@........T@@....@@@@@@@@@@@@@@@@@@@@@@@@@@@
@@@@@@@@@@@@@@@@@@@@@@@@@.TTT..@@@...T.....@TT....@@@@@@@@@@@@@@@@@@@@@@@@@@
@@@@@@@@@@@@@@@@@@@@@@@@@...T..@@....T.T..T.......@@@@@@@@@@@@@@@@@@@@@@@@@@
@@@@@@@@@@@@@@@@@@@@@@@@@@.T...@@.....T...T....T...@@@@@@@@@@@@@@@@@@@@@@@@@
@@@@@@@@@@@@@@@@@@@@@@@@@@....T.@T..T......TT.T....T@@@@@@@@@@@@@@@@@@@@@@@@
@@@@@@@@@@@@@@@@@@@@@@@@@@@..TT.@T...T.......TT...T.T@@@@@@@@@@@@@@@@@@@@@@@
@@@@@@@@@@@@@@@@@@@@@@@@T.@T...T..T.TT.TTT....T......@@@@@@@@@@@@@@@@@@@@@@@
@@@@@@@@@@@@@@@@@@@@@@@@..@@.T.TT..TT..T............@@@.@@@@@@@@@@@@@@@@@@@@
@@@@@@@@@@@@@@@@@@@@@@@@.T.@..T.....T..TT...........@@...@@@@@@@@@@@@@@@@@@@
@@@@@@@@@@@@@@@@@@@@@.@@T..@.TT.TT....T...T.....T..T@.....@@@@@@@@@@@@@@@@@@
@@@@@@@@@@@@@@@@@@@@..@@..TT.......TT.......TT..T...T....T.@@@@@@@@@@@@@@@@@
@@@@@@@@@@@@@@@@@@T.T...T..T...T...T.T....TT.....T.....T..T.@@@@@@@@@@@@@@@@
@@@@@@@@@@@@@@@@@..........T..T..T..T....T.................T..@@@@@@@@@@@@@@
@@@@@@@@@@@@@@@@@...T...T......T.T.........T..T.............T.@@@@@@@@@@@@@@
@@@@@@@@@@@@@@@@@......T......T.....T..........TT......T.....@@@@@@@@@@@@@@@
@@@@@@@@@@@@@@@@@......T...T.TT.TT...........T.T............@@@T@@@@@@@@@@@@
@@@@@@@@@@@@@@@@@T.TT..T...T.....T....T............T........@@TT...TT.@@..@@
@@@@@@@@@@@@@@@@@.....T...............T.........TT..T...T...@@T..T.T...T..@@
@@@@@@@@@@@@@@@@@..TT...T..T.T..T..................T........T......T.T....@@
@@@@@@@@@@@@@@@@@...T.....T......T..........TT.T.T...T....T......T...T....@@
@@@@@@@@@@@@@@@@@.T..TT..T.T.TT..T...T...........T..T....TT........TT.....@@
@@@@@@@@@@@@@@@@@......T..T..T..TT..T.TT.TT....T....TT...T........T.T.T...@@
@@@@@@@@@@@@@@@@@........T..T..T.TT.T....T.....TTT......T..T........T..TT.@@
@@@@@@@@@@@@@@@@@....T...............T...T.TT....T........T.T.T..T...TT..@@@
@@@@@@@@@@@@@@@@@...TT.....TT......T...T..T.T.TTT...................T...@@@@
@@@@@@@@@@@@@@@@@@.T.T.T..T.TT......T..T.T.....TT.T.T..T...T.TTT.......@@@@@
@@@@@@@@@@@@@@@@@@@...T......TTT...TT........T....T..T....T.........T.@@@@@@
@@@@@@@@@@@@@@@@@@@@....TT.......T......TT..T..TT....T.T.T.........TT@@@@@@@
@@@@@@@@@@@@@@@@@@@@@..........T....TTT.T.....TT......T.....TT.T..T.@@@@@@@@
@@@@@@@@@@@@@@@@@@@@@@.T......T....T.T....T......TTT..T..TT....T...@@@@@@@@@
@@@@@@@@@@@@@@@@@@@@@@@....T.T.TT....T.....T.T.T..T..T.T.T.T......@@@@@@@@@@
@@@@@@@@@@@@@@@@@@@@@@@@...............T..T...T..T.T..T.TT..TT..T@@@@@@@@@@@
@@@@@@@@@@@@@@@@@@@@@@@@@.....T......T..T.TT..T.......T....TT...@@@@@@@@@@@@
@@@@@@@@@@@@@@@@@@@@@@@@@@.T....TT.....T.......T..T......T.....@@@@@@@@@@@@@
@@@@@@@@@@@@@@@@@@@@@@@@@@@.....TT.TT......TTT.TTTT...........@@@@@@@@@@@@@@
@@@@@@@@@@@@@@@@@@@@@@@@@@@@...T.TT.T....T.....T.......TT.T..@@@@@@@@@@@@@@@
@@@@@@@@@@@@@@@@@@@@@@@@@@@@@TT....T.T..................T...@@@@@@@@@@@@@@@@
@@@@@@@@@@@@@@@@@@@@@@@@@@@@@@.TT......T...T.......TT.T....@@@@@@@@@@@@@@@@@
@@@@@@@@@@@@@@@@@@@@@@@@@@@@@@@....T.T.T...T...TT..T.T....@@@@@@@@@@@@@@@@@@
@@@@@@@@@@@@@@@@@@@@@@@@@@@@@@@@.TTT...T.TT.TTT......T...@@@@@@@@@@@@@@@@@@@
@@@@@@@@@@@@@@@@@@@@@@@@@@@@@@@@@....T....TT..TT.TT...T.@@@@@@@@@@@@@@@@@@@@
@@@@@@@@@@@@@@@@@@@@@@@@@@@@@@@@@@...T.....TT..TT...T.T@@@@@@@@@@@@@@@@@@@@@
@@@@@@@@@@@@@@@@@@@@@@@@@@@@@@@@@@@..T...TT..T...T....@@@@@@@@@@@@@@@@@@@@@@
@@@@@@@@@@@@@@@@@@@@@@@@@@@@@@@@@@@@@.......T......T.@@@@@@@@@@@@@@@@@@@@@@@
@@@@@@@@@@@@@@@@@@@@@@@@@@@@@@@@@@@@@@@@@@@@@@@@@@@@@@@@@@@@@@@@@@@@@@@@@@@@
