type octile
height 86
width 80
map
@@@@@@@@@@@@@@@@@@@@@@@@@@@@@@@@@@@@@@@@@@@@@@@@@@@@@@@@@@@@@@@@@@@@@@@@@@@@@@@@
@@@@@@@@@@@@@@@@@@@@@@@@@@@@@@@@@@@@@@@@@@@@@@@@@@@@@@@@@@@@@@@@@@@@@@@@@@@@@@@@
@@@@@@@@@@@@@@@@@@@@@@@@@@@@@@@@@@@@@@@@@@@@@@@@@@@@@@@@@@@@@@@@@@@@@@@@@@@@@@@@
@@@@@@@@@@@@@@@@@@@@@@@@@@@@@@@@@@@@@@@@@@@@@@@@@@@@@@@@@@@@@@@@@@@@@@@@@@@@@@@@
@@@@@@@@@@@@@@@@@@@@@@@@@@@@@@@@@@@@@@@@@@@@@@@@@@@@@@@@@@@@@@@@@@@@@@@@@@@@@@@@
@@@@@@@@@@@@@@@@@@@@@@@@@@@@@@@@@@@@@@@@@@@@@@@@@@@@@@@@@@@@@@@@@@@@@@@@@@@@@@@@
@@@@@@@@@@@@@@@@@@@@@@@@@@@@@@@@@@@@@@@@@@@@@@@@@@@@@@@@@@@@@@@@@@@@@@@@@@@@@@@@
@@@@@@@@@@@@@@@@@@@@@@@@@@@@@@@@@@@@@@@@@@@@@@@@@@@@@@@@@@@@@@@@@@@@@@@@@@@@@@@@
@@@@@@@@@@@@@@@@@@@@@@@@@@@@@@@@@@@@@@@@@@@@@@@@@@@@@@@@@@@@@@@@@@@@@@@@@@@@@@@@
@@@@@@@@@@@@@@@@@@@@@@@@@@@@@@@@@@@@@@@@@@@@@@@@@@@@@@@@@@@@@@@@@@@@@@@@@@@@@@@@
@@@@@@@@@@@@@@@@@@@@@@@@@@@@@@@@@@@@@@@@@@@@@@@@@@@@@@@@@@@@@@@@@@@@@@@@@@@@@@@@
@@@@@@@@@@@@@@@@@@@@@@@@@@@@@@@@@@@@@@@@@@@@@@@@@@@@@@@@@@@@@@@@@@@@@@@@@@@@@@@@
@@@@@@@@@@@@@@@@@@@@@@@@@@@@@@@@@@@@@@@@@@@@@@@@@@@@@@@@@@@@@@@@@@@@@@@@@@@@@@@@
@@@@@@@@@@@@@@@@@@@@@@@@@@@@@@@@@@@@@@@@@@@@@@@@@@@@@@@@@@@@@@@@@@@@@@@@@@@@@@@@
@@@@@@@@@@@@@@@@@@@@@@@@@@@@@@@@@@@@@@@@@T@@@@@@@@@.T.@@@@@@@@@@@@@@@@@@@@@@@@@@
@@@@@@@@@@@@@@@@@@@@@@@@@@@@@@@@@@@@@@@@T..T@@@@@@..T..@@@@@@@@@@@@@@@@@@@@@@@@@
@@@@@@@@@@@@@@@@@@@@@@@@@@@@@@@@@@@@@@@......@@@@......@@@@@@@@@@@@@@@@@@@@@@@@@
@@@@@@@@@@@@@@@@@@@@@@@@@@@@@@@@@@@@@@@.......@@@.T..T@@@@@@@@@@@@@@@@@@@@@@@@@@
@@@@@@@@@@@@@@@@@@@@@@@@@@@@@@@@@@@@@@@@TT...@@@@....@@@@@@@@@@@@@@@@@@@@@@@@@@@
@@@@@@@@@@@@@@@@@@@@@@@@@@@@@@@@@@@@@@@...T..@@@@...@@@@@@@@@@@@@@@@@@@@@@@@@@@@
@@@@@@@@@@@@@@@@@@@@@@@@@@@@@@@@@@@@@@.TT...T...TT..@@@@@@@.@@@@@@@@@@@@@@@@@@@@
@@@@@@@@@@@@@@@@@@@@@@@@@@@@@@@@@@@@@T.....TT..TT..@@@@@@@...@@@@@@@@@@@@@@@@@@@
@@@@@@@@@@@@@@@@@@@@@@@@@@@@@@@@@@@@T.T...T..T.T.@@@@@@@@..TT.@@@@@@@@@@@@@@@@@@
@@@@@@@@@@@@@@@@@@@@@@@@@@@@@@@@@@@@@.TTTT...T...T@@@@@..T.TT@@@@@@@@@@@@@@@@@@@
@@@@@@@@@@@@@@@@@@@@@@@@@@@@@@@@@@@@@@.............@@..T..T.@@@@@@@@@@@@@@@@@@@@
@@@@@@@@@@@@@@@@@@@@@@@@@@@@@@@@@@@@@@@.T.............TT..T@@@@@@@@@@@@@@@@@@@@@
@@@@@@@@@@@@@@@@@@@@@@@@@@@@@..T@@@@@@@@..TTTTTT..T.....TT@@@@@@@@@@@@@@@@@@@@@@
@@@@@@@@@@@@@@@@@@@@@@@@@@@@@.T..@@@@@@@@......TT.....T..@@@@@@@@@@@@@@@@@@@@@@@
@@@@@@@@@@@@@@@@@@@@@@@@@@@@@.T.T@@@@@@@@@T........TTTT..@@@@@@...T..@@@@@@@@@@@
@@@@@@@@@@@@@@@@@@@@@@@@@@@@@@@...@@@@@@@@@......T.T....T.@@@@@....T..@@@@@@@@@@
@@@@@@@@@@@@@@@@@@@@@@@@@@@@@@@@...@@..@@@@@TTT...TT.......@@.T.T...T.@@@@@@@@@@
@@@@@@@@@@@@@@@@@@@@@@@@T@@@@@@@@.T...T.@@@@@.......T......@@....TT..@@@@@@@@@@@
@@@@@@@@@@@@@@@@@@@@@@@T..@@@@@@@..T..T...@@@@.......T..T..T...T.T.T@@@@@@@@@@@@
@@@@@@@@@@@@@@@@@@@@@@.T.T.@@@@@T....T..T@@@@@........T.T.T........@@@@@@@@@@@@@
@@@@@@@@@@@@@@@@@@@@@......T@@@TT...TT..@@@@@......T......T.......@@@@@@..T@@@@@
@@@@@@@@@@@@@@@@@@@@..TTT.........TT..T@@@@@..TT..TTT.T..T..TTT..@@@@@@....T.@@@
@@@@@@@@@@@@@@@@@@@....T..T.....TT....@@@@@.T........T.T....TT...@@@@@.TT....@@@
@@@@@@@@@@@@@@@@@@@@....T........TT..@@@@@.T....T..@...T..T.....T.@@@....T...@@@
@@@@@@@@@@@@@@@@@@@@@..........T...T.@@@@..TT...TT@@@..............T.TT....TT@@@
@@@@@@@@@@@@@@@@@@@@@@.T..T...T.T..TT@@@...T..T..@@@@@...TT........T.TT....T@@@@
@@@@@@@@@@@@@@@@@@@@@@@...TTT...T@TT..@..T.T..TT@@@@@@@.....T...@@.T..T....@@@@@
@@@@@@@@@@@@@@@@@@@@@@@@........@@@.....T.....T@@@@@@@@@TT.TTT.@@.T.T.....@@@@@@
@@@@@@@@@@@@@@@@@@@@@@@@@TT..T.@@@@@T..T......@@@@@@@@@@@..TTT@@.T...TT..@@@@@@@
@@@@@@@@@@@@@@@@@@.@@@@@@@....@@@@@@.........@@@@@@.@@@@@@TT.@@......T.T@@@@@@@@
@@@@@@@@@@.@@@@@@@..@@@@@@@.T@@@@@@.T.T.T.T.@@@@@@@.T@@@@@@.@@T.T.T.T..@@@@@@@@@
@@@@@@@@@T..@@@@..TT.@@@@@@@@@@@@@T..T.T.T..@@@.......@@@@@@@.........@@@@@@@@@@
@@@@@@@@TTT...@.....T.@@@@@@@@@@@.....T......@.TTT..@TT@@@@@@...T..TT@@@@@@@@@@@
@@@@@@@TTT..........T..@@@@@@@@@T......T@@......@@@@@.T.@@@@@@T.....@@@@@@@@@@@@
@@@@@@.T.............T.T@@@@@@@.T...T..@@@@....@@@@@@..T.@@@@@@....@@@@@@@@@@@@@
@@@@@T.TT.T@....TT......T@@@@@..T.....@@@@@...T@@@@@@...T.@@@@@@T.@@@@@@@@@@@@@@
@@@@......@@@TTT...T....@@@@@..T..T..@@@@@@T...@@@@@@T....T@@@@@@@@@@@@@@@@@@@@@
@@@TT....@@@@@.TT....T.@@@@@.T.T.TT.@@@@@@@@TT.@@@@@@...TT..@@@@@@@@@@@@@@@@@@@@
@@.T..@@@@@@@@..T.T..T@@@@@....T.TT@@@@@@@@...@@@@@@@T..T....@@@@@@@@@@@@@@@@@@@
@@.T.@@@.@@@@@.......T@@@@@T..T.T.@@@@@@@@...T@@@@@@TTT...T...@@@@@@@@@@@@@@@@@@
@@@T@@@.T.@@@...T......@..T...T..@@@@@@@@...T.@@@@@...TT.TTT.@@@@@@@@@@@@@@@@@@@
@@@@@@..T....T....@@.TT.........@@@@@@@@....T..@......T...TT@@@@@@@@@@@@@@@@@@@@
@@@@@T.......T.T.@@@@T........T@@@@@@@@@@..T....TT.T.......@@@@@@@@@@@@@@@@@@@@@
@@@@@@T.....TT..@@@@@T..T.T...@@@@@@@@@@@@.T....T..TT.T...@@@@@@@@@@@@@@@@@@@@@@
@@@@@@@.TT..T..@@@@@T...TT...@@@@@@@@@@@@@@......T....T.T@@@@@@@@@@@@@@@@@@@@@@@
@@@@@@@@....TT@@@@@T.....T...@@@..@@...@@@@@....T...TTTT@@@@@@@@@@@@@@@@@@@@@@@@
@@@@@@@@@....@@@@@.......TT..@@....TT.T.@@@@@...T.T....@@@@@@@@@@@@@@@@@@@@@@@@@
@@@@@@@@@@..@@@@@.T..T.T...............T@@@@@@T...TTT.@@@@@@@@@@@@@@@@@@@@@@@@@@
@@@@@@@@@@@@@@@@......T.@@...T...@T.....@@@@@@@....T.@@@@@@@@@@@@@@@@@@@@@@@@@@@
@@@@@@@@@@@@@@@T...T...@@@@....@@@@.T....@@@@@@@.TT.@@@@@@@@@@@@@@@@@@@@@@@@@@@@
@@@@@@@@@@@@@@..TT.T..@@@@@...@@@@@@T....T@T@@@@@..@@@@@@@@@@@@@@@@@@@@@@@@@@@@@
@@@@@@@@@@@@@@@.TT.T.@@@@@TT.@@@@@@@@...T....@@@@@@@@@@@@@@@@@@@@@@@@@@@@@@@@@@@
@@@@@@@@@@@@@@@@...T@@@@@.TT.@@@@@@@@T..T.....@@@@@@@@@@@@@@@@@@@@@@@@@@@@@@@@@@
@@@@@@@@@@@@@@@@@.T@@@@@T.T.T@@@@@@@...T....T..@@@@@@@@@@@@@@@@@@@@@@@@@@@@@@@@@
@@@@@@@@@@@@@@@@@@@@@@@TTT..@@@@@@@@.T.T.......@@@@@@@@@@@@@@@@@@@@@@@@@@@@@@@@@
@@@@@@@@@@@@@@@@@@@@@@.....T@@@@@@@...TTTT.T..@@@@@@@@@@@@@@@@@@@@@@@@@@@@@@@@@@
@@@@@@@@@@@@@@@@@@@@@T.T...T@@@@@@.....T.....@@@@@@@@@@@@@@@@@@@@@@@@@@@@@@@@@@@
@@@@@@@@@@@@@@@@@@@@@.T.....@@@@.......T..TT@@@@@@@@@@@@@@@@@@@@@@@@@@@@@@@@@@@@
@@@@@@@@@@@@@@@@@@@@@@...T..T.T........T..T@@@@@@@@@@@@@@@@@@@@@@@@@@@@@@@@@@@@@
@@@@@@@@@@@@@@@@@@@@@@@.T...TT.........T.T@@@@@@@@@@@@@@@@@@@@@@@@@@@@@@@@@@@@@@
@@@@@@@@@@@@@@@@@@@@@@@@...T....T.....T..@@@@@@@@@@@@@@@@@@@@@@@@@@@@@@@@@@@@@@@
@@@@@@@@@@@@@@@@@@@@@@@@@.T..T.TT.T.....@@@@@@@@@@@@@@@@@@@@@@@@@@@@@@@@@@@@@@@@
@@@@@@@@@@@@@@@@@@@@@@@@@@.....T.TT...T@@@@@@@@@@@@@@@@@@@@@@@@@@@@@@@@@@@@@@@@@
@@@@@@@@@@@@@@@@@@@@@@@@@@@...........@@@@@@@@@@@@@@@@@@@@@@@@@@@@@@@@@@@@@@@@@@
@@@@@@@@@@@@@@@@@@@@@@@@@@@@.TT.T....@@@@@@@@@@@@@@@@@@@@@@@@@@@@@@@@@@@@@@@@@@@
@@@@@@@@@@@@@@@@@@@@@@@@@@@@@....T.@@@@@@@@@@@@@@@@@@@@@@@@@@@@@@@@@@@@@@@@@@@@@
@@@@@@@@@@@@@@@@@@@@@@@@@@@@@@.TT@@@@@@@@@@@@@@@@@@@@@@@@@@@@@@@@@@@@@@@@@@@@@@@
@@@@@@@@@@@@@@@@@@@@@@@@@@@@@@@@@@@@@@@@@@@@@@@@@@@@@@@@@@@@@@@@@@@@@@@@@@@@@@@@
@@@@@@@@@@@@@@@@@@@@@@@@@@@@@@@@@@@@@@@@@@@@@@@@@@@@@@@@@@@@@@@@@@@@@@@@@@@@@@@@
@@@@@@@@@@@@@@@@@@@@@@@@@@@@@@@@@@@@@@@@@@@@@@@@@@@@@@@@@@@@@@@@@@@@@@@@@@@@@@@@
@@@@@@@@@@@@@@@@@@@@@@@@@@@@@@@@@@@@@@@@@@@@@@@@@@@@@@@@@@@@@@@@@@@@@@@@@@@@@@@@
@@@@@@@@@@@@@@@@@@@@@@@@@@@@@@@@@@@@@@@@@@@@@@@@@@@@@@@@@@@@@@@@@@@@@@@@@@@@@@@@
