type octile
height 80
width 80
map
@@@@@@@@@@@@@@@@@@@@@@@@@@@@@@@@@@@@@@@@@@@@@@@@@@@@@@@@@@@@@@@@@@@@@@@@@@@@@@@@
@@@@@@@@@@@@@@@@@@@@@@@@@@@@@@@@@@@@@@@@@@@@@@@@@@@@@@@@@@@@@@@@@@@@@@@@@@@@@@@@
@@@@@@@@@@@@@@@@@@@@@@@@@@@@@@@@@@@@@@@@@@@@@@@@@@@@@@@@@@@@@@@@@@@@@@@@@@@@@@@@
@@@@@@@@@@@@@@@@@@@@@@@@@@@@@@@@@@@@@@@@@@@@@@@@@@@@@@@@@@@@@@@@@@@@@@@@@@@@@@@@
@@@@@@@@@@@@@@@@@@@@@@@@@@@@@@@@@@@@@@@@@@@@@@@@@@@@@@@@@@@@@@@@@@@@@@@@@@@@@@@@
@@@@@@@@@@@@@@@@@@@@@@@@@@@@@@@@@@@@@@@@@@@@@@@@@@@@@@@@@@@@@@@@@@@@@@@@@@@@@@@@
@@@@@@@@@@@@@@@@@@@@@@@@@@@@@@@@@@@@@@@@@@@@@@@@@@@@@@@@@@@@@@@@@@@@@@@@@@@@@@@@
@@@@@@@@@@@@@@@@@@@@@@@@@@@@TT@@@@@@@@@@@@@@@@@@@@@@@@@@@@@@@@@@@@@@@@@@@@@@@@@@
@@@@@@@@@@@@@@@@@@@@@@@@@T.T..@@@@@@@@@@@@@@@@@@@@@@@@@@@@@@@@@@@@@@@@@@@@@@@@@@
@@@@@@@@@@@@@@@@@@@@@@@@...T.@@@@@@@@@@@@@@@@@@@@@@@@@@@@@@@@@@@@@@@@@@@@@@@@@@@
@@@@@@@@@@@@@@@@@@@@@@@.T.T..@@@@@@@@@@@@@@@@@@@@@@@@@@@@@@@@@@@@@@@@@@@@@@@@@@@
@@@@@@@@@@@@@@@@@@@@@@@.....T@@@@@@@@@@@@@@@@@@@@@@@@@@@@@@@@@@@@@@@@@@@@@@@@@@@
@@@@@@@@@@@@@@@@@@@@@@T.T....@@@@@@@@@@@@@@@@@@@@@@@@@@@@@@@@@@@@@@@@@@@@@@@@@@@
@@@@@@@@@@@@@@@@@@@@@@.T.....@@@@@@@@@@@@@@@@@@@@@@@@@@@@@@@@@@@@@@@@@@@@@@@@@@@
@@@@@@@@@@@@@@@@@@@@@....T....@@@@@@@@@@@@@@@@@@@@@@@@@@@@@@@@@@@@@@@@@@@@@@@@@@
@@@@@@@@@@@@@@@@@@@@@.....T.T..@@@@@@@@@@@@@@@@@@@@@@@@@@@@@@@@@@@@@@@@@@@@@@@@@
@@@@@@@@@@@@@@@@@@@@...TT....TT.@@@@@@@@@@@@@@@@@@@@@@@@@@@@@@@@@@@@@@@@@@@@@@@@
@@@@@@@@@@@@@@@@@@@@T.@@.........T@.T.@@@@@@@@@@@@@@@@@@@@@@@@@@@@@@@@@@@@@@@@@@
@@@@@@@@@@@@@@@@@@@..T@@.T.T..T....T.T.@@@@@@@@@@@@@@@@@@@@@@@@@@@@@@@@@@@@@@@@@
@@@@@@@@@@@@@@@@@@@...@@.....T....T..T...T..T@@@@@@@@@@@@@@@@@@@@@@@@@@@@@@@@@@@
@@@@@@@@@@@@@@@@@@@..T...T...T.........T..T.T@@@@@@@@@@@@@@@@@@@@@@@@@@@@@@@@@@@
@@@@@@@@@@@@@@@@@@@.......TT....T..T..........@@@@@@@@@@@@@@@@@@@@@@@@@@@@@@@@@@
@@@@@@@@@@@@@@@@@@@....T..................T...@@@@@@@@@@@@@@@@@@@@@@@@@@@@@@@@@@
@@@@@@@@@@@@@@@@@@@........T..T.....T.TT..T..T@@@@@@@@@@@@@@@@@@@@@@@@@@@@@@@@@@
@@@@@@@@@@@@@@@@@@@TT..T..................T.@@@@@@@@@@@@@@@@@@@@@@@@@@@@@@@@@@@@
@@@@@@@@@@@@@@@@@@..T.TT.T..................@@@@@@@@@@@@@@@@@@@@@@@@@@@@@@@@@@@@
@@@@@@@@@@@@@@@@@@..T.......T...T..T......TT@@@@@@@@@@@@@@@@@@@@@@@@@@@@@@@@@@@@
@@@@@@@@@@@@@@@@@@..TT...T...T....TT.TTT.....T@@@@@@@@@@@@@@@@@@@@@@@@@@@@@@@@@@
@@@@@@@@@@@@@@@@@@..T..T.....T......T.TTTTT..@@@@@@@@@@@@@@@@@@@@@@@@@@@@@@@@@@@
@@@@@@@@@@@@@@@@@@.T....T....T..............@@@@@@@@@@@@@@@@@@@@@@@@@@@@@@@@@@@@
@@@@@@@@@@@@@@@@@@..T....TT..T...T.T..T....@@@@@@@@@@@@@@@@@@@@@@@@@@@@@@@@@@@@@
@@@@@@@@@@@@@@@@@@....T..T....T.T........T@@@@@@@@@@@@@@@@@@@@@@@@@@@@@@@@@@@@@@
@@@@@@@@@@@@@@@@@.....T...TTT.....T.T......@@@@@@@@@@@@@@@@@@@@@@@@@@@@@@@@@@@@@
@@@@@@@@@@@@@@@@..T.....T.T....T.............@@@@@@@@@@@@@@@@@@@@@@@@@@@@@@@@@@@
@@@@@@@@@@@@@@@T.......T..T....T....T.T..T....@@@@@@@@@@@@@@@@@@@@@@@@@@@@@@@@@@
@@@@@@@....T....T..TT...T..TTTT.TT....TTT.T.T..@@@@@@@@@@@@@@@@@@@@@@@@@@@@@@@@@
@@@@@@@@.T...T.....T.T......TT.TT.....T...TT..@@@@@@@@@@@@@@@@@@@@@@@@@@@@@@@@@@
@@@@@@@@...T....T..........T...........T....T@@@@@@@@@@@@@@@@@@@@@@@@@@@@@@@@@@@
@@.@@T.T...T......T.............T..T......T.@@@@@@@@@@@@@@@@@@@@@@@@@@@@@@@@@@@@
@@.T......T....T..TT.....TT.T.T......TT.T.T.@@@@@@@@@@@@@@@@@@@@@@@@@@@@@@@@@@@@
@@.TT..T.TT........TTT.T.T..................T@@@@@@@@@@@@@@@@@@@@@@@@@@@@@@@@@@@
@@........T..T..T......T.....T........T.......@@@@@@@@@@@@@@@@@@@@@@@@@@@@@@@@@@
@@T.....TT.T.T.T..TT....T.T..T.T...............@@@@@@@@@@@@@@@@@@@@@@@@@@@@@@@@@
@@.T..TTT........T....TT...T.T...T.TT.T...T......T.@@@@@@@@@@@@@@@@@@@@@@@@@@@@@
@@.T..T....T...T...T.T..TT........TT..T..TT.....T...@@@@@T@@@@@@@@@@@@@@@@@@@@@@
@@..T.T......TT.....TT......TT............T.T..T....T.....@@@..@@@@@@@@@@@@@@@@@
@@T...T....T..TT..T.......T.....T....T.T....T..T..T.TT..TT.....@@@@@@@@@@@@@@@@@
@@T....TT.T..TT....T..TTT..TTT....T..T.....T..TT.T.TTT....T.@T.@@@@@@@@@@@@@@@@@
@@.T..T.......T..T...T..T.T......T...T.T........T.T........@@@.@@@@@@@@@@@@@@@@@
@@.T...T......T.T......T.T.T.......T.TT..TT.T.......T.......@..@@@@@@@@@@@@@@@@@
@@.T.....T.......T.....................T....T.T.....T...T.T...@@@@@@@@@@@@@@@@@@
@@T.T.TT......T.T..T.TT.....T..T..TT...T....T....TT..TTT...T..@@@@@@@@@@@@@@@@@@
@@T.T..TT...T....T...T...T..T......T.....TT......T..T.T..T.TT.@@@@@@@@@@@@@@@@@@
@@...T..T...TT.....T............T..T....T.TTTT...T..........TT@@@@@@@@@@@@@@@@@@
@@.T.......T.....T.TT..T.TT....T...T..T....TTTT...........T....@@@@@@@@@@@@@@@@@
@@..TT..T.T.T.....T.T...T.T.T.T.T.T...TT.TTT..TT..TTT.T..........T.@@@@@@@@@@@@@
@@.T.......T...T..T.TT...T..T.....T....T..T...T......T....TT.......T@@.@@@@@@@@@
@@.T............T.....T...T..T.T.....T..T..T.............T.TT.T....T.TT@@@@@@@@@
@@.......TTTT....TTT.......TT...T...TT.TT...T...T.........T.....T.T..T.@@@@@@@@@
@@...T.T.T.T......T.....T..T.........T.......TT.T...T...T..T...TT..T.T.@@@@@@@@@
@@....T...TT.T....T........TT.......T...T.....T..T..T.....T......TT....T@@@@@@@@
@@..T...........T.T....T..T..TT......T.....TTT.T...T................TTT..@@@@@@@
@@..T..TT..TT....TT......T........T..T.T.....TT...T..T..T.......T.......T..@@@@@
@@........TT.........TT.T.T.TT.....T...T...T.T...T...T.T.T...T.T....T....T..@@@@
@@.T.......T.TT..T..T....T..T.............T........T....TTT.T..T.T..........T.@@
@@.T...T.T.T.T...........TT..T......TTT..T.TTT..T..T........T.....T...TT.T..T.@@
@@T......T......T.T..T...T...............T.....T..T....T.........T.TTT....T..T@@
@@TT...T..T....TTT......T....T........T.....T..T........TT..T..T.....TT.T....T@@
@@..T...T.T........@...T.......TTT.T.T..........T...TTT.T........T...T...T....@@
@@.......T.T..T.@@@@@@....T.......TT.T.T...T.T...T.T......TTTT...T.T..T....T..@@
@@....TT......T.@@@@@@@.T.T......T.....T.T.T..T.......T.....T.T..T.T....TTTT..@@
@@.....TTTT....@@@@@@@@@@.T..TT.T....T..T.TT..TT....T..TTT...T........T...TTT.@@
@@.............@@@@@@@@@@@.....................TT..T.........T...T..T......T.T@@
@@TT.....T..T.@@@@@@@@@@@@@@@@@@@...TT...T.T....T..TTT.T.......T...T..T..T.TT.@@
@@.T.TT.......@@@@@@@@@@@@@@@@@@@@@@@@@...TT......TT...T.TT..TT...T......T..T.@@
@@@@@T...T..T@@@@@@@@@@@@@@@@@@@@@@@@@@@@T..................@@..TT....T.T..T..@@
@@@@@@@@TTTT.@@@@@@@@@@@@@@@@@@@@@@@@@@@@@T..@@..T.......T..@@T....TT....TT.TT@@
@@@@@@@@@...@@@@@@@@@@@@@@@@@@@@@@@@@@@@@@@@@@@@@@@@@...T@@@@@@@@@.......T...T@@
@@@@@@@@@@@@@@@@@@@@@@@@@@@@@@@@@@@@@@@@@@@@@@@@@@@@@@@@@@@@@@@@@@@@@@@@@@@@@@@@
@@@@@@@@@@@@@@@@@@@@@@@@@@@@@@@@@@@@@@@@@@@@@@@@@@@@@@@@@@@@@@@@@@@@@@@@@@@@@@@@
