type octile
height 86
width 92
map
@@@@@@@@@@@@@@@@@@@@@@@@@@@@@@@@@@@@@@@@@@@@@@@@@@@@@@@@@@@@@@@@@@@@@@@@@@@@@@@@@@@@@@@@@@@@
@@@@@@@@@@@@@@@@@@@@@@@@@@@@@@@@@@@@@@@@@@@@@@@@@@@@@@@@@@@@@@@@@@@@@@@@@@@@@@@@@@@@@@@@@@@@
@@@@@@@@@@@@@@@@@@@@@@@@@@@@@@@@@@@@@@@@@@@@@@@@@@@@@@@@@@@@@@@@@@@@@@@@@@@@@@@@@@@@@@@@@@@@
@@@@@@@@@@@@@@@@@@@@@@@@@@@@@@@@@@@@@@@@@@@@@@@@@@@@@@@@@@@@@@@@@@@@@@@@@@@@@@@@@@@@@@@@@@@@
@@@@@@@@@@@@@@@@@@@@@@@@@@@@@@@@@@@@@@@@@@@@@@@@@@@@@@@@@@@@@@@@@@@@@@@@@@@@@@@@@@@@@@@@@@@@
@@@@@@@@@@@@@@@@@@@@@@@@@@@@@@@@@@@@@@@@@@@@@@@@@@@@@@@@@@@@@@@@@@@@@@@@@@@@@@@@@@@@@@@@@@@@
@@@@@@@@@@@@@@@@@@@@@@@@@@@@@@@@@@@@@@@@@@@@@@@@@@@@@@@@@@@@@@@@@@@@@@@@@@@@@@@@@@@@@@@@@@@@
@@@@@@@@@@@@@@@@@@@@@@@@@@@@@@@@@@@@@@@@@@@@@@@@@@@@@@@@@@@@@@@@@@@@@@@@@@@@@@@@@@@@@@@@@@@@
@@@@@@@@@@@@@@@@@@@@@@@@@@@@@@@@@@@@@@@@@@@@@@@@@@@@@@@@@@@@@@@@@@@@@@@@@@@@@@@@@@@@@@@@@@@@
@@@@@@@@@@@@@@@@@@@@@@@@@@@@@@@@@@@@@@@@@@@@@@@@@@@@@@@@@@@@@@@@@@@@@@@@@@@@@@@@@@@@@@@@@@@@
@@@@@@@@@@@@@@@@@@@@@@@@@@@@@@@@@@@@@@@@@@@@@@@@@@@@@@@@@@@@@@@@@@@@@@@@@@@@@@@@@@@@@@@@@@@@
@@@@@@@@@@@@@@@@@@@@@@@@@@@@@@@@@@@@@@@@@@@@@@@@@@@@@@@@@@@@@@@@@@@@@@@@@@@@@@@@@@@@@@@@@@@@
@@@@@@@@@@@@@@@@@@@@@@@@@@@@@@@@@@@@@@@@@@@@@@@@@@@@@@@@@@@@@@@@@@@@@@@@@@@@@@@@@@@@@@@@@@@@
@@@@@@@@@@@@@@@@@@@@@@@@@@@@@@@@@@@@@@@@@@@@@@@@@@@@@@@.@@@@@@@@@@@@@@@@@@@@@@@@@@@@@@.T@@@@
@@@@@@@@@@@@@@@@@@@@@@@@@@@@@@@@@@@@@@@@@@@@@@@@@@@@@@@..@@@@@@@@@@@@@@@@@@@@@@@@@@@@..T@@@@
@@@@@@@@@@@@@@@@@@@@@@@@@@@@@@@@@@@@@@@@@@@@@@@@@@@@@@.T..@@@@@@@@@@@@@@@@@@@@@@@@@@@.T..@@@
@@@@@@@@@@@@@@@@@@@@@@@@@@@@@@@@@@@@@@@@@@@@@@@@@@@@...@@.T@@@@@@@@@@@@@@@@@@@@@@@@@....T.@@
@@@@@@@@@@@@@@@@@@@@@@@@@@@@@@@@@@@@@@@@.@@@@@@@@@@.T..@@...@@@@@@@@@@@@@@@@@@@@@@@.T.T..T@@
@@@@@@@@@@@@@@@@@@@@@@@@@@@@@@@@@@@@@@@T.T@@@@@@@@.T..T..T.@@@@@@@@@@@@@@@@@@@@@@@TT..T..T@@
@@@@@@@@@@@@@@@@@@@@@@@@@@@@@@@@@@@@@@...T..@@@@@T.T......@@@@@@@@@@@@@@@@@@@@@@@TT.....TT@@
@@@@@@@@@@@@@@@@@@@@@@@@@@@@@@@@@@@@@@..TT.T.@@@@@....TTT@@@@@@@@@@@@@@@@@@@@@@@...T.T.T..@@
@@@@@@@@@@@@@@@@@@@@@@@@@@@@@@@@@@@..@@.......@@@@@T...T@@@@@@@@@@@@@@@@@@@@@@@.TT....T.T@@@
@@@@@@@@@@@@@@@@@@@@@@@@@@@@@@@@@@....@@T..T...@@@..TT.@@@@@T@@@@@@@@@@@@@@@@@...TT..TTT@@@@
@@@@@@@@@@@@@@@@@@@@@@@@@@@@@@@@@..T.TT@@TT....T@......@@@@T.@@T@@@@@@@@@@@@@..T...T...@@@@@
@@@@@@@@@@@@@@@@@@@@@@@@@@@@@@@@........@@..T..TT....@@@..T.....T@@@@@@@@@@@.........T@@@@@@
@@@@@@@@@@@@@@@@@@@@@@@@@@@@@@@...TT.....@@......T..@@@@T......T.@@.@@@@@@@T...T...T.@@@@@@@
@@@@@@@@@@@@@@@@@@@@@@@@@@@@@@.T.TT.T.....@@......TT@@...T.....TT@@..@@@@@..........@@@@@@@@
@@@@@@@@@@@@@@@@@@@@@@@@@@@@@...T.TT.T..TT.@@T...T..T............@@T..@@@..T.T.....@@@@@@@@@
@@@@@@@@@@@@@@@@@@@@@@@@@@@@..T..T....T.T...@@.TT..T.T.....T....T@@T@@@@@@.T.T....@@@@@@@@@@
@@@@@@@@@@@@@@@@@@@@@@@@@@@T..T...TT...T..T.T@@T....T....T.T..T.T...@@@@@@@...TT.T@@@@@@@@@@
@@@@@@@@@@@@@@@@@@@@@@@@@@....................@@@..TTTTT.TT..T......@@@.@@@@TTT@@@@@@@@@@@@@
@@@@@@@@@@@@@@@@@@@@@@@@@....T..T.T..T..T.......@......TT.TTT@@.....@@@.T.....@@@@@@@@@@@@@@
@@@@@@@@@@@@@@@@@@@@@@@@.T.....T.......T...T...@@.T..T.T.T.@@@@@.T..T.TT..TT.@@@@@@@@@@@@@@@
@@@@@@@@@@@@@@@@@@@@@@@@T............T........@@..T..T...TT@@@@@@...........@@@@@@@@@@@@@@@@
@@@@@@@@@@@@@@@@@@@T@@@@..TTT.TT.....TTT....TT@T.....T.....TT@@@@@T.T.T.T...@@@@@@@@@@@@@@@@
@@@@@@@@@@@@@@@@@@T..@@@@T...T.........T....@..T..TT..........@@@.T....T.@@@@@@@@@@@@@@@@@@@
@@@@@@@@@@@@@@@@@@.TT.@@@T...TT......T.....@@.T..T....T...T..TT@...T...@@@@@@@@@@@@@@@@@@@@@
@@@@@@@@@@@@@@@@@TT...@@@..TT......T....T.@@..TT.T....TT.....T.......TT@@@@@@@@@@@@@@@@@@@@@
@@@@@@@@@@@@@@@@......@@@@.....T.T...T..T@@.T.........T@...............@@@@@@@@@@@@@@@@@@@@@
@@@@@@@@@@@@@@@@.T..T@@@@@@.....TT.....@@@.........T..@@@@.T.T..T...T...@@@@@@@@@@@@@@@@@@@@
@@@@@@@@@@@@@@@T.T...@@@@@@@..........@@....T......T.@@..@@T..T.T........@@@@@@@@@@@@@@@@@@@
@@@@@@@@@@@@@@@...T.@@@@@@@@@...T..T.@@.......TT..........@@.T...T.....T.@@@@@@@@@@@@@@@@@@@
@@@@@@@@@@@@@@....TT@@@@.@@@@@......@@....TT...TT...T.T...T@@.T..TT......@@@@@@@@@@@@@@@@@@@
@@@@@@@@@@@@@@T..T.@@@@..T@@@@@..T.@@...TTT......@@@TT.....T@@..T...TT..@@@@@@@@@@@@@@@@@@@@
@@@@@@@@@@@@@@@..TT@@@....@@@@@@..@@T...T...T.TT@@@@......T..@@..T.....@@@@@@@@@@@@@@@@@@@@@
@@@@@@@@@@@@@@@T..@@..T..@@@@@@@@@@..T.....T...@@......T.T.T..@@......@@@@@@@@@@@@@@@@@@@@@@
@@@@@@@@@@@@@@....@@...T@@@@@@@@@@.T...T....TT@@.T....T.......T@@...T@@@@@@@@@@@@@@@@@@@@@@@
@@@@@@@@@@@@....T.@..@@@@@@@@@@@@T......TTT.T@@.T...T..T.....T..@@T.@@@@@@@@@@@@@@@@@@@@@@@@
@@@@@@@@@@TT........@@@@@@@@@@@@@........T.T@@.T..TT.T.T......T..@@@@@@@@@@@@@@@@@@@@@@@@@@@
@@@@@@@@@@@.TTTT...T@@@@@@@@@@@@.T....T..T.T@.........T.T...T...TT@@@@@@@@@@@@@@@@@@@@@@@@@@
@@@@@@@@@@@@T.T.....T@@@@@@@@@@.T.T.......T......T.T....T.T.T....@@@@@@@@@@@@@@@@@@@@@@@@@@@
@@@@@@@@@@@@.T...TT..@@@@@@@@@TT.T................T..TTT.T......@@@@@@@@@@@@@@@@@@@@@@@@@@@@
@@@@@@@@@@@T.T..T....@@@@@@@.T.......@@@@...........T..........@@@@@@@@@@@@@@@@@@@@@@@@@@@@@
@@@@@@@@@@T...........T@@@@@..T...T..@@@@@.........T...TT.TT..@@@@@@@@@@@@@@@@@@@@@@@@@@@@@@
@@@@@@@@@TT..T.T.T......@@@.T.T..T...@@@@@@T.................@@@@@@@@@@@@@@@@@@@@@@@@@@@@@@@
@@@@@@@@T..T...T.TTT............T.T.@@@@@@@@........T....T..@@@@@@@@@@@@@@@@@@@@@@@@@@@@@@@@
@@@@@@@@@....TTT.....T....TT.T.T....@@@@@@@@@TTTTTT..T..T.T@@@@@@@@@@@@@@@@@@@@@@@@@@@@@@@@@
@@@@@@@@@@.T.T..T..T....T.....T.T.....@@@@@@@@...T..TT...T@@@@@@@@@@@@@@@@@@@@@@@@@@@@@@@@@@
@@@@@@@@@@@.T.T..........TT....T.T.T...@@@@@@@@T.T....T.T@@@@@@@@@@@@@@@@@@@@@@@@@@@@@@@@@@@
@@@@@@@@@@@@T.....TT.T.....T....TT....T@@@@@@@@@T..T.T..@@@@@@@@@@@@@@@@@@@@@@@@@@@@@@@@@@@@
@@@@@@@@@@@@@.T...T........T...T.T..T..@@@@@@@@@@...T.@@@@@@@@@@@@@@@@@@@@@@@@@@@@@@@@@@@@@@
@@@@@@@@@@@@@@.TT.T.....T..T........TT.@@@@@@@@@@@@@@@@@@@@@@@@@@@@@@@@@@@@@@@@@@@@@@@@@@@@@
@@@@@@@@@@@@@@@T..T..T....T.......T..@@@@@@@@@@@@@@@@@@@@@@@@@@@@@@@@@@@@@@@@@@@@@@@@@@@@@@@
@@@@@@@@@@@@@@@@..T.....TT..T....T.@@@@@@@@@@@@@@@@@@@@@@@@@@@@@@@@@@@@@@@@@@@@@@@@@@@@@@@@@
@@@@@@@@@@@@@@@@@..TT.T......@@@..T.@@@@@@@@@@@@@@@@@@@@@@@@@@@@@@@@@@@@@@@@@@@@@@@@@@@@@@@@
@@@@@@@@@@@@@@@@@@....TTT...T@@@.@@TT@@@@@@@@@@@@@@@@@@@@@@@@@@@@@@@@@@@@@@@@@@@@@@@@@@@@@@@
@@@@@@@@@@@@@@@@@@@..T...T.T.@@@@@@TT@@@@@T@@@@@@@@@@@@@@@@@@@@@@@@@@@@@@@@@@@@@@@@@@@@@@@@@
@@@@@@@@@@@@@@@@@@@@..TT@@@.T@@@@@@.T@@@T.T..@@@@@@@@@@@@@@@@@@@@@@@@@@@@@@@@@@@@@@@@@@@@@@@
@@@@@@@@@@@@@@@@@@@@@...@@@@.@@@@@T.T@@@.T..T@@@@@@@@@@@@@@@@@@@@@@@@@@@@@@@@@@@@@@@@@@@@@@@
@@@@@@@@@@@@@@@@@@@@@@.@@@@@@@@@@@@..T.TT..T@@@@@@@@@@@@@@@@@@@@@@@@@@@@@@@@@@@@@@@@@@@@@@@@
@@@@@@@@@@@@@@@@@@@@@@@@@@@@@.@@@@@....TT..@@@@@@@@@@@@@@@@@@@@@@@@@@@@@@@@@@@@@@@@@@@@@@@@@
@@@@@@@@@@@@@@@@@@@@@@@@@@@@@.TT...T...T..@@@@@@@@@@@@@@@@@@@@@@@@@@@@@@@@@@@@@@@@@@@@@@@@@@
@@@@@@@@@@@@@@@@@@@@@@@@@@@@T..T.TTT...T.@@@@@@@@@@@@@@@@@@@@@@@@@@@@@@@@@@@@@@@@@@@@@@@@@@@
@@@@@@@@@@@@@@@@@@@@@@@@@@T.T....T.TT...@@@@@@@@@@@@@@@@@@@@@@@@@@@@@@@@@@@@@@@@@@@@@@@@@@@@
@@@@@@@@@@@@@@@@@@@@@@@@@@@.TT....T....@@@@@@@@@@@@@@@@@@@@@@@@@@@@@@@@@@@@@@@@@@@@@@@@@@@@@
@@@@@@@@@@@@@@@@@@@@@@@@@@@@T......TT.@@@@@@@@@@@@@@@@@@@@@@@@@@@@@@@@@@@@@@@@@@@@@@@@@@@@@@
@@@@@@@@@@@@@@@@@@@@@@@@@@@@@.......T@@@@@@@@@@@@@@@@@@@@@@@@@@@@@@@@@@@@@@@@@@@@@@@@@@@@@@@
@@@@@@@@@@@@@@@@@@@@@@@@@@@@@@TTTT..@@@@@@@@@@@@@@@@@@@@@@@@@@@@@@@@@@@@@@@@@@@@@@@@@@@@@@@@
@@@@@@@@@@@@@@@@@@@@@@@@@@@@@@@@..@@@@@@@@@@@@@@@@@@@@@@@@@@@@@@@@@@@@@@@@@@@@@@@@@@@@@@@@@@
@@@@@@@@@@@@@@@@@@@@@@@@@@@@@@@@@@@@@@@@@@@@@@@@@@@@@@@@@@@@@@@@@@@@@@@@@@@@@@@@@@@@@@@@@@@@
@@@@@@@@@@@@@@@@@@@@@@@@@@@@@@@@@@@@@@@@@@@@@@@@@@@@@@@@@@@@@@@@@@@@@@@@@@@@@@@@@@@@@@@@@@@@
@@@@@@@@@@@@@@@@@@@@@@@@@@@@@@@@@@@@@@@@@@@@@@@@@@@@@@@@@@@@@@@@@@@@@@@@@@@@@@@@@@@@@@@@@@@@
@@@@@@@@@@@@@@@@@@@@@@@@@@@@@@@@@@@@@@@@@@@@@@@@@@@@@@@@@@@@@@@@@@@@@@@@@@@@@@@@@@@@@@@@@@@@
@@@@@@@@@@@@@@@@@@@@@@@@@@@@@@@@@@@@@@@@@@@@@@@@@@@@@@@@@@@@@@@@@@@@@@@@@@@@@@@@@@@@@@@@@@@@
@@@@@@@@@@@@@@@@@@@@@@@@@@@@@@@@@@@@@@@@@@@@@@@@@@@@@@@@@@@@@@@@@@@@@@@@@@@@@@@@@@@@@@@@@@@@
@@@@@@@@@@@@@@@@@@@@@@@@@@@@@@@@@@@@@@@@@@@@@@@@@@@@@@@@@@@@@@@@@@@@@@@@@@@@@@@@@@@@@@@@@@@@
