type octile
height 80
width 80
map
@@@@@@@@@@@@@@@@@@@@@@@@@@@@@@@@@@@@@@@@@@@@@@@@@@@@@@@@@@@@@@@@@@@@@@@@@@@@@@@@
@@@@@@@@@@@@@@@@@@@@@@@@@@@@@@@@@@@@@@@@@@@@@@@@@@@@@@@@@@@@@@@@@@@@@@@@@@@@@@@@
@@..T...T..T.TT.....T.T....TT....TT..T........TTT..T...T.T...T..T...T.TT.T...T@@
@@T...T................T...TT..TTT.........T..T......TT.........T.T...T....T.T@@
@@......TT.....T.T..TTT..T..TT.T....T.T..T..TT.TT.T..T.T.T.T.T..T.T.T...T.T...@@
@@..TT.T.......TT.T....T..TT....T......T.T.....T..TT......TT..T.T...T..TTT..TT@@
@@......T............T...T......T..TTTT...TT........T.......T.T....T.....T.T..@@
@@.T....T.T....TT..........T...T...T.....T.T..T.T..T.....T.......T...TT..T.T..@@
@@......T.......TTT......TT.T...T.....T..TTT........T...T.TT.TT...T.T.T...T.TT@@
@@T...TTT....TT......TT.........T.....TTT.T..T.......T.T....T...T......T......@@
@@T.....T..TT...........TT...T.T.......T....T....TT.T....T...T.....TT.....T.T.@@
@@T...T.T.T.TT.....T..TT.T..........T....@@@.T..T...T.............T...T.....TT@@
@@...TT.T..T....T.T.............T.T...T.@@@@@...T..T.TT...TT.......T......T..T@@
@@...........TT.TT...............T....T.@@@@@...T.....T...T......T..TTT..T.T..@@
@@.....T.T..T....T.......TTT..........T..@@@.......T.@@@@..T...T..T..T..T..TT.@@
@@..T.T....T....T.TT..T..T....TT..T..T.T...T....T.T..@@@@.........T.....TT...T@@
@@TTT....T.....T..T...T.T.T....T...TTTT...T........TTT@@.T..........T..TTT....@@
@@....TTT...T.T.T.......T.........@@@@@.....T..T...T.TT...T....T............TT@@
@@T.....TT.T....T.........T...T.T.@@@@@......T........T.....TT....@@@@@T......@@
@@...TT....TTT.T.TT....T..T..T...T.@@@......TT..TTT.TT.T.T..TTTT..@@@@@.T....T@@
@@..T..TTT.....TT..T...T................T.T.T.T...TTT.......T.....T@@@.....T.T@@
@@.........TT....T.....T..T..T....T.T.T........T..T...............TTT..T.T....@@
@@T......T...........TTT..T......T...............TT.TT..T.............T......T@@
@@.T.TT.T..T..T..T.....TT.T.T..T....T.T.T....T................T....TT....T....@@
@@TT........T....TT....TTT.....T......T...TT.......T....T..TT...T.....T....T.T@@
@@T.................T.T..T.T.......TT....T...T..T.T.T.....TTT...T..T...T......@@
@@T......T.....TT........T...T..........T.T..T....TT....T.......T......T.TT...@@
@@....T.........TTT.T.TT..........T.........T..TT..T................T.....T...@@
@@T...T..TT..T....TT....T...T...T.....T......T...T...........TT.....T........T@@
@@....T..T....T.TT...T...TTT.......T..........TT.......T...T....T.......T.TT..@@
@@.TTT......T..T.TT.......T..T..T.T..T.TT......TTT...T.....T...T..T.T....T..@@@@
@@....T.T.T..TTT..T.T.....T.....T.T....T.T..T.T.T......T.T.T.TT.T.........TT@@@@
@@TT.T.T.........T..T....TTT.....T..TT....T....TT............T....TT......T.@@@@
@@.T..T....TT....TT.T.T.....T.T.....T.T....T...T..TT.T....T.........T.......T.@@
@@..T....T.T..T.......TT..T........TT..T......T..T....T.......TT............T.@@
@@T..T.T.....T...T..T...T.T...T.....T..TTT......T.T......T..T.....T...TT....T.@@
@@T......T......TTT.............T.T..T......T.....TT....T....T.T.T.T..........@@
@@..TTT...TTT..T..T.TT.....T.........T........TTTTT....T...T.TTT.T.T..T..T..T.@@
@@.....T..TTT.T..T.T.T.......TT...T....TTT.....T.TT......T......T..........TT.@@
@@.TT.....TT.T...T........T........TT....T.TTT...T.TTT.T...T.TT...T..TT.TT....@@
@@..........T.....TT......T..TT..T...T....TTTT.....TT.............TTTT..T..T.T@@
@@...TT..T..T...T.T..T..T..TT....TTT..T.T..T..T.....T..................TT.T...@@
@@T.T......T....T......T.........T...........T...T.T..T...................T...@@
@@......T.T.T........T....T.T.....T...T.T..TTT......T........T..T......T.T....@@
@@..........T.......TT...T..T.......T...T.TTT....T..TT@@@@.T..TTTTT....T.T...T@@
@@...T.TT............TTT...T.TTTTT..TTTTTT...T..T.T.@@@@@@@.T........T....T...@@
@@.....T.T...T.....................TT..........T...@@@@@@@@@.T...T............@@
@@.........T.TT......T.T....T...TT.T.T....T........@@@@@@@@@.........T........@@
@@T..T......@@T.....T..TT....T...T.....T....T....T...@@@@@@TTT....T.T.....T...@@
@@T.T....TT@@@@.......T......TT...........T.T..T......T...T..T...T..T......T..@@
@@.T...TT..@@@@..T.TTTT.T.........TT.T.T..TT...T..TT..T.....T...T..T.....T..T.@@
@@.T........@@T.....T.......TT..........T.TTT..T.T.T..TT...TT..TT.....T....TTT@@
@@........T.....TT.T............T..TT......T.T.......TTT..TTTT..T......T..T..T@@
@@..T...T.T...TTT...T..T.....T..T..................T..T..T..T.......TT.....T.T@@
@@.....T.....T.........TTT.T..T.TT.........TT..T.T....T....T.T.TT.TT...T.....T@@
@@.@@@T.T...TT.T.T......TT......T.TT.T.....T....T.T....T..T...........T...T...@@
@@.@@@...TT.T.T......T...........T..T.T..T...TTT.............T..........T.....@@
@@.@@@.....TT......T...T.T.............T.T....T..T...T................T.......@@
@@.@@@...T..T...TT.....T.T..T...T...TT..T....TTTT....T....T.T.T...........T.T.@@
@@...TTT..T..TT.T.T..T.T..TT............T......T..T.....TTTT.T..T......TTT....@@
@@..T.....TTT.....TT....TT.T..T.T......T...TT...TT..T..T.TT.T....TT...T..TTT.T@@
@@.T.......TTT...TTTT....T..TTT.T...T...T......T..........TT...T.......TT.T...@@
@@..T...TT.....TT.T....T..T....T.T.T...TTT....T....T..TTT.........TT..........@@
@@....T..TT....T................TT............T....T.T.....T.....T....T.....T.@@
@@..T..T.....T.....TTT...T...T...TT..TT.T......T.....TT..........T...TT..TTT..@@
@@.T.....T.......TTT.....TT.....T....T..T.....T..T.....TT..TTT...T..T.T.T..T..@@
@@...T.....T...T...T...T.....T..T.....T....T......T..T.....T..T..............T@@
@@......T..T...T....T.TT..........TT.....T..T..T....T..T..........TT..........@@
@@.....T.....T...TT........T..T.T.T.T.......T.TTT.T...T..T.T.T..............T.@@
@@T..T.T.T..T........T.......TT.TT....T...T...T....T.TTT.....T.....T.TT.TT...T@@
@@....T..TT...T........TT..T...T....TTT......T..T......T.....TT.TT.T...T.T.T..@@
@@....T....T....T.T.......T...T...TT........T.........T...TT...TT.T....T....TT@@
@@......T....T........TT.T...T.T.....T..TT........T......T....T...........T...@@
@@.T.......T..T..TT.T....T.T..............T......T.T.T..T..T.................T@@
@@..T...TT...T.TT.T.T.TT..TT.......T..T.T......TT.....TT..T...TT...T.......T..@@
@@..T...T..T.......T...T...T..T....T....T..T...................T.........T.T..@@
@@.T..........TT.T.T@@@T........T....T...T.....T.T...T...T...T...T.T..T.T.TTT.@@
@@...T......@@@@@@@@@@@@@@@@@@.............T.TTTT.T...............T....T.T....@@
@@@@@@@@@@@@@@@@@@@@@@@@@@@@@@@@@@@@@@@@@@@@@@@@@@@@@@@@@@@@@@@@@@@@@@@@@@@@@@@@
@@@@@@@@@@@@@@@@@@@@@@@@@@@@@@@@@@@@@@@@@@@@@@@@@@@@@@@@@@@@@@@@@@@@@@@@@@@@@@@@
