type octile
height 59
width 56
map
@@@@@@@@@@@@@@@@@@@@@@@@@@@@@@@@@@@@@@@@@@@@@@@@@@@@@@@@
@@@@@@@@@@@@@@@@@@@@@@@@@@@@@@@@@@@@@@@@@@@@@@@@@@@@@@@@
@@@@@@@@@@@@@@@@@@@@@@@@@@@@@@@@@@@@@@@@@@@@@@@@@@@@@@@@
@@@@@@@@@@@@@@@@@@@@@@@@@@@@@@@@@@@@@@@@@@@@@@@@@@@@@@@@
@@@@@@@@@@@@@@@@@@@@@@@@@@@@@@@@@@@@@@@@@@@@@@@@@@@@@@@@
@@@@@@@@@@@@@@@@@@@@@@@@@@@@@@@@@@@@@@@@@@@@@@@@@@@@@@@@
@@@@@@@@@@@@@@@@@@@@@@@@@@@@@@@@@@@@@@@@@@@@@@@@@@@@@@@@
@@@@@@@@@@@@@@@@@@@@@@@@@@@@@@@@@@@@@@@@@@@@@@@@@@@@@@@@
@@@@@@@@@@@@@@@@@@@@@@@@@@@@@@@@@@@@@@@@@@@@@@@@@@@@@@@@
@@@@@@@@@@@@@@@@@@@@@@@@@@@@@@@@@@@@@@@@@@@@@@@@@@@@@@@@
@@@@@@@@@@@@@@@@@@@@@@@@@@@@@@@@@@@@@@@@@@@@@@@@@@@@@@@@
@@@@@@@@@@@@@@@@@@@@@@@@@@@@@@@@@@@@@@@@@@@@@@@@@@@@@@@@
@@@@@@@@@@@@@@@@@@@@@@@...T...T...@@@@@@@@@@@@@@@@@@@@@@
@@@@@@@@@@@@@@@@@@@@.................@@@@@@@@@@@@@@@@@@@
@@@@@@@@@@@@@@@@@.....@@@@@@@.TTT......@@@@@@@@@@@@@@@@@
@@@@@@@@@@@@@@@@@....@@@@@@@@@.T..T....@@@@@@@@@@@@@@@@@
@@@@@@@@@@@@@@@@@.T..@@@@@@@@@@..T..T.@@@@@@@@@@@@@@@@@@
@@@@@@@@@@@@@@@@.TTT@@@@@@@@...........@@@@@@@@@@@@@@@@@
@@@@@@@@@@@@@@@@@.T.@@@@@......T....TT...@@@@@@@@@@@@@@@
@@@@@@@@@@@@@@@@@@T.@@@.T...T....T....T...@@@@@@@@@@@@@@
@@@@@@@@@@@@@@@@@@.T.T@@@......TT.........@@@@@@@@@@@@@@
@@@@@@@@@@@@@TT@@....T.....................@@@@@@@@@@@@@
@@@@@@@@@@@..TT.T..T..T......T...T...TTT...@@@@@@@@@@@@@
@@@@@@@@@@..T....T..........TT.....T.......T@@@@@@@@@@@@
@@@@@@@@@TT.....T..T......T........T...T..T.TTT@@@@@@@@@
@@@@@@@@@T......T...TTT.T...T..T..TT..TT.....T.@@@@@@@@@
@@@@@@@@@.T.T..............@@@@@@@@@...T.......@@@@@@@@@
@@@@@@@@@...T...T.TT.T...@@@@@@@@@@@@.T........@@@@@@@@@
@@@@@@@@@@.........T..@@@@@@@@@@@@@@@@.........@@@@@@@@@
@@@@@@@@@@@@....T.T@@@@@@@@@@@@@@@@@@@..TTTT..T..T@@@@@@
@@@@@@@@@@@@@...T.@@@@@@@@@@@@@@@@@@@@..TT..T.....@@@@@@
@@@@@@@@@@@@@T.T..@@@@@@@@@@@@@@@@@@@@@TT..@@@....@@@@@@
@@@@@@@@@@@@@T....@@@@@@@@@@@@@@@@@@@@@T...@@@@@T.@@@@@@
@@@@@@@@@@.T@@...T@@@@@@@@@@@@@@@@@@@@@@..@@@@@@@.@@@@@@
@@@@@@@@@....@..T@@@@@@@@@@@@@@@@@@@@@@@.T@@@@@..T@@@@@@
@@@@@@@@@T.....T.@@@@@@@@@@@@@@@@@@@@@@@T..TT@@...@@@@@@
@@@.....T.......T@@@@@@@@@@@@@@@@@@@@@@@.........T.@@@@@
@@@T..T..T.TTTT..@@@@@@@@@@@@@@@@@@@@@@@......TT..T.@@@@
@@@...T...........@@@@@@@@@@@@@@@@@@@@..T......@@@.TT.T@
@@@T...T.T....T...T@@@@@@@@@@@@@@@@@@@.........@@@T.T..@
@@@....@@....T....T.@@@@@@@@@@@@@@@@@......T.T.@@@.....@
@@@@...@@T...T.....T.@@@@@@@@@@@@@@@@@.....T..T.....T..@
@@@@..T...............@@@@@@@@@@@@@@@@....T....T...T...@
@@@@......T....T..T..T.@@@@@@@@@@@@@@@........TTTTT.TTT@
@@@@....T....T......T.T...@@@@@@@@@@@..T.T.T.....TTT...@
@@@@.....T.....T......T.T...@@@@@@@@......T....T.T.TTT.@
@@@@..T..T.T..TT.....T..TT.T.TT.T..T..T.......T......T.@
@@@@@..TT..TT.....T..TT....TT.TT.T...T.....T..T.T......@
@@@@@.TTT.T..T....T.T.T.......T.T...T..T...............@
@@@@@@...T..T.......T...T.TT......TT............T.T....@
@@@@@@@...........T....T...T......T@@....T........TTT..@
@@@@@@@@......T.T..@@T...T..T...T.T@@.......TT.T.......@
@@@@@@@@@..TT...TT.@@...TTT.....TT.T......T.T.TTT.T..T.@
@@@@@@@@@@......TT.T..TTT...T...........TT.......TT...@@
@@@@@@@@@@@.TT...........T...T......T..T....T....T...@@@
@@@@@@@@@@@@.T.......T...TTT.....T.........TTT....@@@@@@
@@@@@@@@@@@@@T...T..............T..T.T......T.TT.@@@@@@@
@@@@@@@@@@@@@@@........T.T..T.T....T...T....TT.@@@@@@@@@
@@@@@@@@@@@@@@@@@@@@@@@@@@@@@@@@@@@@@@@@@@@@@@@@@@@@@@@@
