type octile
height 86
width 100
map
@@@@@@@@@@@@@@@@@@@@@@@@@@@@@@@@@@@@@@@@@@@@@@@@@@@@@@@@@@@@@@@@@@@@@@@@@@@@@@@@@@@@@@@@@@@@@@@@@@@@
@@@@@@@@@@@@@@@@@@@@@@@@@@@@@@@@@@@@@@@@@@@@@@@@@@@@@@@@@@@@@@@@@@@@@@@@@@@@@@@@@@@@@@@@@@@@@@@@@@@@
@@@@@@@@@@@@@@@@@@@@@@@@@@@@@@@@@@@@@@@@@@@@@@@@@@@@@@@@@@@@@@@@@@@@@@@@@@@@@@@@@@@@@@@@@@@@@@@@@@@@
@@@@@@@@@@@@@@@@@@@@@@@@@@@@@@@@@@@@@@@@@@@@@@@@@@@@@@@@@@@@@@@@@@@@@@@@@@@@@@@@@@@@@@@@@@@@@@@@@@@@
@@@@@@@@@@@@@@@@@@@@@@@@@@@@@@@@@@@@@@@@@@@@@@@@@@@@@@@@@@@@@@@@@@@@@@@@@@@@@@@@@@@@@@@@@@@@@@@@@@@@
@@@@@@@@@@@@@@@@@@@@@@@@@@@@@@@@@@@@@@@@@@@@@@@@@@@@@@@@@@@@@@@@@@@@@@@@@@@@@@@@@@@@@@@@@@@@@@@@@@@@
@@@@@@@@@@@@@@@@@@@@@@@@@@@@@@@@@@@@@@@@@@@@@@@@@@@@@@@@@@@@@@@@@@@@@@@@@@@@@@@@@@@@@@@@@@@@@@@@@@@@
@@@@@@@@@@@@@@@@@@@@@@@@@@@@@@@@@@@@@@@@@@@@@@@@@@@@@@@@@@@@@@@@@@@@@@@@@@@@@@@@@@@@@@@@@@@@@@@@@@@@
@@@@@@@@@@@@@@@@@@@@@@@@@@@@@@@@@@@@@@@@@@@@@@@@TT.@@@@@@@@@@@@@@@@@@@@@@@@@@@@@@@@@@@@@@@@@@@@@@@@@
@@@@@@@@@@@@@@@@@@@@@@@@@@@@@@@@@@@@@@@@@@@@@@@@...@....@@@@@@@@@@@@@@@@@@@@...T.@@@@@@@@@@@@@@@@@@@
@@@@@@@@@@@@@@@@@@@@@@@@@@@@@@@@@@@@@@@@@@@@@@@@...@....TT@@@@@@@@@@@@@@@@@.......@@@@@@@@@@@@@@@@@@
@@@@@@@@@@@@@@@@@@@@@@@@@@@@@@@@@@@@@@@..@@@@@@@...@@@@@..@@@@@@@@@@@@@@@@....T.TT@@@@@@@@@@@@@@@@@@
@@@@@@@@@@@@@@@@@@@@@@@@@@@@@@@@@@@@@..T@@@@@@@@T..@@@@@.....@@@@@@@@@@@@..@@..T.@@@@@@@@@@@@@@@@@@@
@@@@@@@@@@@@@@@@@@@@@@@@@@@@@@@@@@@@....@@@@@@@@T..@.....T...@@@@@@@@@@@T.T@@@....@@@@@@@@@@@@@@@@@@
@@@@@@@@@@@@@@@@@@@@@@@@@@@@@@@T.T..........T...TT.@@..T.....@@@@@@@@@@.T@..@@@....@@@@@@@@@@@@@@@@@
@@@@@@@@@@@@@@@@@@@@@@@@@@@@@@@T......T.........TTT.@@@@.....T@@@@@@@@@..@@..@@@....@@@.@@@@@@@@@@@@
@@@@@@@@@@@@@@@@@@@@@@@@@@@@@@@.........T..@@@@@...TT.......T.T@@@@@@@@@..@@..............@@@@@@@@@@
@@@@@@@@@@@@@@@@@@@@@@@@@@@@@@@..........TT@@@@@..T.......T.....@@@@@@@@@..@@@...@@T..T...@@@@@@@@@@
@@@@@@@@@@@@@@@@@@@@@@@@@@@@@@@...T..T..T.T@@@@@..T.........T....@@@@@@@@@..TTT.T@@@...T.T@@@@@@@@@@
@@@@@@@@@@@@@@@@@@@@@@@@@@@@@@@.....T.@@@@@@@@@@...T.......TT@T...@@@@@@@@@@...@T.@@@....@@@@@@@@@@@
@@@@@@@@@@@@@@@@@@@@@@@@@@@@@@@...T@@@@@@@@@@@@@....T........@@..T.@@@@@@@.T...@@..@@T..@@@@@@@@@@@@
@@@@@@@@@@@@@@@@@@@@@@@@@@@@@@@@@@@@@@@@@@@@@@@@T......TTT.T.@@@...T@@@@@@......@@.....@@@@@@@@@@@@@
@@@@@@@@@@@@@@@@@@@@@@@@@@@@@@@@@@@@@@@@@@@@@@@@@@@@@@@@@@@@@@@@@T.T.@@@@@T.T..T.@@...@@@@@@@@@@@@@@
@@@@@@@@@@@@@@@@@@@@@@@@@@@@@@@@@@@@@@@@@@@@@@@@@@@@@@@@@@@@@@@@@@....@@@@T..@.......@@@@@@@@@@@@@@@
@@@@@@@@@@@@.@@.@@@@@@@@@@@@@@@@@@@@@@@@@@@@@@@@@@@@@@@@@@@@@@@@@@@....@@T..@@@T...@@@@@@@@@@@@@@@@@
@@@@@..@@@@..T.T...@@@@@@@@@@@@@@@@@@@@@@@@@@@@@@@@@@@@@@@@@@@@@@@@@.T.T..T@@@@@@T@@@@@@@@@@@@@@@@@@
@@@@@.........T..T...@@@@@@@@@@@@@@@@@@@@@@@@@@@@@@@@@@@@@@@@@@@@@@@@......@@@@@@@@@@@@@@@@@@@@@@@@@
@@@@T.......T..@@....T@@@@@@@@@@@@@@@@@@@@@@@@@@@@@@@@@@@@@@@@@@@@@@@@T....@@@@@@@@@@@@@@@@@.@@@@@@@
@@@@..T.@@@.T..@@@T...@@@@@@@@@@@@@@@@@@@@@@@@@@@@@@@@@@@@@@@@@@@@@@@@@T....@@@@@@@@@@@@@@...T@@@@@@
@@@.T........T@@@@...@@@@@@@@@@@@@@@@@@@@@@@@@@@@@@@@@@@@@@@@@@@@@@@@@@@...T.@@@@@@@@@@@T....@@@@@@@
@@@........T..@@@..T.@@@@@@@@@@@@@@@@@@@@...T.@@@@@@@@@.@@@@@@@@@@@@@@@@@..TT.@@@@@@@@.....@@@@@@@@@
@@...........@@@@....@@@@@@@@@@@@@@@@@@....T....@@@@@@@..@@@@@@@@@@@@@@@@@T....@@@@@TTT.T@@@@@@@@@@@
@@@TT..T.TT..@@@@...@@@@@@@@@@@@@@@@@....TT.......T@@@@@...@@@@@@@@@@@@@@@@.....@@@T..T@@@@@@@@@@@@@
@@@@@.....T...@@TTTT@@@@@@@@@@@@@@@.T.@@@......T...@@@@@....@@@@@@@@@@@@@@@@..........@@@@@@@@@@@@@@
@@@@@@@@T.....T....@@@@@@@@@@@@@@@.T..@@@@@@@.T...T@@@@@TT...@@@@@@@@@@@@@@@@..T...T@@@@@@@@@@@@@@@@
@@@@@@@@...@@@@@.TT@@@@@@@@@@@@@@T....T...@@@@T.T.@@@@@@T.TTT.@@@@@@@@@@@@@@@@@..TTT@@@@@@@@@@@@@@@@
@@@@@@@@..@@@@@@@@@@@@@@@@@@@@@@@T....T......@@@T.@@@@@T...T..T@@@@@@@@@@@@@@@@..TT.@@@@@@@@@@@@@@@@
@@@@@@..T.@@@@@@@@@@@@@@@@@@@@@@@@..@@....T....@..@@@@@....T....@@@@@@@@@@@@@@@T.T..@@@@@@@@@@@@@@@@
@@@@@@....@@@@@@@@@@@@@@@@@@@@@@@@T.@@@@@.TT.T...@@@@@.T..TTT...T@@T@@@@@@@@@@@...T.@@@@@@@@@@@@@@@@
@@@@@@..TT.@@@@@@@@@@@@@@@@@@@@@@.....@@@@@@.....@@@@@T.@@@@@...T...@@@@@@@@@@@...T@@@@@@@@@@@@@..@@
@@@@@@TT.T.@@@@@@@@@@@@@@@@@@@@@@..@@.T.T@@@@@T.@@.T.T.@@@@@@@..@@...@@@@@@@@@@T...@@@@@@@@@@@@.TTT@
@@@@@@.T...@@@@@@@@@@@@@@@@@@@@@T..@@@@@..T.@@.T@....T....@@...@@@@..@@@@@@@@@@@@TT@@@@@@@@@@@@T.T.@
@@@@@@.T...@@@@@@@@@@@@@@@@@@@.TT...@@@@@@@..T.@@.T.TT.T......@@@@@.T.@@@@@@@@@...T.@@@@@@@@@@@..T.@
@@@@@@....T@@@@@@@@@@@@@@@@@@.......T..@@@@...T@@..T...T.T.T.@@@@@@...@@@@@@@@@TTT..@@@@@@@@@@...T.@
@@@@@@....T@@@@@@@@@@@@@@@@@@..........T.T.....T...T.....T..T.@@@@@...@@@@@@@@@@@@......@@@@TT.T...@
@@@@@@.T.T.@@@@@@@@@@@@@@@@@@.T.@@@T.T..............T.........@@@@..TT@@@@@@@@@@@@.....T@@@@.T....T@
@@@@@@....T@@@@@@@@@@@@@@@@@@T..@@@@@@T...........T.@@@@@@@.....T.TT..@@@@@@@@@@@@....T.@@@@T..TT..@
@@@@@@.T....@@@@@@@@@@@@@@@@@...@@..@@@@@TT..@....@@@@@@@@@@.....@..TT@@@@@@@@@@@@...T.T@@@@..TT..T@
@@@@@@......@@@@@@@@@@@@@@@@@T.....T..@@@@@.@@..T@@@@@@@@@@@@..@@@@@@.@@@@@@@@@@@@...T......T.T.T.T@
@@@@@@T.....@@@@@@@@@@@@@@@@@.T..T.....T@@..@.T.T@..@@@@@..@@@@@@@@@..@@@@@@@@@@@@.....T......T...T@
@@@@@@.T..T.@@@@@@@@@@@@@@@@@@.T......T..T..@T...@..@@@@@T.@@@@@@@@...@@@@@@@@@@@@................@@
@@@@@@..T...@@@@@@@@@@@@@@@@@@@.TT...T..T.T@@T.T.@.T@@@@...@@@@@@@@TT.@@@@@@@@@..T.............T..@@
@@@@@@@T....@@@@@@@@@@@@@@@@@@@@@@....T..T.@.......T....T.@@@@@@@T...@@@@@@@@@@T..T.T.T.....T.....@@
@@@@@@@...TT.@@@@@@@@@@@@@@@@@@@@@@@@@..T.@@T......TT..T.@@@.....T.T.@@@@@@@@@....@@@@@.........T@@@
@@@@@@@.....T@@@@@@@@@@@@@@@@@@@@@@@@@@@T.@.........T..@@@@..........@@@@@@@@@.T.@@@@@@@@@.....TT@@@
@@@@@@@...T..@@@@@@@@@@@@@@@@@@@@@@@@@@@@@@.TT................T.....@@@@@@@@@...@@@@@@@@@@@@..T..@@@
@@@@@@@...T..@@@@@@@@@@@@@@@@@@@@@@@@@@@@@.TTT.........T..T.........@@@@@@@@...T@@@@@@@@@@@@@@..@@@@
@@@@@@@@..T..@@@@@@@@@@@@@@@@@@@@@@@@@@@@@T.....T..T.........T...T..T@@@@@@@.T..@@@@@@@@@@@@@@@@@@@@
@@@@@@@@......@@@@@@@@@@@@@@@@@@@@@@@@@@@..........T.............@...T@@@@@@....@@@@@@@@@@@@@@@@@@@@
@@@@@@@@......T@@@@@@@@@@@@@@@@@@@@@@@@@@@@@@.T..TT.............@@@....@@@@.....@@@@@@@@@@@@@@@@@@@@
@@@@@@@@.T...T.@@@@@@@@@@@@@@@@@@@@@@@@@@@@@@@@@T.T............@@@@@.T..T@@..TT..@@@@@@@@@@@@@@@@@@@
@@@@@@@@@..T.T.T@@@@@@@@@@@@@@@@@@@@@@@@@@@@@@@@@@T........T.@@@@@@@@.....T..@@@@@@...@@@@@@@@@@@@@@
@@@@@@@@@T.......@@@@@@@@@@@@@@@@@@@@@@@@@@@@@@@@@.TT...@...@@@@@@@@@@@......@@@@@.....@@@@@@@@@@@@@
@@@@@@@@@@T..T..T.@@@@@@@@@@@@@@@@@@@@@@@@@@@@@@@@@@@@@@@.T@@@@@@@@@@@@@@.....T.......@@@@@@@@@@@@@@
@@@@@@@@@@@TT.T..T.@@@@@@@@@@@@@@@@@@@@@@@@@@@@@@@@@@@@@@T..@@@@@@@@@@@@@@@@@TTT..T..@@@@@@@@@@@@@@@
@@@@@@@@@@@@.T.T....@@@@@@@@@@@@@@@@@@@@@@@@@@@@@@@@@@@@@@...@@@@@@@@@@@@@@@@@@T....@@@@@@@@@@@@@@@@
@@@@@@@@@@@@TTT......@@@@@@@@@@@@@@@@@@@@@@@@@@@@@@@@@@@@@....@@@@@@@@@@@@@@@@@@@.T@@@@@@@@@@@@@@@@@
@@@@@@@@@@@@@....T....T@@@@.@@@@@@@@@@@@@@@@@@@@@@@@@@@@@@.TT.@@@@@@@@@@@@@@@@@@@@@@@@@@@@@@@@@@@@@@
@@@@@@@@@@@@@@....T.....T@@...T.T@@@@@@@@@@@@@@@@@@@@@@@@@....@@@@@@@@@@@@@@@@@@@@@@@@@@@@@@@@@@@@@@
@@@@@@@@@@@@@@@......T..TT........T.@@@@@@@@@@@@@@@@@@@@@@....@@@@@@@@@@@@@@@@@@@@@@@@@@@@@@@@@@@@@@
@@@@@@@@@@@@@@@@......T..T.....T.T......@@TT@@@@@@@@@@@@@@T...@@@@@@@@@@@@@@@@@@@@@@@@@@@@@@@@@@@@@@
@@@@@@@@@@@@@@@@@...TT...........T.TT.T.....@@@@@@@@@@@@@@TT..@@@@@@@@@@@@@@@@@@@@@@@@@@@@@@@@@@@@@@
@@@@@@@@@@@@@@@@@@@.......T.T..@@@.......T.T@@@@@@@@@@@@@.....@@@@@@@@@@@@@@@@@@@@@@@@@@@@@@@@@@@@@@
@@@@@@@@@@@@@@@@@@@@.TT.....@@@@@@..TT..TT.T@@@@@@@@@@@@.....@@@@@@@@@@@@@@@@@@@@@@@@@@@@@@@@@@@@@@@
@@@@@@@@@@@@@@@@@@@@@........@@@@@@......T..@@@@@@@@@@.....T@@@@@@@@@@@@@@@@@@@@@@@@@@@@@@@@@@@@@@@@
@@@@@@@@@@@@@@@@@@@@@@T.....T.@@@@@@@@.T........TT........T@@@@@@@@@@@@@@@@@@@@@@@@@@@@@@@@@@@@@@@@@
@@@@@@@@@@@@@@@@@@@@@@@....@T...@@@@@@..@..TT..TT....T...@@@@@@@@@@@@@@@@@@@@@@@@@@@@@@@@@@@@@@@@@@@
@@@@@@@@@@@@@@@@@@@@@@@.T.@@@..@@@@@@@T@@@.....T..TT.@@@@@@@@@@@@@@@@@@@@@@@@@@@@@@@@@@@@@@@@@@@@@@@
@@@@@@@@@@@@@@@@@@@..@....@@..@@@@@@@@.@@@@..T....@@@@@@@@@@@@@@@@@@@@@@@@@@@@@@@@@@@@@@@@@@@@@@@@@@
@@@@@@@@@@@@@@@@@@.......T.@@@@@@@@@@@@@@@...@@@@@@@@@@@@@@@@@@@@@@@@@@@@@@@@@@@@@@@@@@@@@@@@@@@@@@@
@@@@@@@@@@@@@@@@@.T..TT........@@@@@@@@@@@...@@@@@@@@@@@@@@@@@@@@@@@@@@@@@@@@@@@@@@@@@@@@@@@@@@@@@@@
@@@@@@@@@@@@@@@@@@@...T......TT....@@@@@@..T.@@@@@@@@@@@@@@@@@@@@@@@@@@@@@@@@@@@@@@@@@@@@@@@@@@@@@@@
@@@@@@@@@@@@@@@@@@@@@@...............@@@@...T@@@@@@@@@@@@@@@@@@@@@@@@@@@@@@@@@@@@@@@@@@@@@@@@@@@@@@@
@@@@@@@@@@@@@@@@@@@@@@@@@.............T.@..T.@@@@@@@@@@@@@@@@@@@@@@@@@@@@@@@@@@@@@@@@@@@@@@@@@@@@@@@
@@@@@@@@@@@@@@@@@@@@@@@@@@@@@.......T......TT@@@@@@@@@@@@@@@@@@@@@@@@@@@@@@@@@@@@@@@@@@@@@@@@@@@@@@@
@@@@@@@@@@@@@@@@@@@@@@@@@@@@@@@@@@@@@@@@@@@@@@@@@@@@@@@@@@@@@@@@@@@@@@@@@@@@@@@@@@@@@@@@@@@@@@@@@@@@
