type octile
height 80
width 80
map
@@@@@@@@@@@@@@@@@@@@@@@@@@@@@@@@@@@@@@@@@@@@@@@@@@@@@@@@@@@@@@@@@@@@@@@@@@@@@@@@
@@@@@@@@@@@@@@@@@@@@@@@@@@@@@@@@@@@@@@@@@@@@@@@@@@@@@@@@@@@@@@@@@@@@@@@@@@@@@@@@
@@@@@@@@@@@@@@@@@@@@@@@@@@@@@@@@@@@@@@@@@@@@@@@@@@..T............T....TT......@@
@@@@@@@@@@@@@@@@@@@@@@@@@@@@@@@@@@@@@@@@@@@@@@@@@....TT.TT...T............T...@@
@@@@@@@@@@@@@@@@@@@@@@@@@@@@@@@@@@@@@@@@@@@@@@@@..T....T.....T................@@
@@@@@@@@@@@@@@@@@@@@@@@@@@@@@@@@@@@@@@@@@@@@@@@T..T.T...........TT.....TTT....@@
@@@@@@@@@@@@@@@@@@@@@@@@@@@@@@@@@@@@@@@@@@@@@@..TT........T..T.T.......T.T....@@
@@@@@@@@@@@@@@@@@@@@@@@@@@@@@@@@@@@@@@@@@@@@@T..TT..T.T........TT.......T..T..@@
@@@@@@@@@@@@@@@@@@@@@@@@@@@@@@@@@@@@@@@@@@@@T.T......T.TT...T....T....T.......@@
@@@@@@@@@@@@@@@@@@@@@@@@@@@@@@@@@@@@@@@@@@@.T....T.T.....T....................@@
@@@@@@@@@@@@@@@@@@@@@@@@@@@@@@@@@@@@@@@@@@T....T.T.......T.......T.T.T.....T..@@
@@@@@@@@@@@@@@@@@@@@@@@@@@@@@@@@@@@@@@@@@@............TTT........T.....T......@@
@@@@@@@@@@@@@@@@@@@@@@@@@@@@@@@@@@@@@@@@@@@......T...TT..T.....TT...T..TT..TT.@@
@@@@@@@@@@@@@@@@@@@@@@@@@@@@@@@@@@@@@@@@@@@@.T.....T......T.........T.T.....T.@@
@@@@@@@@@@@@@@@@@@@@@@@@@@@@@@@@@@@@@@@@@@@@.....T..T...T........TT...TT......@@
@@@@@@@@@@@@@@@@@@@@@@@@@@@@@@@@@@@@@@@@@@@@@...........T......T..T...T.......@@
@@@@@@@@@@@@@@@@@@@@@@@@@@@@@@@@@@@@@@@@@@@@@@.T.T................T...........@@
@@@@@@@@@@@@@@@@@@@@@@@@@@@@@@@@@@@@@@@@@@@@@@........................T......T@@
@@@@@@@@@@@@@@@@@@@@@@@@@@@@@@@@.@@@@@@@@@@@@@@T...T...T.......T.......T....T.@@
@@@@@@@@@@@@@@@@@@@@@@@@@@@@@@@..T@@@@@@@@@@@@@@....T...............T...T.TT..@@
@@@@@@@@@@@@@@@@@@@@@@@@@@@@@@.T.T@@@@@@@@@.@@@@@T....T..T.TT..T...........TT@@@
@@@@@@@@@@@@@@@@@@@@@@@@@@@@@.TT..@@@@@@@@.TT@@@.....TT....T...T....T......T@@@@
@@@@@@@@@@@@@@@@@@@@@@@@@@@@.T.......@@@@..T.@@...........T..T...TT...TT.T.@@@@@
@@@@@@@@@@@@@@@@@@@@@@@@@@@..T...T..T@@@@@....T.......TT........T@@@@@@@@T@@@@@@
@@@@@@@@@@@@@@@@@@@@@@@@.@T..T........T@@@..TT.......T.T.........@@@@@@@@@@@@@@@
@@@@@@@@@@@@@@@@@@@@@@@.......TTTTT...T.@T......TT..T...TT..T....@@@@@@@@@@@@@@@
@@@@@@@@@@@@@@@@@@@@@@....TT....T....T.....T....TT..................T.T@@@@@@@@@
@@@@@@@@@@@@@@@@@@@@@T...T.T.............................TT..@@@.....T@@@@@@@@@@
@@@@@@@@@@@@@@@@@@@@...T..........T..........T..T........T@@@@@@.....@@@@@@@@@@@
@@@@@@@@@@@@@@@@@@@......T..............T...T....T.T....@@@@@@@@@...@@@@@@@@@@@@
@@@@@@@@@@@@@@@@@@@@@...T..T...................TT.T..T@@@@@@@@@@@.T@@@@@@@@@@@@@
@@@@@@@@@@@@@@@@@@@@@@@@@.TTT.....T...T.T..........TT.@@@@@@@@@@@T@@@@@@@@@@@@@@
@@@@@@@@@@@@@@@@@@@@@@@@@@..T....T.T.TT.T........T....@@@@@@@@@@@@@@@@@@@@@@@@@@
@@@@@@@@@@@@@@@@@.@@@@@@@@@@...TT......T......T..T.T..@@..@@@T.@@@@@@@@@@@@@@@@@
@@@@@@@@@@@@@@@@..@@@@@@@@@@T..T..T.......T....T.....T..T.....@@@@@@@@@@@@@@@@@@
@@@@@@@@@@@@@@@@..@@@@@@@@@@T........TTT................T..T.@@@@@@@@@@@@@@@@@@@
@@@@@@@@@@@@@@@@@..T@@@.@@@T.TTTTT........T..TT.......T...T.@@@@@@@@@@@@@@@@@@@@
@@@@@@@@@@@@@@@@@.T.....T@.......T.T..T..T...T..T.T........@@@@@@@@@@@@@@@@@@@@@
@@@@@@@@@@@@@@@@.......T............T.T...T..T.......T...@@@@@@@@@@@@@@@@@@@@@@@
@@@@@@@@@@@@@@@.....T.T.T.T.T....T........T...T..T..@@@@@@@@@@@@@@@@@@@@@@@@@@@@
@@@@@@@@@@@@@@.......T.T.......T.............T...T..@@@@@@@@@@@@@@@@@@@@@@@@@@@@
@@@@@@@@.@@.......T..T..T........T...T...........T..@@@@@@@@@@@@@@@@@@@@@@@@@@@@
@@@@@@@..T......T............T...T...TT.....T.....@@@@@@@@@@@@@@@@@@@@@@@@@@@@@@
@@@@T..T.....TT...T.......T.T..........TTT...T....@@@@@@@@@@@@@@@@@@@@@@@@@@@@@@
@@@...T....T..T.T...............TTT...TT....T..T.T@@@@@@@@@@@@@@@@@@@@@@@@@@@@@@
@@....T....T.TT.TT..........T...T..T.T....TTTTT...@@..@@@@@@@@@@@@@@@@@@@@@@@@@@
@@.....TTT..T..T...T........T...T.T..............T...@@@@@@@@@@@@@@@@@@@@@@@@@@@
@@........T.....T..................T..T......T....T...@@@@@@@@@@@@@@@@@@@@@@@@@@
@@.T...T.T......T....T....T..T.T......T....TT........T.@@@@@@@@@@@@@@@@@@@@@@@@@
@@..TT......TT.......TT..T....T...T...........T.T...T.T.@@@@@@@@@@@@@@@@@@@@@@@@
@@.........T.....T...T.T..............T...T...T.@@..T.T..@@@@@@@@@@@@@@@@@@@@@@@
@@......T........T.T...T.T.T.....T.......TTT@@..@@@.....@@@@@@@@@@@@@@@@@@@@@@@@
@@.....TT.T....TTT.......TT.......TT..T....@@@T@@@@@@@@@@@@@@@@@@@@@@@@@@@@@@@@@
@@....T.....T..T......T......T..TT.....TT.T@@@@@@@@@@@@@@@@@@@@@@@@@@@@@@@@@@@@@
@@.....................TTT....TTT.....T.T.T.@@@@@.@@@@@@@@@@@@@@@@@@@@@@@@@@@@@@
@@..TT............T.T.....T..........TT.TT.T..@@@..@@@@@@@@@@@@@@@@@@@@@@@@@@@@@
@@...T..T..................................T...@@T.@@@@@@@@@@@@@@@@@@@@@@@@@@@@@
@@T.T.....T..........TT....TT..T..T....T.T......T...@@@@@@@@@@@@@@@@@@@@@@@@@@@@
@@...T....T...T.T...T..T.......................T..T@@@@@@@@@@@@@@@@@@@@@@@@@@@@@
@@.........TT...T........T..T..........T........T.@@@@@@@@@@@@@@@@@@@@@@@@@@@@@@
@@............T....T....TTT........T.TTT........T@@@@@@@@@@@@@@@@@@@@@@@@@@@@@@@
@@....T........T....T....TT...TT................@@@@@@@@@@@@@@@@@@@@@@@@@@@@@@@@
@@..T..........T........T....TTT..T.TTTT.......@@@@@@@@@@@@@@@@@@@@@@@@@@@@@@@@@
@@......T...TT...T......T...............T..T..@@@@@@@@@@@@@@@@@@@@@@@@@@@@@@@@@@
@@.............T..........TT.......@@.T.T.T..@@@@@@@@@@@@@@@@@@@@@@@@@@@@@@@@@@@
@@T..T........T....T...TT.........@@@@......@@@@@@@@@@@@@@@@@@@@@@@@@@@@@@@@@@@@
@@..T............T..TT....@@....@@@@@@@...T@@@@@@@@@@@@@@@@@@@@@@@@@@@@@@@@@@@@@
@@T.....TTT.T...T..TT..T.@@@T..@@@@@@@@@..@@@@@@@@@@@@@@@@@@@@@@@@@@@@@@@@@@@@@@
@@.T........T.T.T.T....@@@@@@.@@@@@@@@@@@@@@@@@@@@@@@@@@@@@@@@@@@@@@@@@@@@@@@@@@
@@..........T.....T.T.@@@@@@@@@@@@@@@@@@@@@@@@@@@@@@@@@@@@@@@@@@@@@@@@@@@@@@@@@@
@@..........T.......T@@@@@@@@@@@@@@@@@@@@@@@@@@@@@@@@@@@@@@@@@@@@@@@@@@@@@@@@@@@
@@T...T.......T.T..T.@@@@@@@@@@@@@@@@@@@@@@@@@@@@@@@@@@@@@@@@@@@@@@@@@@@@@@@@@@@
@@T..T..T.T............@@@@@@@@@@@@@@@@@@@@@@@@@@@@@@@@@@@@@@@@@@@@@@@@@@@@@@@@@
@@............T.......@@@@@@@@@@@@@@@@@@@@@@@@@@@@@@@@@@@@@@@@@@@@@@@@@@@@@@@@@@
@@......@@@@....T..T.@@@@@@@@@@@@@@@@@@@@@@@@@@@@@@@@@@@@@@@@@@@@@@@@@@@@@@@@@@@
@@...@@@@@@@@TT....@@@@@@@@@@@@@@@@@@@@@@@@@@@@@@@@@@@@@@@@@@@@@@@@@@@@@@@@@@@@@
@@..@@@@@@@@@@..T.@@@@@@@@@@@@@@@@@@@@@@@@@@@@@@@@@@@@@@@@@@@@@@@@@@@@@@@@@@@@@@
@@.T.@@@@@@@@@@@.T@@@@@@@@@@@@@@@@@@@@@@@@@@@@@@@@@@@@@@@@@@@@@@@@@@@@@@@@@@@@@@
@@@@@@@@@@@@@@@@@@@@@@@@@@@@@@@@@@@@@@@@@@@@@@@@@@@@@@@@@@@@@@@@@@@@@@@@@@@@@@@@
@@@@@@@@@@@@@@@@@@@@@@@@@@@@@@@@@@@@@@@@@@@@@@@@@@@@@@@@@@@@@@@@@@@@@@@@@@@@@@@@
