type octile
height 160
width 160
map
@@@@@@@@@@@@@@@@@@@@@@@@@@@@@@@@@@@@@@@@@@@@@@@@@@@@@@@@@@@@@@@@@@@@@@@@@@@@@@@@@@@@@@@@@@@@@@@@@@@@@@@@@@@@@@@@@@@@@@@@@@@@@@@@@@@@@@@@@@@@@@@@@@@@@@@@@@@@@@@@
@@@@@@@@@@@@@@@@@@@@@@@@@@@@@@@@@@@@@@@@@@@@@@@@@@@@@@@@@@@@@@@@@@@@@@@@@@@@@@@@@@@@@@@@@@@@@@@@@@@@@@@@@@@@@@@@@@@@@@@@@@@@@@@@@@@@@@@@@@@@@@@@@@@@@@@@@@@@@@@@
@@@@@@@@@@@@@@@@@@@@@@@@@@@@@@@@@@@@@@@@@@@@@@@@@@@@@@@@@@@@@@@@@@@@@@@@@@@@@@@@@@@@@@@@@@@@@@@@@@@@@@@@@@@@@@@@@@@@@@@@@@@@@@@@@@@@@@@@@@@@@@@@@@@@@@@@@@@@@@@@
@@@@@@@@@@@@@@@@@@@@@@@@@@@@@@@@@@@@@@@@@@@@@@@@@@@@@@@@@@@@@@@@@@@@@@@@@@@@@@@@@@@@@@@@@@@@@@@@@@@@@@@@@@@@@@@@@@@@@@@@@@@@@@@@@@@@@@@@@@@@@@@@@@@@@@@@@@@@@@@@
@@@@@@@@@@@@@@@@@@@@@@@@@@@@@@@@@@@@@@@@@@@@@@@@@@@@@@@@@@@@@@@@@@@@@@@@@@@@@@@@@@@@@@@@@@@@@@@@@@@@@@@@@@@@@@@@@@@@@@@@@@@@@@@@@@@@@@@@@@@@@@@@@@@@@@@@@@@@@@@@
@@@@@@@@@@@@@@@@@@@@@@@@@@@@@@@@@@@@@@@@@@@@@@@@@@@@@@@@@@@@@@@@@@@@@@@@@@@@@@@@@@@@@@@@@@@@@@@@@@@@@@@@@@@@@@@@@@@@@@@@@@@@@@@@@@@@@@@@@@@@@@@@@@@@@@@@@@@@@@@@
@@@@@@@@@@@@@@@@@@@@@@@@@@@@@@@@@@@@@@@@@@@@@@@@@@@@@@@@@@@@@@@@@@@@@@@@@@@@@@@@@@@@@@@@@@@@@@@@@@@@@@@@@@@@@@@@@@@@@@@@@@@@@@@@@@@@@@@@@@@@@@@@@@@@@@@@@@@@@@@@
@@@@@@@@@@@@@@@@@@@@@@@@@@@@@@@@@@@@@@@@@@@@@@@@@@@@@@@@@@@@@@@@@@@@@@@@@@@@@@@@@@@@@@@@@@@@@@@@@@@@@@@@@@@@@@@@@@@@@@@@@@@@@@@@@@@@@@@@@@@@@@@@@@@@@@@@@@@@@@@@
@@@@@@@@@@@@@@@@@@@@@@@@@@@@@@@@@@@@@@@@@@@@@@@@@@@@@@@@@@@@@@@@@@@@@@@@@@@@@@@@@@@@@@@@@@@@@@@@@@@@@@@@@@@@@@@@@@@@@@@@@@@@@@@@@@@@@@@@@@@@@@@@@@@@@@@@@@@@@@@@
@@@@@@@@@@@@@@@@@@@@@@@@@@@@@@@@@@@@@@@@@@@@@@@@@@@@@@@@@@@@@@@@@@@@@@@@@@@@@@@@@@@@@@@@@@@@@@@@@@@@@@@@@@@@@@@@@@@@@@@@@@@@@@@@@@@@@@@@@@@@@@@@@@@@@@@@@@@@@@@@
@@@@@@@@@@@@@@@@@@@@@@@@@@@@@@@@@@@@@@@@@@@@@@@@@@@@@@@@@@@@@@@@@@@@@@@@@@@@@@@@@@@@@@@@@@@@@@@@@@@@@@@@@@@@@@@@@@@@@@@@@@@@@@@@@@@@@@@@@@@@@@@@@@@@@@@@@@@@@@@@
@@@@@@@@@@@@@@@@@@@@@@@@@@@@@@@@@@@@@@@@@@@@@@@@@@@@@@@@@@@@@@@@@@@@@@@@@@@@@@@@@@@@@@@@@@@@@@@@@@@@@@@@@@@@@@@@@@@@@@@@@@@@@@@@@@@@@@@@@@@@@@@@@@@@@@@@@@@@@@@@
@@@@@@@@@@@@@@@@@@@@@@@@@@@@@@@@@@@@@@@@@@@@@@@@@@@@@@@@@@@@@@@@@@@@@@@@@@@@@@@@@@@@@@@@@@@@@@@@@@@@@@@@@@@@@@@@@@@@@@@@@@@@@@@@@@@@@@@@@@@@@@@@@@@@@@@@@@@@@@@@
@@@@@@@@@@@@@@@@@@@@@@@@@@@@@@@@@@@@@@@@@@@@@@@@@@@@@@@@@@@@@@@@@@@@@@@@@@@@@@@@@@@@@@@@@@@@@@@@@@@@@@@@@@@@@@@@@@@@@@@@@@@@@@@@@@@@@@@@@@@@@@@@@@@@@@@@@@@@@@@@
@@@@@@@@@@@@@@@@@@@@@@@@@@@@@@@@@@@@@@@@@@@@@@@@@@@@@@@@@@@@@@@@@@@@@@@@@@@@@@@@@@@@@@@@@@@@@@@@@@@@@@@@@@@@@@@@@@@@@@@@@@@@@@@@@@@@@@@@@@@@@@@@@@@@@@@@@@@@@@@@
@@@@@@@@@@@@@@@@@@@@@@@@@@@@@@@@@@@@@@@@@@@@@@@@@@@@@@@@@@@@@@@@@@@@@@@@@@@@@@@@@@@@@@@@@@@@@@@@@@@@@@@@@@@@@@@@@@@@@@@@@@@@@@@@@@@@@@@@@@@@@@@@@@@@@@@@@@@@@@@@
@@@@@@@@@@@@@@@@@@@@@@@@@@@@@@@@@@@@@@@@@@@@@@@@@@@@@@@@@@@@@@@@@@@@@@@@@@@@@@@@@@@@@@@@@@@@@@@@@@@@@@@@@@@@@@@@@@@@@@@@@@@@@@@@@@@@@@@@@@@@@@@@@@@@@@@@@@@@@@@@
@@@@@@@@@@@@@@@@@@@@@@@@@@@@@@@@@@@@@@@@@@@@@@@@@@@@@@@@@@@@@@@@@@@@@@@@@@@@@@@@@@@@@@@@@@@@@@@@@.@@T@@@@@@@@@@@@@@@@@@@@@@@@@@@@@@@@@@@@@@@@@@@@@@@@@@@@@@@@@@@
@@@@@@@@@@@@@@@@@@@@@@@@@@@@@@@@@@@@@@@@@@@@@@@@@@@@@@@@@@@@@@@@@@@@@@@@@@@@@@@@@@@@@@@@@@@@@@@@@....@@@@@@@@@@@@@@@@@@@@@@@@@@@@@@@@@@@@@@@@@@@@@@@@@@@@@@@@@@@
@@@@@@@@@@@@@@@@@@@@@@@@@@@@@@@@@@@@@@@@@@@@@@@@@@@@@@@@@@@@@@@@@@@@@@@@@@@@@@@@@@@@@@@@@@@@@@@@......@@@@@@@@@@@@@@@@@@@@@@@@@@@@@@@@@@@@@@@@@@@@@@@@@@@@@@@@@@
@@@@@@@@@@@@@@@@@@@@@@@@@@@@@@@@@@@@@@@@@@@@@@@@@@@@@@@@@@@@@@@@@@@@@@@@@@@@@@@@@@@@@@@@@@@@@@@.T....T.@@@@@@@@@@@@@@@@@@@@@@@@@@@@@@@@@@@@@@@@@@@@@@@@@@@@@@@@@
@@@@@@@@@@@@@@@@@@@@@@@@@@@@@@@@@@@@@@@@@@@@@@@@@@@@@@@@@@@@@@@@@@@@@@@@@@@@@@@@@@@@@@@@@@@@@@....T...T.@@@@@@@@@@@@@@@@@@@@@@@@@@@@@@@@@@@@@@@@@@@@@@@@@@@@@@@@
@@@@@@@@@@@@@@@@@@@@@@@@@@@@@@@@@@@@@@@@@@@@@@@@@@@@@@@@@@@@@@@@@@@@@@@@@@@@@@@@@@@@@@@@@@@@......T.....T@@@@@@@@@@@@@@@@@@@@@@@@@@@@@@@@@@@@@@@@@@@@@@@@@@@@@@@
@@@@@@@@@@@@@@@@@@@@@@@@@@@@@@@@@@@@@@@@@@@@@@@@@@@@@@@@@@@@@@@@@@@@@@@@@@@@@@@@@@@@@@@@@@@..T...T......TT@@@@@@@@@@@@@@@@@@@@@@@@@@@@@@@@@@@@@@@@@@@@@@@@@@@@@@
@@@@@@@@@@@@@@@@@@@@@@@@@@@@@@@@@@@@@@@@@@@@@@@@@@@@@@@@@@@@@@@@@@@@@@@@@@@@@@@@@@@@@@@@@@....T.@@@@@......@@@@@@@@@@@@@@@@@@@@@@@@@@@@@@@@@@@@@@@@@@@@@@@@@@@@@
@@@@@@@@@@@@@@@@@@@@@@@@@@@@@@@@@@@@@@@@@@@@@@@@@@@@@@@@@@@@@@@@@@@@@@@@@@@@@@@@@@@@@@@@......T.@@@@@@@@....@@@@@@@@@@@@@@@@@@@@@@@@@@@@@@@@@@@@@@@@@@@@@@@@@@@@
@@@@@@@@@@@@@@@@@@@@@@@@@@@@@@@@@@@@@@@@@@@@@@@@@@@@@@@@@@@@@@@@@@@@@@@@@@@@@@@@@@@@@@@@TT...T..@@@@@@@@....T@@@@@@@@@@@@@@@@@@@@@@@@@@@@@@@@@@@@@@@@@@@@@@@@@@@
@@@@@@@@@@@@@@@@@@@@@@@@@@@@@@@@@@@@@@@@@@@@@@@@@@@@@@@@@@@@@@@.@@@@@@@@@@@@@@@@@@@@@@@.....TT.@@@@@@@@@.T....@@@@@@@@@@@@@@@@@@@@@@@@@@@@@@@@@@@@@@@@@@@@@@@@@@
@@@@@@@@@@@@@@@@@@@@@@@@@@@@@@@@@@@@@@@@@@@@@@@@@@@@@@@@@@@@@@...@@@@@@@@@@@@@@@@@@@@@..T.....T@@@@@@@@@...T..T@@@@@@@@@@@@@@@@@@@@@@@@@@@@@@@@@@@@@@@@@@@@@@@@@
@@@@@@@@@@@@@@@@@@@@@@@@@@@@@@@@@@@@@@@@@@@@@@@@@@@@@@@@@@@@@@....@@@@@@@@@@@@@@@@@@@.......T.T@@@@@@@@@..T.....@@@@@@@@@@@@@@@@@@@@@@@@@@@@@@@@@@@@@@@@@@@@@@@@
@@@@@@@@@@@@@@@@@@@@@@@@@@@@@@@@@@@@@@@@@@@@@@@@@@@@@@@@@@@@@T..T.@@@@@@@@@@@@@@@@@........T...T.......T.T.T..T..@@@@@@@@@@@@@@@@@@@@@@@@@@@@@@@@@@@@@@@@@@@@@@@
@@@@@@@@@@@@@@@@@@@@@@@@@@@@@@@@@@@@@@@@@@@@@@@@@@@@@@@@@@@@@.T..@@@@@@@@@@@@@@@@@@@@.....T...T......T..T......T..@@@@@@@@@@@@@@@@@@@@@@@@@@@@@@@@@@@@@@@@@@@@@@
@@@@@@@@@@@@@@@@@@@@@@@@@@@@@@@@@@@@@@@@@@@@@@@@@@@@@@@@@@@@.T...@@@@@@@@@@@@@@@@@@@@@T..........................T.@@@@@@@@@@@@@@@@@@@@@@@@@@@@@@@@@@@@@@@@@@@@@
@@@@@@@@@@@@@@@@@@@@@@@@@@@@@@@@@@@@@@@@@@@@@@@@@@@@@@@@@@@@....@@@@@@@@@@@@@@@@@@@@@@T....T.....T.TT..T.TT........@@@@@@@@@@@@@@@@@@@@@@@@@@@@@@@@@@@@@@@@@@@@@
@@@@@@@@@@@@@@@@@@@@@@@@@@@@@@@@@@@@@@@@@@@@@@@@@@@@@@@@@@@@....@@@@@@@@@@@@@@@@@@@@@@.........@........T....T....@@@@@@@@@@@@@@@@@@@@@@@@@@@@@@@@@@@@@@@@@@@@@@
@@@@@@@@@@@@@@@@@@@@@@@@@@@@@@@@@@@@@@@@@@@@@@@@@@@@@@@@@@@.....@@@@@@@@@@@@@@.@@@@..T.....T...@@@@...........T.T@@@@@@@@@@@@@@@@@@@@@@@@@@@@@@@@@@@@@@@@@@@@@@@
@@@@@@@@@@@@@@@@@@@@@@@@@@@@@@@@@@@@@@@@@@@@@@@@@@@@@@@@@@@....@@@@@@@@@@@@@@T...T...T........@@@@@@@....T.T..T.@@@@@@@@...T@@@@@@@@@@@@@@@@@@@@@@@@@@@@@@@@@@@@
@@@@@@@@@@@@@@@@@@@@@@@@@@@@@@@@@@@@@@@@@@@@@@@@@@@@@@@@@@T.T.@@@@@@@@..@@@@..................@@@@@@@@@.......T@@@@@@@....TT.@@@@@@@@@@@@@@@@@@@@@@@@@@@@@@@@@@@
@@@@@@@@@@@@@@@@@@@@@@@@@@@@@@@@@@@@@@@@@@@@@@@@@@@@@@@@@@...T@@@@@@@T...@@...........T..T...@@@@@@@@@@......T@@@@@@@.....T.@@@@@@@@@@@@@@@@@@@@@@@@@@@@@@@@@@@@
@@@@@@@@@@@@@@@@@@@@@@@@@@@@@@@@@@@@@@@@@@@@@@@@@@@@@@@@@@.T.@@@@@@@@@......TT.....T......T..@@@@@@@@@@...T.T@@@@@@@.......@@@@@@@@@@@@@@@@@@@@@@@@@@@@@@@@@@@@@
@@@@@@@@@@@@@@@@@@@@@@@@@@@@@@@@@@@@@@@@@@@@@@@@@@@@@@@@@.TT.@@@@@@@@@@...TT...T.T.....T...T....@@@@@@.T..T.@@@@@@@T........@@@@@@@@@@@@@@@@@@@@@@@@@@@@@@@@@@@@
@@@@@@@@@@@@@@@@@@@@@@@@@@@@@@@@@@@@@@@@@@@@@@@@@@@@@@@@......@@@@@@@@@@...........T.T...T....T.....@@.....@@@@@@@@@T.T......@@@@@@@@@@@@@@@@@@@@@@@@@@@@@@@@@@@
@@@@@@@@@@@@@@@@@@@@@@@@@@@@@@@@@@@@@@@@@@@@@@@@@@@@@@@T.TT.T.T@@@@@@@@@@.TT...T........T.@@TTT.T.....T..T@@@@@@@@@@.TT...T..T@@@@@@@@@@@@@@@@@@@@@@@@@@@@@@@@@@
@@@@@@@@@@@@@@@@@@@@@@@@@@@@@@@@@@@@@@@@@@@@@@@@@@@@@@....T...T.@@@.@@@@@@T.T.T..T...TT..@@@@..T......T..@@@@@@@@@@T...T...TTTT@@@@@@@@@@@@@@@@@@@@@@@@@@@@@@@@@
@@@@@@@@@@@@@@@@@@@@@@@@@@@@@@@@@@@@@@@@@@@@@@@@@@@@@.T.T....T...@.T.@@@@@@..T..T..T.T..@@@@@@..........@@@@@@.@@@..............@@@..@@@@@@@@@@@@@@@@@@@@@@@@@@@
@@@@@@@@@@@@@@@@@@@@@@@@@@@@@@@@@@@@@@@@@@@@@@@@@@@@@@.T.........@@...@@@@@@...T.......@@@@@@@.........@@@@@@...@..T.......T.T...T....@@@@@@@@@@@@@@@@@@@@@@@@@@
@@@@@@@@@@@@@@@@@@@@@@@@@@@@@@@@@@@@@@@@@@@@@@@@@@@@@@@...T.T.T...@..T.@@@@@...TT.T.T..@@@@@@@@......T@@@@@@@@.T.....................@@@@@@@@@@@@@@@@@@@@@@@@@@@
@@@@@@@@@@@@@@@@@@@@@@@@@@@@@@@@@@@@@@@@@@@@@@@@@@@@@@@@....T.....@@...T@@@@........T..@@@@@@@@....T@@@@@@@@@@@........@@@.............T@@@@@@@@@@@@@@@@@@@@@@@@
@@@@@@@@@@@@@@@@@@@@@@@@@@@@@@@@@@@@@@@@@@@@@@@@@@@@@@@@@.....T....@T...@@@@.....TT.T...@@@@@@@T...@@@@@@@@@@@@...TT..@@@@@......T.TT...@@@@@@@@@@@@@@@@@@@@@@@@
@@@@@@@@@@@@@@@@@@@@@@@@@@@@@@@@@@@@@@@@@@@@@@@@@@@@@@@@@@T........@@.T.@@@..T@@...........@@@@T..@@@@@@@.T@@@....@@.@@@@@.T......T..T.@@@@@@@@@@@@@@@@@@@@@@@@@
@@@@@@@@@@@@@@@@@@@@@@@@@@@@@@@@@@@@@@@@@@@@@@@@@@@@@@@@@@@....T....@.T..T....@@@.T...T....@@@@..@@@@@@@@.....T...@@@@@@@@@.T.T.......@@@@@@@@@@@@@@@@@@@@@@@@@@
@@@@@@@@@@@@@@@@@@@@@@@@@@@@@@@@@@@@@@@@@@@@@..@@@@@@@@@@@@T........@@T......@@@@@.T.......T....@@@@@@@@@@........@@@@@@@.....T......@@@@@@@@@@@@@@@@@@@@@@@@@@@
@@@@@@@@@@@@@@@@@@@@@@@@@@@@@@@@@@@@@@@@@@@@....@@@@@@@@@@@@....T..TT@.T...T@@@@@@@@T...T.TT.T.@@@@@@@@@@...T..@@.@@@@@@T..T......T.@@@@@@@@@@@@@@@@@@@@@@@@@@@@
@@@@@@@@@@@@@@@@@@@@@@@@@@@@@@@@@@@@@@@@@@@...T..@@@@@@@@@@@.........@@...T.@@@@@@@@@.T.......@@@@@@@@@@......T@@@@@@@@@@.......T.T@@@@@@@T@@@@@@@@@@@@@@@@@@@@@
@@@@@@@@@@@@@@@@@@@@@@@@@@@@@@@@@@@@@@@@@@.......T@@@@@@@@@@.T...T..T.@.......T@@@@@@@...TT..@@@@@@@.T@..T....T@@@@@@@@@@T........@@@@@@@@.T@@@@@@@@@@@@@@@@@@@@
@@@@@@@@@@@@@@@@@@@@@@@@@@@@@@@@@@T.@@@@@.....T....@@@@@@@@@@T.T.T...T@@@@T....@@@@@@@@...TT@@@@@@@............@@@@@@TT..T..T....@@@@@@@@@T.T@@@@@@@@@@@@@@@@@@@
@@@@@@@@@@@@@@@@@@@@@@@@@@@@@@@@@@@.T..TTT.......TT.@@@@@@@@@........T..@T.....@@@@@@@@@...@@@@@@@...T..T....T@@@@@@@...........@@@@@@@@@@..T.@@@@@@@@@@@@@@@@@@
@@@@@@@@@@@@@@@@@@@@@@@@@@@@@@@@@@@@@T...........T...@@@@@@@@@.............T...TT@@@@@@@@@@@@@@@@T...T..T..TT.@@@@@@@.......T..@@@@@@@@@@.T....@@@@@@@@@@@@@@@@@
@@@@@@@@@@@@@@@@@@@@@@@@@@@@@@@@@@@@@@@@..T..TT.TT...@@@@@@@@@T......T..T.......@@@@@@@@@@@@@@@@@...TT....TT.@@@@@TTT...T.....@@@@@@@@@@@..T....TT@@@@@@@@@@@@@@
@@@@@@@@@@@@@@@@@@@@@@@@@@@@@@@@@@@@@@@@@@...T.....TT.@@@@@@@@@.T..T...........T.@@@@@@@@@@@@@@@@..T......TT.@@@@.T.......T.T@@@@@@@@@@.TT....T...@@@@@@@@@@@@@@
@@@@@@@@@@@@@@@@@@@@@@@@@@@@@@@@@@@@@@@@@@@.TT..T.....@@@@@@@@@@...............TTT@@@@@@@@@@@@@@....T...TT...T.........T...T@@@@@@@@@@.T..T.T.TT..@@@@@@@@@@@@@@
@@@@@@@@@@@@@@@@@@@@@@@@@@@@@@@@@@@@@@@@@@@@.TTT.......@@@@@@@@@..........TT......T.@@@@@@@@@T.TT............T....T.....TT.@@@@@@@@@@..T...........@@.@@@@@@@@@@
@@@@@@@@@@@@@@@@@@@@@@@@@@@@@@@@@@@@@@@@@@@@...TT.T.T..@@@@@@@@@..T..................@.@@@@@@@......T.TT.TTT.TT......TTT..@@@@@.@@@@...T...@@T.T.T....@@@@@@@@@@
@@@@@@@@@@@@@@@@@@@@@@@@@@@@@@@@@@@@@@@@@@@@@....T.T...@@@@@@@..T.T.........T......@...@@@@@@@@T.TT..........T.T.......T.@@@@@@...T...T..@@@@@...T..T.@@@@@@@@@@
@@@@@@@@@@@@@@@@@@@@@@@@@@@@@@@@@@@@@@@@@@@@@T......T...@@@@@.....T......T..T......@@.TT@@@@@@@@......T.T..T...T.T..T.TT@@@@@@@..T....@@..@@@@@.T.TT.@@@@@@@@@@@
@@@@@@@@@@@@@@@@@@@@@@@@@@@@@@@@@@@@@@@@@@@@@@.TTTTT...T@@@@.........T........T.....T....@@@@@@@@T..T...........T....T.@@@@@@@@......@@@@...@@@@.....@@@@@@@@@@@
@@@@@@@@@@@@@@@@@@@@@@@@@@@@@@@@@@@@@@@@@@@@@@..TTTTT....@@..TTTT.........T...TT.T..T.....@@@@@@@@...T.........T......@@@@@@@@@.......@@@@@..@@@T.....@@@@@@@@@@
@@@@@@@@@@@@@@@@@@@@@@@@@@@@@@@@@@@@@@@@@@@@@@@..T.TT.TT.@..T...T.T..TTT..T...............@@@@@@@@T..T.....TT..T..T..@@@@@@@@@...TT..T.@@@@@..@@.T....T@@@@@@@@@
@@@@@@@@@@@@@@@@@@@@@@@@@@@@@@@@@@@@@@@@.T@@@@@..........................T................T@@@@@@@...T..............@@@@@@@@@.T..T..@@..@@@@T..TT.........@@@@@@
@@@@@@@@@@@@@@@@@@@@@@@@@@@@@@@@@@@@@@@....@@@@@.......T............TT.T.......T......TT..@@..@@@TT.TT.T....T.....@@@@@@@@@@...TTT.@@@@.T@@T.@.......TT.....@@@@
@@@@@@@@@@@@@@@@@@@@@@@@@@@@@@@@@@@@@@......@@@@TTT..T.TT.....T.....T.T....TT......T...T.T@@..T.T....@....T..T...@@@@@@@...T.T.T...@@@@@....@@@.T..T........T@@@
@@@@@@@@@@@@@@@@@@@@@@@@@@@@@@@@@@@@@@T......@@@.....T..TT.TT.T.T........TT.T......T....T...T......T@@@.T.......@@@@@@@@T.T......T..@@@@@..@@@@.......T.T....@@@
@@@@@@@@@@@@@@@@@@@@@@@@@@@@@@@@@@@@@@@T..T...@@@...................T..T...T.....T...T.T.TT..T.....T@@@@.......@@@@@@@.T.............@@@@@T.@@T........TT...@@@@
@@@@@@@@@@@@@@@@@@@@@@@@@@@@@@.T@@@@@@@@..T..T.@@.......T........TT........T....T.....T.....T..T...@@@@@@T....@@@@@@@@...T..T.......T.@@@............T...T.@@@@@
@@@@@@@@@@@@@@@@@@@@@@@@@@@@@@...@@@@@@@@.TT..T.@@T.....................@@.........T..T......T...T.@@@@@@@T..@@@@@@@@@@............T....T..TT.T...T..T..TT@@@@@@
@@@@@@@@@@@@@@@@@@@@@@@@@@@@@@@.TT@@@@@@@@.......@@...........T..T....@@@@@...TTT..................T.@@@@@@.@@@@@@@......T...@...T.TT..T...T..T..T....TT.@@@@@@@
@@@@@@@@@@@@@@@@@@@@@@@@@@@@@@@@.T..@@@@@@@T.....@@TT........T......T@@@@@@@TT.......TTT...........T.@@@@@@@@@@@@@T..T....T.@@@..............T...T.T.T..@@@@@@@@
@@@@@@@@@@@@@@@@@@@@@@@@@@@@@@@@@@.T.T@@@@@.......................T.T@@@@@@@@...T.T..TT...........T..T@T@@@@@@@@@TTT..TTT...@@@..TT....T.......T......T@@@@@@@@@
@@@@@@@@@@@@@@@@@@@@@@@@@@@@@@@@@@..T..@@@@.T.T.T..T...TT....T..TT.T.T@@@@@@.T...T....T.......T........T.@@@@@@@TT...T..T..T.@@.......T...T...T..T....@@@@@@@@@@
@@@@@@@@@@@@@@@@@@@@@@@@@@@@@@@@@@@....@@@@.TTT.....T..T.......T.T..T.....T..T..T...T.........T..T.@@....T@@@@@...T....T.@@..T....T.......T....TT....@@@@@@@@@@@
@@@@@@@@@@@@@@@@@@@@@@@.@@.@@@@@@@.....@..T..@@@.TTT......T.......T..TT.......TT.T.......TT.TT.....@@...T@@@@@@@....T...@@@@.............T...T..T...@@@@@@@@@@@@
@@@@@@@@@@@@@@@@@@@@@@..T.TT@@@@@...........@@@@@...T.T.T...............T....T......T...T..T..T.............@@@@@...T.T..@@@....T....T...........TT@@@@@@@@@@@@@
@@@@@@@@@@@@@@@@@@@@@@..T..@@@@............T.@@@@@..T.T.T.................TT.T....@@.........T.......T.T.T..@@@@@@@.......@@.TT....T.T...T......T.@@@@@@@@@@@@@@
@@@@@@@@@@@@@@@@@@@@@..T...@@@@.....T....T..T@@@@@@............TT..TT........T...@@@@.............T..T......@@@@@@@@.T............T.T.......T...@@@@@@@@@@@@@@@@
@@@@@@@@@@@@@@@@@@@@@@T.....@@.......T..TT.@@@@@@@@@T.......T.T...T.TT.T.....T...@@@@@..T.TT.T......T...T..T@@.@@@@@...T............T.....TT...@@@@@@@@@@@@@@@@@
@@@@@@@@@@@@@@@@@@@@@@@T...TTT.T..T....T..@@@@@@@@@@@...T..TT..T..T......T.......@@@@@....T......T..T.TT..@..T..@@@T.T...T.TT.T..T..T......T..@@@@@@@@@@@@@@@@@@
@@@@@@@@@@@@@@@@@@@@@@@@....T..T..TT......@@@@@@@@@@@@.TT.T........T.........T.T@@@@@@......T.......T.....@@.TT.@@...@@T.T.......T.T...TT...T@@@@@@@@@@@@@@@@@@@
@@@@@@@@@@@@@@@@@@@@@@@@@...T....TTT...T.T@@@.@@@@@@@@@T..@@.........T....T....T@@@@@@@@...T.....T.....T.........T...@@@.......TT..T....T...@@@@@@@@@@@@@@@@@@@@
@@@@@@@@@@@@@@@@@@@@@@@@@@..T....T.T..TT.T@...@@@@@@@@@@..@@TT.T.T...........T..@@@@@@@@@TTT..........T.......TTT.T..@@@@...T........T.....@@@@@@@@@@@@@@@@@@@@@
@@@@@@@@@@@@@.@@..@@@@@T...T.....T..T.....@..@@@@@@@@@@@@.....T...........TTTT.@@@@@@@@@@T.......T..T......T....T..T@@@@@@@T......T..T....@@@@@@@@@@@@@@@@@@@@@@
@@@@@@@@@@@@.T....@@@@@...T.......T...T.......T.@@@.@@@@@@.T.........T........T@@@@@@@@@@...T.....T.........T..T....@@@@@@@@T......T..T..@@@@@@@@@@@@@@@@@@@@@@@
@@@@@@@@@@@...TT.@@@@....T..T...........T..T....@@@TT@@@@@@.TT..T......TTTT.....TT.@@T......T........T...T.T.T.T..TT..@@@@@@@..TT.......@@@@@@@@@@@@@@@@@@@@@@@@
@@@@@@@@@@........@@@....TT..TTTT.......@@@....@@@@...@@@@@@TT..TT......T........TT..........@...T....TT..T...T...T.TT.@@@@@@@...T.....@@@@@@@@@@@@@@@@@@@@@@@@@
@@@@@@@@@@@...T.....T..T........T...T...@@@....@@@...@@@@@@@@....@@.....T.T......T..T..T..T.@@@.T...T.T.............T..@@@@@@@@....T..@@@@@@@@@@@@@@@@@@@@@@@@@@
@@@@@@@@@@@@TT.T...T.T...T.T....T....T...@@...@@@@..@@@@@@@@@@...@@...............T..T.T...T@@@@....TT.T...............@@@@@@@@@@...@@@@@@@@@@@@@@@@@@@@@@@@@@@@
@@@@@@@@@@@@@...TT......T...T..TT...T....@@...@@...@@@@@@@@@@@@..T.........T......T.....T...@@@@@...T....T...........T.T..@@@@@@@@T@@@@@@@@@@@@@@@@@@@@@@@@@@@@@
@@@@.@@@@@@@@@.....T.T..T..........T.T..@@.TT....@@@@@@@@@@@@@@@............T...............@@@@@T.......T.....TT.........T@@@@@@@@@@@@@@@@@@@@@@@@@@@@@@@@@@@@@
@@@..T@@@@@@@@@@..T..TT.T.@@T..........@@@@..T..@@@@@@@@@@T@@@@@@.....T...T...T.......TT.T..@@@@@.T....T....T.....T....T...T.@@@@@@@@@@@@@@@@@@@@@@@@@@@@@@@@@@@
@@.....@@@@@@@@T.T....T.T@@@T..@@......@@@@..TT@@@@@@@@@T...@@@@@@..T...T..TT...T.........T.@@@@@...T....TT..T.....T...T......@@@@@@@@@@@@@@@@@@@@@@@@@@@@@@@@@@
@T......@@@@@T..T......T@@@@T.T@@......@@@@..T@@@@@@@@@..@@.T@@@@T........TT.....T..........@@@T..T..T.......T.........T.T.....@@@@@@@@@@@@@@@@@@@@@@@@@@@@@@@@@
@@....T.@@@..TT........@@@@@.TT.@@...........@@@@@@@@@@.@@@@T@@@@..@@...T..T..T....T..........T..T.TT..T......T......TT.........@@@@@@@@@@@@@@@@@@@@@@@@@@@@@@@@
@@@...T..@@...TT.T.T...@@@@.....@@.T...T.TTT@@@@@@@@@...@@@T.......@@@T..T..T..........TT......T...T.T.T.T...T.T......T...T....@@@@@@@@@@@@@@@@@@@@@@@@@@@@@@@@@
@@@@.....T...........T@@@@.T@@@...T...T...@@@@@@@@@@..@@@...T......@@@@....@@..T....TTT.T..T.......TT.T.......TT........T...T.@@@@@@@@@@@@@@@@@@@@@@@@@@@@@@@@@@
@@@@@TTT.......T...T.@@@@..@@@@..T.T.....@@@@@@@@@@@.@@@@.@@@TTT.T@@@@@@T..@@..TTT..T.....T.T.........TTT...T..T............T@@@@@@@@@@@@@@@@@@@@@@@@@@@@@@@@@@@
@@@@@@.T...T.......T.@@@..@@@@...TT..T..@@@@@@@@@...T@@@@.@@@....@@@@@@@@....TTT.....................T.....T.T..............@@@@@@@@@@@@@@@@@@@@@@@@@@@@@@@@@@@@
@@@@@@@.T.....T..T.TT.TTT.@@@.T.T...T..@@@@@@@@@......@@@.@@@....@@@@@@@@@.T.T...T..........TT.T.T....T..T......T...T......@@@@@@@@@@@@@@@@@@@@@@@@@@@@@@@@@@@@@
@@@@@@@@..TT.......T.......@.T..T...T.@@@@@@@@@T..T.T...T...T.....@@@@@@@@@...T....TT...........T.........T..T.TT.........@@@@@@@@@@@@@@@@@@@@@@@@@@@@@@@@@@@@@@
@@@@@@@@@.T....TTT.T..T.T............@@@@@@@@@...T..T.....T....T..T@@@@@@@@@.......@@..T...T..T......T...T.....TT..T...T.@@@@@@@@@@@@@@@@@@@@@@@@@@@@@@@@@@@@@@@
@@@@@@@@@@..TT.........T....TT.....T@@@@@@@@@...T.....T.TTT.T.......@@@@@@@@@.TT..T@@T............TT.....TT..T..........@@@@@@@@@@@@@@@@@@@@@@@@@@@@@@@@@@@@@@@@
@@@@@@@@@@@T...........TT....T.T...@@@@@@@@@TTT....T..T..............@@@@@@@@@............T...TT...T.T.....T......T.T..@@@@@@@@@@@@@@@@@@@@@@@@@@@@@@@@@@@@@@@@@
@@@@@@@@@@@@.T......T..T.......T.T@@@@@@@@@.......TT...........TT..T.@@@@@@@@@@T..TT.TT.......T...........T......T....@@@@@@@@@@@@@@@@@@@@@@@@@@@@@@@@@@@@@@@@@@
@@@@@@@@@@@@@......T..........T..@@@@@@@@@..T.......@.........T.....@@@@@@@@@@@@.............T........T.T...T...T....@@@@@@@@@@@@@@@@@@@@@@@@@@@@@@@@@@@@@@@@@@@
@@@@@@@@@@@@@@....T.....T...TT..@@@@@@@@@...........@@T...T.T......@@@@@@@@T@@@@@....T..T..TT.......T..T..T.........@@@@@@@@@@@@@@@@@@@@@@@@@@@@@@@@@@@@@@@@@@@@
@@@@@@@@@@@@@@@.T.....T........@@@@@@@@@@@.T..TT...@@@..T..T....T.@@@@@@@....@@@@@.TT...T...T...TT........T.T.TT...@@@@@@@@@@@@@@@@@@@@@@@@@@@@@@@@@@@@@@@@@@@@@
@@@@@@@@@@@@@@@@.T...T.T......@@@@@@@@@@@@...T....T.@@@.........T@@@@@@@@@@@..@@@@@........T.................T....@@@@@@@@@@@@@@@@@@@@@@@@@@@@@@@@@@@@@@@@@@@@@@
@@@@@@@@@@@@@@@@@.T.......T..@@@@@@@@@@@@...T..TT.@@@@@T.......T@@@@@@@@@@@@...@@@@.T.T...T.TT.T...T.T.T.T..T...T@@@@@@@@@@@@@@@@@@@@@@@@@@@@@@@@@@@@@@@@@@@@@@@
@@@@@@@@@@@@@@@@@@.......TTT@@@@@@@@@@@@........@@@@@@@@.......@@@@@@@.TTTT.T...@@.....T......TT.T...........TT.@@@@@@@@@@@@@@@@@@@@@@@@@@@@@@@@@@@@@@@@@@@@@@@@
@@@@@@@@@@@@@@@@@@@......TT@@@@@@@@@@@@..T.....T.@@@@@@@@.....@@@@@@@.T..T..T......T@@@.......T....T......T...@@@@@@@@@@@@@@@@@@@@@@@@@@@@@@@@@@@@@@@@@@@@@@@@@@
@@@@@@@@@@@@@@@@@@@@.T.T.T@@@@@@@@@@@@@.T.T......@@@@@@@@T.T.@@@@@@@.......T.T.....@@@@@.T.T......T..T....T..@@@@@@@@@@@@@@@@@@@@@@@@@@@@@@@@@@@@@@@@@@@@@@@@@@@
@@@@@@@@@@@@@@@@@@@@@....@@@@@@@@@@@@@@@..........@@@@.@@...@@@@@@@...TT......T....@@@@@@...T......TTT......@@@@@@@@@@@@@@@@@@@@@@@@@@@@@@@@@@@@@@@@@@@@@@@@@@@@
@@@@@@@@@@@@@@@@@@@@@@..@@@@@@..@@@@@@@@@..T...T..@@@@.....@@@@@@@....T...T.T.....T.@@@@@@......T..........@@@@@@@@@@@@@@@@@@@@@@@@@@@@@@@@@@@@@@@@@@@@@@@@@@@@@
@@@@@@@@@@@@@@@@@@@@@@@@@@@@@....@@@@@@@@@...T.....@.T....@@@@@@@@..T..........T.....@@@@@@....T..........@@@@@@@@@@@@@@@@@@@@@@@@@@@@@@@@@@@@@@@@@@@@@@@@@@@@@@
@@@@@@@@@@@@@@@@@@@@@@@@@@@@....TT@@@@@@@@@....T...TT..T.@@@@@@@@.....T......TT.T..TT.@@@@@@......T..T...@@@@@@@@@@@@@@@@@@@@@@@@@@@@@@@@@@@@@@@@@@@@@@@@@@@@@@@
@@@@@@@@@@@@@@@@@@@@@@@@@@@........@@@@@@@...T...T......@@@@@@@@@..........T.T....TT...@@@@@@........T..@@@@@@@@@@@@@@@@@@@@@@@@@@@@@@@@@@@@@@@@@@@@@@@@@@@@@@@@
@@@@@@@@@@@@@@@@@@@@@@@@@@@.........@@@@@............TT@@@@@@@.T..TT........T.T.........@@@@@@.........@@@@@@@@@@@@@@@@@@@@@@@@@@@@@@@@@@@@@@@@@@@@@@@@@@@@@@@@@
@@@@@@@@@@@@@@@@@@@@@@@@@@@@.T.......@@@..T...........@@@@@@@@@.TT.T........T............@@@@@@....T..@@@@@@@@@@@@@@@@@@@@@@@@@@@@@@@@@@@@@@@@@@@@@@@@@@@@@@@@@@
@@@@@@@@@@@@@@@@@@@@@@@@@@@@@.........@...........TT.@@@@@@@@@@@T..@@.....T....T....T.T..T@@@@@@T...@@@@@@@@@@@@@@@@@@@@@@@@@@@@@@@@@@@@@@@@@@@@@@@@@@@@@@@@@@@@
@@@@@@@@@@@@@@@@@@@@@@@@@@@@@@T.T..........T........@@@@@@@@@@@@...@@.T......TT..T.T.......@@@@@@T.@@@@@@@@@@@@@@@@@@@@@@@@@@@@@@@@@@@@@@@@@@@@@@@@@@@@@@@@@@@@@
@@@@@@@@@@@@@@@@@@@@@@@@@@@@@@@.......T.....TT.....@@@@@@@@@@@@..T.........T..T.T.......T...@@@@@@@@@@@@@@@@@@@@@@@@@@@@@@@@@@@@@@@@@@@@@@@@@@@@@@@@@@@@@@@@@@@@
@@@@@@@@@@@@@@@@@@@@@@@@@@@@@@@@.T...T.....T.T....@@@@@@@@@@@@....T..........T.....T..TT.....@@@@@@@@@@@@@@@@@@@@@@@@@@@@@@@@@@@@@@@@@@@@@@@@@@@@@@@@@@@@@@@@@@@
@@@@@@@@@@@@@@@@@@@@@@@@@@@@@@@@@..TT..........T.@@@@@@.@@@@@...TT.....T..TT...T.T.TT..T...T..@@@@@@@@@@@@@@@@@@@@@@@@@@@@@@@@@@@@@@@@@@@@@@@@@@@@@@@@@@@@@@@@@@
@@@@@@@@@@@@@@@@@@@@@@@@@@@@@@@@@@....T...TTTT..@@@@@@...@@@.T........T.......T............T..@@@@@@@@@@@@@@@@@@@@@@@@@@@@@@@@@@@@@@@@@@@@@@@@@@@@@@@@@@@@@@@@@@
@@@@@@@@@@@@@@@@@@@@@@@@@@@@@@@@@@@............@@@@@@@@T..@..................T.T..........T..@@@@@@@@@@@@@@@@@@@@@@@@@@@@@@@@@@@@@@@@@@@@@@@@@@@@@@@@@@@@@@@@@@@
@@@@@@@@@@@@@@@@@@@@@@@@@@@@@@@@@@@@........T@@@@@@@T@@..........T....T....T.T..TT..T....T.T@@@@@@@@@@@@@@@@@@@@@@@@@@@@@@@@@@@@@@@@@@@@@@@@@@@@@@@@@@@@@@@@@@@@
@@@@@@@@@@@@@@@@@@@@@@@@@@@@@@@@@@@@@....T..@@@@@@@@............T..T...........T.........T.@@@@@@@@@@@@@@@@@@@@@@@@@@@@@@@@@@@@@@@@@@@@@@@@@@@@@@@@@@@@@@@@@@@@@
@@@@@@@@@@@@@@@@@@@@@@@@@@@@@@@@@@@@@@.....@@@@@@@@.............T.....T..TT...............@@@@@@@@@@@@@@@@@@@@@@@@@@@@@@@@@@@@@@@@@@@@@@@@@@@@@@@@@@@@@@@@@@@@@@
@@@@@@@@@@@@@@@@@@@@@@@@@@@@@@@@@@@@@@@...@@@@@@@.......@@T........TTT..TT....T..........@@@@@@@@@@@@@@@@@@@@@@@@@@@@@@@@@@@@@@@@@@@@@@@@@@@@@@@@@@@@@@@@@@@@@@@
@@@@@@@@@@@@@@@@@@@@@@@@@@@@@@@@@@@@@@@@T@@@@@@@..TT....@@......T..TT....T.T..T....T....@@@@@@@@@@@@@@@@@@@@@@@@@@@@@@@@@@@@@@@@@@@@@@@@@@@@@@@@@@@@@@@@@@@@@@@@
@@@@@@@@@@@@@@@@@@@@@@@@@@@@@@@@@@@@@@@@@@@@@@@.....TT.T...T..TT................T......@@@@@@@@@@@@@@@@@@@@@@@@@@@@@@@@@@@@@@@@@@@@@@@@@@@@@@@@@@@@@@@@@@@@@@@@@
@@@@@@@@@@@@@@@@@@@@@@@@@@@@@@@@@@@@@@@@@@@@@@...T.....T..T..........T.............T.T@@@@@@@@@@@@@@@@@@@@@@@@@@@@@@@@@@@@@@@@@@@@@@@@@@@@@@@@@@@@@@@@@@@@@@@@@@
@@@@@@@@@@@@@@@@@@@@@@@@@@@@@@@@@@@@@@@@@@@@@...T..TT.........T...........T..........@@@@@@@@@@@@@@@@@@@@@@@@@@@@@@@@@@@@@@@@@@@@@@@@@@@@@@@@@@@@@@@@@@@@@@@@@@@
@@@@@@@@@@@@@@@@@@@@@@@@@@@@@@@@@@@@@@@@@@@@@......T.......T.T.........T.......T....@@@@@@@@@@@@@@@@@@@@@@@@@@@@@@@@@@@@@@@@@@@@@@@@@@@@@@@@@@@@@@@@@@@@@@@@@@@@
@@@@@@@@@@@@@@@@@@@@@@@@@@@@@@@@@@@@@@@@@@@@@@..........T..T.............T.T.T.....@@@@@@@@@@@@@@@@@@@@@@@@@@@@@@@@@@@@@@@@@@@@@@@@@@@@@@@@@@@@@@@@@@@@@@@@@@@@@
@@@@@@@@@@@@@@@@@@@@@@@@@@@@@@@@@@@@@@@@@@@@@@@...T..T...........T...T.T.T.T......@@@@@@@@@@@@@@@@@@@@@@@@@@@@@@@@@@@@@@@@@@@@@@@@@@@@@@@@@@@@@@@@@@@@@@@@@@@@@@
@@@@@@@@@@@@@@@@@@@@@@@@@@@@@@@@@@@@@@@@@@@@@@@@.T........T..TT........T........@@@@@@@@@@@@@@@@@@@@@@@@@@@@@@@@@@@@@@@@@@@@@@@@@@@@@@@@@@@@@@@@@@@@@@@@@@@@@@@@
@@@@@@@@@@@@@@@@@@@@@@@@@@@@@@@@@@@@@@@@@@@@@@@@@T..........T..................@@@@@@@@@@@@@@@@@@@@@@@@@@@@@@@@@@@@@@@@@@@@@@@@@@@@@@@@@@@@@@@@@@@@@@@@@@@@@@@@@
@@@@@@@@@@@@@@@@@@@@@@@@@@@@@@@@@@@@@@@@@@@@@@@@@@TT.........T....T...........@@@@@@@@@@@@@@@@@@@@@@@@@@@@@@@@@@@@@@@@@@@@@@@@@@@@@@@@@@@@@@@@@@@@@@@@@@@@@@@@@@
@@@@@@@@@@@@@@@@@@@@@@@@@@@@@@@@@@@@@@@@@@@@@@@@@@@..TT......TTT.......T....T@@@@@@@@@@@@@@@@@@@@@@@@@@@@@@@@@@@@@@@@@@@@@@@@@@@@@@@@@@@@@@@@@@@@@@@@@@@@@@@@@@@
@@@@@@@@@@@@@@@@@@@@@@@@@@@@@@@@@@@@@@@@@@@@@@@@@@@@TT.T..TTT.T.T.T.........@@@@@@@@@@@@@@@@@@@@@@@@@@@@@@@@@@@@@@@@@@@@@@@@@@@@@@@@@@@@@@@@@@@@@@@@@@@@@@@@@@@@
@@@@@@@@@@@@@@@@@@@@@@@@@@@@@@@@@@@@@@@@@@@@@@@@@@@@@........T...TT.....T.@@@@@@@@@@@@@@@@@@@@@@@@@@@@@@@@@@@@@@@@@@@@@@@@@@@@@@@@@@@@@@@@@@@@@@@@@@@@@@@@@@@@@@
@@@@@@@@@@@@@@@@@@@@@@@@@@@@@@@@@@@@@@@@@@@@@@@@@@@@@@T.T.T..............@@@@@@@@@@@@@@@@@@@@@@@@@@@@@@@@@@@@@@@@@@@@@@@@@@@@@@@@@@@@@@@@@@@@@@@@@@@@@@@@@@@@@@@
@@@@@@@@@@@@@@@@@@@@@@@@@@@@@@@@@@@@@@@@@@@@@@@@@@@@@@@TT.....TTT.....T.@@@@@@@@@@@@@@@@@@@@@@@@@@@@@@@@@@@@@@@@@@@@@@@@@@@@@@@@@@@@@@@@@@@@@@@@@@@@@@@@@@@@@@@@
@@@@@@@@@@@@@@@@@@@@@@@@@@@@@@@@@@@@@@@@@@@@@@@@@@@@@@@@..T...T........@@@@@@@@@@@@@@@@@@@@@@@@@@@@@@@@@@@@@@@@@@@@@@@@@@@@@@@@@@@@@@@@@@@@@@@@@@@@@@@@@@@@@@@@@
@@@@@@@@@@@@@@@@@@@@@@@@@@@@@@@@@@@@@@@@@@@@@@@@@@@@@@@@@...........T.@@@@@@@@@@@@@@@@@@@@@@@@@@@@@@@@@@@@@@@@@@@@@@@@@@@@@@@@@@@@@@@@@@@@@@@@@@@@@@@@@@@@@@@@@@
@@@@@@@@@@@@@@@@@@@@@@@@@@@@@@@@@@@@@@@@@@@@@@@@@@@@@@@@@@.....T.T..@@@@@@@@@@@@@@@@@@@@@@@@@@@@@@@@@@@@@@@@@@@@@@@@@@@@@@@@@@@@@@@@@@@@@@@@@@@@@@@@@@@@@@@@@@@@
@@@@@@@@@@@@@@@@@@@@@@@@@@@@@@@@@@@@@@@@@@@@@@@@@@@@@@@@@@@.....T.T@@@@@@@@@@@@@@@@@@@@@@@@@@@@@@@@@@@@@@@@@@@@@@@@@@@@@@@@@@@@@@@@@@@@@@@@@@@@@@@@@@@@@@@@@@@@@
@@@@@@@@@@@@@@@@@@@@@@@@@@@@@@@@@@@@@@@@@@@@@@@@@@@@@@@@@@@@..T..@@@@@@@@@@@@@@@@@@@@@@@@@@@@@@@@@@@@@@@@@@@@@@@@@@@@@@@@@@@@@@@@@@@@@@@@@@@@@@@@@@@@@@@@@@@@@@@
@@@@@@@@@@@@@@@@@@@@@@@@@@@@@@@@@@@@@@@@@@@@@@@@@@@@@@@@@@@@@@..@@@@@@@@@@@@@@@@@@@@@@@@@@@@@@@@@@@@@@@@@@@@@@@@@@@@@@@@@@@@@@@@@@@@@@@@@@@@@@@@@@@@@@@@@@@@@@@@
@@@@@@@@@@@@@@@@@@@@@@@@@@@@@@@@@@@@@@@@@@@@@@@@@@@@@@@@@@@@@@@@@@@@@@@@@@@@@@@@@@@@@@@@@@@@@@@@@@@@@@@@@@@@@@@@@@@@@@@@@@@@@@@@@@@@@@@@@@@@@@@@@@@@@@@@@@@@@@@@
@@@@@@@@@@@@@@@@@@@@@@@@@@@@@@@@@@@@@@@@@@@@@@@@@@@@@@@@@@@@@@@@@@@@@@@@@@@@@@@@@@@@@@@@@@@@@@@@@@@@@@@@@@@@@@@@@@@@@@@@@@@@@@@@@@@@@@@@@@@@@@@@@@@@@@@@@@@@@@@@
