type octile
height 134
width 124
map
@@@@@@@@@@@@@@@@@@@@@@@@@@@@@@@@@@@@@@@@@@@@@@@@@@@@@@@@@@@@@@@@@@@@@@@@@@@@@@@@@@@@@@@@@@@@@@@@@@@@@@@@@@@@@@@@@@@@@@@@@@@@
@......T@@@@@@@@@@@@@@@@@@@@@@@@@@@@@@@@@@@@@@@@@@@@@@@@@@@@@@@@@@@@@@@@@@@@@@@@@@@@@@@@@@@@@@@@@@@@@@@@@@@@@@@@@@@@@@@@@@@@
@..T....@@@@@@@@@@@@@@@@@@@@@@@@@@@@@@@@@@@@@@@@@@@@@@@@@@@@@@@@@@@@@@@@@@@@@@@@@@@@@@@@@@@@@@@@@@@@@@@@@@@@@@@@@@@@@@@@@@@@
@T....T.@@@@@@@@@@@@@@@@@@@@@@@@@@@@@@@@@@@@@@@@@@@@@@@@@@@@@@@@@@@@@@@@@@@@@@@@@@@@@@@@@@@@@@@@@@@@@@@@@@@@@@@@@@@@@@@@@@@@
@.T.TT..@@@@@@@@@@@@@@@@@@@@@@@@@@@@@@@@@@@@@@@@@@@@@@@@@@@@@@@@@@@@@@@@@@@@@@@@@@@@@@@@@@@@@@@@@@@@@@@@@@@@@@@@@@@@@@@@@@@@
@T..T.T.@@@@@@@@@@@@@@@@@@@@@@@@@@@@@@@@@@@@@@@@@@@@@@@@@@@@@@@@@@@@@@@@@@@@@@@@@@@@@@@@@@@@@@@@@@@@@@@@@@@@@@@@@@@@@@@@@@@@
@....T..@@@@@@@@@@@@@@@@@@@@@@@@@@@@@@@@@@@@@@@@@@@@@@@@@@@@@@@@@@@@@@@@@@@@@@@@@@@@@@@@@@@@@@@@@@@@@@@@@@@@@@@@@@@@@@@@@@@@
@.T.....@@@@@@@@@@@@@@@@@@@@@@@@@@@@@@@@@@@@@@@@@@@@@@@@@@@@@@@@@@@@@@@@@@@@@@@@@@@@@@@@@@@@@@@@@@@@@@@@@@@@@@@@@@@@@@@@@@@@
@@@@@@@@@@@@@@@@@@@@@@@@@@@@@@@@@@@@@@@@@@@@@@@@@@@@@@@@@@@@@@@@@@@@@@@@@@@@@@@@@@@@@@@@@@@@@@@@@@@@@@@@@@@@@@@@@@@@@@@@@@@@
@@@@@@@@@@@@@@@@@@@@@@@@@@@@@@@@@@@@@@@@@@@@@@@@@@@@@@@@@@@@@@@@@@@@@@@@@@@@@@@@@@@@@@@@@@@@@@@@@@@@@@@@@@@@@@@@@@@@@@@@@@@@
@@@@@@@@@@@@@@@@@@@@@@@@@@@@@@@@@@@@@@@@@@@@@@@@@@@@@@@@@@@@@@@@@@@@@@@@@@@@@@@@@@@@@@@@@@@@@@@@@@@@@@@@@@@@@@@@@@@@@@@@@@@@
@@@@@@@@@@@@@@@@@@@@@@@@@@@@@@@@@@@@@@@@@@@@@@@@@.@@@@@@@@@@@@@@@@@@@@@@@@@@@@@@@@@@@@@@@@@@@@@@@@@@@@@@@@@@@@@@@@@@@@@@@@@@
@@@@@@@@@@@@@@@@@@@@@@@@@@@@@@@@@@@@@@@@@@@@@@@@...@@@@@@@@@@@@@@@@@@@@@@@@@@@@@@@@@@@@@@@@@@@@@@@@@@@@@@@@@@@@@@@@@@@@@@@@@
@@@@@@@@@@@@@@@@@@@@@@@@@@@@@@@@@@@@@@@@@@@@@@......@@@@@@@@@@@@@@@@@@@@@@@@@@@@@@@@@@@@@@@@@@@@@@@@@@@@@@@@@@@@@@@@@@@@@@@@
@@@@@@@@@@@@@@@@@@@@@@@@@@@@@@@@@@@@@@@@@@@@@....T...@@@@@@@@@@@@@@@@@@@@@@@@@@@@@@@@@@@@@@@@@@@@@@@@@@@@@@@@@@@@@@@@@@@@@@@
@@@@@@@@@@@@@@@@@@@@@@@@@@@@@@@@@@@@@@@@@@@@..T..T....@@@@@@@@@@@@@@@@@@@@@@@@@@@@@@@@@@@@@@@@@@@@@@@@@@@@@@@@@@@@@@@@@@@@@@
@@@@@@@@@@@@@@@@@@@@@@@@@@@@@@@@@@@@@@@@@@@.......T.TT.@@@@@@@@@@@@@@@@@@@@@@@@@@@@@@@@@@@@@@@@@@@@@@@@@@@@@@@@@@@@@@@@@@@@@
@@@@@@@@@@@@@@@@@@@@@@@@@@@@@@@@@@@@@@@@@@......@@...T..@@@@@@@@@@@@@@@@@@@@@@@@@@@@@@@@@@@@@@@@@@@@@@@@@@@@@@@@@@@@@@@@@@@@
@@@@@@@@@@@@@@@@@@@@@@@@@@@@@@@@@@@@@@@@@......@@@@......@@@@@@@@@@@@@@@@@@@@@@@@@@@@@@@@@@@@@@@@@@@@@@@@@@@@@@@@@@@@@@@@@@@
@@@@@@@@@@@@@@@@@@@@@@@@@@@@@@@@@@@@@@@@..T...@@@@@....T..@@@@@@@@@@@@@@@@@@@@@@@@@@@@@@@@@@@@@@@@@@@@@@@@@@@@@@@@@@@@@@@@@@
@@@@@@@@@@@@@@@@@@@@@@@@@@@@@@@@@@@@@@@.....T@@@@@@@.T.....@@@@@@@@@@@@@@@@@@@@@@@@@@@@@@@@@@@@@@@@@@@@@@@@@@@@@@@@@@@@@@@@@
@@@@@@@@@@@@@@@@@@@@@@@@@@@@@@@@@@@@@@......@@@@@@@@.T...T.T.@@@@@@@@@@@@@@@@@@@@@@@@@@@@@@@@@@@@@@@@@@@@@@@@@@@@@@@@@@@@@@@
@@@@@@@@@@@@@@@@@@@@@@@@@@@@@@@@@@@@@.T....@@@@@@@@@..T.....T.@@@@@@@@@@@@@@@@@@@@@@@@@@@@@@@@@@@@@@@@@@@@@@@@@@@@@@@@@@@@@@
@@@@@@@@@@@@@@@@@@@@@@@@@@@@@@@@@@@@.....T@@@@@@@@@@@..T.T...T.@@@@@@@@@@@@@@@@@@@@@@@@@@@@@@@@@@@@@@@@@@@@@@@@@@@@@@@@@@@@@
@@@@@@@@@@@@@@@@@@@@@@@@@@@@@@@@@@.TT.T..@@@@@@@..@@@T.T...TTT..@@@@@@@@@@@@@@@@@@@@@@@@@@@@@@@@@@@@@@@@@@@@@@@@@@@@@@@@@@@@
@@@@@@@@@@@@@@@@@@@@@@@@@@@@@@@@@.T...TT@@@@@@@..T.@@...T.....T.@@@@@@@@@@@@@@@@@@@@@@@@@@@@@@@@@@@@@@@@@@@@@@@@@@@@@@@@@@@@
@@@@@@@@@@@@@@@@@@@@@@@@@@@@@@@@...T...@@@@@@@.........@@@@..T....@@@@@@@@@@@@@@@@@@@@@@@@@@@@@@@@@@@@@@@@@@@@@@@@@@@@@@@@@@
@@@@@@@@@@@@@@@@@@@@@@@@@@@@@@@...T...@@@@@@@..........@@@@@T.....T@@@@@@@@@@@@@@@@@@@@@@@@@@@@@@@@@@@@@@@@@@@@@@@@@@@@@@@@@
@@@@@@@@@@@@@@@@@@@@@@@@@@@@@@@..TT..@@@@@@@....T.....T.@@@@@.......@@@@@@@@@@@@@@@@@@@@@@@@@@@@@@@@@@@@@@@@@@@@@@@@@@@@@@@@
@@@@@@@@@@@@@@@@@@@@@@@@@@@@@.T.....@@@@@@@...T.T.T....@@@@@@..T.....@@@@@@@@@@@@@@@@@@@@@@@@@@@@@@@@@@@@@@@@@@@@@@@@@@@@@@@
@@@@@@@@@@@@@@@@@@@@@@@@@@@@.....T.@@@@@@@@.....T.....@@@@@@@.T...T...@@@@@@@@@@@@@@@@@@@@@@@@@@@@@@@@@@@@@@@@@@@@@@@@@@@@@@
@@@@@@@@@@@@@@@@@@@@@@@@@@@..T.T..@@@@@@@@@@T......T.@@@@@@@@.TT.....T.@@@@@@@@@@@@@@@@@@@@@@@@@@@@@@@@@@@@@@@@@@@@@@@@@@@@@
@@@@@@@@@@@@@@@@@@@@@@@@@@.......T@@@@@@@@@@@.T.....@@@@@@@@@...T....TT.@@@@@@@@@@@@@@@@@@@@@@@@@@@@@@@@@@@@@@@@@@@@@@@@@@@@
@@@@@@@@@@@@@@@@@@@@@@@@@.T.......@@@@@@@@@@@@T.T..@@@@@@@T.@...TT.T.....@@@@@@@@@@@@@@@@@@@@@@@@@@@@@@@@@@@@@@@@@@@@@@@@@@@
@@@@@@@@@@@@@@@@@@@@@@@@.T.....T..@@@..@@@@@@@@...@@@@@@@....T..@@...T....@@@@@@@@@@@@@@@@@@@@@@@@@@@@@@@@@@@@@@@@@@@@@@@@@@
@@@@@@@@@@@@@@@@@@@@@@@T..T.T.@...@@TT.@@@@@@@@@T@@@@@@@@...T..@@@@@T.T....@@@@@@@@@@@@@@@@@@@@@@@@@@@@@@@@@@@@@@@@@@@@@@@@@
@@@@@@@@@@@@@@@@@@@@@@T......@@@..@TTT.T@@@@@@@@@@@@@@@@@.T.T..T@@@@....TT..@@@@@@@@@@@@@@@@@@@@@@@@@@@@@@@@@@@@@@@@@@@@@@@@
@@@@@@@@@@@@@@@@@@@@@..T..T.@@@@.T.......@@@@@@@@@@@@@@@...T.TT@@@@@@.T......@@@@@@@@@@@@@@@@@@@@@@@@@@@@@@@@@@@@@@@@@@@@@@@
@@@@@@@@@@@@@@@@@@@@..T....@@@@@.T..TT.T..@@@@@@@@@@@@@.......@@@@@@@....T.....@@@@@@@@@@@@@@@@@@@@@@@@@@@@@@@@@@@@@@@@@@@@@
@@@@@@@@@@@@@@@@@@@....T..@@@@@.....T......@@@@@@@@@@@@...T..@@@@@@@@@..........@@@@@@@@@@@@@@@@@@@@@@@@@@@@@@@@@@@@@@@@@@@@
@@@@@@@@@@@@@@@@@@.....T.@@@@@@.TTT...T....@@@@@@@@@@.......@@@@@@@@@@...T.TT...T@@@@@@@@@@@@@@@@@@@@@@@@@@@@@@@@@@@@@@@@@@@
@@@@@@@@@@@@@@@@@.......@@@@@@@@.....T...T@@@@@@@@@@@@....T@@@@@@@...@T..T.T.T...T@@@@@@@@@@@@@@@@@@@@@@@@@@@@@@@@@@@@@@@@@@
@@@@@@@@@@@@@@@@........@@@@@@@@@T.......@@@@@@@@@@@@@@...@@@@@@@.T.T......T......@@@@@@@@@@@@@@@@@@@@@@@@@@@@@@@@@@@@@@@@@@
@@@@@@@@@@@@@@@...T.T..@@@@@@@@@@@TT..T.@@@@@@@@@@@@@@@@.@@@@@@@T...T...@@.T..T..T..@@@@@@@@@@@@@@@@@@@@@@@@@@@@@@@@@@@@@@@@
@@@@@@@@@@@@@@.....T..T@@@@@@@@@@@@...T@@@@@@@@.@@@@@@@@@@@@@@@@@T....TT.@@....TT....@@@@@@@@@@@@@@@@@@@@@@@@@@@@@@@@@@@@@@@
@@@@@@@@@@@@@.........T@@@.@@@@@@@@@@T@@@@@@@@@.T.T@@@@@@@@@@@@@...T..T.@@@@........T.@@@@@@@@@@@@@@@@@@@@@@@@@@@@@@@@@@@@@@
@@@@@@@@@@@T...........@@...@@@@@@@@@@@@@@@@@@.....@@@@@@@@@@@@...T...T@@@@@@.TT.....@@@@@@@@@@@@@@@@@@@@@@@@@@@@@@@@@@@@@@@
@@@@@@@@@@........@@...T....T@@@@@@@@@@@@@@@.T.......@@@@@@@@@T.T..TT.@@@@@@@...T...@@@@@@@@@@@@@@@@@@@@@@@@@@@@@@@@@@@@@@@@
@@@@@@@@@@..T...T@@@@.....T...@@@@@@@@@@@@@..........@@@@@@@@.......T@@@@@@@T.....T@@@@@@@@@@@@@@@@@@@@@@@@@@@@@@@@@@@@@@@@@
@@@@@@@@@.T......@@@@..........@@@@@@@@@@@..T........T@@@@@@@@......@@@@@@@.......@@@@@@@@@@@@@@@@@@@@@@@@@@@@@@@@@@@@@@@@@@
@@@@@@@@..TT...T@@@.............@@@@@@@@@.........T..T.T@@@@@@@....@@@@@@@@T.T.T.@@@@@@@@@@@@@@@@@@@@@@@@@@@@@@@@@@@@@@@@@@@
@@@@@@@...TT...@@@@@.T...TT...T.@@@@@@@@......T........T.@@@@@@@..@@@@@@@@....T.@@@@@@@@@@@@@@@@@@@@@@@@@@@@@@@@@@@@@@@@@@@@
@@@@@@........@@@@@@@..........@@@@@@@@.....T.............@@@@@@@@@@@@@@@.T.T..@@@@@@@@@@@@@@@@@@@@@@@@@@@@@@@@@@@@@@@@@@@@@
@@@@@.T......T@@@@@@@@........@@@@@@@@.TT....T......TT....@@@@@@@@@@@@@@..T...@@@@@@@@@@@@@@@@@@@@@@@@@@@@@@@@@@@@@@@@@@@@@@
@@@@..........@@@@@@@@@......@@@@@@@@T.........@@....T...T..@@@@@@@@@@@@.TTTT@@@@@@@@@@@@@.T@@@@@@@@@@@@@@@@@@@@@@@@@@@@@@@@
@@@......T.TTT.@@@@@@@@@....@@@@@@@@..T.T.T...@@@@........TT.@@@@@@@@@@T.T.T@@@@@@@@@@@@@@..T@@@@@@@@@@@@@@@@@@@@@@@@@@@@@@@
@@@@.TT......T..@@@@@@@@@..@@@@@@@@T..T.....T@@@@@@.........@@@@@@@@@@@..TT@@@@@@@@@@@@@@@@...@@@@@@@@@@@@@@@@@@@@@@@@@@@@@@
@@@@@....T..T.TTT@@@@@@@@@@@@@@@@@.T........@@@@@@@@T..T...@@@@@@@@@@@.....@@@@@@@@@@@@@@@@@T.T@@@@@@@@@@@@@@@@@@@@@@@@@@@@@
@@@@@@......TT....@@@@@@@@@@@@@@@.T.T...TT.@@@@@@@@@......@@@@@@@@@@@......@@@@@@@@@@@@@@@@@@...@@@@@@@@@@@@@@@@@@@@@@@@@@@@
@@@@@@@....TTT.T...@@@@@@@@@@@@@.T.T.T.T.T@@@@@@@@@..TT..@@@@@@@@@@@@.TT...@@@@@@@@@@.@@@@@@@T.T@@@@@@@@@@@@@@@@@@@@@@@@@@@@
@@@@@@@@..T.........@@@@@@@@@@@.T....TTT.@@@@@@@@@@.T...@@@@@@@@@@@@@T..T..@@@@@@@@@...@@@@@..T@@@@@@@@@@@@@@@@@@@@@@@@@@@@@
@@@@@@@@@.T..T...TTT.@@@@@@@@@@...T.T..TT@@@@@@@@@...TT@@@@@@@@@@@@.T.T....@@@@@@@@@....@@.T....@@@@@@@@@@@@@@@@@@@@@@@@@@@@
@@@@@@@@@@.....T....T.@@@@@@@@@T..........@@@@@@@..TT.@@@@@@@@@@@@..T.T.T.@@@@@@@@@.T.T.@@..T........@@@@@@@@@@@@@@@@@@@@@@@
@@@@@@@@@@@........T...@@@@@@@@.........TTT@@@@@.....@@@@@@@@@@@@T.......@@@@@@@@@@.T.................@@@@@@@@@@@@@@@@@@@@@@
@@@@@@@@@@@@..T.........@@@@@@@@...........@@@@..T..@@@@@@@@@@@@...TTT..@@@@@@@@@@@@T..TT.....T@.......@@@@@@@@@@@@@@@@@@@@@
@@@@@@@@@@@@@............@@@@@@@.T.........TT......@@@@@@@@@@@@......T..T@@@@@@@@@@@@.....T..T@@@...T..@@@@@@@@@@@@@@@@@@@@@
@@@@@@@@@@@@@@T.T..T.TT...@@@@@@T.T....T...T.T.T..@@@@@@@@@@@........T..@@@@@@@@@@@@@@@....T.@@@@@.....@@@@@@@@@@@@@@@@@@@@@
@@@@@@@@@@@@@@@T....T......@@@@@.T...T......T...T@@@@@@@@@@@..TT.......@@@@@@@@@@@@@@@@@.T..@@@@@@@...T@@@@@@@@@@@@@@@@@@@@@
@@@@@@@@@@@@@@@@............@@@@.T...TT..TTT.TT.@@@@@@@@@@@@.....T.T.TT@@@@@@@@@@@@@@@@@@.T@@@@@@@@@...T@@T@@@@@@@@@@@@@@@@@
@@@@@@@@@@@@@@@@@..T.TT.....T.@@.....T......T.T@@@@@@@@@@@@..T....T....@@@@@@@@@@@@@@@@@@@@@@@@@@@@@........@@@@@@@@@@@@@@@@
@@@@@@@@@@@@@@@@@@..T........T......@@@@......@@@@@@@@@@@..T..T...T......@@@@@@@@@@@@@@@@@@@@@@@@@@@..T....@@@@@@@@@@@@@@@@@
@@@@@@@@@@@@@@@@@@@@@@@@@T.....T...@@@@@@...@@@@@@@@@@@@.........T..T.....@@@@@@@@@@@@@@@@@@@@@@@@@@....T..@@@@@@@@@@@@@@@@@
@@@@@@@@@@@@@@@@@@@@@@@@@@.........@@@@@@@T@@@@@@@@@@@@......TT.T..T.T..T.@@@@@@@@@@@@@@@@@@@@@@@@@@.T..T....@@@@@@@@@@@@@@@
@@@@@@@@@@@@@@@@@@@@@@@@@@@.TT..T...@@@@@@@@@@@@@@@@@@@..........T.TT..T...T.@@@@@@@@@@@@@@@@@@@@@@@.T.....T..@@@@@@@@@@@@@@
@@@@@@@@@@@@@@@@@@@@@@@@@@@@T.......T@@@@@@@@@@@@@@@@........T.............T.@@@@@@@@@@@@@@@@@@@@@@@.TT.....@..@@@@@@@@@@@@@
@@@@@@@@@@@@@@@@@@@@@@@@@@@@@T...T.T..@@@@@@@@@@@@@@........T..T.T..........T.@@@@@@@@@@@@@@@@@@@@@@.TT....@@@....@@@@@@@@@@
@@@@@@@@@@@@@@@@@@@@@@@@@@@@@T..T.....@@@@@@@@@@@@@.....T......T.......T.......T@@@@@@@@@@@@@@@@@@@@......@@@@@...T@@@@@@@@@
@@@@@@@@@@@@@@@@@@@@@@@@@@@@@..TT..T...@@@@@@@@@@@...T......TT..TT............T..@@@@@@@@@@@@@@@@@@....T.@@@@@@@..T.@@@@@@@@
@@@@@@@@@@@@@@@@@@@@@@@@@@@@@.T.T.......@@@@@@@@@@T..T..T....T..T..T....T.........@@@@@@@@@@@@@@@@.......@@@@@@@.TT..@@@@@@@
@@@@@@@@@@@@@@@@@@@@@@@@@.@@@T...T.T....@@@@@@@@@..T.T.T.........T..T..T..........@@@@@@@@@@@@@.T....TT....@@@@@T.....@@@@@@
@@@@@@@@@@@@@@@@@@@@@@@@...@@.....T.TT..T@@@@@@@@@...T............T..T.T............@@@@@@@@@@@...........@@@@@...T....@@@@@
@@@@@@@@@@@@@@@@@@@@@@@T..TT......T......T@@@@@@@@@..........T..T..T....T...T.....T..@@@@@@@@@@T...TTT.T.T@@@@......T..@@@@@
@@@@@@@@@@@@@@@@@@@@@@...........@......T.@@@@@@@@@@..T...TT.T.T...TTT.....TT........@@@@@@@@@@.T..TT@@.TT@@@..T...T..@@@@@@
@@@@@@@@@@@@@@@@@@@@@T...T.T....@@@.......@@@@@@@@@@@......T...........T....T..........@@@@@@@@.....@@@@@...T.....T..@@@@@@@
@@@@@@@@@@@@@@@@@@@@..T....TT.TT.@@@TTT.TT@@@@@@@@@@@@...T...TT.........T..T..T.T.TT....@@@@.@@....@@@@@@@..........@@@@@@@@
@@@@@@@@@@@@@@@@@@.T.......T...T@@@@......T@@@@@@@@@@@@...T..T...TTT....T....T....T.....@@@....T...@@@@@@@@T.T.T.T.@@@@@@@@@
@@@@@@@@@@@@@@@@@TT......T.T...@@@@@..T..T..@@@@@@@@@@@@TT..TT..........T....TT..............TT..T@@@@@@@@@@T.....@@@@@@@@@@
@@@@@@@@@@@@@@@@TT........T..T@@@@@@@........@@@@@@@@@@@@T..TT..T.TT...T......T...T...........TT.T@@@@@@@@@@@T...@@@@@@@@@@@
@@@@@@@@@@@@@@@T.T...T..T....@@@@@@@@.........@@@@@@@@@@@@....T..........T..........T.TT..........@@@@@@@@@@@@..@@@@@@@@@@@@
@@@@@@@@@@@@@@@T..T..T...T..@@@@@@@@@@.T.......@@@@@@@@@@@@.T........T...T......T..T.......T...T.T@@@@@@@@@@@@@@@@@@@@@@@@@@
@@@@@@@@@@@@@@@@..TT......T@@@@@@@@@@@.......T..@@@@@@@@@@@@................T.......T.T...T......@@@@@@@@@@@@@@@@@@@@@@@@@@@
@@@@@@@@@@@@@@@@@..TT....@@@@@@@@@@@@T...T.......@@@@@@@@@@@@TT.....T.......T.T..........T.T..TT@@@@@@@@@@@@@@@@@@@@@@@@@@@@
@@@@@@@@@@@@@@@@@@....T.@@@@@@@@@@@@..............@@@@@@@@@@@@T..T....T.......TT..T..........T..@@@@@@@@@@@@@@@@@@@@@@@@@@@@
@@@@@@@@@@@@@@@@@@@....@@@@@@@@@@@@..TT...T.........@@@@@@@@@@@TTTT.........TT...T...........TT..@@@@@@@@@@@@@@@@@@@@@@@@@@@
@@@@@@@@@@@@@@@@@@@@..@@@@@@@@@@@@T...........T.T..T.@@@@@@@@@@@...T....TT...T.T....T..............@@@@@@@@@@@@@@@@@@@@@@@@@
@@@@@@@@@@@@@@@@@@@@@@@@@@@@@@@@@........T.TT@@T...TT.@@@@@@@@@@@.....T...T...T..........T...T.....@@@@@@@@@@@@@@@@@@@@@@@@@
@@@@@@@@@@@@@@@@@@@@@@@@@@@@@@@@...T.....T.T.@@@.......@@@@@@@@@@@...........T..T........T.....T....@@@@@@@@@@@@@@@@@@@@@@@@
@@@@@@@@@@@@@@@@@@@@@@@@@@@@@@@.T...........@@@@TT.TT...@@@@@@@@@@@.TT.T....T.......T..T.......T.TT.T.@@@@@@@@@@@@@@@@@@@@@@
@@@@@@@@@@@@@@@@@@@@@@@@@@@@@@......T.......@@@@.......T.@@@@@@@@@@@.T........TTT.T....T..T.T...T..T..T@@@@@@@@@@@@@@@@@@@@@
@@@@@@@@@@@@@@@@@@@@@@@@@@@@@...T.T.TT.T.@@@@@@@T....T...T@@@@@@@@@@@........TT...............T.TTT....T@@@@@@@@@@@@@@@@@@@@
@@@@@@@@@@@@@@@@@@@@@@@@@@@@......T....T.@@@@@@@@@@@@@@....@@@@@@@@@@@...............T.......T.T...T.....@@@@@@@@@@@@@@@@@@@
@@@@@@@@@@@@@@@@@@@@@@@@@@@TTT...........@@@@@@@@@@@@@@@...T@@@@@@@@@@@............T.T.....TT....T.TT...@@@@@@@@@@@@@@@@@@@@
@@@@@@@@@@@@@@@@@@@@@@@@@@@.TT....T...T..@@@@@@@@@@@@@@@.....@@@@@@@@@@@.T......T.....TT.TT.T........T.@@@@@@@@@@@@@@@@@@@@@
@@@@@@@@@@@@@@@@@@@@@@@@@@@@T..T.........@@@@@@@@@@@@@@@....TT@@@@@@@@@@@.T..T.T.T.........TT.......T.@@@@@@@@@@@@@@@@@@@@@@
@@@@@@@@@@@@@@@@@@@@@@@@@@@@@....T........@@@@@@@@@@@@@@T......@@@@@@@@@@@T.......T.............T.T.TT.@@@@@@@@@@@@@@@@@@@@@
@@@@@@@@@@@@@@@@@@@@@@@@@@@@@@....T..T.TT.....@@@@@@@@@@T...T...@@@@@@@@@@@..T...T...TTT.T.T.TT.......T@@@@@@@@@@@@@@@@@@@@@
@@@@@@@@@@@@@@@@@@@@@@@@@@@@@@@...T.......T...T...@@@@@@@....T..T@@@@@@@@@@@......T.T.....T.......T....@@@@@@@@@@@@@@@@@@@@@
@@@@@@@@@@@@@@@@@@@@@@@@@@@@@@@@..T.........TTT....@@@@@@T.....T..@@@@@@@@@@@...............T....TT...@@@@@@@@@@@@@@@@@@@@@@
@@@@@@@@@@@@@@@@@@@@@@@@@@@@@@@@@.T......TT.T...TTT.@@@@@.........T@@@@@@@@@@.....T..T.T....T.....T..@@@@@@@@@@@@@@@@@@@@@@@
@@@@@@@@@@@@@@@@@@@@@@@@@@@@@@@@@@...T.TT..T.T...T..@@@@@.T.@.....T.@@@@@@@@@@.T....T........T.....T@@@@@@@@@@@@@@@@@@@@@@@@
@@@@@@@@@@@@@@@@@@@@@@@@@@@@@@@@@@@TT.T.T....T.T....T.@@@TT@@@@......@@@@@@@@@@.T.TT....T..........@@@@@@@@@@@@@@@@@@@@@@@@@
@@@@@@@@@@@@@@@@@@@@@@@@@@@@@@@@@@@@..TT...TTT......@@@@@..@@@@.......@@@@@@@@@......T.........@.T@@@@@@@@@@@@@@@@@@@@@@@@@@
@@@@@@@@@@@@@@@@@@@@@@@@@@@@@@@@@@@@@T..T....T..TT.@@@@@...@@@@........@@@@@@@@@...TT...TT.T.T@@@@@@@@@@@@@@@@@@@@@@@@@@@@@@
@@@@@@@@@@@@@@@@@@@@@@@@@@@@@@@@@@@@@@.......T.TT...@@@@.T.@@.....T....T@@@@@@@@@.........T.T@@@@@@@@@@@@@@@@@@@@@@@@@@@@@@@
@@@@@@@@@@@@@@@@@@@@@@@@@@@@@@@@@@@@@@@......T.T.....@@@........T......T@@@@@@@@@@.T.T......@@@@@@@@@@@@@@@@@@@@@@@@@@@@@@@@
@@@@@@@@@@@@@@@@@@@@@@@@@@@@@@@@@@@@@@@@....T....T....@@T.........T....@@@@@@@@@@@@T..T....@@@@@@@@@@@@@@@@@@@@@@@@@@@@@@@@@
@@@@@@@@@@@@@@@@@@@@@@@@@@@@@@@@@@@@@@@@@T.....T........T.............@@@@@@@@@@@@@@......@@@@@@@@@@@@@@@@@@@@@@@@@@@@@@@@@@
@@@@@@@@@@@@@@@@@@@@@@@@@@@@@@@@@@@@@@@@@@T....T...............TT....@@@@@@@@@@@@@@@@.T..@@@@@@@@@@@@@@@@@@@@@@@@@@@@@@@@@@@
@@@@@@@@@@@@@@@@@@@@@@@@@@@@@@@@@@@@@@@@@@@...T..T.T..T..TT...T.....@@@@@@@@@@@@@@@@@@.T@@@@@@@@@@@@@@@@@@@@@@@@@@@@@@@@@@@@
@@@@@@@@@@@@@@@@@@@@@@@@@@@@@@@@@@@@@@@@@@@@...T....T.TT...TT...T..@@@@@@@@@@@@@@@@@@@@@@@@@@@@@@@@@@@@@@@@@@@@@@@@@@@@@@@@@
@@@@@@@@@@@@@@@@@@@@@@@@@@@@@@@@@@@@@@@@@@@@@....T..........T.....@@@@@@@@@@@@@@@@@@@@@@@@@@@@@@@@@@@@@@@@@@@@@@@@@@@@@@@@@@
@@@@@@@@@@@@@@@@@@@@@@@@@@@@@@@@@@@@@@@@@@@@@@...........T.T.....@@@@@@@@@@@@@@@@@@@@@@@@@@@@@@@@@@@@@@@@@@@@@@@@@@@@@@@@@@@
@@@@@@@@@@@@@@@@@@@@@@@@@@@@@@@@@@@@@@@@@@@@@@@.T.T.............@@@@@@@@@@@@@@@@@@@@@@@@@@@@@@@@@@@@@@@@@@@@@@@@@@@@@@@@@@@@
@@@@@@@@@@@@@@@@@@@@@@@@@@@@@@@@@@@@@@@@@@@@@@@@....T.....TT.T.@@@@@@@@@@@@@@@@@@@@@@@@@@@@@@@@@@@@@@@@@@@@@@@@@@@@@@@@@@@@@
@@@@@@@@@@@@@@@@@@@@@@@@@@@@@@@@@@@@@@@@@@@@@@@@@.......T.T...@@@@@@@@@@@@@@@@@@@@@@@@@@@@@@@@@@@@@@@@@@@@@@@@@@@@@@@@@@@@@@
@@@@@@@@@@@@@@@@@@@@@@@@@@@@@@@@@@@@@@@@@@@@@@@@@@T.....T.T..@@@@@@@@@@@@@@@@@@@@@@@@@@@@@@@@@@@@@@@@@@@@@@@@@@@@@@@@@@@@@@@
@@@@@@@@@@@@@@@@@@@@@@@@@@@@@@@@@@@@@@@@@@@@@@@@@@@........T@@@@@@@@@@@@@@@@@@@@@@@@@@@@@@@@@@@@@@@@@@@@@@@@@@@@@@@@@@@@@@@@
@@@@@@@@@@@@@@@@@@@@@@@@@@@@@@@@@@@@@@@@@@@@@@@@@@@@.......@@@@@@@@@@@@@@@@@@@@@@@@@@@@@@@@@@@@@@@@@@@@@@@@@@@@@@@@@@@@@@@@@
@@@@@@@@@@@@@@@@@@@@@@@@@@@@@@@@@@@@@@@@@@@@@@@@@@@@@.T.T.@@@@@@@@@@@@@@@@@@@@@@@@@@@@@@@@@@@@@@@@@@@@@@@@@@@@@@@@@@@@@@@@@@
@@@@@@@@@@@@@@@@@@@@@@@@@@@@@@@@@@@@@@@@@@@@@@@@@@@@@@...@@@@@@@@@@@@@@@@@@@@@@@@@@@@@@@@@@@@@@@@@@@@@@@@@@@@@@@@@@@@@@@@@@@
@@@@@@@@@@@@@@@@@@@@@@@@@@@@@@@@@@@@@@@@@@@@@@@@@@@@@@@.@@@@@@@@@@@@@@@@@@@@@@@@@@@@@@@@@@@@@@@@@@@@@@@@@@@@@@@@@@@@@@@@@@@@
@@@@@@@@@@@@@@@@@@@@@@@@@@@@@@@@@@@@@@@@@@@@@@@@@@@@@@@@@@@@@@@@@@@@@@@@@@@@@@@@@@@@@@@@@@@@@@@@@@@@@@@@@@@@@@@@@@@@@@@@@@@@
@@@@@@@@@@@@@@@@@@@@@@@@@@@@@@@@@@@@@@@@@@@@@@@@@@@@@@@@@@@@@@@@@@@@@@@@@@@@@@@@@@@@@@@@@@@@@@@@@@@@@@@@@@@@@@@@@@@@@@@@@@@@
@@@@@@@@@@@@@@@@@@@@@@@@@@@@@@@@@@@@@@@@@@@@@@@@@@@@@@@@@@@@@@@@@@@@@@@@@@@@@@@@@@@@@@@@@@@@@@@@@@@@@@@@@@@@@@@@@@@@@@@@@@@@
