type octile
height 102
width 92
map
@@@@@@@@@@@@@@@@@@@@@@@@@@@@@@@@@@@@@@@@@@@@@@@@@@@@@@@@@@@@@@@@@@@@@@@@@@@@@@@@@@@@@@@@@@@@
@@@@@@@@@@@@@@@@@@@@@@@@@@@@@@@@@@@@@@@@@@@@@@@@@@@@@@@@@@@@@@@@@@@@@@@@@@@@@@@@@@@@@@@@@@@@
@@@@@@@@@@@@@@@@@@@@@@@@@@@@@@@@@@@@@@@@@@@@@@@@@@@@@@@@@@@@@@@@@@@@@@@@@@@@@@@@@@@@@@@@@@@@
@@@@@@@@@@@@@@@@@@@@@@@@@@@@@@@@@@@@@@@@@@@@@@@@@@@@@@@@@@@@@@@@@@@@@@@@@@@@@@@@@@@@@@@@@@@@
@@@@@@@@@@@@@@@@@@@@@@@@@@@@@@@@@@@@@@@@@@@@@@@@@@@@@@@@@@@@@@@@@@@@@@@@@@@@@@@@@@@@@@@@@@@@
@@@@@@@@@@@@@@@@@@@@@@@@@@@@@@@@@@@@@@@@@@@@@@@@@@@@@@@@@@@@@@@@@@@@@@@@@@@@@@@@@@@@@@@@@@@@
@@@@@@@@@@@@@@@@@@@@@@@@@@@@@@@@@@@@@@@@@@@@@@@@@@@@@@@@@@@@@@@@@@@@@@@@@@@@@@@@@@@@@@@@@@@@
@@@@@@@@@@@@@@@@@@@@@@@@@@@@@@@@@@@@@@@@@@@@@@@@@@@@@@@@@@@@@@@@@@@@@@@@@@@@@@@@@@@@@@@@@@@@
@@@@@@@@@@@@@@@@@@@@@@@@@@@@@@@@@@@@@@@@@@@@@@@@@@@@@@@@@@@@@@@@@@@@@@@@@@@@@@@@@@@@@@@@@@@@
@@@@@@@@@@@@@@@@@@@@@@@@@@@@@@@@@@@@@@@@@@@@@@@@@@@@@@@@@@@@@@@@@@@@@@@@@@@@@@@@@@@@@@@@@@@@
@@@@@@@@@@@@@@@@@@@@@@@@@@@@@@@@@@@@@@@@@@@@@@@@@@@@@@@@@@@@@@@@@@@@@@@@@@@@@@@@@@@@@@@@@@@@
@@@@@@@@@@@@@@@@@@@@@@@@@@@@@@@@@@@@@@@@@@@@@@@@@@@@@@@@@@@@@@@@@@@@@@@@@@@@@@@@@@@@@@@@@@@@
@@@@@@@@@@@@@@@@@@@@@@@@@@@@@@@@@@@@@@@@@@@@@@@@@@@@@@@@@@@@@@@@@@@@@@@@@@@@@@@@@@@@@@@@@@@@
@@@@@@@@@@@@@@@@@@@@@@@@@@@@@@@@@@@@@@@@@@@@@@@@@@@@@@@@@@@@@@@@@@@@@@@@@@@@@@@@@@@@@@@@@@@@
@@@@@@@@@@@@@@@@@@@@@@@@@@@@@@@@@@@@@@@@@@@@@@@@@@@@@@@@@@@@@@@@@@@@@@@@@@@@@@@@@@@@@@@@@@@@
@@@@@@@@@@@@@@@@@@@@@@@@@@@@@@@@@@@@@@@@@@@@@@@@@@@@@@@@@@@@@@@@@@@@@@@@@@@@@@@@@@@@@@@@@@@@
@@@@@@@@@@@@@@@@@@@@@@@@@@@@@@@@@@@@@@@@@@@@@@@@@@@@@@@@@@@@@@@@@@@@@@@@@@@@@@@@@@@@@@@@@@@@
@@@@@@@@@@@@@@@@@@@@@@@@@@@@@@@@@@@@@@@@@@@@@@@@@@@@@@@@@@@@@@@@@@@@@@@@@@@@@@@@@@@@@@@@@@@@
@@@@@@@@@@@@@@@@@@@@@@@@@@@@@@@@@@@@@@@@@@@@@@@@@@@@@@@@@@@@@@@@@@@@@@@@@@@@@@@@@@@@@@@@@@@@
@@@@@@@@@@@@@@@@@@@@@@@@@@@@@@@@@@@@@@.T...T........T..T.@@@@@@@@@@@@@@@@@@@@@@@@@@@@@@@@@@@
@@@@@@@@@@@@@@@@@@@@@@@@@@@@@@@@@....T.T.......T..T....T..T@@@@@@@@@@@@@@@@@@@@@@@@@@@@@@@@@
@@@@@@@@@@@@@@@@@@@@@@@@@@@@@.T...............T.TT.T......T@@@@@@@@@@@@@@@@@@@@@@@@@@@@@@@@@
@@@@@@@@@@@@@@@@@@@@@@@@@@@.....T.....T..........T.TT.T....@@@@@@@@@@@@@@@@@@@@@@@@@@@@@@@@@
@@@@@@@@@@@@@@@@@@@@@@@@@..................TT...T.T.....T..@@@@@@@@@@@@@@@@@@@@@@@@@@@@@@@@@
@@@@@@@@@@@@@@@@@@@@@@@.T...........T..T....T...T..TTT.T..T@@@@@@@@@@@@@@@@@@@@@@@@@@@@@@@@@
@@@@@@@@@@@@@@@@@@@@@.T........................T........TT.@@@@@@@@@@@@@@@@@@@@@@@@@@@@@@@@@
@@@@@@@@@@@@@@@@@@@@...........T.....T...T.T.....T..TT..T..@@@@@@@@@@@@@@@@@@@@@@@@@@@@@@@@@
@@@@@@@@@@@@@@@@@@@..................TT.............T....T.@@@@@@@@@@@@@@@@@@@@@@@@@@@@@@@@@
@@@@@@@@..@@@@@@@..............T.T....TT.@@...T.TT@@.......@@@@@@@@@@@@@@@@@@@@@@@@@@@@@@@@@
@@@@@@@@.T.@@@@@.............T....TTT...@@@@..T.T@@@@......@@@@@@@@@@@@@@@@@@@@@@@@@@@@@@@@@
@@@@@@@...T@@@@..T......T...T...@@T......T..........T.....T@@@@@T.@@@@@@@@@@@@@@@@@...@@@@@@
@@@@@@@..T..@@T..T...T...T...T.@@@@.T..@@@@@@@@@@@@@@T.....@@@@@...@@@@@@@@@@@@@@@..T..@@@@@
@@@@@@......T.T.........T......T@@@@@@@@@@@@@@@@@@@@@@@@@..@@@@@...@@@@@@@@@@@@@@....T.@@@@@
@@@@@@..........TTT.....@@......@@@@@@@@@@@@@@@@@@@@@@@@@@@@@@@@....@@@@@@@@@@@@.......@@@@@
@@@@@@.........T........@@@..@@@@@@@@@@@@@@@@@@@@@@@@@@@@@@@@@@@....@@@@@@@@@@@..T.....@@@@@
@@@@@..T...T.........T.@@@@@@@@@@@@@@@@@@@@@@@@@@@@@@@@@@@@@@@@@....@@@@@@@@@@..T......@@@@@
@@@@@...T...T.........T..@@@@@@@@@@@@@@@@@@@@@@@@@@@@@@@@@@@@@@.T...@@@@@@@@@TT..TT.....@@@@
@@@@...T.TTT....TT....T@@@@@@@@@@@@@@@@@@@@@@@@@@@@@@@@@@@@@@@.T.T..@@@@@@@@.T.T........@@@@
@@@@.......T.......TT.@@@@@@@@@@@@@@@@@@@@@@@@@@@@@@@@@@@@@@@..T....@@@@@@@@........T...@@@@
@@@@T...T.....TTT@@@@@@@@@@@@@@@@@@@@@@@@@@@@@@@@@@@@@@@@@@@.T......@@@@@@@@...TT..T..T..@@@
@@@@..T..........@@@@@@@@@@@@@@@@@@@@@@@@@@@@@@@@@@@@@@@@@@....T...@@@@@@@@@T....TT.T....@@@
@@@.T....T.......@@@@@@@@@@@@@@@@@@@@@@@@@@@@@@@@@@@@@@@@@...T.T...@@@@@@@@@..T...T......@@@
@@@..T....T.T..T....@@@@@@@@@@@@@@@@@@@@@@@@@@@@@@@@@@@@@@...T.T..@@@@@@@@@@......TT.T...@@@
@@@................T.@@@@@@@@@@@@@@@@@@@@@@@@@@@@@@@@@@@@..T.....@@@@@@@@@......T.....T..@@@
@@@T......T....T.......@@@@@@@@@@@@@@@@@@@@@@@@@@@@@@@@@...TT...@@@@@@@@@@@.....T........@@@
@@@..TT......T.T...T.T.T.@@@@@@@@@@@@@@@@@@@@@@@@@@@@@@..T......@@@@@@@@@@@@...T...T.T...@@@
@@@...T...T..TT.T.....T...T@@@@@@@@@@@@@@@@@@@@@@@@@@@..T..T...@@@@@@@@@@@@@@.@@..T......@@@
@@@..T....T.@@@@....T...T.T.@@@@@@@@@@@@@@@@@@@@@@@@@.T....T..@@@@@@@@@@@@@@@@@@.........@@@
@@@........@@@@@@.T.......T...@@@@@@@@@@@@@@@@@@@@@@@T.TT.T.T@@@@@@@@@@@@@@@@@@@@.....T..@@@
@@@.T.T...TT.@@@@@@.T...T.....T.@@@@@@@@@@@@@@@@@@@@......T..@@@@@@@@@@@@@@@@@@@@...T.T..@@@
@@@T...T.T...@@@@@@@TT.........T.@@@@@@@@@@@@@@@@@@.T.......@@@@@@@@@@@@@@@@@@@...TTTT...@@@
@@@.T.......T@@@@@@@@@........T...@@@@@@@@@@@@@@@@....T....@@@@@@@@@@@@@@@@@@@@....TTT.T.@@@
@@@..T...TT.@@@@@@@@@@@TTT........TT@@@@@@......T....T....@@@@@@@@@@@@@@@@@@@@@@...T.....@@@
@@@.T...T...@@@@@@@@@@@@@T....T......@@.......T..T........@@@@@@@@@@@@@@@@@@@@@@.........@@@
@@@.......T.@@@@@@@@@@@@@@....T.T........T...TT.T.T......@@@@@@@@@@@@@@@@@@@@@@@@.....T..@@@
@@@........@@@@@@@@@@@@@@@@@.T...T.......................@@@@@@@@@@@@@@@@@@@@@@@@.....T..@@@
@@@........@@@@@@@@@@@@@@@@@@...T......T.T.T....T..T..T..@@@@@@@@@@@@@@@@@@@@@@@@@T...TT.@@@
@@@T..TT..T@@@@@@@@@@@@@@@@@@@@T...T..T.......T....T......@@@@@@@@@@@@@@@@@@@@@@@@T......@@@
@@@......TT@@@@@@@@@@@@@@@@@@@@@.T......T......T..TTT.....@@@@@@@@@@@@@@@@@@@@@@@@....T..@@@
@@@..T.T...@@@@@@@@@@@@@@@@@@@@@@...TTT.....@@@@......T....@@@@@@@@@@@@@@@@@@@@@@@..TT..T@@@
@@@..T......@@@@@@@@@@@@@@@@@@@@@T...TT.T.@@@@@@@@..T......@@@@@@@@@@@@@@@@@@@@@@@..T....@@@
@@@T........@@@@@@@@@@@@@@@@@@@@@.......T@@@@@@@@@@......T.@@@@@@@@@@@@@@@@@@@@@@@.......@@@
@@@...T.TTT.@@@@@@@@@@@@@@@@@@@@@..T....@@@@@@@@@@@...T.T.T@@@@@@@@@@@@@@@@@@@@@@@.....T.@@@
@@@T...T....@@@@@@@@@@@@@@@@@@@@@.T..T..@@@@@@@@@@@T.....T.@@@@@@@@@@@@@@@@@@@@@@@T.....T@@@
@@@T........@@@@@@@@@@@@@@@@@@@@@..T....@@@@@@@@@@@...T....@@@@@@@@@@@@@@@@@@@@@@@..T..TT@@@
@@@..T...T...@@@@@@@@@@@@@@@@@@@@.T.....@@@@@@@@@@@...T.T..@@@@@@@@@@@@@@@@@@@@@@@T..T..T@@@
@@@.....T..T.@@@@@@@@@@@@@@@@@@@@........@@@@@@@@@@.......T@@@@@@@@@@@@@@@@@@@@@@@...TT..@@@
@@@..T.T.....@@@@@@@@@@@@@@@@@@@@TT.....T@@@@@@@@@T..T...TT@@@@@@@@@@@@@@@@@@@@@@.T...T.T@@@
@@@.T.T....T..@@@@@@@@@@@@@@@@@@@@.....T.T@@@@@@@..........@@@@@@@@@@@@@@@@@@@@@@........@@@
@@@............@@@@@@@@@@@@@@@@@@@.T...T...@@@@@...T....T.T..@@@@@@@@@@@@@@@@@@@@TTT....T@@@
@@@.....T......@@@@@@@@@@@@@@@@@@@@......T..TT....T.......T...@@@@@@@@@@@@@@@@@@@..TT...T@@@
@@@..TT.........@@@@@@@@@@@@@@@@@@@................T......T.....@@@@@@@@@@@@@@@@.T.......@@@
@@@.T.TT........@@@@@@@@@@@@@@@@@@T...............T.T..T..........@@@@@@@@@@@@@.T....T...@@@
@@@.T......T.....@@@@@@@@@@@@@@@@@T.T............T...@@T....T.......@@@@@@@@@@...........@@@
@@@.....T.T.T.....@@@@@@@@@@@@@@@@T.T.T......T.....@@@@@..T.T..T.T...@@@@@@@@@.TT..T...T.@@@
@@@T..............@@@@@@@@@@@@@@@.T...T..T@@..TT@@@@@@@@@@....T...T....@@@@@@..T..T......@@@
@@@T..............T@@@@@@@@@@@@@..T......@@@@@@@@@@@@@@@@@@.....T......T.@@@.............@@@
@@@.........T.....T.@@@@@@@@@@@@....T.TT@@@@@@@@@@@@@@@@@@@@@T...T......T.T..T...T.....T.@@@
@@@.....TT..T.......@@@@@@@@@@@TTT..T..@@@@@@@@@@@@@@@@@@@@@@@T.T.....T.T.TTT........TT.T@@@
@@@T..T......T.......@@@@@@@@@.T....T..@@@@@@@@@@@@@@@@@@@@@@@@.....T.T.T.......T........@@@
@@@................T..@@@@@@@@T.T.....@@@@@@@@@@@@@@@@@@@@@@@@@@..T....T...T...T.T.......@@@
@@@@....T..........TT.@@@@@@...T.T..T@@@@@@@@@@@@@@@@@@@@@@@@@@@@.T..T......T............@@@
@@@@@@....T.....T.......@@....TTT...@@@@@@@@@@@@@@@@@@@@@@@@@@@@@@T..T.............T....@@@@
@@@@@@...........T.............TT..@@@@@@@@@@@@@@@@@@@@@@@@@@@@@@@...T...TT......TT....@@@@@
@@@@@@@T..T..T.T...............T..@@@@@@@@@@@@@@@@@@@@@@@@@@@@@@@......TT.....T.T..T..@@@@@@
@@@@@@@@@.T...........T..T.TTT..T@@@@@@@@@@@@@@@@@@@@@@@@@@@@@@@@..T...........T.....@@@@@@@
@@@@@@@@@@.....T..T......T......@@@@@@@@@@@@@@@@@@@@@@@@@@@@@@@@.....T.T..T...TT....@@@@@@@@
@@@@@@@@@@@@...........T.......T..@@@@@@@@@@@@@@@@@@@@@@@@@@@@@....T..TT.....T....@@@@@@@@@@
@@@@@@@@@@@@@@......T...TTTT.T.....@@@@@@@@@@@@@@@@@@@@@@@@T....T....T....T..T...@@@@@@@@@@@
@@@@@@@@@@@@@@@..T....T..............TT..T@@@@@@@@@@@@@@@.TT.T..........T.T.T..@@@@@@@@@@@@@
@@@@@@@@@@@@@@@@@@.......T......T.....T...T....TTTTT......T.....T............T@@@@@@@@@@@@@@
@@@@@@@@@@@@@@@@@@@.T.T..T........T.T.T...TT.......TT......T.....TT....T.T.@@@@@@@@@@@@@@@@@
@@@@@@@@@@@@@@@@@@@@.TT....T...TTT................TT...T....T.TTT.TT...@@@@@@@@@@@@@@@@@@@@@
@@@@@@@@@@@@@@@@@@@@@@....T..T......T...T................T..T..T....@@@@@@@@@@@@@@@@@@@@@@@@
@@@@@@@@@@@@@@@@@@@@@@@.........T...T...........T..................@@@@@@@@@@@@@@@@@@@@@@@@@
@@@@@@@@@@@@@@@@@@@@@@@@@@@T..T...........T...............T....@@@@@@@@@@@@@@@@@@@@@@@@@@@@@
@@@@@@@@@@@@@@@@@@@@@@@@@@@@@@.............T.....T...TTT..T.@@@@@@@@@@@@@@@@@@@@@@@@@@@@@@@@
@@@@@@@@@@@@@@@@@@@@@@@@@@@@@@@@...T...T....T...T...T.....@@@@@@@@@@@@@@@@@@@@@@@@@@@@@@@@@@
@@@@@@@@@@@@@@@@@@@@@@@@@@@@@@@@@@@@...T..T.....T...T...@@@@@@@@@@@@@@@@@@@@@@@@@@@@@@@@@@@@
@@@@@@@@@@@@@@@@@@@@@@@@@@@@@@@@@@@@@@@@@@@@@@@@@@@@@@@@@@@@@@@@@@@@@@@@@@@@@@@@@@@@@@@@@@@@
@@@@@@@@@@@@@@@@@@@@@@@@@@@@@@@@@@@@@@@@@@@@@@@@@@@@@@@@@@@@@@@@@@@@@@@@@@@@@@@@@@@@@@@@@@@@
@@@@@@@@@@@@@@@@@@@@@@@@@@@@@@@@@@@@@@@@@@@@@@@@@@@@@@@@@@@@@@@@@@@@@@@@@@@@@@@@@@@@@@@@@@@@
