type octile
height 112
width 108
map
@@@@@@@@@@@@@@@@@@@@@@@@@@@@@@@@@@@@@@@@@@@@@@@@@@@@@@@@@@@@@@@@@@@@@@@@@@@@@@@@@@@@@@@@@@@@@@@@@@@@@@@@@@@@
@@@@@@@@@@@@@@@@@@@@@@@@@@@@@@@@@@@@@@@@@@@@@@@@@@@@@@@@@@@@@@@@@@@@@@@@@@@@@@@@@@@@@@@@@@@@@@@@@@@@@@@@@@@@
@@@@@@@@@@@@@@@@@@@@@@@@@@@@@@@@@@@@@@@@@@@@@@@@@@@@@@@@@@@@@@@@@@@@@@@@@@@@@@@@@@@@@@@@@@@@@@@@@@@@@@@@@@@@
@@@@@@@@@@@@@@@@@@@@@@@@@@@@@@@@@@@@@@@@@@@@@@@@@@@@@@@@@@@@@@@@@@@@@@@@@@@@@@@@@@@@@@@@@@@@@@@@@@@@@@@@@@@@
@@@@@@@@@@@@@@@@@@@@@@@@@@@@@@@@@@@@@@@@@@@@@@@@@@@@@@@@@@@@@@@@@@@@@@@@@@@@@@@@@@@@@@@@@@@@@@@@@@@@@@@@@@@@
@@@@@@@@@@@@@@@@@@@@@@@@@@@@@@@@@@@@@@@@@@@@@@@@@@@@@@@@@@@@@@@@@@@@@@@@@@@@@@@@@@@@@@@@@@@@@@@@@@@@@@@@@@@@
@@@@@@@@@@@@@@@@@@@@@@@@@@@@@@@@@@@@@@@@@@@@@@@@@@@@@@@@@@@@@@@@@@@@@@@@@@@@@@@@@@@@@@@@@@@@@@@@@@@@@@@@@@@@
@@@@@@@@@@@@@@@@@@@@@@@@@@@@@@@@@@@@@@@@@@@@@@@@@@@@@@@@@@@@@@@@@@@@@@@@@@@@@@@@@@@@@@@@@@@@@@@@@@@@@@@@@@@@
@@@@@@@@@@@@@@@@@@@@@@@@@@@@@@@@@@@@@@@@@@@@@@@@@@@@@@@@@@@@@@@@@..@@@@@@@@@@@@@@@@@@@@@@@@@@@@@@@@@@@@@@@@@
@@@@@@@@@@@@@@@@@@@@@@@@@@@@@@@@@@@@@@@@@@@@@@@@@@@@@@@@@@@@@@@@@...@@@@@@@@@@@@@@@@@@@@@@@@@@@@@@@@@@@@@@@@
@@@@@@@@@@@@@@@@@@@@@@@@@@@@@@@@@@@@@@@@@@@@@@@@@@@@@@@@@@@@@@@@@..T.@@@@@@@@@@@@@@@@@@@@@@@@@@@@@@@@@@@@@@@
@@@@@@@@@@@@@@@@@@@@@@@@@@@@@@@@@@@@@@@@@@@@@@@@@@@@@@@@@@@@@@@@@T....@@@@@@@@@@@@@@@@@@@@@@@@@@@@@@@@@@@@@@
@@@@@@@@@@@@@@@@@@@@@@@@@@@@@@@@@@@@@@@@@@@@@@@@@@@@@@@@@@@@@@@@@..T...@@@@@@@@@@@@@@@@@@@@@@@@@@@@@@@@@@@@@
@@@@@@@@@@@@@@@@@@@@@@@@@@@@@@@@@@@@@@@@@@@@@@@@@@@@@@@@@@@@@@@@T.......@@@@@@@@@@@@@@@@@@@@@@@@@@@@@@@@@@@@
@@@@@@@@@@@@@@@@@@@@@@@@@@@@@@@@@@@@@@@@@@@@@@@@@@@@@@@@@@@@@@.TT...@@.T.@@@@@@@@@@@@@@@@@@@@@@@@@@@@@@@@@@@
@@@@@@@@@@@@@@@@@@@@@@@@@@@@@@@@@@@@@@@@@@@@@@@@@.@@@@@@@@@@@TT...T.@@...@@@@@@@@@@@@@@@@@@@@@@@@@@@@@@@@@@@
@@@@@@@@@@@@@@@@@@@@@@@@@@@@@@@@@@@@@@@@@@@@@@@@...@@@@@@.@@...@@@..@@....@@@@@@@@@@@@@@@@@@@@@@@@@@@@@@@@@@
@@@@@@@@@@@@@@@@@@@@@@@@@@@@@@@@@@@@@@@@@@@@@@@..TT@@@@@.T....@@@@.@@@....@@@@@@@@@@@@@@@@@@@@@@@@@@@@@@@@@@
@@@@@@@@@@@@@@@@@@@@@@@@@@@@@@@@@@@@@@@@@@@@@@@.....@@......TT@@...@@@TT..T.@@@@@@@@@@@@@@@@@@@@@@@@@@@@@@@@
@@@@@@@@@@@@@@@@@@@@@@@@@@@@@@@@@@@@@@@@@@@@@@@@@......T..T@.T...@@@@@@T....@@@@@@@@@@@@@@@@@@@@@@@@@@@@@@@@
@@@@@@@@@@@@@@@@@@@@@@@@@@@@@@@@@@@@@@@@@@@@@@@@@@......TT.@@@..@@@@@@@.....@@..@@@@@@@@@@@@@@@@@@@@@@@@@@@@
@@@@@@@@@@@@@@@@@@@@@@@@@@@@@@@@@@@@@@@@@@@@@@@@@@@.T......@@@.@@@@......T.T.....@@@@@@@@@@@@@@@@@@@@@@@@@@@
@@@@@@@@@@@@@@@@@@@@@@@@@@@@@@@@@@@@@@@@@@@@@@@@@@@@....TT.@@@.@@@@.T..T.......T.T@@@@@@@@@@@@@@@@@@@@@@@@@@
@@@@@@@@@@@@@@@@@@@@@@@@@@@@@@@@@@@@@@@@@@@@@@@@@@@@@.T...........TT...............@@@@@@@@@@@@@@@@@@@@@@@@@
@@@@@@@@@@@@@@@@@@@@@@@@@@@@@@@@@@@@@@@@@@@@@@@@@@@@@@........T.T..T..........T.T...@@@@@@@@@@@@@@@@@@@@@@@@
@@@@@@@@@@@@@@@@@@@@@@@@@@@@@@@@@@@@@@@@@@@@@@@@@@@@@@@@.T.T...T.......T.........TT@@@@@@@@@@@@@@@@@@@@@@@@@
@@@@@@@@@@@@@@@@@@@@@@@@@@@@@@@@@@@@@@@@@@@@@@@@@@@@@@@@...............T......T...@@@@@@@@@@@@@@@@@@@@@@@@@@
@@@@@@@@@@@@@@@@@@@@@@@@@@@@@@@@@@@@@@@@@@@@@@@@@@@@@@@@@......T.T...T.........T.@@@@@@@@@@@@@@@@@@@@@@@@@@@
@@@@@@@@@@@@@@@@@@@@@@@@@@@@@@@@@@@@@@@@@@@@@@@@@@@@@@@@@@...TT.T....T...T......@@@@@@@@@@@@@@@@@@@@@@@@@@@@
@@@@@@@@@@@@@@@@@@@@@@@@@@@@@@@@@@@@@@@@@@@@@@@@.@@@@@@@@@@.......T.T......T..T@@@@@@@.@@@@@@@@@@@@@@@@@@@@@
@@@@@@@@@@@@@@@@@@@@@@@@@@@@@@@@@@@@@@@@@@@@@@@@.@@@@@@@@@@@@TT..T...T..T......@@@@@@T....@@@@@@@@@@@@@@@@@@
@@@@@@@@@@@@@@@@@@@@@@@@@@@@@@@@@@@@@@@@@@@@@@@@..@.@@@@@@@T@@...T.T...T.....T..@@@@....T..@@@@@@@@@@@@@@@@@
@@@@@@@@@@@@@@@@@@@@@@@@@@@@@@@@@@@@@@@@@@@@@.......@@.T@@T..@@..................@.....TT..@@@@@@@@@@@@@@@@@
@@@@@@@@@@@@@@@@@@@@@@@@@@@@@@@@@@@@@@@@@@@@@.T........@@.....@@.........T......T..T..T.TT.@@@@@@@@@@@@@@@@@
@@@@@@@@@@@@@@@@@@@@@@@@@@@@@@@@@@@@@@@@@@@@..T......T@@T.T..T@@@T.T.....T..TTTT....TT...T.@@@@@@@@@@@@@@@@@
@@@@@@@@@@@@@@@@@@@@@@@@@@@@@@@@@@@@@@@@@@...........@@......@@@@..TT...T.....TT..........T..@@@@@@@@@@@@@@@
@@@@@@@@@@@@@@@@@@@@@@@@@@@@@@@@@@@@@@@@@...T....TTT@@......@@@@@....T......T.TTT......TTTT.@@@@.@@@@@@@@@@@
@@@@@@@@@@@@@@@@@@@@@@@@@@@@@@@@@@@@@@@@.........T.@@......@@@@@@.T...........T...T........T.T@@..@@@@@@@@@@
@@@@@@@@@@@@@@@@@@@@@@@@@@@@@@@@@@@@@@@.....TT...T.@.....T@@@@@@@.............TT.....T@@@..........@@@@@@@@@
@@@@@@@@@@@@@@@@@@@@@@@@@@@@@@@@@@@@@@..........T..@T....@@@@@@@@.TT............TT....@@@.....T.....@@@@@@@@
@@@@@@@@@@@@@@@@@@@@@@@@@@@@@@@@@@@@@@@...TT....T.T@..T.@@@@@@@@@..............T..T...@@@.@.......@..@@@@@@@
@@@@@@@@@@@@@@@@@@@@@@@@@@@@@@@@@@@@@@@@.T..T.T.T.T....@@@@@@@@@..T....@@TTTT.....T...@@..@@....@@@@.T@@@@@@
@@@@@@@@@@@@@@@@@@@@@@@@@@@@@@@@@@@@@@@@.......T......@@@@@@@......T..@@@@...T......T@@@.@@.T.@@@@@@@@@@@@@@
@@@@@@@@@@@@@@@@@@@@@@@@@@@@@@@@@@@@@@@@T..........T..@@@@@@.........@@.@@@..........@@@T@@...@@@@@@@@@@@@@@
@@@@@@@@@@@@@@@@@@@@@@@@@@@@@@@@@@@@@@@@........@@T..T@@@@@.........@@...@@@.........@@@.@@.T.@@@@@@@@@@@@@@
@@@@@@@@@@@@@@@@@@@@@@@@@@@@@@@@@@@@@@...T.....@@@@...@@@@@.T..T...@@.TT..@@......TTT.@@...T.T..@@....@...@@
@@@@@@@@@@@@@@@@@@@@@@@@@@@@@@@@@@@@...........@@@@@..@@@@.TTT.T..@@..T..@@@@..T.T....@@@......T...T.TT...@@
@@@@@@@@@@@@@@@@@@@@@@@@@@@@@@@@@@@.T.T.........@@@@.T@@T...T....@@...T.@@@@@@.T..T...@@@..T.........T...@@@
@@@@@@@@@@@@@@@@@@@@@@@@@@@@@@@@@@@........TT...T@@@...@.......T@@.....@@@@@@@@....T.T.T....TT..........@@@@
@@@@@@@@@@@@@@@@@@@@@@@@@@.T@@@@@@@@........T...T.@@@.......TT.@@T..T.@@@@@@@@@@..T.......T..TT......T.@@@@@
@@@@@@@@@@@@@@@@@@@@........T@@@@@@@@.......T.T....@@....T.....@T....@@@@@@@@@@@...T...T...T..........@@@@@@
@@@@@@@@@@@@@@@@@@@T.T.T....TT@@@@@@@@T.....T...T..........T...@....@@@@@@@@@@@@.T..T....T..T...T..T.@@@@@@@
@@@@@@@@@@@@@@@@@@.....@@@T....@@@@@@@@......T.......T......T..T...@@@@@@@@@@@@@......T...T..TT.T...@@@@@@@@
@@@@@@@@@@@@@@@@@.T...@@@@@..T..@@@@@@@@........T..T...T..TTT.....@@@@@@@@@@@@@@....T.TT...TT......@@@@@@@@@
@@@@@@@@@@@@@@@@@T...@@@@@@@...TT@@@@@@@@T.............T..........@@@@@@T.@@@@........TT.TTT......@@@@@@@@@@
@@@@@@@@@@@@@@@@@@...@@@@@@@@.T...@@@@@@@@T...T...T.........@@....@@@@@@T..@@...T.......T...T....@@@@@@@@@@@
@@@@@@@@@@@@@@@@@@@...@@@@@@@@...TT@@@@@@@@.T...T..T....T.T.@@@.T.@@@@@.T......@@@.T.T...T......@@@@@@@@@@@@
@@@@@@@@@@@@@@@@@@T...@@@@@@@@@.T.T.@@@@@@@..T..T...TT......@@@@.T@@@@@..T.T..@@@@@T.......T.T.@@@@@@@@@@@@@
@@@@@@@@@@@@@@@@@@.....@@@@@@@@......@@@@@@........TT.......T@@@T.@@@@T..T....@@@@@@..T...TT.T@@@@@@@@@@@@@@
@@@@@@@@@@@@@@@@@@@.....@@@@@@@....T..@@@@@@...T.T........T.T.@@@..@.T.....T.T@@@@@@......T..@@@@@@@@@@@@@@@
@@@@@@@@@@@@@@@@@@@@.T...@@@@@@.T.T....@@@@@..T.....T.T.....T..@@.T@T.....T...@@@@@@T...TTTT@@@@@@@@@@@@@@@@
@@@@@@@@@@@@@@@@@@@@@T...@@@...T.TTT....@@@T....T..T...T.......@@.............@@@@@........@@@@@@@@@@@@@@@@@
@@@@@@@@@@@@@@@@@@@@@@...TTT......TT.T..@@.................TT...@T.........T..............@@@@@@@@@@@@@@@@@@
@@@@@@@@@.@@@@.@@@@@@@@.............T...@T.T...........................T......T........TT@@@@@@@@@@@@@@@@@@@
@@@@@@@@...@@...@@@@@@@@.....T..@@@@..............T.....T..T....T.........T.T....T.T....@@@@@@@@@@@@@@@@@@@@
@@@@@@@....@@...@@@@@@@@@T.T.TT@@@@@@T............@@....T................T...TTTT.....T@@@@@@@@@@@@@@@@@@@@@
@@@@@@...........@@@@@@@@@T...@@@@@@@TT.....TT....@@@@..T...T......T.....T.@@.T...T.T.@@@@@@@@@@@@@@@@@@@@@@
@@@@@@@@...T..T.TT@@@@@@@@@..@@@@@@@.............T@@@@@..T....T.T.T..T..T.@@@@......T@@@@@@@@@@@@@@@@@@@@@@@
@@@@@@@@@...T........@@@@@@@@@@@@@@....T...T.....@@@@@@@.........T.T.....@@@@@@....T@@@@@@@@@@@@@@@@@@@@@@@@
@@.@@@@@@TT....T..TT.T@@@@@@@@@@@@....T...T....T.@@@@@@@@..T..........T.@@@@@@T.T..@@@@@@@@@@@@@@@@@@@@@@@@@
@@..@@@@T.....TT....T..@@@@@@@@@@.......T...T..TT@@@@@@@@@.............@@@@@@T....@@@@@@@@@@@@@@@@@@@@@@@@@@
@@....TT.TT..TTT........@@@@@@@@.............T...@@@@@@@@@@.T....TT...@@@@@@TT..T@@@@@@@@@@@@@@@@@@@@@@@@@@@
@@............T..T....TT.@@@@@@@....................@@@@@@@@..T.TTT..@@@@@@TT...@@@@@@@@@@@@@@@@@@@@@@@@@@@@
@@...T.T.....T.....T.....@@@@@.@T....T.T@@@@@........@@@@@@@@.......@@@@@@.T...@@@@@@@@@@@@@@@@@@@@@@@@@@@@@
@@.T...T..TT...T..T.T.T..@@@@T.......T.@@@@@@@.....T..@@@@@@@@......@@@@@T...@@@@@@@@@@@@@@@@@@@@@@@@@@@@@@@
@@@T........T.T.T.T......@@@T........T@@@@@@@@T......@@@@@@@@@@.T...@@@@....@@@@@@@@@@@@@@@@@@@@@@@@@@@@@@@@
@@@@...T.....T....T......@@........T.@@@@@@@@T....T...T@@@@@@@@@T....@@TT..@@@@@@@@@@@@@@@@@@@@@@@@@@@@@@@@@
@@@@@..T.T.......T@@@...T@..........@@@@@@@@.T....T....T@@@@@@@@@........T@@@@@@@@@@@@@@@@@@@@@@@@@@@@@@@@@@
@@@@@@..........T@@@@@...T...T.....@@@@@@@@.............T@@@@@@@@@......T@@@@@@@@@@@@@@@@@@@@@@@@@@@@@@@@@@@
@@@@@@@.....TT..@@@@@@........TT..@@@@@@@@........@TT...T@@@@@@@@@@TT...@@@@@@@@@@@@@@@@@@@@@@@@@@@@@@@@@@@@
@@@@@@@@.......@@@@@@@......T...T.@@@@@@@.......T@@@@@...T..@@@@@@@@TT.@@@@@@@@@@@@@@@@@@@@@@@@@@@@@@@@@@@@@
@@@@@@@@@...T.@@@@@@@@..T..T......@@@@@@@@.T..T.T@@@@@@@.T...@@@@@@@@.@@@@@@@@@@@@@@@@@@@@@@@@@@@@@@@@@@@@@@
@@@@@@@@@@T.T@@@@@@@@.......T...T.@@@@@@@@@.......@@@@@@.....T@@@@@@@@@@@@@@@@@@@@@@@@@@@@@@@@@@@@@@@@@@@@@@
@@@@@@@@@@@.@@@@@@@@.TT...T.......@@@@@@@@@@.....@@@@@@@.......@@@@@@@@@@@@@@@@@@@@@@@@@@@@@@@@@@@@@@@@@@@@@
@@@@@@@@@@@@@@@@@@@.TT.....T....T.@@@@@@@@@@@....@@@@...........@@@@@@@@@@@@@@@@@@@@@@@@@@@@@@@@@@@@@@@@@@@@
@@@@@@@@@@@@@@@@@@T............T..@@@@@@@@@@@@....@..TT........T.@@@@@@@@@@@@@@@@@@@@@@@@@@@@@@@@@@@@@@@@@@@
@@@@@@@@@@@@@@@@@.......T.T...T....TT..@@@@@@@@T.....T......T..T@@@@@@@@@@@@@@@@@@@@@@@@@@@@@@@@@@@@@@@@@@@@
@@@@@@@@@@@@@@@@...T...TTT@@@.........@@@@@@@@@@....T.....T....@@@@@@@@@@@@@@@@@@@@@@@@@@@@@@@@@@@@@@@@@@@@@
@@@@@@@@@@@@@@@@..T...T..@@@@@.T..T...@@@@@@@@@@@....T........@@@@@@@@@@@@@@@@@@@@@@@@@@@@@@@@@@@@@@@@@@@@@@
@@@@@@@@@@@@@@@@@.....T.@@@@@@@....TT......@@@@@@@..T........@@@@@@@@@@@@@@@@@@@@@@@@@@@@@@@@@@@@@@@@@@@@@@@
@@@@@@@@@@@@@@@@@@.....@@@@@@@..T...T.....@@@@@@@@@T....T...@@@@@@@@@@@@@@@@@@@@@@@@@@@@@@@@@@@@@@@@@@@@@@@@
@@@@@@@@@@@@@@@@@@@..T@@@@@@@......T..T.T@@@@@@@@@@@.T.....@@@@@@@@@@@@@@@@@@@@@@@@@@@@@@@@@@@@@@@@@@@@@@@@@
@@@@@@@@@@@@@@@@@@@@T@@@@@@@...T....T..@@@@@@@@@@@@@@...T.@@@@@@@@@@@@@@@@@@@@@@@@@@@@@@@@@@@@@@@@@@@@@@@@@@
@@@@@@@@@@@@@@@@@@@@@@@@@@@......T.TT...@@@@@@@@@@@@@@...@@@@@@@@@@@@@@@@@@@@@@@@@@@@@@@@@@@@@@@@@@@@@@@@@@@
@@@@@@@@@@@@@@@@@@@@@@@@@@T..T.......TT..@@@.T@@@@@@@@@T@@@@@@@@@@@@@@@@@@@@@@@@@@@@@@@@@@@@@@@@@@@@@@@@@@@@
@@@@@@@@@@@@@@@@@@@@@@@@@..TTTT....TT.T.T.@.TTT.@@@@@@@@@@@@@@@@@@@@@@@@@@@@@@@@@@@@@@@@@@@@@@@@@@@@@@@@@@@@
@@@@@@@@@@@@@@@@@@@@@@@@.T.T..TTT.........T.T.T..@@@@@@@@@@@@@@@@@@@@@@@@@@@@@@@@@@@@@@@@@@@@@@@@@@@@@@@@@@@
@@@@@@@@@@@@@@@@@@@@@@@@@...T.T.....T...T.........@@@@@@@@@@@@@@@@@@@@@@@@@@@@@@@@@@@@@@@@@@@@@@@@@@@@@@@@@@
@@@@@@@@@@@@@@@@@@@@@@@@@@T..................T...T.@@@@@@@@@@@@@@@@@@@@@@@@@@@@@@@@@@@@@@@@@@@@@@@@@@@@@@@@@
@@@@@@@@@@@@@@@@@@@@@@@@@@@T..T.....T..........T...@@@@@@@@@@@@@@@@@@@@@@@@@@@@@@@@@@@@@@@@@@@@@@@@@@@@@@@@@
@@@@@@@@@@@@@@@@@@@@@@@@@@@@.........T..T.........@@@@@@@@@@@@@@@@@@@@@@@@@@@@@@@@@@@@@@@@@@@@@@@@@@@@@@@@@@
@@@@@@@@@@@@@@@@@@@@@@@@@@@@@...T.......T.....T..@@@@@@@@@@@@@@@@@@@@@@@@@@@@@@@@@@@@@@@@@@@@@@@@@@@@@@@@@@@
@@@@@@@@@@@@@@@@@@@@@@@@@@@@@@T.................@@@@@@@@@@@@@@@@@@@@@@@@@@@@@@@@@@@@@@@@@@@@@@@@@@@@@@@@@@@@
@@@@@@@@@@@@@@@@@@@@@@@@@@@@@@@..TT..T.........@@@@@@@@@@@@@@@@@@@@@@@@@@@@@@@@@@@@@@@@@@@@@@@@@@@@@@@@@@@@@
@@@@@@@@@@@@@@@@@@@@@@@@@@@@@@@@.T.......T.T..@@@@@@@@@@@@@@@@@@@@@@@@@@@@@@@@@@@@@@@@@@@@@@@@@@@@@@@@@@@@@@
@@@@@@@@@@@@@@@@@@@@@@@@@@@@@@@@@T....TTT..T.@@@@@@@@@@@@@@@@@@@@@@@@@@@@@@@@@@@@@@@@@@@@@@@@@@@@@@@@@@@@@@@
@@@@@@@@@@@@@@@@@@@@@@@@@@@@@@@@@@T..TT...T.@@@@@@@@@@@@@@@@@@@@@@@@@@@@@@@@@@@@@@@@@@@@@@@@@@@@@@@@@@@@@@@@
@@@@@@@@@@@@@@@@@@@@@@@@@@@@@@@@@@@...T....@@@@@@@@@@@@@@@@@@@@@@@@@@@@@@@@@@@@@@@@@@@@@@@@@@@@@@@@@@@@@@@@@
@@@@@@@@@@@@@@@@@@@@@@@@@@@@@@@@@@@@..T...@@@@@@@@@@@@@@@@@@@@@@@@@@@@@@@@@@@@@@@@@@@@@@@@@@@@@@@@@@@@@@@@@@
@@@@@@@@@@@@@@@@@@@@@@@@@@@@@@@@@@@@@...T@@@@@@@@@@@@@@@@@@@@@@@@@@@@@@@@@@@@@@@@@@@@@@@@@@@@@@@@@@@@@@@@@@@
@@@@@@@@@@@@@@@@@@@@@@@@@@@@@@@@@@@@@@..@@@@@@@@@@@@@@@@@@@@@@@@@@@@@@@@@@@@@@@@@@@@@@@@@@@@@@@@@@@@@@@@@@@@
@@@@@@@@@@@@@@@@@@@@@@@@@@@@@@@@@@@@@@@@@@@@@@@@@@@@@@@@@@@@@@@@@@@@@@@@@@@@@@@@@@@@@@@@@@@@@@@@@@@@@@@@@@@@
