type octile
height 80
width 80
map
@@@@@@@@@@@@@@@@@@@@@@@@@@@@@@@@@@@@@@@@@@@@@@@@@@@@@@@@@@@@@@@@@@@@@@@@@@@@@@@@
@@@@@@@@@@@@@@@@@@@@@@@@@@@@@@@@@@@@@@@@@@@@@@@@@@@@@@@@@@@@@@@@@@@@@@@@@@@@@@@@
@@@@@@@@@@@@@@@@@@@@@@@@@@@@@@@@@@@@@@@@@@@@@@@@@@@@@@@@@@@@@@@@@@@@@@@@@@@@@@@@
@@@@@@@@@@@@@@@@@@@@@@@@@@@@@@@@@@@@@@@@@@@@@@@@@@@@@@@@@@@@@@@@@@@@@@@@@@@@@@@@
@@@@@@@@@@@@@@@@@@@@@@@@@@@@@@@@@@@@@@@@@@@@@@@@@@@@@@@@@@@@@@@@@@@@@@@@@@@@@@@@
@@@@@@@@@@@@@@@@@@@@@@@@@@@@@@@@@@@@@@@@@@@@@@@@@@@@@@@@@@@@@@@@@@@@@@@@@@@@@@@@
@@@@@@@@@@@@@@@@@@@@@@@@@@@@@@@@@@@@@@@@@@@@@@@@@@@@@@@@@@@@@@@@@@@@@@@@@@@@@@@@
@@@@@@@@@@@@@@@@@@@@@@@@@@@@@@@@@@@@@@@@@@@@@@@@@@@@@@@@@@@@@@@@@@@@@@@@@@@@@@@@
@@@@@@@@@@@@@@@@@@@@@@@@@@@@@@@@@@@@@@@@@@@@@@@@@@@@.@@@@@@@@@@@@@@@@@@@@@@@@@@@
@@@@@@@@@@@@@@@@@@@@@@@@@@@@@@@@@@@@@@@@@@@@@@@@@@@...@@@@@@@@@@@@@@@@@@@@@@@@@@
@@@@@@@@@@@@@@@@@@@@@@@@@@@@@@@@@@@@@@@@@@@@@@@@@@TT...@@@@@@@@@@@@@@@@@@@@@@@@@
@@@@@@@@@@@@@@@@@@@@@@@@@@@@@@@@@@@@@@@@@@@@@@@@@...@@..@@@@@@@@@@@@@@@@@@@@@@@@
@@@@@@@@@@@@@@@@@@@@@@@@@@@@@@@@@@@@@@@@@@@@@@@@TT.@@@@@@@@@@@@@@@@@@@@@@@@@@@@@
@@@@@@@@@@@@@@@@@@@@@@@@@@@@@@@@@@@@@@@@@@@@@@@T..@@@@@@@@@@@@@@@@@@@@@@@@@@@@@@
@@@@@@@@@@@@@@@@@@@@@@@@@@@@@@@@@@@@@@@@@@@@@@...@@@@@@@@@@@@@@@@@@@@@@@@@@@@@@@
@@@@@@@@@@@@@@@@@@@@@@@@@@@@@@@@@@@@@@@@@@@@@.T.@@@@..@@@@@@@@@@@@@@@@@@@@@@@@@@
@@@@@@@@@@@@@@@@@@@@@@@@@@@@@@@@@@@@@@@@@@@@...@@@@@@..@@@@@@@@@@@@@@@@@@@@@@@@@
@@@@@@@@@@@@@@@@@@@@@@@@@@@@@@@@@@@@@@@@@@@.....@@.@@T...@.@@@@@@@@@@@@@@@@@@@@@
@@@@@@@@@@@@@@@@@@@@@@@@@@@@@@@@@@@@@@@@@@....TTTTT....T...@@@@@@@@@@@@@@@@@@@@@
@@@@@@@@@@@@@@@@@@@@@@@@@@@@@@@@@@@@@@@@@@@....T.TT...TTT.@@@@@@@@@@@@@@@@@@@@@@
@@@@@@@@@@@@@@@@@@@@@@@@@@@@@@@@@@@@@@@@@@@@..T....T.....@@@@@@@@@@@@@@@@@@@@@@@
@@@@@@@@@@@@@@@@@@@@@@@@@@@@@@@@@@@@@@@@@@@@@..T....T.....@@@@@@@@@@@@@@@@@@@@@@
@@@@@@@@@@@@@@@@@@@@@@@@@@@@@@@@@@@@@@@@@@@@@@..T..........@@@@@@@@@@@@@@@@@@@@@
@@@@@@@@@@@@@@@@@@@@@@@@@@@@@@@@@@@@.@@@@.@@@@@.TT....T.....@@@@@@@@@@@@@@@@@@@@
@@@@@@@@@@@@@@@@@@@@@@@@@@@@@@@@@@@..@@@@..@@@@@...........T.@@@@@@@@@@@@@@@@@@@
@@@@@@@@@@@@@@@@@@@@@@@@@@@@@@@@@@........@@@@@@@............TT@@@@@@@@@@@@@@@@@
@@@@@@@@@@@@@@@@@@@@@@@@@@@@@@@@@@..T.T..@@@@@@@@@..........T.TT...@@@@@@@@@@@@@
@@@@@@@@@@@@@@@@@@@@@@@@@@@@@@@@@..........@@@@@@@@T..TT........T...@@@@@@@@@@@@
@@@@@@@@@@@@@@@@@@@@@@@@@@@@@@@@....TT....T.@@@@@@@@.TT....TT....T...@@@@@@@@@@@
@@@@@@@@@@@@@@@@@@@@@@@@@@@@@@@..T.....T.....@@@@@@.................TT.@@@@@@@@@
@@@@@@@@@@@@@@@@@@@@@@@@@@@@@@@....T.T........@@@@@......TT............@@@@@@@@@
@@@@@@@@@@@@@@@@@@@@@@@@@@@@TT..........@@@...T@..T..T@@......T..T....@@@@@@@@@@
@@@@@@@@@@@@@@@@@@@@@@@@@@@.........TT.@@@@@..T.......@@@T...T.....T...@@@@@@@@@
@@@@@@@@@@@@@@@@@@@@@@@@@@......@@@@T..@@@@@@..TT..T.@@@@@........T.T.T..@@@@@@@
@@@@@@@@@@@@@@@@@@@@@@@@..T....@@@@@..T.@@@@@@........@@@@@T.T......T.....@@@@@@
@@@@@@@@@@@@@@@@@@@@@@@.T....@@@@@@....T.@@@@@@.T.....T@@@@@..TT..T.T.T..@@@@@@@
@@@@@@@@@@@@@@@@@@@@@@T....T..@@@@@...T.T.@@@@@@........@@@@@....T......@@@@@@@@
@@@@@@@@@@@@@@@@@@@@@.....T.T...T@@@.....@@@@@@@@..TT....@@@@@....T....@@@@@@@@@
@@@@@@@@@@@@@@@@@@@@..T.T..T..T..@@..T.TT@@@@@@@@@...T...@@@@@@.......@@@@@@@@@@
@@@@@@@@@@@@@@@@@@@...........@.T...T.....TT@@@@@@@@T....T@@@@@@.T...@@@@@@@@@@@
@@@@@@@@@@@@@@@@@@...........@@....T.@@...T.@@@@@@@@@......@@@@@@...@@@@@@@@@@@@
@@@@@@@@@@@@@@@@@T.T......TT..@...@@@@@@T....@@@@@@@@@...T.@@@@@@@.@@@@@@@@@@@@@
@@@@@@@@@@@@@@@@.T......T.........@@@@@@.....T.@@@@@@@...T..@@@@@@@@@@@@@@@@@@@@
@@@@@@@@@@@@@@@T.....T....T.@@..T..@@@@@@.....T@@@@@@..T......@@@@@@@@@@@@@@@@@@
@@@@@@@@@@@@@@..T......T.@@@@@@....@@@@@........@@.@@.........T@@@@@@@@@@@@@@@@@
@@@@@@@@@@@@@@......@@@.T@@@@@.T....@............T......T......@@@@@@@@@@@@@@@@@
@@@@@@@@@@@@@T...TT..@@.T@@@@@@.........TT.T.@@...T....T..T...@@@@@@@@@@@@@@@@@@
@@@@@@@@@@@@...T......@.T@@@@@@.......T..T.@@@@@.T..........T@@@@@@@@@@@@@@@@@@@
@@@@@@@@@@@T.T..T..T.@@@..@@..........@T..@@@@@@...TTT...TT.@@@@@@@@@@@@@@@@@@@@
@@@@@@@@@@.....@..TT.@@@......T.T...T@@@...@@@@@....T......@@@@@@@@@@@@@@@@@@@@@
@@@@@@@@....T@@@@@...T.@@.............@..T@@@@@@TT...TT..T@@@@@@@@@@@@@@@@@@@@@@
@@@@@@@...T.@@@@@@@.T.T........T..@@@......@@@@@.........@@@@@@@@@@@@@@@@@@@@@@@
@@@@@@TT..T.@@@@@@@......TT.....@@@@@@@....T.T......T.TT@@@@@@@@@@@@@@@@@@@@@@@@
@@@@@..T...@@@@@@@@@TT..T...TT..@@@@@@@T...............@@@@@@@@@@@@@@@@@@@@@@@@@
@@@@....TT.@@@@@@@@@..T.T......T..@@@.TTT....T....TTT.@@@@@@@@@@@@@@@@@@@@@@@@@@
@@@..TT.....@@@@@@TT..........T..T@@@..TT.....T....T@@@@@@@@@@@@@@@@@@@@@@@@@@@@
@@@..T......@@.@@@....T...TT...T.T......T......T...@@@@@@@@@@@@@@@@@@@@@@@@@@@@@
@@@@T....T......@.T...T.T..T....T.T..T..T.TTT...T.@@@@@@@@@@@@@@@@@@@@@@@@@@@@@@
@@@@@..T...TT.......T..TT.....................TT.@@@@@@@@@@@@@@@@@@@@@@@@@@@@@@@
@@@@@@TT.......T........@.T.T..T.T...T......T...@@@@@@@@@@@@@@@@@@@@@@@@@@@@@@@@
@@@@@@@.......TT..TT.@@@@..T.TT.@.....TT....T..@@@@@@@@@@@@@@@@@@@@@@@@@@@@@@@@@
@@@@@@@@............@@@...TT....@@@..@@.......@@@@@@@@@@@@@@@@@@@@@@@@@@@@@@@@@@
@@@@@@@@@.........T@@@@@TT@@@@@@@@@@.@@@T.TT.@@@@@@@@@@@@@@@@@@@@@@@@@@@@@@@@@@@
@@@@@@@@@@..T....T@@@@@@..@@@@@@@@@@@@@@....@@@@@@@@@@@@@@@@@@@@@@@@@@@@@@@@@@@@
@@@@@@@@@@@TTT...@@..@@...@@@@@@@@@.@@@.T..@@@@@@@@@@@@@@@@@@@@@@@@@@@@@@@@@@@@@
@@@@@@@@@@@@.T...@...T..@@@@@@@@@@@T.@@...@@@@@@@@@@@@@@@@@@@@@@@@@@@@@@@@@@@@@@
@@@@@@@@@@@@@..T.@......@@@@@@@@@@@.T.@@.@@@@@@@@@@@@@@@@@@@@@@@@@@@@@@@@@@@@@@@
@@@@@@@@@@@@@@@T.@.....TT.@@@@@@@@....T@@@@@@@@@@@@@@@@@@@@@@@@@@@@@@@@@@@@@@@@@
@@@@@@@@@@@@@@@@.@.TT..T.T@@@@@T..T....@@@@@@@@@@@@@@@@@@@@@@@@@@@@@@@@@@@@@@@@@
@@@@@@@@@@@@@@@@@@.....TT.@@@@..T..TT.@@@@@@@@@@@@@@@@@@@@@@@@@@@@@@@@@@@@@@@@@@
@@@@@@@@@@@@@@@@@@...T..T.@@@.T...T..@@@@@@@@@@@@@@@@@@@@@@@@@@@@@@@@@@@@@@@@@@@
@@@@@@@@@@@@@@@@@@....T...........TT@@@@@@@@@@@@@@@@@@@@@@@@@@@@@@@@@@@@@@@@@@@@
@@@@@@@@@@@@@@@@@@@.....T...T...TT.@@@@@@@@@@@@@@@@@@@@@@@@@@@@@@@@@@@@@@@@@@@@@
@@@@@@@@@@@@@@@@@@@@..T......T....@@@@@@@@@@@@@@@@@@@@@@@@@@@@@@@@@@@@@@@@@@@@@@
@@@@@@@@@@@@@@@@@@@@@............@@@@@@@@@@@@@@@@@@@@@@@@@@@@@@@@@@@@@@@@@@@@@@@
@@@@@@@@@@@@@@@@@@@@@@..TT......@@@@@@@@@@@@@@@@@@@@@@@@@@@@@@@@@@@@@@@@@@@@@@@@
@@@@@@@@@@@@@@@@@@@@@@@@......@@@@@@@@@@@@@@@@@@@@@@@@@@@@@@@@@@@@@@@@@@@@@@@@@@
@@@@@@@@@@@@@@@@@@@@@@@@@@T..@@@@@@@@@@@@@@@@@@@@@@@@@@@@@@@@@@@@@@@@@@@@@@@@@@@
@@@@@@@@@@@@@@@@@@@@@@@@@@@@@@@@@@@@@@@@@@@@@@@@@@@@@@@@@@@@@@@@@@@@@@@@@@@@@@@@
@@@@@@@@@@@@@@@@@@@@@@@@@@@@@@@@@@@@@@@@@@@@@@@@@@@@@@@@@@@@@@@@@@@@@@@@@@@@@@@@
