type octile
height 75
width 76
map
@@@@@@@@@@@@@@@@@@@@@@@@@@@@@@@@@@@@@@@@@@@@@@@@@@@@@@@@@@@@@@@@@@@@@@@@@@@@
@@@@@@@@@@@@@@@@@@@@@@@@@@@@@@@@@@@@@@@@@@@@@@@@@@@@@@@@@@@@@@@@@@@@@@@@@@@@
@@@@@@@@@@@@@@@@@@@@@@@@@@@@@@@@@@@@@@@@@@@@@@@@@@@@@@@@@@@@@@@@@@@@@@@@@@@@
@@@@@@@@@@@@@@@@@@@@@@@@@@@@@@@@@@@@@@@@@@@@@@@@@@@@@@@@@@@@@@@@@@@@@@@@@@@@
@@@@@@@@@@@@@@@@@@@@@@@@@@@@@@@@@@@@@@@@@@@@@@@@@@@@@@@@@@@@@@@@@@@@@@@@@@@@
@@@@@@@@@@@@@@@@@@@@@@@@@@@@@@@@@@@@@@@@@@@@@@@@@@@@@@@@@@@@@@@@@@@@@@@@@@@@
@@@@@@@@@@@@@@@@@@@@@@@@@@@@@@@@@@@@@@@@@@@@@@@@@@@@@@@@@@@@@@@@@@@@@@@@@@@@
@@@@@@@@@@@@@@@..@@@@@@@@@@@@@@@@@@@@@@@@@@@@@@@@@@@@@@@@@@@@@@@@@@@@@@@@@@@
@@@@@@@@@@@@@..TT...@@@@@@@@@@@@@@@@@@@@@@@@@@@@@@@@@@@@@@@@@@@@@@@@@@@@@@@@
@@@@@@@@@@@..T.TT.....T@@@@@@@@@@@@@@@@@@@@@@@@@@@@@@@@@@@@@@@@@@@@@@@@@@@@@
@@@@@@@@@@...........T..@@@@@@@@@@@@@@@@@@@@@@@@@@@@@@@@@@@@@@@@@@@@@@@@@@@@
@@@@@@@@@........T.......@@@@@@@@@@@@@@@@@@@@@@@@@@@@@@@@@@@@@@@@@@@@@@@@@@@
@@@@@@@@..........T....T.@@@@@@@@@@@@@@@@@@@@@@@@@@@@@@@@@@@@@@@@@@@@@@@@@@@
@@@@@@@..T.T.T...T..TT...@@@@@@@@@@@@@@@@@@@@@@@@@@@@@@@@@@@@@@@@@@@@@@@@@@@
@@@@@@@.T....T......TT..T@@@@@@@@@@@@@@@@@@@@@@@@@@@@@@@@@@@@@@@@@@@@@@@@@@@
@@@@@@@...TT.............@@@@@@@@@@@@@@@@@@@@@@@@@@@@@@@@@@@@@@@@@@@@@@@@@@@
@@@@@@@...TT...@@.........@@@@@@@@@@@@@@@@@@@@@@@@@@@@@@@@@@@@@@@@@@@@@@@@@@
@@@@@@........@@@@........@@@@@@@@@@@@@@@@@@@@@@@@@@@@@@@@@@@@@@@@@@@@@@@@@@
@@@@@@...T.....@@.........@@@@@@@@@@@@@@@@@@@@@@@@@@@@@@@@@@@@@@@@@@@@@@@@@@
@@@@@@T..................@@@@@@@@@@@@@@@@@@@@@@@@@@@@@@@@@@@@@@@@@@@@@@@@@@@
@@@@@@@..T.T.T....T..T..T@@@@@@@@@@@@@@@@@@@@@@@@@@@@@@@@@@@@@@@@@@@@@@@@@@@
@@@@@@@@....T...........T.@@@@@@@@@@@@@@@@@@@@@@@@@@@@@@@@@@@@@@@@@@@@@@@@@@
@@@@@@@@@@TTT.T....T....TT@@@@@@@@@@@..@@@@@@@@@@@@@@@@@@@@@@@@@@@@@@@@@@@@@
@@@@@@@@@@@........@@...T..@@@@@@@@@..TT@@@@@@@@@@@@@@@@@@@@@@@@@@@@@@@@@@@@
@@@@@@@@@@@@@@@@@@@@@@..TT.@@@@@@@@.....T@@@@@@@@@@@@@@@@@@@@@@@@@@@@@@@@@@@
@@@@@@@@@@@@@@@@@@@@@@.....T@@@@@@@TT.....@@@@@@@@@@@@@@@@@@@@@@@@@@@@@@@@@@
@@@@@@@@@@@@@@@@@@@@@@.T....@@@@@...........@@@@@@@@@@@@@@@@@@@@@@@@@@@@@@@@
@@@@@@@@@@@@@@@@@@@@@@@...T..@@@@......T.T..@@@@@@@@@@@@@@@@@@@@@@@@@@@@@@@@
@@@@@@@@@@@@@@@@@@@@@@@......@@@@.........T.@@@@@@@@@@@@@@@@@@@@@@@@@@@@@@@@
@@@@@@@@@@@@@@@@@@@@@@@@......@@@...T.......@@..@@@@@@@@@@@@@@@@@@@@@@@@@@@@
@@@@@@@@@@@@@@@@@@@@@@@@T.....@@@@.T......T@@TT..@@@@@@@@@@@@@@@@@@@@@@@@@@@
@@@@@@@@@@@@@@@@@@@@@@@@@.T....@@@.........@......@@@@@@@@@@@@@@@@@@@@@@@@@@
@@@@@@@@@@@@@@@@@@@@@@@@@.....T@@...T..T......T...@@@@@@@@@@@@@@@@@@@@@@@@@@
@@@@@@@@@@@@@@@@@@@@@@@@@@T....@@..T........T..TTT.@@@@@@@@@@@@@@@@@@@@@@@@@
@@@@@@@@@@@@@@@@@@@@@@@@@@T.....@..........T.....T..@@@@@@@@@@@@@@@@@@@@@@@@
@@@@@@@@@@@@@@@@@@@@@@@@@@@..T..@.T......TT....T.....@@@@@@@@@@@@@@@@@@@@@@@
@@@@@@@@@@@@@@@@@@@@@@@@..@T.....T.T.T...T....TT.T..T@@@@@@@@@@@@@@@@@@@@@@@
@@@@@@@@@@@@@@@@@@@@@@@@..@@...T..TT..T..T..T......T@@@.@@@@@@@@@@@@@@@@@@@@
@@@@@@@@@@@@@@@@@@@@@@@@.T.@.............T..T.......@@..T@@@@@@@@@@@@@@@@@@@
@@@@@@@@@@@@@@@@@@@@@.@@...@.T.T...T..T...T...T.....@.T...@@@@@@@@@@@@@@@@@@
@@@@@@@@@@@@@@@@@@@@..@@.....T.T...TT.....T....TTT.T..T.T..@@@@@@@@@@@@@@@@@
@@@@@@@@@@@@@@@@@@..T...T.....T..........T..T.....T.T...T..T@@@@@@@@@@@@@@@@
@@@@@@@@@@@@@@@@@.T..T.........TTT....T....T..T..T......T.....@@@@@@@@@@@@@@
@@@@@@@@@@@@@@@@@........T.....................T............T.@@@@@@@@@@@@@@
@@@@@@@@@@@@@@@@@.T.......T...........T....T..TT....T....T...@@@@@@@@@@@@@@@
@@@@@@@@@@@@@@@@@.....TT.........T.........TT..T.T...T...TT.@@@.@@@@@@@@@@@@
@@@@@@@@@@@@@@@@@.T....T...T.TT.T......T.T........TT.......T@@...T....@@..@@
@@@@@@@@@@@@@@@@@.....T..........TT..T.T..TTT..T...TT.T.T.TT@@...TT.......@@
@@@@@@@@@@@@@@@@@T......T.TT.TT.T...........T...T......T................TT@@
@@@@@@@@@@@@@@@@@............T.T.....T..T..T....T........T...T......T.....@@
@@@@@@@@@@@@@@@@@...T............T...T.T........T.T.........T.......T.....@@
@@@@@@@@@@@@@@@@@...........T......T..T.........T..TTT..........TT........@@
@@@@@@@@@@@@@@@@@........T....T.................T............T.....TT.....@@
@@@@@@@@@@@@@@@@@...T...TT..TT..T.T...TT...........T....T.T.......T..TT.T@@@
@@@@@@@@@@@@@@@@@....T.........TTT.T.....T......................T.......@@@@
@@@@@@@@@@@@@@@@@@T.T.............T...T..T.T.T................T..TTT...@@@@@
@@@@@@@@@@@@@@@@@@@.T.....TT....T.......TT...........T..TTT..T.T......@@@@@@
@@@@@@@@@@@@@@@@@@@@...T...T...T.T.T......T......................TT..@@@@@@@
@@@@@@@@@@@@@@@@@@@@@..T.T.TT...T....T...T.......T....T..T.T....T..T@@@@@@@@
@@@@@@@@@@@@@@@@@@@@@@.TT....TT...T..T...T.............T...T......T@@@@@@@@@
@@@@@@@@@@@@@@@@@@@@@@@...T..T.T.T..TT......T..............T...T..@@@@@@@@@@
@@@@@@@@@@@@@@@@@@@@@@@@T..........TTT.......T......T.........T..@@@@@@@@@@@
@@@@@@@@@@@@@@@@@@@@@@@@@...T................T.T................@@@@@@@@@@@@
@@@@@@@@@@@@@@@@@@@@@@@@@@T.....T....T.........T.....T...TT....@@@@@@@@@@@@@
@@@@@@@@@@@@@@@@@@@@@@@@@@@T...TT.T.T.............T....T......@@@@@@@@@@@@@@
@@@@@@@@@@@@@@@@@@@@@@@@@@@@T........T......T........T....T..@@@@@@@@@@@@@@@
@@@@@@@@@@@@@@@@@@@@@@@@@@@@@T.T..........TTT.TT.TTT......T.@@@@@@@@@@@@@@@@
@@@@@@@@@@@@@@@@@@@@@@@@@@@@@@...T........T...T......T....T@@@@@@@@@@@@@@@@@
@@@@@@@@@@@@@@@@@@@@@@@@@@@@@@@..T.TT......T.....T..T.....@@@@@@@@@@@@@@@@@@
@@@@@@@@@@@@@@@@@@@@@@@@@@@@@@@@T............T........T..@@@@@@@@@@@@@@@@@@@
@@@@@@@@@@@@@@@@@@@@@@@@@@@@@@@@@..TT........T..........@@@@@@@@@@@@@@@@@@@@
@@@@@@@@@@@@@@@@@@@@@@@@@@@@@@@@@@..TT.T......T..T.....@@@@@@@@@@@@@@@@@@@@@
@@@@@@@@@@@@@@@@@@@@@@@@@@@@@@@@@@@......T....TT......@@@@@@@@@@@@@@@@@@@@@@
@@@@@@@@@@@@@@@@@@@@@@@@@@@@@@@@@@@@@T......T...T.T..@@@@@@@@@@@@@@@@@@@@@@@
@@@@@@@@@@@@@@@@@@@@@@@@@@@@@@@@@@@@@@@@@@@@@@@@@@@@@@@@@@@@@@@@@@@@@@@@@@@@
