type octile
height 54
width 52
map
@@@@@@@@@@@@@@@@@@@@@@@@@@@@@@@@@@@@@@@@@@@@@@@@@@@@
@@@@@@@@@@@@@@@@@@@@@@@@@@@@@@@@@@@@@@@@@@@@@@@@@@@@
@@@@@@@@@@@@@@@@@@@@@@@@@@@@@@@@@@@@@@@@@@@@@@@@@@@@
@@@@@@@@@@@@@@@@@@@@@@@@@@@@@@@@@@@@@@@@@@@@@@@@@@@@
@@@@@@@@@@@@@@@@@@@@@@@@@@@@@@@@@@@@@@@@@@@@@@@@@@@@
@@@@@@@@@@@@@@@@@@@@@@@@@@@@@@@@@@@@@@@@@@@@@@@@@@@@
@@@@@@@@@@@@@@@@@@@@@@@@@@@@@@@@@@@@@@@@@@@@@@@@@@@@
@@@@@@@@@@@@@@@@@@@@@@@@@@@@@@@@@@@@@@@@@@@@@@@@@@@@
@@@@@@@@@@@@@@@@@@@@@@@@@@@@@@@@@@@@@@@@@@@@@@@@@@@@
@@@@@@@@@@@@@@@@@@@@@@@@@@@@@@@@@@@@@@@@@@@@@@@@@@@@
@@@@@@@@@@@@@@@@@@@@@@@@@@@@@@@@@@@@@@@@@@@@@@@@@@@@
@@@@@@@@@@@@@@@@@@@@@@@@@@@@@@@@@@@@@@@@@@@@@@@@@@@@
@@@@@@@@@@@@@@@@@@@@@@@@@@@@@@@@@@@@@@@@@@@@@@@@@@@@
@@@@@@@@@@@@@@@@@@@@@@@@@@@@@@@@@@@@@@@@@@@@@@@@@@@@
@@@@@@@@@@@@@@@@@@@@@@@@@@@@@@@@@@@@@@@@@@@@@@@@@@@@
@@@@@@@@@@@@@@@@@@@@@@@@@@@@@@@@@@@@@@@@@@@@@@@@@@@@
@@@@@@@@@@@@@@@@@@@@@@@@@@@@.@@@@T.@@@@@@@@@@@@@@@@@
@@@@@@@@@@@@@@@@@@@@@@@@@@@.T.@@T.T.T@@@@@@@@@@@@@@@
@@@@@@@@@@@@@@@@@@@@@@@@@@..TT........@@@@@@@@@@@@@@
@@@@@@@@@@@@@@@@@@@@@@@@@@T..T.........@@@@@@@@@@@@@
@@@@@@@@@@@@@@@@@@@@@@@@@.T.T...@@...TT.@@@@@@@@@@@@
@@@@@@@@@@@@@@@@@@@@@@@..T...T.@@@@@.....@@@@@@@@@@@
@@@@@@@@@@@@@@@@@@@@@@.....T...@@@@@@@T..T@@@@@@@@@@
@@@@@@@@@@@@@@@@@@@@@TT........@@@@@@@...@@@@@@@@@@@
@@@@@@@@@@@@@@@@@@@@@@...T..T..@@@@...T.@@@@@@@@@@@@
@@@@@@@@@@@@@@@@@@@@@@@.........@.....T@@@@@@@@@@@@@
@@@@@@@@@@@@@@@@@@@@@@@@.T.TT........TT@@@@@@@@@@@@@
@@@@@@@@@@@@@@@@@..@@@@@@T............T@@@@@@@@@@@@@
@@@@@@@@@@@@@@@@T...@@@@@.T........T.T..@@@@@@@@@@@@
@@@@@@@@@@@@@@@T.T...@@@@.............T..@@@@@@@@@@@
@@@@@@@@@@@@@@@@..TT.@@@......TT..T....TT.@@@@@@@@@@
@@@@@@@@@@@@@@@@@...T.....T.........T.T..@@@@@@@@@@@
@@@@@@@@@@@@@@@@@@..TT.T....T........T..@@@@@@@@@@@@
@@@@@@@@@@@@@@@@@@@TT......T..T...T....@@@@@@@@@@@@@
@@@@@@@@@@@@.@@@@@@...T.....T...TTT.TT@@@@@@@@@@@@@@
@@@@@@@@.@@.T.@@@@@..........T...T...@@@@@@@@@@@@@@@
@@@@@@@........@@@.T..T.............@@@@@@@@@@@@@@@@
@@@@@@.....T........T.TTT...T.....T@@@@@@@@@@@@@@@@@
@@@@@@.....T..TTT...T@@T......TT..@@@@@@@@@@@@@@@@@@
@@@@@@@........T....@@@..TT...T..@@@@@@@@@@@@@@@@@@@
@@@@@@@@..T....T...@@T.T........@@@@@@@@@@@@@@@@@@@@
@@@@@@@@@...T...T.@@.....TT....@@@@@@@@@@@@@@@@@@@@@
@@@@@@@@@@....T.T@@......T....@@@@@@@@@@@@@@@@@@@@@@
@@@@@@@@@@@...T.@@T....T..TTT@@@@@@@@@@@@@@@@@@@@@@@
@@@@@@@@@@@@..T@@...........@@@@@@@@@@@@@@@@@@@@@@@@
@@@@@@@@@@@@@.@@.T.T..T...T@@@@@@@@@@@@@@@@@@@@@@@@@
@@@@@@@@@@@@@@@....T.T.T..@@@@@@@@@@@@@@@@@@@@@@@@@@
@@@@@@@@@@@@@@@........T.@@@@@@@@@@@@@@@@@@@@@@@@@@@
@@@@@@@@@@@@@@@@T.......@@@@@@@@@@@@@@@@@@@@@@@@@@@@
@@@@@@@@@@@@@@@@@TT.T..@@@@@@@@@@@@@@@@@@@@@@@@@@@@@
@@@@@@@@@@@@@@@@@@...T@@@@@@@@@@@@@@@@@@@@@@@@@@@@@@
@@@@@@@@@@@@@@@@@@@..@@@@@@@@@@@@@@@@@@@@@@@@@@@@@@@
@@@@@@@@@@@@@@@@@@@@@@@@@@@@@@@@@@@@@@@@@@@@@@@@@@@@
@@@@@@@@@@@@@@@@@@@@@@@@@@@@@@@@@@@@@@@@@@@@@@@@@@@@
