type octile
height 86
width 92
map
@@@@@@@@@@@@@@@@@@@@@@@@@@@@@@@@@@@@@@@@@@@@@@@@@@@@@@@@@@@@@@@@@@@@@@@@@@@@@@@@@@@@@@@@@@@@
@@@@@@@@@@@@@@@@@@@@@@@@@@@@@@@@@@@@@@@@@@@@@@@@@@@@@@@@@@@@@@@@@@@@@@@@@@@@@@@@@@@@@@@@@@@@
@@@@@@@@@@@@@@@@@@@@@@@@@@@@@@@@@@@@@@@@@@@@@@@@@@@@@@@@@@@@@@@@@@@@@@@@@@@@@@@@@@@@@@@@@@@@
@@@@@@@@@@@@@@@@@@@@@@@@@@@@@@@@@@@@@@@@@@@@@@@@@@@@@@@@@@@@@@@@@@@@@@@@@@@@@@@@@@@@@@@@@@@@
@@@@@@@@@@@@@@@@@@@@@@@@@@@@@@@@@@@@@@@@@@@@@@@@@@@@@@@@@@@@@@@@@@@@@@@@@@@@@@@@@@@@@@@@@@@@
@@@@@@@@@@@@@@@@@@@@@@@@@@@@@@@@@@@@@@@@@@@@@@@@@@@@@@@@@@@@@@@@@@@@@@@@@@@@@@@@@@@@@@@@@@@@
@@@@@@@@@@@@@@@@@@@@@@@@@@@@@@@@@@@@@@@@@@@@@@@@@@@@@@@@@@@@@@@@@@@@@@@@@@@@@@@@@@@@@@@@@@@@
@@@@@@@@@@@@@@@@@@@@@@@@@@@@@@@@@@@@@@@@@@@@@@@@@@@@@@@@@@@@@@@@@@@@@@@@@@@@@@@@@@@@@@@@@@@@
@@@@@@@@@@@@@@@@@@@@@@@@@@@@@@@@@@@@@@@@@@@@@@@@@@@@@@@@@@@@@@@@@@@@@@@@@@@@@@@@@@@@@@@@@@@@
@@@@@@@@@@@@@@@@@@@@@@@@@@@@@@@@@@@@@@@@@@@@@@@@@@@@@@@@@@@@@@@@@@@@@@@@@@@@@@@@@@@@@@@@@@@@
@@@@@@@@@@@@@@@@@@@@@@@@@@@@@@@@@@@@@@@@@@@@@@@@@@@@@@@@@@@@@@@@@@@@@@@@@@@@@@@@@@@@@@@@@@@@
@@@@@@@@@@@@@@@@@@@@@@@@@@@@@@@@@@@@@@@@@@@@@@@@@@@@@@@@@@@@@@@@@@@@@@@@@@@@@@@@@@@@@@@@@@@@
@@@@@@@@@@@@@@@@@@@@@@@@@@@@@@@@@@@@@@@@@@@@@@@@@@@@@@@@@@@@@@@@@@@@@@@@@@@@@@@@@@@@@@@@@@@@
@@@@@@@@@@@@@@@@@@@@@@@@@@@@@@@@@@@@@@@@@@@@@@@@@@@@@@@.@@@@@@@@@@@@@@@@@@@@@@@@@@@@@@..@@@@
@@@@@@@@@@@@@@@@@@@@@@@@@@@@@@@@@@@@@@@@@@@@@@@@@@@@@@@..@@@@@@@@@@@@@@@@@@@@@@@@@@@@...@@@@
@@@@@@@@@@@@@@@@@@@@@@@@@@@@@@@@@@@@@@@@@@@@@@@@@@@@@@T.TT@@@@@@@@@@@@@@@@@@@@@@@@@@@T.TT@@@
@@@@@@@@@@@@@@@@@@@@@@@@@@@@@@@@@@@@@@@@@@@@@@@@@@@@...@@..@@@@@@@@@@@@@@@@@@@@@@@@@..T...@@
@@@@@@@@@@@@@@@@@@@@@@@@@@@@@@@@@@@@@@@@.@@@@@@@@@@T...@@...@@@@@@@@@@@@@@@@@@@@@@@.T...T.@@
@@@@@@@@@@@@@@@@@@@@@@@@@@@@@@@@@@@@@@@.T.@@@@@@@@.....T...@@@@@@@@@@@@@@@@@@@@@@@......T.@@
@@@@@@@@@@@@@@@@@@@@@@@@@@@@@@@@@@@@@@..T...@@@@@.T...T...@@@@@@@@@@@@@@@@@@@@@@@TT.......@@
@@@@@@@@@@@@@@@@@@@@@@@@@@@@@@@@@@@@@@......T@@@@@.T.T..T@@@@@@@@@@@@@@@@@@@@@@@..T..T....@@
@@@@@@@@@@@@@@@@@@@@@@@@@@@@@@@@@@@..@@..T....@@@@@TT...@@@@@@@@@@@@@@@@@@@@@@@.........T@@@
@@@@@@@@@@@@@@@@@@@@@@@@@@@@@@@@@@....@@T....TT@@@.T...@@@@@.@@@@@@@@@@@@@@@@@.T.T....T.@@@@
@@@@@@@@@@@@@@@@@@@@@@@@@@@@@@@@@.T....@@T......@..T...@@@@T.@@T@@@@@@@@@@@@@TT...T.T..@@@@@
@@@@@@@@@@@@@@@@@@@@@@@@@@@@@@@@....TT..@@T..........@@@..T......@@@@@@@@@@@.T..T.....@@@@@@
@@@@@@@@@@@@@@@@@@@@@@@@@@@@@@@T....T...T@@....T....@@@@.........@@T@@@@@@@.TTTT.T...@@@@@@@
@@@@@@@@@@@@@@@@@@@@@@@@@@@@@@...T..T.T...@@..T.....@@T....T...TT@@T.@@@@@....T.T.T.@@@@@@@@
@@@@@@@@@@@@@@@@@@@@@@@@@@@@@.............T@@..T.T.T.T...........@@T.T@@@........T.@@@@@@@@@
@@@@@@@@@@@@@@@@@@@@@@@@@@@@..TT..T...T.....@@T..........T...TTT.@@.@@@@@@.......T@@@@@@@@@@
@@@@@@@@@@@@@@@@@@@@@@@@@@@TT.T..T.....T.T.T.@@..T....TTT..T...T..T.@@@@@@@....T..@@@@@@@@@@
@@@@@@@@@@@@@@@@@@@@@@@@@@T...............T..T@@@.T....T..T......T..@@@.@@@@...@@@@@@@@@@@@@
@@@@@@@@@@@@@@@@@@@@@@@@@.T..T...TTT..TT..TT....@..T...T....T@@..TTT@@@..T....@@@@@@@@@@@@@@
@@@@@@@@@@@@@@@@@@@@@@@@T..T.TTT.............T.@@..........@@@@@......TT.TT..@@@@@@@@@@@@@@@
@@@@@@@@@@@@@@@@@@@@@@@@..T...TT........TT....@@....T.....T@@@@@@...........@@@@@@@@@@@@@@@@
@@@@@@@@@@@@@@@@@@@.@@@@.......TT....T..T.....@......TT....TT@@@@@......TT..@@@@@@@@@@@@@@@@
@@@@@@@@@@@@@@@@@@...@@@@.....T.....T.......@....TTTT.T..T..T.@@@T.......@@@@@@@@@@@@@@@@@@@
@@@@@@@@@@@@@@@@@@...T@@@.T..T....T.T.T.T.T@@..T............T..@.T.....@@@@@@@@@@@@@@@@@@@@@
@@@@@@@@@@@@@@@@@..T..@@@..T..T...........@@.......TT..T..T.TT..T......@@@@@@@@@@@@@@@@@@@@@
@@@@@@@@@@@@@@@@T.T.TT@@@@........TT.T...@@...T.T....T.@.T.......T.....@@@@@@@@@@@@@@@@@@@@@
@@@@@@@@@@@@@@@@T...T@@@@@@T....TT.T...@@@....T.T.T...@@@@.T....TT...T..@@@@@@@@@@@@@@@@@@@@
@@@@@@@@@@@@@@@.T....@@@@@@@....T.....@@.T......T....@@..@@........T....T@@@@@@@@@@@@@@@@@@@
@@@@@@@@@@@@@@@..T..@@@@@@@@@...TT..T@@...TTT.............@@....TT..T.T.T@@@@@@@@@@@@@@@@@@@
@@@@@@@@@@@@@@.T....@@@@.@@@@@......@@..T.T......T........T@@....T.....TT@@@@@@@@@@@@@@@@@@@
@@@@@@@@@@@@@@.T...@@@@.T.@@@@@....@@.....T.....T@@@..T.....@@....TT....@@@@@@@@@@@@@@@@@@@@
@@@@@@@@@@@@@@@.T..@@@TT..@@@@@@..@@....T.......@@@@....TT.T.@@.T..T...@@@@@@@@@@@@@@@@@@@@@
@@@@@@@@@@@@@@@...@@.....@@@@@@@@@@TTT....T....@@...T.T.....T.@@T.....@@@@@@@@@@@@@@@@@@@@@@
@@@@@@@@@@@@@@..T.@@..T.@@@@@@@@@@T......T..T.@@....T.T....TT..@@....@@@@@@@@@@@@@@@@@@@@@@@
@@@@@@@@@@@@......@..@@@@@@@@@@@@...T....T...@@.......T.T..TT.T.@@..@@@@@@@@@@@@@@@@@@@@@@@@
@@@@@@@@@@.......TT.@@@@@@@@@@@@@......T...T@@.T....T............@@@@@@@@@@@@@@@@@@@@@@@@@@@
@@@@@@@@@@@....TT...@@@@@@@@@@@@..T..T......@............T.....T..@@@@@@@@@@@@@@@@@@@@@@@@@@
@@@@@@@@@@@@TT....T..@@@@@@@@@@......T.T.T...T.....TT.T.TT...T..T@@@@@@@@@@@@@@@@@@@@@@@@@@@
@@@@@@@@@@@@...TT....@@@@@@@@@T..........T..........T..T..T.....@@@@@@@@@@@@@@@@@@@@@@@@@@@@
@@@@@@@@@@@..........@@@@@@@.T.......@@@@...T......T....T.T.T..@@@@@@@@@@@@@@@@@@@@@@@@@@@@@
@@@@@@@@@@..T.T....T...@@@@@.T.TT.T..@@@@@......T.........TT..@@@@@@@@@@@@@@@@@@@@@@@@@@@@@@
@@@@@@@@@T.T...T...T....@@@.......T..@@@@@@....T...TT.....T..@@@@@@@@@@@@@@@@@@@@@@@@@@@@@@@
@@@@@@@@.T..T...T..TTT.TT...........@@@@@@@@.....T..........@@@@@@@@@@@@@@@@@@@@@@@@@@@@@@@@
@@@@@@@@@........T...T.....T...T..TT@@@@@@@@@..........T..T@@@@@@@@@@@@@@@@@@@@@@@@@@@@@@@@@
@@@@@@@@@@..T............T....T.......@@@@@@@@............@@@@@@@@@@@@@@@@@@@@@@@@@@@@@@@@@@
@@@@@@@@@@@..T.T.T.............TT......@@@@@@@@T.TT.T....@@@@@@@@@@@@@@@@@@@@@@@@@@@@@@@@@@@
@@@@@@@@@@@@...TTT......T.....TT...T...@@@@@@@@@........@@@@@@@@@@@@@@@@@@@@@@@@@@@@@@@@@@@@
@@@@@@@@@@@@@....TTTT...T...........TT.@@@@@@@@@@...T.@@@@@@@@@@@@@@@@@@@@@@@@@@@@@@@@@@@@@@
@@@@@@@@@@@@@@.T....T.......TT...T.T...@@@@@@@@@@@@@@@@@@@@@@@@@@@@@@@@@@@@@@@@@@@@@@@@@@@@@
@@@@@@@@@@@@@@@....T......TT...TT....@@@@@@@@@@@@@@@@@@@@@@@@@@@@@@@@@@@@@@@@@@@@@@@@@@@@@@@
@@@@@@@@@@@@@@@@T.T...........T....@@@@@@@@@@@@@@@@@@@@@@@@@@@@@@@@@@@@@@@@@@@@@@@@@@@@@@@@@
@@@@@@@@@@@@@@@@@..TT..T.T..T@@@.T.T@@@@@@@@@@@@@@@@@@@@@@@@@@@@@@@@@@@@@@@@@@@@@@@@@@@@@@@@
@@@@@@@@@@@@@@@@@@T.T....T.T.@@@T@@..@@@@@@@@@@@@@@@@@@@@@@@@@@@@@@@@@@@@@@@@@@@@@@@@@@@@@@@
@@@@@@@@@@@@@@@@@@@..T....TTT@@@@@@.T@@@@@.@@@@@@@@@@@@@@@@@@@@@@@@@@@@@@@@@@@@@@@@@@@@@@@@@
@@@@@@@@@@@@@@@@@@@@.T.T@@@..@@@@@@..@@@.....@@@@@@@@@@@@@@@@@@@@@@@@@@@@@@@@@@@@@@@@@@@@@@@
@@@@@@@@@@@@@@@@@@@@@...@@@@.@@@@@.T.@@@.T.T.@@@@@@@@@@@@@@@@@@@@@@@@@@@@@@@@@@@@@@@@@@@@@@@
@@@@@@@@@@@@@@@@@@@@@@.@@@@@@@@@@@@.T..T....@@@@@@@@@@@@@@@@@@@@@@@@@@@@@@@@@@@@@@@@@@@@@@@@
@@@@@@@@@@@@@@@@@@@@@@@@@@@@@.@@@@@.T..T.T.@@@@@@@@@@@@@@@@@@@@@@@@@@@@@@@@@@@@@@@@@@@@@@@@@
@@@@@@@@@@@@@@@@@@@@@@@@@@@@@..TT...T.....@@@@@@@@@@@@@@@@@@@@@@@@@@@@@@@@@@@@@@@@@@@@@@@@@@
@@@@@@@@@@@@@@@@@@@@@@@@@@@@.TT.....TT.T.@@@@@@@@@@@@@@@@@@@@@@@@@@@@@@@@@@@@@@@@@@@@@@@@@@@
@@@@@@@@@@@@@@@@@@@@@@@@@@.....T......T.@@@@@@@@@@@@@@@@@@@@@@@@@@@@@@@@@@@@@@@@@@@@@@@@@@@@
@@@@@@@@@@@@@@@@@@@@@@@@@@@......T.....@@@@@@@@@@@@@@@@@@@@@@@@@@@@@@@@@@@@@@@@@@@@@@@@@@@@@
@@@@@@@@@@@@@@@@@@@@@@@@@@@@......T..T@@@@@@@@@@@@@@@@@@@@@@@@@@@@@@@@@@@@@@@@@@@@@@@@@@@@@@
@@@@@@@@@@@@@@@@@@@@@@@@@@@@@T.....TT@@@@@@@@@@@@@@@@@@@@@@@@@@@@@@@@@@@@@@@@@@@@@@@@@@@@@@@
@@@@@@@@@@@@@@@@@@@@@@@@@@@@@@......@@@@@@@@@@@@@@@@@@@@@@@@@@@@@@@@@@@@@@@@@@@@@@@@@@@@@@@@
@@@@@@@@@@@@@@@@@@@@@@@@@@@@@@@@T.@@@@@@@@@@@@@@@@@@@@@@@@@@@@@@@@@@@@@@@@@@@@@@@@@@@@@@@@@@
@@@@@@@@@@@@@@@@@@@@@@@@@@@@@@@@@@@@@@@@@@@@@@@@@@@@@@@@@@@@@@@@@@@@@@@@@@@@@@@@@@@@@@@@@@@@
@@@@@@@@@@@@@@@@@@@@@@@@@@@@@@@@@@@@@@@@@@@@@@@@@@@@@@@@@@@@@@@@@@@@@@@@@@@@@@@@@@@@@@@@@@@@
@@@@@@@@@@@@@@@@@@@@@@@@@@@@@@@@@@@@@@@@@@@@@@@@@@@@@@@@@@@@@@@@@@@@@@@@@@@@@@@@@@@@@@@@@@@@
@@@@@@@@@@@@@@@@@@@@@@@@@@@@@@@@@@@@@@@@@@@@@@@@@@@@@@@@@@@@@@@@@@@@@@@@@@@@@@@@@@@@@@@@@@@@
@@@@@@@@@@@@@@@@@@@@@@@@@@@@@@@@@@@@@@@@@@@@@@@@@@@@@@@@@@@@@@@@@@@@@@@@@@@@@@@@@@@@@@@@@@@@
@@@@@@@@@@@@@@@@@@@@@@@@@@@@@@@@@@@@@@@@@@@@@@@@@@@@@@@@@@@@@@@@@@@@@@@@@@@@@@@@@@@@@@@@@@@@
@@@@@@@@@@@@@@@@@@@@@@@@@@@@@@@@@@@@@@@@@@@@@@@@@@@@@@@@@@@@@@@@@@@@@@@@@@@@@@@@@@@@@@@@@@@@
