type octile
height 54
width 60
map
@@@@@@@@@@@@@@@@@@@@@@@@@@@@@@@@@@@@@@@@@@@@@@@@@@@@@@@@@@@@
@@@@@@@@@@@@@@@@@@@@@@@@@@@@@@@@@@@@@@@@@@@@@@@@@@@@@@@@@@@@
@@@@@@@@@@@@@@@@@@@@@@@@@@@@@@@@@@@@@@@@@@@@@@@@@@@@@@@@@@@@
@@@@@@@@@@@@@@@@@@@@@@@@@@@@@@@@@@@@@@@@@@@@@@@@@@@@@@@@@@@@
@@@@@@@@@@@@@@@@@@@@@@@@@@@@@@@@@@@@@@@@@@@@@@@@@@@@@@@@@@@@
@@@@@@@@@@@@@@@@@@@@@@@@@@@@@@@@@@@@@@@@@@@@@@@@@@@@@@@@@@@@
@@@@@@@@@@@@@@@@@@@@@@@@@@@@@@@@@@@@@@@@@@@@@@@@@@@@@@@@@@@@
@@@@@@@@@@@@@@@@@@@@@@@@@@@@@@@@@@@@@@@@@@@@@@@@@@@@@@@@@@@@
@@@@@@@@@@@@@@@@@@@@@@@@@@@@@@@@@@@@@@@@@@@@@@@@@@@@@@@@@@@@
@@@@@@@@@@@@@@@@@@@@@@T.T..T.T.T.......@@@@@@@@@@@@@@@@@@@@@
@@@@@@@@@@@@@@@@@@@........T.....TT.......@@@@@@@@@@@@@@@@@@
@@@@@@@@@@@@@@@@@........T...T..T.TTT.T..TT.@@@@@@@@@@@@@@@@
@@@@@@@@@@@@@@@....T...T.......T......T...T.T.@@@@@@@@@@@@@@
@@@@@@@@@@@@@..................T........T...TT.@@@@@@@@@@@@@
@@@@@@@@@@@@..TT......T.........T.....TT..T.T.T.@@@@@@@@@@@@
@@@@@@@@@@@T.....T.T......@@@@T.T.......T...T...T@@@@@@@@@@@
@@@@@@@@@@TT....@@......T.@@@@@@@.....T.T.......T.@@@@@@@@@@
@@@@@@@@@.TT...@@@T.T.@......@@@@.T.....T........T.@@@@@@@@@
@@@@@@@@T....T@@@.T..T@..........T..T...............@@@@@@@@
@@@@@@@.T.TT.@@@T...T....TT..TT...@@..TTT@.........T.@@@@@@@
@@@@@@...T..@@@.....T.T...TT.....@@@@..T.@TT.......T.@@@@@@@
@@@@@@....T..@......T....T........T@@@@T..........T...@@@@@@
@@@@@.....T..TT.....T..T.....T....TT@@@@.....TTTT@....@@@@@@
@@@@@.T.....TT..T............TT......@..........@@@....@@@@@
@@@@T...........T....T.......T.....T.....@.......@@@..TT@@@@
@@@@.....TTTT...T....T..T.@@..TTT.TT....@@@@@....T@@@.@.@@@@
@@@@TT..T..........T.....@@@@@@....T...@@@@@@@T....@@@@.@@@@
@@@@..T.........T..TTT.T..@@@@@@T....T.TT..@@T..T..@@@@@@@@@
@@@@......T...T..TTT....TT..@@.TT....T..........T...@@@@@@@@
@@@@.......@@.......T...T........TT..T..T...T.......@@@@@@@@
@@@@......T.@....T...............T.......T......T...T@@@@@@@
@@@@...T.TT.TT........@@@T...T....T.T.T....TT.T.T.....@@@@@@
@@@@.@@........T@@...@@@@@.....@....T....T..T...TT.T..TT@@@@
@@@@@@@@T...TT.@@@@T...@@@@@..@@T..TT..T............T...@@@@
@@@@@@@@@......@@@@..T...@@@.......T.TT.T...TT..@......T@@@@
@@@@T@@@.T....@@@@@.......@....T.T..T.....T.T...@@......@@@@
@@@@..@@.....T..@.@@T....T.T...T................T.....T.@@@@
@@@@.....T..T.......T.................@@........T....TT.@@@@
@@@@..T...T...T..T............T....TT@@@T........@@..T..@@@@
@@@@T........TT.T.........T..T.......@@@@TT.T...@@@@....@@@@
@@@@@T........T.....T.....T.T...TT..@@@@........@@@@.T..@@@@
@@@@@.....T.......T.........T.....T....@.......@@@@@.T.T@@@@
@@@@@@T..TT@@T...............TTT..T..........T.T.@@@@T..@@@@
@@@@@@....@@@@T.TTT.....T..TTT..........T...............@@@@
@@@@@@@..@@@@@@...............T...TT..T.........T......@@@@@
@@@@@@@....@@@@T.T...........T.T......TT........T.....@@@@@@
@@@@@@@@T...@@............T....T.T.......T..@@@@....TT@@@@@@
@@@@@@@@.......TTT...............TTTT..T...T@@@@TT...@@@@@@@
@@@@@@@@@T..T.....@..T...T.T....T.......TT.@@@@@.TT.@@@@@@@@
@@@@@@@@@T..TTT.T.@@...........T.@@.........T...T..@@@@@@@@@
@@@@@@@@@@.......TT.T...T...T...@@@@.T...T......T.@@@@@@@@@@
@@@@@@@@@@@@.T.T..T.........TT.T@@@@....@@..TT.T.@@@@@@@@@@@
@@@@@@@@@@@@@@T....T.........T..@@@@@........T.@@@@@@@@@@@@@
@@@@@@@@@@@@@@@@@@@@@@@@@@@@@@@@@@@@@@@@@@@@@@@@@@@@@@@@@@@@
