type octile
height 118
width 128
map
@@@@@@@@@@@@@@@@@@@@@@@@@@@@@@@@@@@@@@@@@@@@@@@@@@@@@@@@@@@@@@@@@@@@@@@@@@@@@@@@@@@@@@@@@@@@@@@@@@@@@@@@@@@@@@@@@@@@@@@@@@@@@@@@
@@@@@@@@@@@@@@@@@@@@@@@@@@@@@@@@@@@@@@@@@@@@@@@@@@@@@@@@@@@@@@@@@@@@@@@@@@@@@@@@@@@@@@@@@@@@@@@@@@@@@@@@@@@@@@@@@@@@@@@@@@@@@@@@
@@@@@@@@@@@@@@@@@@@@@@@@@@@@@@@@@@@@@@@@@@@@@@@@@@@@@@@@@@@@@@@@@@@@@@@@@@@@@@@@@@@@@@@@@@@@@@@@@@@@@@@@@@@@@@@@@@@@@@@@@@@@@@@@
@@@@@@@@@@@@@@@@@@@@@@@@@@@@@@@@@@@@@@@@@@@@@@@@@@@@@@@@@@@@@@@@@@@@@@@@@@@@@@@@@@@@@@@@@@@@@@@@@@@@@@@@@@@@@@@@@@@@@@@@@@@@@@@@
@@@@@@@@@@@@@@@@@@@@@@@@@@@@@@@@@@@@@@@@@@@@@@@@@@@@@@@@@@@@@@@@@@@@@@@@@@@@@@@@@@@@@@@@@@@@@@@@@@@@@@@@@@@@@@@@@@@@@@@@@@@@@@@@
@@@@@@@@@@@@@@@@@@@@@@@@@@@@@@@@@@@@@@@@@@@@@@@@@@@@@@@@@@@@@@@@@@@@@@@@@@@@@@@@@@@@@@@@@@@@@@@@@@@@@@@@@@@@@@@@@@@@@@@@@@@@@@@@
@@@@@@@@@@@@@@@@@@@@@@@@@@@@@@@@@@@@@@@@@@@@@@@@@@@@@@@@@@@@@@@@@@@@@@@@@@@@@@@@@@@@@@@@@@@@@@@@@@@@@@@@@@@@@@@@@@@@@@@@@@@@@@@@
@@@@@@@@@@@@@@@@@@@@@@@@@@@@@@@@@@@@@@@@@@@@@@@@@@@@@@@@@@@@@@@@@@@@@@@@@@@@@@@@@@@@@@@@@@@@@@@@@@@@@@@@@@@@@@@@@@@@@@@@@@@@@@@@
@@@@@@@@@@@@@@@@@@@@@@@@@@@@@@@@@@@@@@@@@@@@@@@@@@@@@@@@@@@@@@@@@@@@@@@@@@@@@@@@@@@@@@@@@@@@@@@@@@@@@@@@@@@@@@@@@@@@@@@@@@@@@@@@
@@@@@@@@@@@@@@@@@@@@@@@@@@@@@@@@@@@@@@@@@@@@@@@@@@@@@@@@@@@@@@@@@@@@@@@@@@@@@@@@@@@@@@@@@@@@@@@@@@@@@@@@@@@@@@@@@@@@@@@@@@@@@@@@
@@@@@@@@@@@@@@@@@@@@@@@@@@@@@@@@@@@@@@@@@@@@@@@@@@@@@@@@@@@@@@@@@@@@@@@@@@@@@@@@@@@@@@@@@@@@@@@@@@@@@@@@@@@@@@@@@@@@@@@@@@@@@@@@
@@@@@@@@@@@@@@@@@@@@@@@@@@@@@@@@@@@@@@@@@@@@@@@@@@@@@@@@@@@@@@@@@@@@@@@@@@@@@@@@@@@@@@@@@@@@@@@@@@@@@@@@@@@@@@@@@@@@@@@@@@@@@@@@
@@@@@@@@@@@@@@@@@@@@@@@@@@@@@@@@@@@@@@@@@@@@@@@@@@@@@@@@@@@@@@@@@@@@@@@@@@@@@@@@@@@@@..@@@@@@@@@@@@@@@@@@@@@@@@@@@@@@@@@@@@@@@@@
@@@@@@@@@@@@@@@@@@@@@@@@@@@@@@@@@@@@@@@@@@@@@@@@@@@@@@@@@@@@@@@@@@@@@@@@@@@@@@@@@@@@....@@@@@@@@@@@@@@@@@@@@@@@@@@@@@@@@@@@@@@@@
@@@@@@@@@@@@@@@@@@@@@@@@@@@@@@@@@@@@@@@@@@@@@@@@@@@@@@@@@@@@@@@@@@@@@@@@@@@@@@@@@.TT....@@@@@@@@@@@@@@@@@@@@@@@@@@@@@@@@@@@@@@@@
@@@@@@@@@@@@@@@@@@@@@@@@@@@@@@@@@@@@@@@@@@@@@@@@@@@@@@@@@@@@@@@@@@@@@@@@@@@@@@@@....@@..@@@@@@@@@@@@@@@@@@@@@@@@@@@@@@@@@@@@@@@@
@@@@@@@@@@@@@@@@@@@@@@@@@@@@@@@@@@@@@@@@@@@@@@@@@@@@@@@@@@@@@@@@@@@@@@@@@@@@@@@@.T..@@TT.@@@@@@@@@@@@@@@@@@@@@@@@@@@@@@@@@@@@@@@
@@@@@@@@@@@@@@@@@@@@@@@@@@@@@@@@@@@@@@@@@@@@@@@@@@@@@@@@@@@@@@@@@@@@@@@@@@@@@@@@....T@....@@@@@@@@@@@@@@@@@@@@@@@@@@@@@@@@@@@@@@
@@@@@@@@@@@@@@@@@@@@@@@@@@@@@@@@@@@@@@@@@@@@@@@@@@@@@@@@@@@@@@@@@@@@@@@@@@@@@@@..T.T.@...@@T.@@@@@@@@@@@@@@@@@@@@@@@@@@@@@@@@@@@
@@@@@@@@@@@@@@@@@@@@@@@@@@@@@@@@@@@@@@@@@@@@@@@@@@@@@@@@@@@@@@@@@@@@@@@@@@@@@@T.........@@@....@@@@@@@@@@@@@@@@@@@@@@@@@@@@@@@@@
@@@@@@@@@@@@@@@@@@@@@@@@@@@@@@@@@@@@@@@@@@@@@@@@@@@@@@@@@@@@@@@@@@@@@@@@@@@....T....T.TT@@T...T@@@@@@@@@@@@@@@@@@@@@@@@@@@@@@@@@
@@@@@@@@@@@@@@@@@@@@@@@@@@@@@@@@@@@@@@@@@@@@@@@@@@@@@@@@@@@@@@@@@@@@@@@@@@.....TT......T.T....@@@@@@@@@@@@@@@@@@@@@@@@@@@@@@@@@@
@@@@@@@@@@@@@@@@@@@@@@@@@@@@@@@@@@@@@@@@@@@@@@@@@@@@@@@@@@@@@@@@@@@@@@@@@..TT.....T...T..T....@@@@@@@@@@@@@@@@@@@@@@@@@@@@@@@@@@
@@@@@@@@@@@@@@@@@@@@@@@@@@@@@@@@@@@@@@@@@@@@@@@@@@@@@@@@@@@@@@@@@@@@@@@@.....T..T......T...TT..@@@@@@@@@@@@@@@@@@@@@@@@@@@@@@@@@
@@@@@@@@@@@@@@@@@@@@@@@@@@@@@@@@@@@@@@@@@@@@@@@@@@@@@@@@@@@@@@@@@@@@@@@T.T........T........@@T...T..@@@@@@@@@@@@@@@@@@@@@@@@@@@@
@@@@@@@@@@@@@@@@@@@@@@@@@@@@@@@@@@@@@@@@@@@@@@@@@@@@@@@@@@@@@@@@@@@@@@.T...............T..@@@....T.TT@@@@@@@@@@@@@@@@@@@@@@@@@@@
@@@@@@@@@@@@@@@@@@@@@@@@@@@@@@@@@@@@@@@@@@@@@@@@@@@@@@@@@@@@@@@@@@@@@..........TT...TT....@@...T.....T@@@@@@@@@@@@@@@@@@@@@@@@@@
@@@@@@@@@@@@@@@@@@@@@@@@@@@@@@@@@@@@@@@@@@@@@@@@@@@@@@@@@@@@@@@@@@@@T..T.TT................@T.....T..@@@@@@@@@@@@@@@@@@@@@@@@@@@
@@@@@@@@@@@@@@@@@@@@@@@@@@@@@@@@@@@@@@@@@@@@@@@@@@@@@@@@@@@@@@@@@@@.TTT..T.......T..T.....T...T....T..@@@@@@@@@@@@@@@@@@@@@@@@@@
@@@@@@@@@@@@@@@@@@@@@@@@@@@@@@@@@@@@@@@@@@@@@@@@@@@@@@@@@@@@@@@@@@........TT..T......TT.............T..@@@@@@@@@@@@@@@@@@@@@@@@@
@@@@@@@@@@@@@@@@@@@@@@@@@@@@@@@@@@@@@@@@@@@@@@@@@@@@@@@@@@@@@@@@@............T..T......T......T....T@@..@@@@@@@@@@@@@@@@@@@@@@@@
@@@@@@@@@@@@@@@@@@@@@@@@@@@@@@@@@@@@@@@@@@@@@@@@@@@@@@@@@@@@@@@@T......T.......T............@@...TT.@@...@@@@@@@@@@@@@@@@@@@@@@@
@@@@@@@@@@@@@@@@@@@@@@@@@@@@@@@@@@@@@@@@@@@@@@@@@@@@@@@@@@@@@@@@TT.......T.......T.........@@@@.....@.T..@@@@@@@@@@@@@@@@@@@@@@@
@@@@@@@@@@@@@@@@@@@@@@@@@@@@@@@@@@@@@@@@@@@@@@@@@@@@@@@@..T@@@@@.............T..TT......@@@@@@@@..T.....@@@@@@@@@@@@@@@@@@@@@@@@
@@@@@@@@@@@@@@@@@@@@@@@@@@@@@@@@@@@@@@@@@@@@@@@@@@@@@@@@.T.@@@@@..T........T..T.....T..@@@@@@@@@@.T....@@@@@@@@@@@@@@@@@@@@@@@@@
@@@@@@@@@@@@@@@@@@@@@@@@@@@@@@@@@@@@@@@@@@@@@@@@@@@@@@@@..T@@@@@......T.T.T....TT.T.T...@@@@@@@@@T....T@@@@@@@@@@@@@@@@@@@@@@@@@
@@@@@@@@@@@@@@@@@@@@@@@@@@@@@@@@@@@@@@@@@@@@@@@@@@@@@@@@...@@@@.............T.T..........@@@@@@@.....T@@@@@@@@@@@@@@@@@@@@@@@@@@
@@@@@@@@@@@@@@@@@@@@@@@@@@@@@@@@@@@@@@@@@@@@@@@@@@@@@@@@..T@@@...TT...T.....TT....T.T.T...@@@@@.....T.@@@@@@@@@@@@@@@@@@@@@@@@@@
@@@@@@@@@@@@@@@@@@@@@@@@@@@@@@@@@@@@@@@@@@@@@@@@@..@@@@@T..@@....T..T..TT...T....T.T.....T.@@@@.......@@.T@@@@@@@@@@@@@@@@@@@@@@
@@@@@@@@@@@@@@@@@@@@@@@@@@@@@@@@@@@@@@@@@@@@@@@@T.......TT...TT.T.TT.................T......@@...@@@@.T....@@@@@@@@@@@@@@@@@@@@@
@@@@@@@@@@@@@@@@@@@@@@@@@@@@@@@@@@@@@@@@@@@@@@@T.TT..................T.T..TT.T..T.T.T...T.T.T...@@@@...T...T@@@@@@@@@@@@@@@@@@@@
@@@@@@@@@@@@@@@@@@@@@@@@@@@@@@@@@@@@@@@@@@@@@@.....@@@@.T.T....@@@........T...T.......T.T.......@@@@.TTT....T@@@@@@@@@@@@@@@@@@@
@@@@@@@@@@@@@@@@@@@@@@@@@@@@@@@@@@@@@@@@@@@@@......@..@@.....TT@@...T.................T....T...@@@@@.TT.T.T...@@@@@@@@@@@@@@@@@@
@@@@@@@@@@@@@@@@@@@@@@@@@@@@@@@@@@@@@@@@@@@@.T.T.T.T...@....T........T.....T............T.......@@@@@T.........@@@@@@@@@@@@@@@@@
@@@@@@@@@@@@@@@@@@@@@@@@@@@@@@@@@@@@@@@@@@.@T......T.T.@.....T..T....T..T..T....TT......T.T.....@@@@@@..T.T.....@@@@@@@@@@@@@@@@
@@@@@@@@@@@@@@@@@@@@@@@@@@@@@@@@@@@@@@@@@@.........@@..@@.@@....T..T.@@......T...T...T....T......@@@@@@..........@@@@@@@@@@@@@@@
@@@@@@@@@@@@@@@@@@@@@@@@@@@@@@@@@@@@@@@@@@@..T..@@@@@...@.@@T....T...@@....................T.....T@@@@@@...TT..T..@@@@@@@@@@@@@@
@@@@@@@@@@@@@@@@@@@@@@@@@@@@@@@@@@@@@@@@@@@@...@@@@@@......@@.....T.@@...T.......T...T..T........T.@@@@@@..T......T@@@@@@@@@@@@@
@@@@@@@@@@@@@@@@@@@@@@@@@@@@@@@@@@@@@@@@@@@@@..T..@@@....@......T..T.TT.......T...TT..........TT....@@@@@@......T...@@@@@@@@@@@@
@@@@@@@@@@@@@@@@@@@@@@@@@@@@@@@@@@@@@..@@@@@@.T....T.TTTT@..T.T@@@@..........T..T..T.TTT...T..T....T.@@@@@@T.........@@@@@@@@@@@
@@@@@@@@@@@@@@@@@@@@@@@@@@@@@@@@@@@@..TT@@@@@T....T.....TT.T..@@@@@.........TT..T....T.....T..T..T....@@@@@@@T..TT....@@@@@@@@@@
@@@@@@@@@@@@@@@@@@@@@@@@@@@@@@@@@@@.....T@@@@T.....T.....T......@@.T...T.T.T.T....TTT.T.T...........T@@@@@@@@@T........@@@@@@@@@
@@@@@@@@@@@@@@@@@@@@@@@@@@@@@@@@@@..T.....@@TT......T....T......T....T.T...T......T.T..T..T.T.......@@@@@@@@@@@.....TT..@@@@@@@@
@@@@@@@@@@@@@@@@@@@@@@@@@@@@@@@@@......T..@@T..@@@......T..T.TTT..T..T.....T.....T.TT...T.....T.TT.@@@@@@@@@@@@@T.T.TT.T.@@@@@@@
@@@@@@@@@@@@@@@@@@@@@@@@@@@@@@@@.TT....T..@@..T@@@@T...T...T.T......T....T.......T.T.........T.TT.@@@@@@@@@@@@@@@..TT...T.@@@@@@
@@@@@@@@@@@@@@@@@@@@@@@@@@@@@@@.T.@@.....@@T..@@@@@@..T..TTT..T.....TT..T.T..T...T.T.....TT......@@@@@@@@@@@@@@@@@.T...T...@@@@@
@@@@@@@@@@@@@@@@@@@@@@@@@@@@@@.T..@@T...T@@TTT@@@@@@@@.....@@@@....TTT.T.T.......T..........T..T@@@@@@@@@@@@@@@@@@@...TT....@@@@
@@@@@@@@@@@@@@@@@@@@@@@@@@@@@T.T..@@@..T.@.T.@@@@@@@@@..T.T@@@@..T................T...T.....T..@@@@@@@@@@@@@@@@@@@@@.......T.@@@
@@@@@@@@@@@@@@@@@@@@@@@@@@@@T...T.T@@@.......@@@@@@@@@@....@@@@.......T.T@@T.TTT.....T........@@@@@@@@@@@@@@@@@@@@@@@..T....T@@@
@@@@@@@@@@@@@@@@@@@@@@@@@@@...TT..T@@@@.....T@@@@@@@@@@@T...@@@......T..T@@....T....TT.......@@@@@@@@@@@@@@@@@@@@@@@@....T.T@@@@
@@@@@@@@@@@@@@@@@@@@@@@@@@.TT..T...T@@@@...T@@.@@@@@@@@@@...T........T..@@..@@.....T@@@...TT@@@@@@@@@@@@@@@@@@@@@@@@@..T..T@@@@@
@@@@@@@@@@@@@@@@@@@@@@@@@T......@@.T.@@@@..T@...T.@@@@@@@@.........T....@..@@@......@@@TT.T@@@@@@@@@@@@@@@@@@@@@@@@@......@@@@@@
@@@@@@@@@@@@@@@@@@@@@@@@..T....T@@@.T..@@@.....T..@@@@@@@@@........TTT...T@@@TT.......T.T.@@@@@@@@@@@@@@@@@@@@@@@@.......@@@@@@@
@@@@@@@@@@@@@@@@@@@@@@@..@@...T..@@@T...@@@..T....@..@@@@@@@...@@......TTT@....TT...T..T.@@@@@@@@@@@@@@@@@@@@@@@@@.T..@@@@@@@@@@
@@@@@@@@@@@@@@@@@@@@@....@@.@@@T.T@@@T...@@@...TT.....@@@@@@@..@@...T................T.T@@@@@@@@@@@@@@@@@@@@@@@@@@....@@@@@@@@@@
@@@@@@@@@@@@@@@@@@@@.....@@.@@@@T..@@@....@@.T.T....T.@@@@@@@@...TT.TTT.....T...T......@@@@@@@@@@@@@@@@@@@@@@@@@@@.TT..@@@@@@@@@
@@@@@@@@@@@@@@@@@@@.T........@@@@T.T@@@T..T..T..T.....@T@@@@@@@T.......T.....TT......T@@@@@@@@@@@@@@@@@@@@@@@@@@@@T....T@@@@@@@@
@@@@@@@@@@@@@@@@@@..T.T..T....@@@@...@@@..T..T.......T...@@@@@@.....T.T...........T..@@@@@@@@@@@@@@@@@@@@@@@@@@@@T.......@@@@@@@
@@@@@@@@@@@@@@@@@.......@@..T..@@@@T..@@TT..T.T.........T.@@@@@.......T.@........T....@@@@@@@@@@@@@@@@@@@@@@@@@@@@.....T..@@@@@@
@@@@@@@@@@@@@@@@.T..TT..@@@..T.T@@@@.T.TT.....TTTT.T.T....@@@@@T.T.T....@........T.T..T@@@@@@@@@@@@@@@@@@@@@@@@@@...T.....T@@@@@
@@@@@@@@@@@@@@@...T......@@@T.T.T@@@@.......T....T@@@.......T@@T..@.....T....T........T.@@@@@@@@@@@@@@@@.@@@@@@@...........@@@@@
@@@@@@@@@@@@@@......T.....@@@...TT@@@TT..T.....TT.@@@@.TT.T..@...@@@.........T....T.....T@@@@@@@@@@@@@@.....T.T......T....@@@@@@
@@@@@@@@@@@@@...@@..T@@....@@@.......T..T.....T....@@@@TT...@@..T@@@@..T..T.T.@@......T...@@@@@@@@@@@@....T....TT.T.T....@@@@@@@
@@@@@@@@@@@@T..T@@..T@@@.T..@@@...............TT...T@@@@..T.@....@@@@@.TT.T..@@@@.........@@@@@@@@@@@@................T.@@@@@@@@
@@@@@@@@@@@.T...@@..T.@@.....@@@T........T.....T@@..T@@@@TT.@...@@@@@@@....T@@@@@@......T.@@@@@@@@@@@T.........T.......@@@@@@@@@
@@@@@@@@@@.............@@..T..@@T.TT....T...T...@@@...@@@..@@...@@@@@@@@T..@@@@@@@@..TT..T..@.@@@@.@@............TT...@@@@@@@@@@
@@@@@@@@@..T...T.T.....@@@..T.@@TT..T.T.T.@@@...@@@@.T.@@@..TT.@@..@@@@@@.@@@@@@@@@@.@@@@T..T...T.....T...T......T..T@@@@@@@@@@@
@@@@@@@@@@....T..@@.....@@@..........T..T.@@@@...@@@....@@@...T@@...@@@@@@@@@@@@@@@@@@@@@T.T.TT.T..T.T.@..T.T.....T.@@@@@@@@@@@@
@@@@@@@@@@@...TT.@@@T....@@@......T.T......@@@@...@@@....@..T.T@.T...@@@@@@@@@@@@@@@@@@@.....T..T.T.@@@@@@T..T..T..@@@@@@@@@@@@@
@@@@@@@@@@@@T....@@@@..T..@@.....T....TT...T@@@@@..@@@..T....T....TT..@@@@@@@@@@@@@@@@@@.......T..@@@@@@@@.......T@@@@@@@@@@@@@@
@@@@@@@@@@@@@....T.@@@@...@@.....T.....@@@...T@@@@..@@@T.TTTT.....TT.@@@@@@@@@@@@@@@@@@@T......T.@@@@@@@@@.TT..T.@@@@@@@@@@@@@@@
@@@@@@@@@@@@@@.....T@@@@...T....TTT....@@@@T...@@@@.@@@...T.T..T....@@@@@@@@@@@@@@@@@@@@@...T..T.@@@@@@@@@.T.T.T@@@@@@@@@@@@@@@@
@@@@@@@@@@@@@@..T.T...@@@.........T.@@TT.@@@TT..@@@..@@............@@@@@@@@@@@@@@@@@@@@@@@...T..T@@@@@@@@@.....@@@@@@@@@@@@@@@@@
@@@@@@@@@@@@@@@........@@@T..T.T....@@@T..@@@TT..@@...........T.T.@@@@@@@@@@@@@@@@@@@@@@@@@.T...T@@@@@@@T...TT@@@@@@@@@@@@@@@@@@
@@@@@@@@@@@@@@@@.T...T..@@..T.T......@@@...@@@..T.T..T...T.......@@@@@@@@@@@@@@@@@@@@@@@@@@@T.....@@@@@..T.TT@@@@@@@@@@@@@@@@@@@
@@@@@@@@@@@@@@@@.TT..T...........@@...@@@@..@@@..........T......@@@@@@@@@@@@@@@@@@@@@@@@@@@@@T...T.T........@@@@@@@@@@@@@@@@@@@@
@@@@@@@@@@@@@@@@@.......T........@@.T.T@@@@..@@@TT..T..........@@@@@@@@@@@@@@@@@@@@@@@@@@@@@@@.TT........T.@@@@@@@@@@@@@@@@@@@@@
@@@@@@@@@@@@@@@@@..T.TT.....TT...@@@....@@@@..@@.T....T..T....@@@@@@@@@@@@@@@@@@@@@@@@@@@@@@@@@.T.......T.@@@@@@@@@@@@@@@@@@@@@@
@@@@@@@@@@@@@@@@@@.T.......T......@@@....@@@.T.....T..T......@@@@@@@@@@@@@@@@@@@@@@@@@@@@@@@@@@@...T....T@@@@@@@@@@@@@@@@@@@@@@@
@@@@@@@@@@@@@@@@@@.T.......T.......@@@..T.@@T...TT...T...TT.@@@@@@@@@@@@@@@@@@@@@@@@@@@@@@@@@@@@@.......@@@@@@@@@@@@@@@@@@@@@@@@
@@@@@@@@@@@@@@@@@@..................@@@.T....TT.......T....@@@@@@@@@@@@@@@@@@@@@@@@@@@@@@@@@@@@@@@.T...@@@@@@@@@@@@@@@@@@@@@@@@@
@@@@@@@@@@@@@@@@@@..T.T......T.......@@@@T....TT.T...T....@@@@@@@@@@@@@@@@@@@@@@@@@@@@@@@@@@@@@@@@@...@@@@@@@@@@@@@@@@@@@@@@@@@@
@@@@@@@@@@@@@@@@........T............T@@@......T.........@@@@@@@@@@@@@@@@@@@@@@@@@@@@@@@@@@@@@@@@@@@T@@@@@@@@@@@@@@@@@@@@@@@@@@@
@@@@@@@@@@@@@@@@.....T........T........@@.....T..TT.T...@@@@@@@@@@@@@@@@@@@@@@@@@@@@@@@@@@@@@@@@@@@@@@@@@@@@@@@@@@@@@@@@@@@@@@@@
@@@@@@@@@@@@@@@..T.......TTT.......T.......T.....T.T...@@@@@@@@@@@@@@@@@@@@@@@@@@@@@@@@@@@@@@@@@@@@@@@@@@@@@@@@@@@@@@@@@@@@@@@@@
@@@@@@@@@@@@@@T.T............T.T.TT........TT.......T.@@@@@@@@@@@@@@@@@@@@@@@@@@@@@@@@@@@@@@@@@@@@@@@@@@@@@@@@@@@@@@@@@@@@@@@@@@
@@@@@@@@@@@@@@.........T.T.T.T.T...........T.......TT@@@@@@@@@@@@@@@@@@@@@@@@@@@@@@@@@@@@@@@@@@@@@@@@@@@@@@@@@@@@@@@@@@@@@@@@@@@
@@@@@@@@@@@@@.........T.T...T..T..T..TT........T....@@@@@@@@@@@@@@@@@@@@@@@@@@@@@@@@@@@@@@@@@@@@@@@@@@@@@@@@@@@@@@@@@@@@@@@@@@@@
@@@@@@@@@@@@@.T......T..T..T..T@..........T...T....@@@@@@@@@@@@@@@@@@@@@@@@@@@@@@@@@@@@@@@@@@@@@@@@@@@@@@@@@@@@@@@@@@@@@@@@@@@@@
@@@@@@@@@@@@@@@@@@@....T...T..@@@T...TT....TT.....@@@@@@@@@@@@@@@@@@@@@@@@@@@@@@@@@@@@@@@@@@@@@@@@@@@@@@@@@@@@@@@@@@@@@@@@@@@@@@
@@@@@@@@@@@@@@@@@@@....TT....@@@@@......T...T..T.@@@@@@@@@@@@@@@@@@@@@@@@@@@@@@@@@@@@@@@@@@@@@@@@@@@@@@@@@@@@@@@@@@@@@@@@@@@@@@@
@@@@@@@@@@T@@@@@@@..T...TT..@@@@@@@T...T...TT...@@@@@@@@@@@@@@@@@@@@@@@@@@@@@@@@@@@@@@@@@@@@@@@@@@@@@@@@@@@@@@@@@@@@@@@@@@@@@@@@
@@@@.T.......@@@@.......T..@@@@@@@@@...........@@@@@@@@@@@@@@@@@@@@@@@@@@@@@@@@@@@@@@@@@@@@@@@@@@@@@@@@@@@@@@@@@@@@@@@@@@@@@@@@@
@@@..........T..T...T.T...@@@@@@@@@@@...TT.T..@@@@@@@@@@@@@@@@@@@@@@@@@@@@@@@@@@@@@@@@@@@@@@@@@@@@@@@@@@@@@@@@@@@@@@@@@@@@@@@@@@
@@..T.....T.....T.T......@@@@@@@@@@@@@...TT..@@@@@@@@@@@@@@@@@@@@@@@@@@@@@@@@@@@@@@@@@@@@@@@@@@@@@@@@@@@@@@@@@@@@@@@@@@@@@@@@@@@
@TT...T....T...TTT.....T@@@@@@@@@@@@@@@..T..@@@@@@@@@@@@@@@@@@@@@@@@@@@@@@@@@@@@@@@@@@@@@@@@@@@@@@@@@@@@@@@@@@@@@@@@@@@@@@@@@@@@
@@.T.T.T..........T...T@@@@@@@@@@@@@@@@@.T.@@@@@@@@@@@@@@@@@@@@@@@@@@@@@@@@@@@@@@@@@@@@@@@@@@@@@@@@@@@@@@@@@@@@@@@@@@@@@@@@@@@@@
@@@..T.........T......@@@@@@@@@@@@@@@@@@@T@@@@@@@@@@@@@@@@@@@@@@@@@@@@@@@@@@@@@@@@@@@@@@@@@@@@@@@@@@@@@@@@@@@@@@@@@@@@@@@@@@@@@@
@@@@.T.....T....TT...@@@@@@@@@@@@@@@@@@@@@@@@@@@@@@@@@@@@@@@@@@@@@@@@@@@@@@@@@@@@@@@@@@@@@@@@@@@@@@@@@@@@@@@@@@@@@@@@@@@@@@@@@@@
@@@@@....T..T....T.T@@@@@@@@@@@@@@@@@@@@@@@@@@@@@@@@@@@@@@@@@@@@@@@@@@@@@@@@@@@@@@@@@@@@@@@@@@@@@@@@@@@@@@@@@@@@@@@@@@@@@@@@@@@@
@@@@@@....T........@@@@@@@@@@@@@@@@@@@@@@@@@@@@@@@@@@@@@@@@@@@@@@@@@@@@@@@@@@@@@@@@@@@@@@@@@@@@@@@@@@@@@@@@@@@@@@@@@@@@@@@@@@@@@
@@@@@@@..T..T.....@@@@@@@@@@@@@@@@@@@@@@@@@@@@@@@@@@@@@@@@@@@@@@@@@@@@@@@@@@@@@@@@@@@@@@@@@@@@@@@@@@@@@@@@@@@@@@@@@@@@@@@@@@@@@@
@@@@@@@@.TTTT....@@@@@@@@@@@@@@@@@@@@@@@@@@@@@@@@@@@@@@@@@@@@@@@@@@@@@@@@@@@@@@@@@@@@@@@@@@@@@@@@@@@@@@@@@@@@@@@@@@@@@@@@@@@@@@@
@@@@@@@@@T.T....@@@@@@@@@@@@@@@@@@@@@@@@@@@@@@@@@@@@@@@@@@@@@@@@@@@@@@@@@@@@@@@@@@@@@@@@@@@@@@@@@@@@@@@@@@@@@@@@@@@@@@@@@@@@@@@@
@@@@@@@@@@...T.@@@@@@@@@@@@@@@@@@@@@@@@@@@@@@@@@@@@@@@@@@@@@@@@@@@@@@@@@@@@@@@@@@@@@@@@@@@@@@@@@@@@@@@@@@@@@@@@@@@@@@@@@@@@@@@@@
@@@@@@@@@@@..T@@@@@@@@@@@@@@@@@@@@@@@@@@@@@@@@@@@@@@@@@@@@@@@@@@@@@@@@@@@@@@@@@@@@@@@@@@@@@@@@@@@@@@@@@@@@@@@@@@@@@@@@@@@@@@@@@@
@@@@@@@@@@@@@@@@@@@@@@@@@@@@@@@@@@@@@@@@@@@@@@@@@@@@@@@@@@@@@@@@@@@@@@@@@@@@@@@@@@@@@@@@@@@@@@@@@@@@@@@@@@@@@@@@@@@@@@@@@@@@@@@@
@@@@@@@@@@@@@@@@@@@@@@@@@@@@@@@@@@@@@@@@@@@@@@@@@@@@@@@@@@@@@@@@@@@@@@@@@@@@@@@@@@@@@@@@@@@@@@@@@@@@@@@@@@@@@@@@@@@@@@@@@@@@@@@@
