type octile
height 54
width 56
map
@@@@@@@@@@@@@@@@@@@@@@@@@@@@@@@@@@@@@@@@@@@@@@@@@@@@@@@@
@@@@@@@@@@@@@@@@@@@@@@@@@@@@@@@@@@@@@@@@@@@@@@@@@@@@@@@@
@@@@@@@@@@@@@@@@@@@@@@@@@@@@@@@@@@@@@@@@@@@@@@@@@@@@@@@@
@@@@@@@@@@@@@@@@@@@@@@@@@@@@@@@@@@@@@@@@@@@@@@@@@@@@@@@@
@@@@@@@@@@@@@@@@@@@@@@@@@@@@@@@@@@@@@@@@@@@@@@@@@@@@@@@@
@@@@@@@@@@@@@@@@@@@@@@@@@@@@@@@@@@@@@@@@@@@@@@@@@@@@@@@@
@@@@@@@@@@@@@@@@@@@@@@@@@@@@@@@@@@@@@@@@@@@@@@@@@@@@@@@@
@@@@@@@@@@@@@@@@@@@@@@@@@@@@@@@@@@@@@@@@@@@@@@@@@@@@@@@@
@@@@@@@@@@@@@@@@@@@@@@@@@@@@@@@@@@@@@@@@@@@@@@@@@@@@@@@@
@@@@@@@@@@@@@@@@@@@@@@@@@@@@@@@@@@@@@@@@@@@@@@@@@@@@@@@@
@@@@@@@@@@@@@@@@@@@@@..@@@@@@@@@@@@@@@@@@@@@@@@@@@@@@@@@
@@@@@@@@@@@@@@@@@@@@....@@@@@@@@@@@@@@@@@@@@@@@@@@@@@@@@
@@@@@@@@@@@@@@@@@@@...T.T@@@@@@@@@@@@@@@.@@@@@@@@@@@@@@@
@@@@@@@@@@@@@@@@@@....T..T@@@@@@@@@@@@@...@@@@@@@@@@@@@@
@@@@@@@@@@@@@@@@@.T...T..T.@@@@@@@@@@@T....@@@@@@@@@@@@@
@@@@@@@@@@@@@@@@....@@..T.T.@@@@@@@@@@....T@@@@@@@@@@@@@
@@@@@@@@@@@@@@@...T@@@....T..@@@@@@@@T....T@@@@@@@@@@@@@
@@@@@@@@@@@@@@...T@@@@.TT.....@@@@@@.T....T@@@@@@@@@@@@@
@@@@@@@@@@@@@TT...@@@.....T....@@@@T.......@@@@@@@@@@@@@
@@@@@@@@@@@@.......@T...T.......@@T...T.@@@@@@@@@@@@@@@@
@@@@@@@@@@......T..T.....T....TT.......@@@@@@@@@@@@@@@@@
@@@@@@@@@..TT..TTTT......TT..T........T@@@@@@@@@@@@@@@@@
@@@@@@@@T....TT.....T....@@@@.........T.@@....@@@@@@@@@@
@@@@@@@@@.T...T.TT.T....T@@@@@..T.....T.TT.T.@@@@@@@@@@@
@@@@@@@@@@.............T@@@@@@@.T...T.....TT@@@@@@@@@@@@
@@@@@@@@@@@............T@@@@@@@@.T.........@@@@@@@@@@@@@
@@@@@@@@@@@@@....@..T..T@@@@@@@@@..T.....@@@@@@@@@@@@@@@
@@@@@@@@@@@@@@@..@@......@@@@@@@@@T...TT@@@@@@@@@@@@@@@@
@@@@@@@@@@@@@@@T..@@T.T...@@@@@@@@@.T..@@@@@@@@@@@@@@@@@
@@@@@@@@@@@@@@@@..@@@T.T...@@@@@@@@...TT@@@@@@@@@@@@@@@@
@@@@@@@@@@@@@@@@.T@@@@......@@@@@@....T..@@@@@@@@@@@@@@@
@@@@@@@@@@@@@@@@@.@@@@@TT....@@@@...T..T..@@@@@@@@@@@@@@
@@@@@@@@@@@@@@@@@@@@@@@@T.T..@@@T....T.....@@@@@@@@@@@@@
@@@@@@@@@@@@@@@@@@@@@@@@..T...T.....TT......@@@@@@@@@@@@
@@@@@@@@@@@@@@@@@@@@@@@@.....T......T..TT...T@@@@@@@@@@@
@@@@@@@@@@@@@@@.@@@@@@@@.........T...T.T......@@@@@@@@@@
@@@@@@@@@@@@...TT..T......TT.....T...T...T.TT.@@@@@@@@@@
@@@@@@@@@@....T...........T......T..T@..TT...@@@@@@@@@@@
@@@@@@@@...T...........T.....T.T....@@@T..T.@@@@@@@@@@@@
@@@@@@@..T.@@T.....................T@@@@...@@@@@@@@@@@@@
@@@@@@.T..@@.T...............T....T..@@@@T@@@@@@@@@@@@@@
@@@@@@..TT....TT.....T...@T..T........@@@@@@@@@@@@@@@@@@
@@@@@@.T.T..............@@@..T...T.....@@@@@@@@@@@@@@@@@
@@@@@@....T.........T.T@@@@@..T.....T..@@@@@@@@@@@@@@@@@
@@@@@@@T....T...T.T.TT@@@@@@@...T.....@@@@@@@@@@@@@@@@@@
@@@@@@@@....TT.......@@@@@@@@@TT.....@@@@@@@@@@@@@@@@@@@
@@@@@@@@@...T...T...@@@@@@@@@@@@T.TT@@@@@@@@@@@@@@@@@@@@
@@@@@@@@@@....T.T..@@@@@@@@@@@@@@.@@@@@@@@@@@@@@@@@@@@@@
@@@@@@@@@@@..T.T..@@@@@@@@@@@@@@@@@@@@@@@@@@@@@@@@@@@@@@
@@@@@@@@@@@@T...@@@@@@@@@@@@@@@@@@@@@@@@@@@@@@@@@@@@@@@@
@@@@@@@@@@@@@@.@@@@@@@@@@@@@@@@@@@@@@@@@@@@@@@@@@@@@@@@@
@@@@@@@@@@@@@@@@@@@@@@@@@@@@@@@@@@@@@@@@@@@@@@@@@@@@@@@@
@@@@@@@@@@@@@@@@@@@@@@@@@@@@@@@@@@@@@@@@@@@@@@@@@@@@@@@@
@@@@@@@@@@@@@@@@@@@@@@@@@@@@@@@@@@@@@@@@@@@@@@@@@@@@@@@@
