type octile
height 64
width 64
map
@@@@@@@@@@@@@@@@@@@@@@@@@@@@@@@@@@@@@@@@@@@@@@@@@@@@@@@@@@@@@@@@
@@@@@@@@@@@@@@@@@@@@@@@@@@@@@@@@@@@@@@@@@@@@@@@@@@@@@@@@@@@@@@@@
@@@@@@@@@@@@@@@@@@@@@@@@@@@@@@@@@@@@@@@@@@@@@@@@@@@@@@@@@@@@@@@@
@@@@@@@@@@@@@@@@@@@@@@@@@@@@@@@@@@@@@@@@@@@@@@@@@@@@@@@@@@@@@@@@
@@@@@@@@@@@@@@@@@@@@@@@@@@@@@@@@@@@@@@@@@@@@@@@@@@@@@@@@@@@@@@@@
@@@@@@@@@@@@@@@@@@@@@@@@@@@@@@@@@@@@@@@@@@@@@@@@@@@@@@@@@@@@@@@@
@@@@@@@@@@@@@@@@@@@@@@@@@@@@@@@@@@@@@@@@@@@@@@@@@@@@@@@@@@@@@@@@
@@@@@@@@@@@@@@@@@@@@@@@@@@@@@@@@@@@@@@@@@@@@@@@@@@@@@@@@@@@@@@@@
@@@@@@@@@@@@@@@@@@@@@@@@@@@@@@@@@@@@@@@@@@@@@@@@@@@@@@@@@@@@@@@@
@@@@@@@@@@@@@@@@@@@@@@@@@@@@@@@@@@@@.@@@@@@@@@@@@@@@@@@@@@@@@@@@
@@@@@@@@@@@@@@@@@@@@@@@@@@@@@@@@@@@...@@@@@@@@@@@@@@@@@@@@@@@@@@
@@@@@@@@@@@@@@@@@@@@@@@@@@@@@@@@@@.T...@@@@@@@@@@@@@@@@@@@@@@@@@
@@@@@@@@@@@@@@@@@@@@@@@@@@@@@@@@@.......@@@@@@@@@@@@@@@@@@@@@@@@
@@@@@@@@@@@@@@@@@@@@@@@@@@@@@@@@TT.T.....@@@@@@@@@@@@@@@@@@@@@@@
@@@@@@@@@@@@@@@@@@@@@@@@@@@@@@@.TT.....T..@@@@@@@@@@@@@@@@@@@@@@
@@@@@@@@@@@@@@@@@@@@@@@@@@@@@@T............@@@@@@@@@@@@@@@@@@@@@
@@@@@@@@@@@@@@@@@@@@@@@@@@@@@......T.......@@@@@@@@@@@@@@@@@@@@@
@@@@@@@@@@@@@@@@@@@@@@@@@@@@....@@.....T..@@.@@@@@@@@@@@@@@@@@@@
@@@@@@@@@@@@@@@@@@@@@@@@@@@......@@..T...@@T..@@@@@@@@@@@@@@@@@@
@@@@@@@@@@@@@@@@@@@@@@@@@.T.......@@....@@....T@@@@@@@@@@@@@@@@@
@@@@@@@@@@@@@@@@@@@@@@@@@TT.T......@@TT@@....T.T@@@@@@@@@@@@@@@@
@@@@@@@@@@@@@@@@@@@@@@@@@.T....T.T..@@@@...T.....@@@@@@@@@@@@@@@
@@@@@@@@@@@@@@@@@@@@@@@@@@........T.T@@..T.........@@@@@@@@@@@@@
@@@@@@@@@@@@@@@@@@@@@@@@@@@...T..........T...T..TT.T@@@@@.@@@@@@
@@@@@@@@@@@@@@@@@@@@@@@@@@@@.T............T....T..T...T....@@@@@
@@@@@@@@@@@@@@@@@@@@@@@@@@@@@....T...T....TT..T............T@@@@
@@@@@@@@@@@@@@@@@@@@@@@@@@@@@@..T......TT.T..T.....T........T@@@
@@@@@@@@@@@@@@@@@@@@@@@@@@.@@@@T.....T...T..TT............TT..@@
@@@@@@@@@@@@@@@@@@@.@@@@@.TT@@@@.......T..........@@TT...T.T...@
@@@@@@@@@@@@@@@@@@...@@@T..T.@@@@....T....TT....@@@@@T.....T...@
@@@@@@@@@@@@@@@@@@TT...TTT.T..@@@@.....T......@@@@@@@@.....T...@
@@@@@@@@@@@@@@@@@@@............@@......T......@@@@@@@@@.T.....@@
@@@@@@@@@@@@@@@@@@@@..T..T.....TT...T.......T..@@@@@@@@@.....@@@
@@@@@@@@@@@@@@@@@@@@..TT.T.T.TT.....@......T...T@@@@@@@@@...@@@@
@@@@@@@@@@@@TT@@@@..T....TT..T.T..T@@@.....TT....@@@@@@@@@.@@@@@
@@@@@@@@@@@..T.@@..........T.@.T...@@@@...T.T.....@@@@@@@@@@@@@@
@@@@@@@@@@@T.T.T........T...@@..T..T@@@@.T.T..TT...@@@@@@@@@@@@@
@@@@@@@@@@@@T..............@@@@......@@@@...........@@@@@@@@@@@@
@@@@@.@@@@@@@T........T...@@@@@@......@@@@.TT...T...T@@@@@@@@@@@
@@@@T..@@@@@@...........T@@@@@@@TT.T...@@@@...TTT.....@@@@@@@@@@
@@@.T.T.@@@@............@@@@@@@@....T..T.@@@...T.....@@@@@@@@@@@
@@@......@@.....T..T...T@@@@@@@.....T...@@@@@@..T...@@@@@@@@@@@@
@@@@T......T.TT.TTTT...@@@@@@@.....T...@@@@@@@@....@@@@@@@@@@@@@
@@@@@......T.T..T...@..@@@@@@.T.......@@@@@@@@@@.T@@@@@@@@@@@@@@
@@@@@@....T........@@@..@@......T...T.@@@@@@@@@@@@@@@@@@@@@@@@@@
@@@@@@@.....T.T...@@@@@TT.T.......TTT.@@@@@@@@@@@@@@@@@@@@@@@@@@
@@@@@@@@T.TT..T..@@@@@@@...T.........T.@@@@@@@@@@@@@@@@@@@@@@@@@
@@@@@@@@@..T...T@@@@@@@@......T...@@..TT@@@@@@@@@@@@@@@@@@@@@@@@
@@@@@@@@@@.......@@@@@@..........@@@@T.T.@@@@@@@@@@@@@@@@@@@@@@@
@@@@@@@@@@@...T...@@@@.T...T....@@@@@@TT..@@@@@@@@@@@@@@@@@@@@@@
@@@@@@@@@@@@..TT..T@@......T..T@@@@@@@@...T@@@@@@@@@@@@@@@@@@@@@
@@@@@@@@@@@@@..TT..T.T..........@@@@@@@@..@@@@@@@@@@@@@@@@@@@@@@
@@@@@@@@@@@@@@T....T.............@@@@@@@@@@@@@@@@@@@@@@@@@@@@@@@
@@@@@@@@@@@@@@@T.T..T..T...@@....T@@@@@@@@@@@@@@@@@@@@@@@@@@@@@@
@@@@@@@@@@@@@@@@.....T....@@@@..TT.@@@@@@@@@@@@@@@@@@@@@@@@@@@@@
@@@@@@@@@@@@@@@@@.T......@@@@@@..TTT@@@@@@@@@@@@@@@@@@@@@@@@@@@@
@@@@@@@@@@@@@@@@@@......@@@@@@@@TT...@@@@@@@@@@@@@@@@@@@@@@@@@@@
@@@@@@@@@@@@@@@@@@@...T.T@@@@@@@@.TT@@@@@@@@@@@@@@@@@@@@@@@@@@@@
@@@@@@@@@@@@@@@@@@@@......@@@@@@@@.@@@@@@@@@@@@@@@@@@@@@@@@@@@@@
@@@@@@@@@@@@@@@@@@@@@..T...@@@@@@@@@@@@@@@@@@@@@@@@@@@@@@@@@@@@@
@@@@@@@@@@@@@@@@@@@@@@..T...@@@@@@@@@@@@@@@@@@@@@@@@@@@@@@@@@@@@
@@@@@@@@@@@@@@@@@@@@@@@T.T...@@@@@@@@@@@@@@@@@@@@@@@@@@@@@@@@@@@
@@@@@@@@@@@@@@@@@@@@@@@@.....T@@@@@@@@@@@@@@@@@@@@@@@@@@@@@@@@@@
@@@@@@@@@@@@@@@@@@@@@@@@@@@@@@@@@@@@@@@@@@@@@@@@@@@@@@@@@@@@@@@@
