type octile
height 64
width 60
map
@@@@@@@@@@@@@@@@@@@@@@@@@@@@@@@@@@@@@@@@@@@@@@@@@@@@@@@@@@@@
@@@@@@@@@@@@@@@@@@@@@@@@@@@@@@@@@@@@@@@@@@@@@@@@@@@@@@@@@@@@
@@@@@@@@@@@@@@@@@@@@@@@@@@@@@@@@@@@@@@@@@@@@@@@@@@@@@@@@@@@@
@@@@@@@@@@@@@@@@@@@@@@@@@@@@@@@@@@@@@@@@@@@@@@@@@@@@@@@@@@@@
@@@@@@@@@@@@@@@@@@@@@@@@@@@@@@@@@@@@@@@@@@@@@@@@@@@@@@@@@@@@
@@@@@@@@@@@@@@@@@@@@@@@@@@@@@@@@@@@@@@@@@@@@@@@@@@@@@@@@@@@@
@@@@@@@@@@@@@@@@@@@@@@@@@@@@@@@@@@@@@@@@@@@@@@@@@@@@@@@@@@@@
@@@@@@@@@@@@@@@@@@@@@@@@@@@@@@@@@@@@@@@@@@@@@@@@@@@@@@@@@@@@
@@@@@@@@@@@@@@@@@@@@@@@@@@@@@@@@@@@@@@@@@@@@@@@@@@@@@@@@@@@@
@@@@@@@@@@@@@@@@@@@@@@@@@@@@@@@@@@@@@@@@@@@@@@@@@@@@@@@@@@@@
@@@@@@@@@@@@@@@@@@@@@@@@@@@@@@@@@@@@@@@@@@@@@@@@@@@@@@@@@@@@
@@@@@@@@@@@@@@@@@@@@@@@@@@@@@@@@T@@@@@@@@@@@@@@@@@@@@@@@@@@@
@@@@@@@@@@@@@@@@@@@@@@@@@@@@@@@T.@@@@@@@@@@@@@@@@@@@@@@@@@@@
@@@@@@@@@@@@@@@@@@@@@@@@@@@@@@@..@@@@...@@@@@@@@@@@@@@@@@@@@
@@@@@@@@@@@@@@@@@@@@@@@@@@@@@@@TT@@@@@@..@@@@@@@@@@@@@@@@@@@
@@@@@@@@@@@@@@@@@@@@@@@@@@@@@@@.T@.@@@@@T.@@@@@@@@@@@@@@@@@@
@@@@@@@@@@@@@@@@@@@@@@@@@@@@@@@.....@@@@@.T@@@@@@@@@@@@@@@@@
@@@@@@@@@@@@@@@@@@@@@@@@@@@@@@@....TT@@@@@.T@@@@@@@@@@@@@@@@
@@@@@@@@@@@@@@@@@@@@@@@@@@@@@@@..T...@@@@@...@@@@@@@@@@@@@@@
@@@@@@@@@@@@@@@@@@@@@@@@@@@@@@@@@....@@@@T...TT.@@@@@@@@@@@@
@@@@@@@@@@@@@@@@@@@@@@@@@@@@@@@@@......T......@.T@@@@@@@@@@@
@@@@@@@@@@@@@@@@@@@@@@@@@@@@@@@T....T..T...TT@@@..@@@@@@@@@@
@@@@@@@@@@@@@@@@@@@@@@@@@@@@@@.....T........@@@.TTT@@@@@@@@@
@@@@@@@@@@@@@@@@@@@@@@@@@@@@@....T...TT..TT@@@@@TTT.@@@@@@@@
@@@@@@@@@@@@@@@@@@@@@@@@@@..@@....T......TT@@@@@@@@T.@@@@@@@
@@@@@@@@@@@@@@@@@@@@@@@.@@.@@@...T...T...T@@@@@@@@@.T.@@@@@@
@@@@@@@@@@@@@@@@@@@@@@@...T.TT...T.......T@@@.@@.......@@@@@
@@@@@@@@@@@@@@@@@@@@@@....T.T......@@@....T........T....@@@@
@@@@@@@@@@@@@@@@@@@@.......TT.T....@@@........T.....TT.T@@@@
@@@@@@@@@@@@@@@@@@@T.....T.........T...T.....T.....T...@@@@@
@@@@@@@@@@@@@@@@@@T..T.@@..TT.......T.....T.T..T......@@@@@@
@@@@@@@@@@@@@@@@@.T...@@@@..@@......T.........T.....T@@@@@@@
@@@@@@@@@@@@@@@@@....@@@@@@@@@.........T..T.T..T.T..@@@@@@@@
@@@@@@@.@@@@@@@@...@@@@@@@@@............T..T.......@@@@@@@@@
@@@@@@...@@@@@@..T@@@@@@@@@@@..@@....TT.....T..T.T@@@@@@@@@@
@@@@@.....@@@@.....@@@@@@@@@@@@@@.........T.....T@@@@@@@@@@@
@@@@....T.@@@...TTT@@@@@@@@@@@@..T.......T......@@@@@@@@@@@@
@@@@.......@.T...T..@..@@@@@@@@@....T.T.T......@@@@@@@@@@@@@
@@@@@..TT..@...TT.T....T@@@@@@@@@..T...T...T..@@@@@@@@@@@@@@
@@@@@.TTT..@@T......TT..@@@@@@@@@@.T.......T.@@@@@@@@@@@@@@@
@@@@@@.....T@.......T...@@@@@@@@..T...T..T.T@@@@@@@@@@@@@@@@
@@@@@@..TT..@@.T....T..@@@@@@@@T......T..T.@@@@@@@@@@@@@@@@@
@@@@@@.......@T.....TT@@@@@@@@........T..T@@@@@@@@@@@@@@@@@@
@@@@@....T...@@......@@@@@@@@@@........T.@@@@@@@@@@@@@@@@@@@
@@@@..........@..T.T@@@@@@@@@@T......T..@@@@@@@@@@@@@@@@@@@@
@@@@......T...@....@@@@@@@@...T....TT..@@@@@@@@@@@@@@@@@@@@@
@@@@@........T....@@@@@@@@@@...TT.....@@@@@@@@@@@@@@@@@@@@@@
@@@@@@.......T...@@@@@@@@.@...T......@@@@@@@@@@@@@@@@@@@@@@@
@@@@@@@........T@@@@@@@@............@@@@@@@@@@@@@@@@@@@@@@@@
@@@@@@@@.T....T@@@@@@@@T.....T...T.@@@@@@@@@@@@@@@@@@@@@@@@@
@@@@@@@@@...TT@@@@@@@@@...........@@@@@@@@@@@@@@@@@@@@@@@@@@
@@@@@@@@@@T....@@@@@@@...T..TTT.T@@@@@@@@@@@@@@@@@@@@@@@@@@@
@@@@@@@@@@@.T.TT@@@@........T...@@@@@@@@@@@@@@@@@@@@@@@@@@@@
@@@@@@@@@@@@.....@@........T.TT@@@@@@@@@@@@@@@@@@@@@@@@@@@@@
@@@@@@@@@@@@@..T........T.....@@@@@@@@@@@@@@@@@@@@@@@@@@@@@@
@@@@@@@@@@@@@@.......T.....T@@@@@@@@@@@@@@@@@@@@@@@@@@@@@@@@
@@@@@@@@@@@@@@@...T........@@@@@@@@@@@@@@@@@@@@@@@@@@@@@@@@@
@@@@@@@@@@@@@@@@..........@@@@@@@@@@@@@@@@@@@@@@@@@@@@@@@@@@
@@@@@@@@@@@@@@@@@........@@@@@@@@@@@@@@@@@@@@@@@@@@@@@@@@@@@
@@@@@@@@@@@@@@@@@@@T....@@@@@@@@@@@@@@@@@@@@@@@@@@@@@@@@@@@@
@@@@@@@@@@@@@@@@@@@@...@@@@@@@@@@@@@@@@@@@@@@@@@@@@@@@@@@@@@
@@@@@@@@@@@@@@@@@@@@@@@@@@@@@@@@@@@@@@@@@@@@@@@@@@@@@@@@@@@@
@@@@@@@@@@@@@@@@@@@@@@@@@@@@@@@@@@@@@@@@@@@@@@@@@@@@@@@@@@@@
@@@@@@@@@@@@@@@@@@@@@@@@@@@@@@@@@@@@@@@@@@@@@@@@@@@@@@@@@@@@
