type octile
height 59
width 56
map
@@@@@@@@@@@@@@@@@@@@@@@@@@@@@@@@@@@@@@@@@@@@@@@@@@@@T.TT
@@@@@@@@@@@@@@@@@@@@@@@@@@@@@@@@@@@@@@@@@@@@@@@@@@@@....
@@@@@@@@@@@@@@@@@@@@@@@@@@@@@@@@@@@@@@@@@@@@@@@@@@@@T...
@@@@@@@@@@@@@@@@@@@@@@@@@@@@@@@@@@@@@@@@@@@@@@@@@@@@@T..
@@@@@@@@@@@@@@@@@@@@@@@@@@@@@@@@@@@@@@@@@@@@@@@@@@@@@T..
@@@@@@@@@@@@@@@@@@@@@@@@@@@@@@@@@@@@@@@@@@@@@@@@@@@@@...
@@@@@@@@@@@@@@@@@@@@@@@@@@@@@@@@@@@@@@@@@@@@@@@@@@@@@..T
@@@@@@@@@@@@@@@@@@@@@@@@@@@@@@@@@@@@@@@@@@@@@@@@@@@@@...
@@@@@@@@@@@@@@@@@@@@@@@@@@@@@@@@@@@@@@@@@@@@@@@@@@@@@...
@@@@@@@@@@@@@@@@@@@@@@@@@@@@@@@@@@@@@@@@@@@@@@@@@@@@@...
@@@@@@@@@@@@@@@@@@@@@@@@@@@@@@@@@@@@@@@@@@@@@@@@@@@@@...
@@@@@@@@@@@@@@@@@@@@@@@@@T..T..T@@@@@@@@@@@@@@@@@@@@@...
@@@@@@@@@@@@@@@@@@@..........T......@@@@@..@@@@@@@@@@...
@@@@@@@@@@@@@@@@@@..T.TT...TT...T..T..@@@TT.@@@@@@@@@...
@@@@@@@@@@@@@@@@.......T...............@@.T.@@@@@@@@@..T
@@@@@@@@@@@@@@..T.T..T.T....TT.T...T....T...@@@@@@@@@T..
@@@@@@@@@@@@@..T...T......T.....T.....T.....@@@@@@@@@@..
@@@@@@@@@@@@....T...............T...T.......@@@@@@@@@@.T
@@@@@@@@@@@T..T...T...................T.....@@@@@@@@@@@.
@@@@@@@@@@...........TT........T..T.T......T.@@@@@@@@@@@
@@@@@@@@@..T....T..T.T..T....T........T.......@@@@@@@@@@
@@@@@@@@....T....TT......T.........T........T..@@@@@@@@@
@@@@@@@@..TTT..T..T..T....T.....T...T....T......@@@@@@@@
@@@@@@@@.......T.T...........................T...@@@@@@.
@@@@@@@.TT....T........T.....T.....T..T...T..T.T.@@@@@@.
@@@@@@@T..............T...................T.....T@@@@@@@
@@@@@@@..T..........T.......T......T.....T.......@@@@@@@
@@@@@@@...............T.........T...T.....TT....T@@@@@@@
@@@@@@@.......T....T..TT...T..T.......T.......T.T@@@@@@@
@@@@@@@.....T......T..T.TT@@@..T......TT..TT.T.T.@@@@@@@
@@@@@@@....T.......T.T....@@@..........T..T..TT.T@@@@@@@
@@@@@@@...T.T.T....TT.....@@@..T..T........T.....@@@@@@@
@@@@@@@.T.......TT......T...TT.............T.....@@@@@@@
@@@@@@@......T.T....TT......T.....T......T...T...@@@@@@@
@@@@@@@...T..T..T...TTT........T.................@@@@@@@
@@@@@@@.T...TT...........T.T...T..T..T....T...T.T@@@@@@@
@@@@@@@.......T....T.T..........T..T....TT..T....@@@@@@@
@@@@@@@..T.........T......TT....T............T...@@@@@@@
@@@@@@@T...T..........T...T......T......T.......T@@@@@@@
@@@@@@@T.....T........T....T..............T.T....@@@@@@@
@@@@@@@TT...................T..T..T..T.TTT...T..T@@@@@@@
@@@@@@@@..................T...TT.T..T.....T.....T.@@@@@@
@@@@@@@@@.....T.....TT.......T.T.................@@@@@@@
@@@@@@@@@@......TTT..........T.T.....T.T..T....T@@@@@@@@
@@@@@@@@@@@T....T...T....................TT....@@@@@@@@@
@@@@@@@@@@@@TT.......T.TT....T......T...T.TTTT@@@@@@@@@@
@@@@@@@@@@@@@.................T..T......T....@@@@@@@@@@@
@@@@@@@@@@@@@@..TT..T..T.T.......T.T......T.@@@@@@@@@@@@
@@@@@@@@@@@@@@@@..TT..T......T..........T..@@@@@@@@@@@@@
@@@@@@@@@@@@@@@@@@TTTT............T....T.@@@@@@@@@@@@@@@
@@@@@@@@@@@@@@@@@@@@.T...T....T......T.@@@@@@@@@@@@@@@@@
@@@@@@@@@@@@@@@@@@@@@@@T.........T..@@@@@@@@@@@@@@@@@@@@
@@@@@@@@@@@@@@@@@@@@@@@@@@@@@@@@@@@@@@@@@@@@@@@@@@@@@@@@
@@@@@@@@@@@@@@@@@@@@@@@@@@@@@@@@@@@@@@@@@@@@@@@@@@@@@@@@
@@@@@@@@@@@@@@@@@@@@@@@@@@@@@@@@@@@@@@@@@@@@@@@@@@@@@@@@
@@@@@@@@@@@@@@@@@@@@@@@@@@@@@@@@@@@@@@@@@@@@@@@@@@@@@@@@
@@@@@@@@@@@@@@@@@@@@@@@@@@@@@@@@@@@@@@@@@@@@@@@@@@@@@@@@
@@@@@@@@@@@@@@@@@@@@@@@@@@@@@@@@@@@@@@@@@@@@@@@@@@@@@@@@
@@@@@@@@@@@@@@@@@@@@@@@@@@@@@@@@@@@@@@@@@@@@@@@@@@@@@@@@
