type octile
height 59
width 56
map
@@@@@@@@@@@@@@@@@@@@@@@@@@@@@@@@@@@@@@@@@@@@@@@@@@@@@@@@
@@@@@@@@@@@@@@@@@@@@@@@@@@@@@@@@@@@@@@@@@@@@@@@@@@@@@@@@
@@@@@@@@@@@@@@@@@@@@@@@@@@@@@@@@@@@@@@@@@@@@@@@@@@@@@@@@
@@@@@@@@@@@@@@@@@@@@@@@@@@@@@@@@@@@@@@@@@@@@@@@@@@@@@@@@
@@@@@@@@@@@@@@@@@@@@@@@@@@@@@@@@@@@@@@@@@@@@@@@@@@@@@@@@
@@@@@@@@@@@@@@@@@@@@@@@@@@@@@@@@@@@@@@@@@@@@@@@@@@@@@@@@
@@@@@@@@@@@@@@@@@@@@@@@@@@@@@@@@@@@@@@@@@@@@@@@@@@@@@@@@
@@@@@@@@@@@@@@@@@@@@@@@@@@@@@@@@@@@@@@@@@@@@@@@@@@@@@@@@
@@@@@@@@@@@@@@@@@@@@@@@@@@@@@@@@@@@@@@@@@@@@@@@@@@@@@@@@
@@@@@@@@@@@@@@@@@@@@@@@@@@@@@@@@@@@@@@@@@@@@@@@@@@@@@@@@
@@@@@@@@@@@@@@@@@@@@@@@@@@@@@@@@@@@@@@@@@@@@@@@@@@@@@@@@
@@@@@@@@@@@@@@@@@@@@@@@@@@@@@@@@@@@@@@@@@@@@@@@@@@@@@@@@
@@@@@@@@@@@@@@@@@@@@@@@....TT...T.@@@@@@@@@@@@@@@@@@@@@@
@@@@@@@@@@@@@@@@@@@@............T...T@@@@@@@@@@@@@@@@@@@
@@@@@@@@@@@@@@@@@.....@@@@@@@..T.......@@@@@@@@@@@@@@@@@
@@@@@@@@@@@@@@@@@T.T.@@@@@@@@@TTT.T....@@@@@@@@@@@@@@@@@
@@@@@@@@@@@@@@@@@T..T@@@@@@@@@@...T.T.@@@@@@@@@@@@@@@@@@
@@@@@@@@@@@@@@@@.T.T@@@@@@@@....T.....T@@@@@@@@@@@@@@@@@
@@@@@@@@@@@@@@@@@..T@@@@@TT..T.T..T...T..@@@@@@@@@@@@@@@
@@@@@@@@@@@@@@@@@@..@@@..........TT.TT....@@@@@@@@@@@@@@
@@@@@@@@@@@@@@@@@@....@@@.....T.T.........@@@@@@@@@@@@@@
@@@@@@@@@@@@@T.@@.......T......T.....T....T@@@@@@@@@@@@@
@@@@@@@@@@@T..........T.T...T.....TT..TT...@@@@@@@@@@@@@
@@@@@@@@@@TTT.........T..T.....T........T.T.@@@@@@@@@@@@
@@@@@@@@@T.T..TT.....TT.........T........T.....@@@@@@@@@
@@@@@@@@@T...TT.......T.T.T..T.TT.....T......T.@@@@@@@@@
@@@@@@@@@...T...TT......T..@@@@@@@@@T.....T....@@@@@@@@@
@@@@@@@@@...............T@@@@@@@@@@@@..........@@@@@@@@@
@@@@@@@@@@....T.......@@@@@@@@@@@@@@@@.........@@@@@@@@@
@@@@@@@@@@@@TT...T.@@@@@@@@@@@@@@@@@@@......T.T...@@@@@@
@@@@@@@@@@@@@.....@@@@@@@@@@@@@@@@@@@@TT.T........@@@@@@
@@@@@@@@@@@@@.TT..@@@@@@@@@@@@@@@@@@@@@....@@@....@@@@@@
@@@@@@@@@@@@@.T...@@@@@@@@@@@@@@@@@@@@@.T..@@@@@..@@@@@@
@@@@@@@@@@TT@@.T..@@@@@@@@@@@@@@@@@@@@@@..@@@@@@@.@@@@@@
@@@@@@@@@....@...@@@@@@@@@@@@@@@@@@@@@@@..@@@@@.T.@@@@@@
@@@@@@@@@....TT..@@@@@@@@@@@@@@@@@@@@@@@..TT.@@...@@@@@@
@@@T..T..........@@@@@@@@@@@@@@@@@@@@@@@T.T..T....T@@@@@
@@@..T.....T.....@@@@@@@@@@@@@@@@@@@@@@@TT.T........@@@@
@@@.....T......T.T@@@@@@@@@@@@@@@@@@@@....T....@@@.T...@
@@@......T.........@@@@@@@@@@@@@@@@@@@..T....T.@@@.T.T.@
@@@TT..@@...T...TT..@@@@@@@@@@@@@@@@@.T.TT..T.T@@@.....@
@@@@...@@.T....T..T..@@@@@@@@@@@@@@@@@..T...TT.........@
@@@@T........T.....T.T@@@@@@@@@@@@@@@@.........TT.T.T.T@
@@@@.TT...........T....@@@@@@@@@@@@@@@T..TT.....T..TT.T@
@@@@..T....T..........T...@@@@@@@@@@@.........TTT...TT.@
@@@@.....TT......T.....T....@@@@@@@@..T......T.TT......@
@@@@TT.T.T.T.T..........T.......T..T.T....T..T...T..T..@
@@@@@..........T..........T...T.T..T..T...T....T.T.T...@
@@@@@...........TTT.....T...T.T....T...T.......T.......@
@@@@@@T..T.T........T.....T....T..T....T...............@
@@@@@@@.T..T..........TT...........@@.........T.....T..@
@@@@@@@@...T.....TT@@......TT......@@.....TT.T...T.T.T.@
@@@@@@@@@.T.TT.....@@..T..T..T...T...............T.TT..@
@@@@@@@@@@........TT..T.TTT.....TT.....TT.....T....T..@@
@@@@@@@@@@@..T...........T........T.T...T.........T..@@@
@@@@@@@@@@@@........T...T.T.T......T..T.T.T.T....T@@@@@@
@@@@@@@@@@@@@.........T..T.............TT........@@@@@@@
@@@@@@@@@@@@@@@T.T.T....T..T...TTT............T@@@@@@@@@
@@@@@@@@@@@@@@@@@@@@@@@@@@@@@@@@@@@@@@@@@@@@@@@@@@@@@@@@
