type octile
height 86
width 80
map
@@@@@@@@@@@@@@@@@@@@@@@@@@@@@@@@@@@@@@@@@@@@@@@@@@@@@@@@@@@@@@@@@@@@@@@@@@@@@@@@
@@@@@@@@@@@@@@@@@@@@@@@@@@@@@@@@@@@@@@@@@@@@@@@@@@@@@@@@@@@@@@@@@@@@@@@@@@@@@@@@
@@@@@@@@@@@@@@@@@@@@@@@@@@@@@@@@@@@@@@@@@@@@@@@@@@@@@@@@@@@@@@@@@@@@@@@@@@@@@@@@
@@@@@@@@@@@@@@@@@@@@@@@@@@@@@@@@@@@@@@@@@@@@@@@@@@@@@@@@@@@@@@@@@@@@@@@@@@@@@@@@
@@@@@@@@@@@@@@@@@@@@@@@@@@@@@@@@@@@@@@@@@@@@@@@@@@@@@@@@@@@@@@@@@@@@@@@@@@@@@@@@
@@@@@@@@@@@@@@@@@@@@@@@@@@@@@@@@@@@@@@@@@@@@@@@@@@@@@@@@@@@@@@@@@@@@@@@@@@@@@@@@
@@@@@@@@@@@@@@@@@@@@@@@@@@@@@@@@@@@@@@@@@@@@@@@@@@@@@@@@@@@@@@@@@@@@@@@@@@@@@@@@
@@@@@@@@@@@@@@@@@@@@@@@@@@@@@@@@@@@@@@@@@@@@@@@@@@@@@@@@@@@@@@@@@@@@@@@@@@@@@@@@
@@@@@@@@@@@@@@@@@@@@@@@@@@@@@@@@@@@@@@@@@@@@@@@@@@@@@@@@@@@@@@@@@@@@@@@@@@@@@@@@
@@@@@@@@@@@@@@@@@@@@@@@@@@@@@@@@@@@@@@@@@@@@@@@@@@@@@@@@@@@@@@@@@@@@@@@@@@@@@@@@
@@@@@@@@@@@@@@@@@@@@@@@@@@@@@@@@@@@@@@@@@@@@@..@@@@@@@@@@@@@@@@@@@@@@@@@@@@@@@@@
@@@@@@@@@@@@@@@@@@@@@@@@@@@@@@@@@@@@@@@@@@@@T.@@@@@@@@@@@@@@@@@@@@@@@@@@@@@@@@@@
@@@@@@@@@@@@@@@@@@@@@@@@@@@@@@@@@@@@@@@@@@@..@@@@@@@@@@@@@@@@@@@@@@@@@@@@@@@@@@@
@@@@@@@@@@@@@@@@@@@@@@@@@@@@@@@@@@@@@@@@@@.T.@@@@@@@@@@@@@@@@@@@@@@@@@@@@@@@@@@@
@@@@@@@@@@@@@@@@@@@@@@@@@@@@@@@@@@@@@@@@@....T@@...@@@@@@@@@@@@@@@@@@@@@@@@@@@@@
@@@@@@@@@@@@@@@@@@@@@@@@@@@@@@@@@@@@@@@@...........T@@@@@@@@@@@@@@@@@@@@@@@@@@@@
@@@@@@@@@@@@@@@@@@@@@@@@@@@@@@@@@@@@@@@....T...@......@@@@@@@@@@@@@@@@@@@@@@@@@@
@@@@@@@@@@@@@@@@@@@@@@@@@@@@@@@@@@@@@@@......T@@@......@@@@@@@@@@@@@@@@@@@@@@@@@
@@@@@@@@@@@@@@@@@@@@@@@@@@@@@@@@@@@@@@@@.T...T@@@@T@@T..@@..@@@@@@@@@@@@@@@@@@@@
@@@@@@@@@@@@@@@@@@@@@@@@@@@@@@@@@@@@@@@@@@..@@@@@@@@@@.......@@@@@@@@@@@@@@@@@@@
@@@@@@@@@@@@@@@@@@@@@@@@@@@@@@@@@@@@@.@@@@.T@@@@@@@@@@......T@@@@@@@@@@@@@@@@@@@
@@@@@@@@@@@@@@@@@@@@@@@@@@@@@@@@@@@@.TT@@....@@@@...........@@@@@@@@@@@@@@@@@@@@
@@@@@@@@@@@@@@@@@@@@@@@@@@@@@@@@@@@.T.TT..T...@@..T..T..T.T@@@@@@@@@@@@@@@@@@@@@
@@@@@@@@@@@@@@@@@@@@@@@@@@@@@@@@@@@@......T.T..T......T...@@@@@@@@@@@@@@@@@@@@@@
@@@@@@@@@@@@@@@@@@@@@@@@@@@@@@@@.@@@....T.TT....T....TT..@@@@@@T.@@@@@@@@@@@@@@@
@@@@@@@@@@@@@@@@@@@@@@@@@@@@@@@..@@@......T.............@@@@@@...@@@@@@@@@@@@@@@
@@@@@@@@@@@@@@@@@@@@@@@@@@@@@@..TTT...T.TT......T.T.T..@@@@@@.....@@@@@@@@@@@@@@
@@@@@@@@@@@@@@@@@@@@@@@@@@@@@@.TT........T....T....T.T@@@@@@T......@@@@@@@@@@@@@
@@@@@@@@@@@@@@@@@@@@@@@@@@@@@@@.........T...T...T...T@@@@@@..........@@@@@@@@@@@
@@@@@@@@@@@@@@@@@@@@@@@@@@@@@@@@..TT..T..T..T.T.....@@@@@@..T.........@@@@@@@@@@
@@@@@@@@@@@@@@@@@@@@@@@@@@@@@@@@@........T.........@@@@@....T.T..TT..T..T@@@@@@@
@@@@@@@@@@@@@@@@@@@@@@@@@@@@@@@@@..T....T...T......@@@..T.T..T.......T....@@@@@@
@@@@@@@@@@@@@@@@@@@@@@@@@@@@@@@......T...T..........@.T...T...T.....TT..T...@@@@
@@@@@@@@@@@@@@@@@@@@@@@@@@@@@@....T.T......T....@@...T...TT...T..@@@.@@@..T.T@@@
@@@@@@@@@@@@@@@@@@@@@@@@@@@@@.T.T..T.T..TT....@@@@.T....@@@@.T..@@@@@@@@.TT....@
@@@@@@@@@@@@@@@@@@@@@@@@@@@...T...TT.T.......@@@@@..T...@@@@@@@@@@@@@@.....TT.T@
@@@@@@@@@@@@@@@@@@@@@@@@@@...T.....T.T...T.T@@@@@@......T@@@@@@@@@@@@@@........@
@@@@@@@@@@@@@@@@@@@@@@@@@@@....T...........@@@@@@.......@@@@@@@@T@@@@@@..T..T..@
@@@@@@@@@@@@@@@@@@@@@@@T@@@@........T.....@@@@@@.......@@@@@@@@...@@@@@.......@@
@@@@@@@@@@@@@@.@@@@@@@TT...@@T...........@@@@@@T...T..@@@@@@@@@..T@@@@@@.T...@@@
@@@@@@@@@@@@@@T.@@@@@T..T....T........T.@@@@@@.....T..@@@@@@@@@.T@@@@@@@@...@@@@
@@@@@@@@@@@@@@..TT@@@..........@T......@@@@@@TT.T..TT@@@@@@@@@...@@@@@@@@@.@@@@@
@@@@@@@@@@@@@@.......T........@@@....T@@@@@@..........@@@@@@@....@@@@@@@@@@@@@@@
@@@@@@@@@@@@@..T...............@@@@..@@@@@@.........T..T..@@@..T@@@@@@@@@@@@@@@@
@@@@@@@@@@@@.....T..T...........T@@@@@@@@@..........T...T.@@@...@@@@@@@@@@@@@@@@
@@@@@@@@@....T.........T.......T..@@@@@@@.T..T...........T@@T..@@@@@@@@@@@@@@@@@
@@@@@@@@@T....TT.....T..T..T....T.@@@@@@.T......T.....T.T.@....@@@@@@@@@@@@@@@@@
@@@@@@@@T...T...TT...T.T....T.TTT@@@@@@.......T......T.T......@@@@@@@@@@@@@@@@@@
@@@@@@@.TTT...T...T....T........@@@@@@.T.....T..T...TT.T..T...@@@@@@@@@@@@@@@@@@
@@@@@@..T..@@......TT.....T....@@@@@@..TT.T.T.......T....T..T@@@@@@@@@@@@@@@@@@@
@@@@@....T@@..T......T........@@@@@@T........T.T..T.T..T..TT.T@@@@@@@@@@@@@@@@@@
@@@@T....@@......TT....T.....@@@@@@T.....T......T........T..T.T@@@@@@@@@@@@@@@@@
@@@@T..T@@@@@T.......TTT..@@@@@@@@.T..TTT.........T.............@@@@@@@@@@@@@@@@
@@@@...@@@@@@@@@T......T..@@@T@@@.........@@@.T.....T....TTTTT.@@@@@@@@@@@@@@@@@
@@@@.T@@@@@@@@@@@@.T..TT...@..@@....T..T.T@@@.....T....T....T.@@@@@@@@@@@@@@@@@@
@@@@@@@@@@@@@@@@@@T...TT.....TT.T..TT@@.TT@@@.T....T........T@@@@@@@@@@@@@@@@@@@
@@@@@@@@@@@@@@@@@@.....@@..........T@@@@@.....TT.....T......@@@@@@@@@@@@@@@@@@@@
@@@@@@@@@@@@@@@@@@....@@@@....T.T..@@@@@@T....T....T...T...@@@@@@@@@@@@@@@@@@@@@
@@@@@@@@@@@@@@@@@@...@@@@@......T.@@@@@@@@.TT.....T.......@@@@@@@@@@@@@@@@@@@@@@
@@@@@@@@@@@@@@@@@@TT@@@@@@.T...T@@@@@@@@@@@@.....T.T...T.@@@@@@@@@@@@@@@@@@@@@@@
@@@@@@@@@@@@@@@@@@.@@@@@@.T...@@@@@@@@@@@@@@T.....T....T@@@@@@@@@@@@@@@@@@@@@@@@
@@@@@@@@@@@@@@@@@@@@@@@@@....T@@@@@@@@@@@@@@...T.......@@@@@@@@@@@@@@@@@@@@@@@@@
@@@@@@@@@@@@@@@@@@@@@@@@......@@@@@@@@@@@@T....TT.....@@@@@@@@@@@@@@@@@@@@@@@@@@
@@@@@@@@@@@@@@@@@@@@@@....T.......T@@@@@@............@@@@@@@@@@@@@@@@@@@@@@@@@@@
@@@@@@@@@@@@@@@@@@@@@T.......T....@@@@@@..........T.@@@@@@@@@@@@@@@@@@@@@@@@@@@@
@@@@@@@@@@@@@@@@@@@@@.TT.T.........@@@@T.......T...@@@@@@@@@@@@@@@@@@@@@@@@@@@@@
@@@@@@@@@@@@@@@@@@@@.T..T..T.......@@@.T........T.@@@@@@@@@@@@@@@@@@@@@@@@@@@@@@
@@@@@@@@@@@@@@@@@@T..T......T.TT...@@..TT........@@@@@@@@@@@@@@@@@@@@@@@@@@@@@@@
@@@@@@@@@@@@@@@@@@.....T...T.......T..TT.T...T.T@@@@@@@@@@@@@@@@@@@@@@@@@@@@@@@@
@@@@@@@@@@@@@@@@@.....TT.TT.TT...TT.....T..T.T.@@@@@@@@@@@@@@@@@@@@@@@@@@@@@@@@@
@@@@@@@@@@@@@@@@.......T.T........TT.TT@TT.T..@@@@@@@@@@@@@@@@@@@@@@@@@@@@@@@@@@
@@@@@@@@@@@@@@@@.T.T....T...........T..@@@...@@@@@@@@@@@@@@@@@@@@@@@@@@@@@@@@@@@
@@@@@@@@@@@@@@@@@.......T..T.....T.T.T..@@@@@@@@@@@@@@@@@@@@@@@@@@@@@@@@@@@@@@@@
@@@@@@@@@@@@@@@@@@...T.......TT.TT.......@@@@@@@@@@@@@@@@@@@@@@@@@@@@@@@@@@@@@@@
@@@@@@@@@@@@@@@@@@@...TTT..T.T...TT.T....T@@@@@@@@@@@@@@@@@@@@@@@@@@@@@@@@@@@@@@
@@@@@@@@@@@@@@@@@@@@.TT.........TT..T....@@@@@@@@@@@@@@@@@@@@@@@@@@@@@@@@@@@@@@@
@@@@@@@@@@@@@@@@@@@@@...T....T.T......T.@@@@@@@@@@@@@@@@@@@@@@@@@@@@@@@@@@@@@@@@
@@@@@@@@@@@@@@@@@@@@@@T.......T@@.....T.@@@@@@@@@@@@@@@@@@@@@@@@@@@@@@@@@@@@@@@@
@@@@@@@@@@@@@@@@@@@@@@@..T...T.@@@TT.T.@@@@@@@@@@@@@@@@@@@@@@@@@@@@@@@@@@@@@@@@@
@@@@@@@@@@@@@@@@@@@@@@@@.......@@@@....@@@@@@@@@@@@@@@@@@@@@@@@@@@@@@@@@@@@@@@@@
@@@@@@@@@@@@@@@@@@@@@@@@@......@@@@@..@@@@@@@@@@@@@@@@@@@@@@@@@@@@@@@@@@@@@@@@@@
@@@@@@@@@@@@@@@@@@@@@@@@@@@..T.@@@@@@@@@@@@@@@@@@@@@@@@@@@@@@@@@@@@@@@@@@@@@@@@@
@@@@@@@@@@@@@@@@@@@@@@@@@@@@@@@@@@@@@@@@@@@@@@@@@@@@@@@@@@@@@@@@@@@@@@@@@@@@@@@@
@@@@@@@@@@@@@@@@@@@@@@@@@@@@@@@@@@@@@@@@@@@@@@@@@@@@@@@@@@@@@@@@@@@@@@@@@@@@@@@@
@@@@@@@@@@@@@@@@@@@@@@@@@@@@@@@@@@@@@@@@@@@@@@@@@@@@@@@@@@@@@@@@@@@@@@@@@@@@@@@@
@@@@@@@@@@@@@@@@@@@@@@@@@@@@@@@@@@@@@@@@@@@@@@@@@@@@@@@@@@@@@@@@@@@@@@@@@@@@@@@@
