type octile
height 144
width 148
map
@@@@@@@@@@@@@@@@@@@@@@@@@@@@@@@@@@@@@@@@@@@@@@@@@@@@@@@@@@@@@@@@@@@@@@@@@@@@@@@@@@@@@@@@@@@@@@@@@@@@@@@@@@@@@@@@@@@@@@@@@@@@@@@@@@@@@@@@@@@@@@@@@@@@
@@@@@@@@@@@@@@@@@@@@@@@@@@@@@@@@@@@@@@@@@@@@@@@@@@@@@@@@@@@@@@@@@@@@@@@@@@@@@@@@@@@@@@@@@@@@@@@@@@@@@@@@@@@@@@@@@@@@@@@@@@@@@@@@@@@@@@@@@@@@@@@@@@@@
@@@@@@@@@@@@@@@@@@@@@@@@@@@@@@@@@@@@@@@@@@@@@@@@@@@@@@@@@@@@@@@@@@@@@@@@@@@@@@@@@@@@@@@@@@@@@@@@@@@@@@@@@@@@@@@@@@@@@@@@@@@@@@@@@@@@@@@@@@@@@@@@@@@@
@@@@@@@@@@@@@@@@@@@@@@@@@@@@@@@@@@@@@@@@@@@@@@@@@@@@@@@@@@@@@@@@@@@@@@@@@@@@@@@@@@@@@@@@@@@@@@@@@@@@@@@@@@@@@@@@@@@@@@@@@@@@@@@@@@@@@@@@@@@@@@@@@@@@
@@@@@@@@@@@@@@@@@@@@@@@@@@@@@@@@@@@@@@@@@@@@@@@@@@@@@@@@@@@@@@@@@@@@@@@@@@@@@@@@@@@@@@@@@@@@@@@@@@@@@@@@@@@@@@@@@@@@@@@@@@@@@@@@@@@@@@@@@@@@@@@@@@@@
@@@@@@@@@@@@@@@@@@@@@@@@@@@@@@@@@@@@@@@@@@@@@@@@@@@@@@@@@@@@@@@@@@@@@@@@@@@@@@@@@@@@@@@@@@@@@@@@@@@@@@@@@@@@@@@@@@@@@@@@@@@@@@@@@@@@@@@@@@@@@@@@@@@@
@@@@@@@@@@@@@@@@@@@@@@@@@@@@@@@@@@@@@@@@@@@@@@@@@@@@@@@@@@@@@@@@@@@@@@@@@@@@@@@@@@@@@@@@@@@@@@@@@@@@@@@@@@@@@@@@@@@@@@@@@@@@@@@@@@@@@@@@@@@@@@@@@@@@
@@@@@@@@@@@@@@@@@@@@@@@@@@@@@@@@@@@@@@@@@@@@@@@@@@@@@@@@@@@@@@@@@@@@@@@@@@@@@@@@@@@@@@@@@@@@@@@@@@@@@@@@@@@@@@@@@@@@@@@@@@@@@@@@@@@@@@@@@@@@@@@@@@@@
@@@@@@@@@@@@@@@@@@@@@@@@@@@@@@@@@@@@@@@@@@@@@@@@@@@@@@@@@@@@@@@@@@@@@@@@@@@@@@@@@@@@@@@@@@@@@@@@@@@@@@@@@@@@@@@@@@@@@@@@@@@@@@@@@@@@@@@@@@@@@@@@@@@@
@@@@@@@@@@@@@@@@@@@@@@@@@@@@@@@@@@@@@@@@@@@@@@@@@@@@@@@@@@@@@@@@@@@@@@@@@@@@@@@@@@@@@@@@@@@@@@@@@@@@@@@@@@@@@@@@@@@@@@@@@@@@@@@@@@@@@@@@@@@@@@@@@@@@
@@@@@@@@@@@@@@@@@@@@@@@@@@@@@@@@@@@@@@@@@@@@@@@@@@@@@@@@@@@@@@@@@@@@@@@@@@@@@@@@@@@@@@@@@@@@@@@@@@@@@@@@@@@@@@@@@@@@@@@@@@@@@@@@@@@@@@@@@@@@@@@@@@@@
@@@@@@@@@@@@@@@@@@@@@@@@@@@@@@@@@@@@@@@@@@@@@@@@@@@@@@@@@@@@@@@@@@@@@@@@@@@@@@@@@@@@@@@@@@@@@@@@@@@@@@@@@@@@@@@@@@@@@@@@@@@@@@@@@@@@@@@@@@@@@@@@@@@@
@@@@@@@@@@@@@@@@@@@@@@@@@@@@@@@@@@@@@@@@@@@@@@@@@@@@@@@@@@@@@@@@@@@@@@@@@@@@@@@@@@@@@@@@@@@@@@@@@@@@@@@@@@@@@@@@@@@@@@@@@@@@@@@@@@@@@@@@@@@@@@@@@@@@
@@@@@@@@@@@@@@@@@@@@@@@@@@@@@@@@@@@@@@@@@@@@@@@@@@@@@@@@@@@@@@@@@@@@@@@@@@@@@@@@@@@@@@@@@@@@@@@@@@@@@@@@@@@@@@@@@@@@@@@@@@@@@@@@@@@@@@@@@@@@@@@@@@@@
@@@@@@@@@@@@@@@@@@@@@@@@@@@@@@@@@@@@@@@@@@@@@@@@@@@@@@@@@@@@@@@@@@@@@@@@@@@@@@@@@@@@@@@@@@@@@@@@@@@@@@@@@@@@@@@@@@@@@@@@@@@@@@@@@@@@@@@@@@@@@@@@@@@@
@@@@@@@@@@@@@@@@@@@@@@@@@@@@@@@@@@@@@@@@@@@@@@@@@@@@@@@@@@@@@@@@@@@@@@@@@@@@@@@@@@@@@@@@@@@@@@@@@@@@@@@@@@@@@@@@@@@@@@@@@@@@@@@@@@@@@@@@@@@@@@@@@@@@
@@@@@@@@@@@@@@@@@@@@@@@@@@@@@@@@@@@@@@@@@@@@@@@@@@@@@@@@@@@@@@@@@..@@@@@@@@@@@@@@@@@@@@@@@@@@@@@@@@@@@@@@@@@@@@@@@@@@@@@@@@@@@@@@@@@@@@@@@@@@@@@@@@@
@@@@@@@@@@@@@@@@@@@@@@@@@@@@@@@@@@@@@@@@@@@@@@@@@@@@@@@@@@@@@@@....T@@@@@@@@@@@@@@@@@@@@@@@@@@@@@@@@@@@@@@@@@@@@@@@@@@@@@@@@@@@@@@@@@@@@@@@@@@@@@@@@
@@@@@@@@@@@@@@@@@@@@@@@@@@@@@@@@@@@@@@@@@@@@@@@@@@@@@@@@@@@@@@.T.....@@@@@@@@@@@@@@@@@@@@@@@@@@@@@@@@@@@@@@@@@@@@@@@@@@@@@@@@@@@@@@@@@@@@@@@@@@@@@@@
@@@@@@@@@@@@@@@@@@@@@@@@@@@@@@@@@@@@@@@@@@@@@@@@@@@@@@@@@@@@@...T.TT..@@@@@@@@@@@@@@@@@@@@@@@@@@@@@@@@@@@@@@@@@@@@@@@@@@@@@@@@@@@@@@@@@@@@@@@@@@@@@@
@@@@@@@@@@@@@@@@@@@@@@@@@@@@@@@@@@@@@@@@@@@@@@@@@@@@@@@@@@@@..T...T...@@@@@@@@@@@@@@@@@@@@@@@@@@@@@@@@@@@@@@@@@@@@@@@@@@@@@@@@@@@@@@@@@@@@@@@@@@@@@@
@@@@@@@@@@@@@@@@@@@@@@@@@@@@@@@@@@@@@@@@@@@@@@@@@@@@@@@@@@...T@@@.....T@@@@@@@@@@@@@@@@@@@@@@@@@@@@@@@@@@@@@@@@@@@@@@@@@@@@@@@@@@@@@@@@@@@@@@@@@@@@@
@@@@@@@@@@@@@@@@@@@@@@@@@@@@@@@@@@@@@@@@@@@@@@@@@@@@@@@@@.T...@@@T......@@@@@@@@@@@@@@@@@@@@@@@@@@@@@@@@@@@@@@@@@@@@@@@@@@@@@@@@@@@@@@@@@@@@@@@@@@@@
@@@@@@@@@@@@@@@@@@@@@@@@@@@@@@@@@@@@@@@@@@@@@@@@@@@@@@@@................@@@@@@@@@@@@@@@@@@@@@@@@@@@@@@@@@@@@@@@@@@@@@@@@@@@@@@@@@@@@@@@@@@@@@@@@@@@@
@@@@@@@@@@@@@@@@@@@@@@@@@@@@@@@@@@@@@@@@@@@@@@@@@@@@@@@@@....TTT...@@...T@@@@@@@@@@@@@@@@@@@@@@@@@@@@@@@@@@@@@@@@@@@@@@@@@@@@@@@@@@@@@@@@@@@@@@@@@@@
@@@@@@@@@@@@@@@@@@@@@@@@@@@@@@@@@@@@@@@@@@@@@@@@@@@@@@@@@@.........@@@...T@@@@@@@@@@@@@@@@@@@@@@@@@@@@@@@@@@@@@@@@@@@@@@@@@@@@@@@@@@@@@@@@@@@@@@@@@@
@@@@@@@@@@@@@@@@@@@@@@@@@@@@@@@@@@@@@@@@@@@@@@@@@@@@@@@@@@T........@@@@...T@@@@@@@@@@@@@@@@@@@@@@@@@@@@@@@@@@@@@@@@@@@@@@@@@@@@@@@@@@@@@@@@@@@@@@@@@
@@@@@@@@@@@@@@@@@@@@@@@@@@@@@@@@@@@@@@@@@@@@@@@@@@@@@..@@@@...T.....@@@@@T...@@@@@@@@@@@@@@@@@@@@@@@@@@@@@@@@@@@@@@@@@@@@@@@@@@@@@@@@@@@@@@@@@@@@@@@
@@@@@@@@@@@@@@@@@@@@@@@@@@@@@@@@@@@@@@@@@@@@@@@@@@@.....@@@@@.......T.@@@@T...@@@@@@@@@@@@@@@@@@@@@@@@@@@@@@@@@@@@@@@@@@@@@@@@@@@@@@@@@@@@@@@@@@@@@@
@@@@@@@@@@@@@@@@@@@@@@@@@@@@@@@@@@@@@@@@@@@@@@@@@@.......@@@@@.T.T.....@@@..T..@@@@@@@@@@@@@@@@@@@@@@@@@@@@@@@@@@@@@@@@@@@@@@@@@@@@@@@@@@@@@@@@@@@@@
@@@@@@@@@@@@@@@@@@@@@@@@@@@@@@@@@@@@@@@@@@@@@@@@@@........@@@@..T......@@@........@@@@@@@@@@@@@@@@@@@@@@@@@@@@@@@@@@@@@@@@@@@@@@@@@@@@@@@@@@@@@@@@@@
@@@@@@@@@@@@@@@@@@@@@@@@@@@@@@@@@@@@@@@@@@@@@@@@@@@T....T..@@@@T.....T.T@@.T...T...@@@@@@@@@@@@@@@@@@@@@@@@@@@@@@@@@@@@@@@@@@@@@@@@@@@@@@@@@@@@@@@@@
@@@@@@@@@@@@@@@@@@@@@@@@@@@@@@@@@@@@@@@@@@@@@@@@@@@@.T....T.@@@@@........T.TTT......@@@@@@@@@@@@@@@@@@@@@@@@@@@@@@@@@@@@@@@@@@@@@@@@@@@@@@@@@@@@@@@@
@@@@@@@@@@@@@@@@@@@@@@@@@@@@@@@@@@@@@@@@@@@@@@@@@@@@@T...T...@@@@@....T............T.@@@@@@@@@@@@@@@@@@@@@@@@@@@@@@@@@@@@@@@@@@@@@@@@@@@@@@@@@@@@@@@
@@@@@@@@@@@@@@@@@@@@@@@@@@@@@@@@@@@@@@@@@@@@@@@@@@@@@@.TT.....@@@@............T.......@@@@@@@@@@@@@@@@@@@@@@@@@@@@@@@@@@@@@@@@@@@@@@@@@@@@@@@@@@@@@@
@@@@@@@@@@@@@@@@@@@@@@@@@@@@@@@@@@@@@@@@@@@@@..@@@@@@@@T..TT..T@@@@.T.......T.T...T.T..@@@@@@@@@@@@@@@@@@@@@@@@@@@@@@@@@@@@@@@@@@@@@@@@@@@@@@@@@@@@@
@@@@@@@@@@@@@@@@@@@@@@@@@@@@@@@@@@@@@@@@@@@T...@@@@@@@@@..T.T.T.@@@T..T..TTT...@@@TT...@@@@@@@@@@@@@@@@@@@@@@@@@@@@@@@@@@@@@@@@@@@@@@@@@@@@@@@@@@@@@
@@@@@@@@@@@@@@@@@@@@@@@@@@@@@@@@@@@@@@@@@@..T..@@@@@@@@@@.......T.T.T@.........@@@@......@@@@@@@@@@@@@@@@@@@@@@@@@@@@@@@@@@@@@@@@@@@@@@@@@@@@@@@@@@@
@@@@@@@@@@@@@@@@@@@@@@@@@@@@@@@@@@@@@@@@@@....@@@@@@@@@@@.........T.@@@TT..T.T.@@@@@......@@@@@@@@@@@@@@@@@@@@@@@@@@@@@@@@@@@@@@@@@@@@@@@@@@@@@@@@@@
@@@@@@@@@@@@@@@@@@@@@@@@@@@@@@@@@@@@@@@@@.....@@@@T@@@@@@....T....T.@@@@@.......@@@@@.....T@@@@@@@@@@@@@@@@@@@@@@@@@@@@@@@@@@@@@@@@@@@@@@@@@@@@@@@@@
@@@@@@@@@@@@@@@@@@@@@@@@@@@@@@@@@@@@@@@.T....TT@@@..@@@@@@....T......@@@@@........@@@@T..T..@@@@@@@@@@@@@@@@@@@@@@@@@@@@@@@@@@@@@@@@@@@@@@@@@@@@@@@@
@@@@@@@@@@@@@@@@@@@@@@@@@@@@@@@@@@@@@@.T..........T.T.@@@...TTT.......@@@@....T...T@@@@......@@@@@@@@@@@@@@@@@@@@@@@@@@@@@@@@@@@@@@@@@@@@@@@@@@@@@@@
@@@@@@@@@@@@@@@@@@@@@@@@@@@@@@@@@@@@@@.T....T......T......T.T....@@..@@@@@@TTT......@@@T.T....@@@@@@@@@@@@@@@@@@@@@@@@@@@@@@@@@@@@@@@@@@@@@@@@@@@@@@
@@@@@@@@@@@@@@@@@@@@@@@@@@@@@@@@@@@@@@@......T.........T....T...@@@@@@@@@@@@......T..@@........@@@@@@@@@@@@@@@@@@@@@@@@@@@@@@@@@@@@@@@@@@@@@@@@@@@@@
@@@@@@@@@@@@@@@@@@@@@@@@@@@@@@@@@@@@@@@@.....TT.....T....T.....@@@@@@@@@@@@@@@T...........T....T@@@@@@@@@@@@@@@@@@@@@@@@@@@@@@@@@@@@@@@@@@@@@@@@@@@@
@@@@@@@@@@@@@@@@@@@@@@@@@@@@@@@@@.@@@@@@@TT...T...TT..T...TT....@@@@@@@@@@@@@@@..T.TTT.......TT..@@@@@@@@@@@@@@@@@@@@@@@@@@@@@@@@@@@@@@@@@@@@@@@@@@@
@@@@@@@@@@@@@@@@@@@@@@@@@@@@@@@@@..@@@@@@@...T...TT............T.@@@@@@@@@...@@@.TT........@.....T@@@@@@@@@@@@@@@@@@@@@@@@@@@@@@@@@@@@@@@@@@@@@@@@@@
@@@@@@@@@@@@@@@@@@@@@@@@@@@@@@@@T..@@@@@@@@......TT.....T..T....T@@@@@@@@..T.@@@@.....T...@@@.T...T@@@@@@@@@@@@@@@@@@@@@@@@@@@@@@@@@@@@@@@@@@@@@@@@@
@@@@@@@@@@@@@@@@@@@@@@@@@@@@@@T.TT.@@@@@@@@@.....T..T.TT...TTT..@@@@@@@@..T.@@@@@@TT......@@@@@.T..T.@@@@@@@@@@@@@@@@@@@@@@@@@@@@@@@@@@@@@@@@@@@@@@@
@@@@@@@@@@@@@@@@@@@@@@@@@@@@@..T..@@@@@@@@@@@...TT.......T....T@@@@@@@@..TT@@@@@@@@TT.....@@@@@@.....@@@@@@@@@@@@@@@@@@@@@@@@@@@@@@@@@@@@@@@@@@@@@@@
@@@@@@@@@@@@@@@@@@@@@@@@@@@@@.....@@@@..@@@@@@.T..T.......T....@@@@@@@...T@@@@@@@@@T...T.....@@@@..T.@@@@@@@@@@@@@@@@@@@@@@@@@@@@@@@@@@@@@@@@@@@@@@@
@@@@@@@@@@@@@@@@@@@@@@@@@@@@TT...T.T@....@@@@@.T...T....T...T..@@@@@@....@@@@@@@@@@@....TT.T.T@@@@......@@@@@@@@@@@@@@@@@@@@@@@@@@@@@@@@@@@@@@@@@@@@
@@@@@@@@@@@@@@@@@@@@@@@@@@..T.........T...@@@@..T.....T........@@@@@....@@@@@@@@T.@@@@...T...T.@@@.......@@@@@@@@@@@@@@@@@@@@@@@@@@@@@@@@@@@@@@@@@@@
@@@@@@@@@@@@@@@@@@@@@@@@@@@..........T..T.T......TTT...........@@@T...T@@@@@@@@...T@@@@.........@@T.....T.@@@@@@@@@@@@@@@@@@@@@@@@@@@@@@@@@@@@@@@@@@
@@@@@@@@@@@@@@@@@@@@@@@@@@@@...T...............T@@@@.T.T...T.T.....T..@@@@@@@@@.T....@@@....T.....T...T....@@@@@@@@@@@@@@@@@@@@@@@@@@@@@@@@@@@@@@@@@
@@@@@@@@@@@@@@@@@@@@@@@@@@@@@........T...T.T...@@@@@T.........T.T....@@@@@@@@@@@...T.@@@@.T...T.T..T...T....@@@@@@@@@@@@@@@@@@@@@@@@@@@@@@@@@@@@@@@@
@@@@@@@@@@@@@@@@@@@@@@..@@@@@@..T..T..T...T...@@@@@@.T@@.....T..T..TT@@@@@@.@@@@.T..@@@@@@...T...T....T.....T@@@@@@@@@@@@@@@@@@@@@@@@@@@@@@@@@@@@@@@
@@@@@@@@@@@@@@@@@@@@@T..@@@@@@@.....T.T.T...T@@@@@@..@@@.T...T..T....@@@@@...@@..T.@@@@@@@@T.......T..T...TT.T@@@@@@@@@@@@@@@@@@@@@@@@@@@@@@@@@@@@@@
@@@@@@@@@@@@@@@@@@@@@...@@@@@@@@TT.T.....T...@@@@@T.@@@@.T..T........@@@@@.TT....T@@@@@@@@@T.....T..TT@@T.....T@@@@@@@@@@@@@@@@@@@@@@@@@@@@@@@@@@@@@
@@@@@@@@@@@@@@@@@@@@TT.@@@@@@@@@@T.T.........T@@@T.@@@@.....TT....T.T@@...T...TT.@@@@@@@@@@@..TT...T.T@@@@...T..@@@@@@@@@@@@@@@@@@@@@@@@@@@@@@@@@@@@
@@@@@@@@@@@@@@@@@@.T...@@@@@@@@@@@..T.....T..TT@..@@@@.........T...T......T.....@@@@@@@@T.@@@...TT....@@@@@......@@@@@@@@@@@@@@@@@@@@@@@@@@@@@@@@@@@
@@@@@@@@@@@@@@@@@.......@@@T.@@@@@@.T............@@@@...@@......T....T....T....@@@@@@@@....@T...........@@@@......@@@@@@@@@@@@@@@@@@@@@@@@@@@@@@@@@@
@@@@@@@@@@@@@@@@@......TT@....@@@@@.T...T.T.....@@@@.T.@@@@..T..........T.T...@@@@@@@@@@.T....@@.........@@@@......@@@@@@@@@@@@@@@@@@@@@@@@@@@@@@@@@
@@@@@@@@@@@@@@@@@@........TTT..@@@..T..T.T.TTT..@@@...@@@@@@...T....T......T.@@@@@@@@@@@@T....@@@@..T.T...@@@@TT....T@@@@@@@@@@@@@@@@@@@@@@@@@@@@@@@
@@@@@@@@@@@@@@@@@@@@.....T......T.T....T........@@.T.@@@@@@@..@@.TT.T.T......@@@@@@@.@@@@......@@@@T..T...@@@@TT..T...@@@@@@@@@@@@@@@@@@@@@@@@@@@@@@
@@@@@@@@@@@@@@@@@@@@@......T...T.....T.T.............@@@@@@T.@@@@TT..........@@@@@@..@@@..T.....@@@@...T..T.....T.....@@@@@@@@@@@@@@@@@@@@@@@@@@@@@@
@@@@@@@@@@@@@@.@@@@@@....T.TTT.TT.T................T.@@@@@.T@@@@@.....T...@@..@@@@@T..@....T@....@@@@....T.T.....TTT..@@@@@@@@@@@@@@@@@@@@@@@@@@@@@@
@@@@@@@@@@@@@@..@@@@@@.TT.T...TTT.......T@.........TT.@@@.T@@@@.....TTT..@@@@..@@@....T....@@@@..@@@@@.T..T............@@@@@@@@@@@@@@@@@@@@@@@@@@@@@
@@@@@@@@@@.......@@@@@@@TT...TT..TTT..T.@@@T..T.........T.@@@@.......T..@@@.@@.T....T.....@@@@@@@@@@@@@T..T.T..........T.T@@@@@@@@@@@@@@@@@@@@@@@@@@
@@@@@@@@@..TT.....@@@@@@@...T....@@@...@@@@@...T.....T...@@@@.T.@@@.T..@@@...@@...........@@@@@@@@@@@@@@...................@@@@@@@@@@@@@@@@@@@@@@@@@
@@@@@@@@@.T....T...@@@@@@.TT....@@@@..@@@@@@T.T.........@@@@...@@@@..T@@@.....@@.....T.TTT.@@@@@@@@@@@@@@......T...@@.T...TT@@@@@@@@@@@@@@@@@@@@@@@@
@@@@@@@@.......TT.T@@@@@@@..T...@@@..@@@@@@...T.T.......@@@..@@@@@@@.@@@.....T.@@....T.....@@@@@@@@@@.@@@@...T..TTT@@@@..T.T.@@@@@@@@@@@@@@@@@@@@@@@
@@@@@@.T....T.....T.T@@@@@@....T@@..@@@@@@@.........T...@@...@@@@@@@@@@.........@@.......T.@@@@@@@@@TT.@@@@..T....T@@@@@...T..@@@@@@@@@@@@@@@@@@@@@@
@@@@@@@TT..T...@@......@@@@........@@@@@@@@T..............T..@@@@@@@@...T...T....@@.......@@@@@@@@@...@@@@@...T.TTTT.@@@@..T.T.@@@@@@@@@@@@@@@@@@@@@
@@@@@@@@T.....@@@@T.....@@T...@@..@@@@@@@@.....TT............T@@@@@@...T.....T...@@T..TT..@@@@@@@@TT.@@@@@@@.....T....@@@T.T..T.@@@@@@@@@@@@@@@@@@@@
@@@@@@@@@..T..@@@@@@....T....@@@@@@@@@@@@...TT@@@@T..T...T.....@@@@......T@..T....@@....T.@@@@@@.T.T@@@@@@@@@@..T......@@@........@@@@@@@@@@@@@@@@@@
@@@@@@@@@@TT..TT@@@@@....T..@@@@@@@@@@@@.....@@@@@......T...TT.@@@...T..T@@@T..T.TT@@T...@@@@@@TT..@@@@@@@@@@@@.....TTT@@@@........@@@@@@@@@@@@@@@@@
@@@@@@@@@@@.......@@@@.T.T.@@@@@@@@@@@@..T..@@@@@@.....T...T...@@...T..T.@@@@..T..T@@@...@@@@@@..T@@@@@@@@@.@@@@......T.@@@T....TT..@@@@@@@@@@@@@@@@
@@@@@@@@@@@@.......@@@..T...@@@@@@@@@@.T.T.@@@@@@@..T.T.T.....@@@@.....T...@@@.....@@@..T@@@@..T.@@@@@@@@@...@@@@...................@@@@@@@@@@@@@@@@
@@@@@@@@@@@@@......@@@@..T.T.@@@@@@@@.T...@@@@@@@.T..T......T@@@@@.T.T...TT.@@T.....@@......TT..@@@@@@@@@@@..T@@@@@..........T...T....@@@@@@@@@@@@@@
@@@@@@@@@@@@@@.T....@@@.....T.@@@@@@@T...@@@@@@@...TT.T.TT..T@@@@@@.TTT.....@@...T.......T.....@@@@@@@@@@@@....@@@@@.T...TT......T.....@@@@@@@@@@@@@
@@@@@@@@@@@@@@@T............T..@@@@@@@..@@@@@@@@.T..T.T.....T@@@@@@@@......@@@@..T.TT...T.......@@@@@@@@@@@T...@@@@@.T.T.....T..TT.....T@@@@@@@@@@@@
@@@@@@@@@@@@@@@@...............T@@@@@@@@@@@@@@@@@T.....T@..T..@@@@@@@@@@@@@@@@@....T.T..T...T.T.@@@@@@.@@@.T..@@@@@@@.....T......@@...T.@@@@@@@@@@@@
@@@@@@@@@@@@@@@@@T...............@@@@@@@@@@@@@@@@..T.T.@@@.....@@@@@@@@@@@@@@@@...T.....TT...TT.@@@@.T..@....@@@@@@@@@..T.....T..@@@.....@@@@@@@@@@@
@@@@@@@@@@@@@@@@@@..............T@@@@@@@@@@@@@@@@.....@@@@@.T....@@@@@@@@@TT@@@.........T....T..@@T..T......@@@@@@@@@@@......TT..@@@@......@@@@@@@@@
@@@@@@@@@@@@@@@@@@@@.T......@T..T..@@@@@@@@@@.@@.....@@@@@....TT..@@@@@@@....@@.......T.....T..........T...@@@@@@@@@@@....T.......@@@@@TT.T.@@@@@@@@
@@@@@@@@@@@@@@@@@@@@@......@@@@.T...@@@@@@@@T.......@@@@@@........@@@@@@.TT.....TTT..T...T.T.......T...T...@@@@@@@@.T..T......TTT...@@@@..T.@@@@@@@@
@@@@@@@@@@@@@@@@@@@@@@TT...@@@@@T...T@@@@@@@@......@@@@@@@...T.....@@@@@T.T.......TT.T@@@......T......T...@@@@@@@@@...T.@@@....T.T..T@@@..T..@@@@@@@
@@@@@@@@@@@@@@@@@@@@@@@T.T..@@@@@.TT.T@@@@@@@@....@@@@@@@@.TT.T.T..T.@@@@......T.T..@@@@@@...T...T.....T.@@@@@@@@@@.T.T.@@@@.......T.@@@@.TT@@@@@@@@
@@@@@@@@@@@@@@@@@@@@@@@@......@@@@.....@@@@@@@@T.@@@@@@@@....T.T..T..T.@@@...T..T..@@@@@@@.....T........@@@@@@@@@@@......@@@@..........@...@@@@@@@@@
@@@@@@@@@@@@@@@@@@@@@@@@@T.....@@@@T....@@@@@@@@@@@@@@@@@..T............@@.T..T....@@@@@@@.T....@T.....T@@@@@@..@@@T..T...@@@@T.....T...T.@@@@@@@@@@
@@@@@@@@@@@@@@@@@@@@@@@@@@.T...@@@@@....T@@@@@@@@@@@@@@@@@........T.....T.....T....@@@@@@.....T@@@..TT..@@@@@TTT.@.........@@@@...TT...T.@@@@@@@@@@@
@@@@@@@@@@@@@@@@@@@@@@@@@@@.TT..@@@@TT..T.@@@@@@@@@@@@@@@@......T..@@...T..T.T...T@@@@@@........@@@....T..@@@.........T.....@@@@.TTT....@@@@@@@@@@@@
@@@@@@@@@@@@@@@@@@@@@@@@@@@@..T..T..........@@@@@@@@@..@@.TT.....T@@@@.T.T..T.....@@@@@.........T@@.......T..................@@@@......@@@@@@@@@@@@@
@@@@@@@@@@@@@@@@@@@@@@@@@@@@@T......T.....T..@@@@@@@..T.T...@@.T.@@@@@..T..T.T...T.@@@@.T.TTT...T.....T...T....T.....T........@@@@....@@@@@@@@@@@@@@
@@@@@@@@@@@@@@@@@@@@@@@@@@@@@@.........@.T...@@@@@@@..T....@@@@.@@@@@T............T.@..........T.T..T.....T........T.T.......T.@@@@.T@@@@@@@@@@@@@@@
@@@@@@@@@@@@@@@@@@@@@@@@@@@@@@@....T..@@@@T.T@@@@@@@@....T@@@@@@@@@@@.....TT.T.TT....T.T......T..T.T....T...T......@@T.T..TT..T.@@@@@@@@@@@@@@@@@@@@
@@@@@@@@@@@@@@@@@@@@@@@@@@@@@@@@@T....@@@@@T...T@@@@@@T...@@@@@@@@@@@@...TT.T..T...TT.....T....T...........T...T..@@@@...........@@@@@@@@@@@@@@@@@@@
@@@@@@@@@@@@@@@@@@@@@@@@@@@@@@@@@@.T..@@@@@@.T..T@@@@...T..@@@@@@@@@@T.........TTT..T.......TT...T.....T.T...T....@@@@@......T....@@@@@@@@@@@@@@@@@@
@@@@@@@@@@@@@@@@@@@@@@@@@@@@@@@@@@@T.T..@@@@@.....@@T.T@.TT@@@@@@@@@....T@...T....T.T.....T...T...T.T..............@@@@@.....T.T.@@@@@@@@@@@@@@@@@@@
@@@@@@@@@@@@@@@@@@@@@@@@@@@@@@@@@@@@T....@@@@.T......T@@@@@@@@@@@@@TTT..@@@@@..T..T.....TT....TT.......T.T.T.T.....@@@@@@TT.T...@@@@@@@@@@@@@@@@@@@@
@@@@@@@@@@@@@@@@@@@@@@@@@@@@@@@@@@@@@.....@@@@...TT.T@@@@@@@@@@@@@.....@@@@@@T...T.T..............T.....T.T...T..TT.@@@@@@..T.T@@@@@@@@@@@@@@@@@@@@@
@@@@@@@@@@@@@@@@@@@@@@@@@@@@@@@@@@@@@@....T@@@.......@@@@@@@@@@@@T...T@@@@@@@........@@.......T...T@.........T......T@@@@@@..T@@@@@@@@@@@@@@@@@@@@@@
@@@@@@@@@@@@@@@@@@@@@@@@@@@@@@@@@@@@@@@.....@@...T..T.@@@@@@@@@@..T..@@@@@@@....TT...@@@..........@@@T........T.TT..@@@@@@@@.@@@@@@@@@@@@@@@@@@@@@@@
@@@@@@@@@@@@@@@@@@@@@@@@@@@@@@@@@@@@@@@@T........T..TT.T@@@@@@@@@TT.@@@@@@@...........@@..T...T.T@@@......T....T.T.@@@@@@@@@@@@@@@@@@@@@@@@@@@@@@@@@
@@@@@@@@@@@@@@@@@@@@@@@@@@@@@@@@@@@@@@@@@T...............@@@@@@@@@T@@@@@@@T.T....T................@..T.............@@@@@@@@@@@@@@@@@@@@@@@@@@@@@@@@@
@@@@@@@@@@@@@@@@@@@@@@@@@@@@@@@@@@@@@@@@@@TT.........TT..T@@@@@@@@@@@@@@@@@TT..T.....T......TT...TTT......TTT..TTT..@@@@@@@@@@@@@@@@@@@@@@@@@@@@@@@@
@@@@@@@@@@@@@@@@@@@@@@@@@@@@@@@@@@@@@@@@@@@.T.T....@@.T...@@@@@@@@@@@@@@@@@..T..TT@@.T..T.TT..............@...........@@@@@@@@@@@@@@@@@@@@@@@@@@@@@@
@@@@@@@@@@@@@@@@@@@@@@@@@@@@@@@@@@@@@@@@@@@@..T..T@@@@...T@@@@@@@@@@@@@@@@@TTT.T@@@@T....T.......TT...@@@@@@TT.........@@@@@@@@@@@@@@@@@@@@@@@@@@@@@
@@@@@@@@@@@@@@@@@@@@@@@@@@@@@@@@@@@@@@@@@@@@@.T...@@@@@...T..@@@@@@@@@@@@T..T..@@@@@@...TT.....T..T..T@@@@@@@......T..@@@@@@@@@@@@@@@@@@@@@@@@@@@@@@
@@@@@@@@@@@@@@@@@@@@@@@@@@@@@@@@@@@@@@@@@@@@@@.T..T@@@@@....T.@@@@@@@@@T.T....@@@@@@@@..TTT...TT......@@@@@@@@.TTTT.T@@@@@@@@@@@@@@@@@@@@@@@@@@@@@@@
@@@@@@@@@@@@@@@@@@@@@@@@@@@@@@@@@@@@@@@@@@@@@@@.T...T@@@@......@@@@@@@@@.....@@@@@@@@@..............T..T@@@@@@@...TT@@@@@@@@@@@@@@@@@@@@@@@@@@@@@@@@
@@@@@@@@@@@@@@@@@@@@@@@@@@@@@@@@@@@@@@@@@@@@@@@@......@@@@......@@@@@@@@@...@@@@@@@@T.T.......T..T...T...@@@@@@@...@@@@@@@@@@@@@@@@@@@@@@@@@@@@@@@@@
@@@@@@@@@@@@@@@@@@@@@@@@@@@@@@@@@@@@@@@@@@@@@@@@@...T..@@@T.TT...@@@@@@@@@.@@@@@@@@T.T.TT.........T..T...@@@@@@@@.@@@@@@@@@@@@@@@@@@@@@@@@@@@@@@@@@@
@@@@@@@@@@@@@@@@@@@@@@@@@@@@@@@@@@@@@@@@@@@@@@@@@@.....@@@.T.TT...@@@@@@@@@@@@@@@@TTT..T....T......TT...T@@@@@@@@@@@@@@@@@@@@@@@@@@@@@@@@@@@@@@@@@@@
@@@@@@@@@@@@@@@@@@@@@@@@@@@@@@@@@@@@@@@@@@@@@@@@@@@T...T......T....@@@@@@@@@@@@@@@@....T.....T..........@@@@@@@@@@@@@@@@@@@@@@@@@@@@@@@@@@@@@@@@@@@@
@@@@@@@@@@@@@@@@@@@@@@@@@@@@@@@@@@@@@@@@@@@@@@@@@@@@.TTT...........T@@@@@@@@@@@@@@@@......TT....T.T.T...@@@@@@@@@@@@@@@@@@@@@@@@@@@@@@@@@@@@@@@@@@@@
@@@@@@@@@@@@@@@@@@@@@@@@@@@@@@@@@@@@@@@@@@@@@@@@@@@@@@...T...T..T..T.@@@@@@@@@@@@@@.T.....T..@T.T........T@@@@@@@@@@@@@@@@@@@@@@@@@@@@@@@@@@@@@@@@@@
@@@@@@@@@@@@@@@@@@@@@@@@@@@@@@@@@@@@@@@@@@@@@@@@@@@@@@@..........T.T..@@@@@@@@.T@@.T....TT..@@@........T...@@@@@@@@@@@@@@@@@@@@@@@@@@@@@@@@@@@@@@@@@
@@@@@@@@@@@@@@@@@@@@@@@@@@@@@@@@@@@@@@@@@@@@@@@@@@@@@@@@TT.T...T@..T...@@@@@@...............@@@@.T.....TTTTT@@@@@@@@@@@@@@@@@@@@@@@@@@@@@@@@@@@@@@@@
@@@@@@@@@@@@@@@@@@@@@@@@@@@@@@@@@@@@@@@@@@@@@@@@@@@@@@@@@......@@@......@@@@@@.....T.TT....T@@@@@@T..TT...T@@@@@@@@@@@@@@@@@@@@@@@@@@@@@@@@@@@@@@@@@
@@@@@@@@@@@@@@@@@@@@@@@@@@@@@@@@@@@@@@@@@@@@@@@@@@@@@@@@@@T....@@@@.....@@@@@@@T..T....T..TT@@@@@@@.......@@@@@@@@@@@@@@@@@@@@@@@@@@@@@@@@@@@@@@@@@@
@@@@@@@@@@@@@@@@@@@@@@@@@@@@@@@@@@@@@@@@@@@@@@@@@@@@@@@@@@@T...@@@@@@....T@@@@@.......T....T.@@@@@@@T....@@@@@@@@@@@@@@@@@@@@@@@@@@@@@@@@@@@@@@@@@@@
@@@@@@@@@@@@@@@@@@@@@@@@@@@@@@@@@@@@@@@@@@@@@@@@@@@@@@@@@@@@.....@@@@@..T..@@@................@@@@@@@T.T@@@@@@@@@@@@@@@@@@@@@@@@@@@@@@@@@@@@@@@@@@@@
@@@@@@@@@@@@@@@@@@@@@@@@@@@@@@@@@@@@@@@@@@@@@@@@@@@@@@@@@@@@@..T..@@@@..T.T......@@...........@@@@@@@@.@@@@@@@@@@@@@@@@@@@@@@@@@@@@@@@@@@@@@@@@@@@@@
@@@@@@@@@@@@@@@@@@@@@@@@@@@@@@@@@@@@@@@@@@@@@@@@@@@@@@@@@@@@@@.....@@@@.T...T...@@@@T..TTT...@@@@@@@@@@@@@@@@@@@@@@@@@@@@@@@@@@@@@@@@@@@@@@@@@@@@@@@
@@@@@@@@@@@@@@@@@@@@@@@@@@@@@@@@@@@@@@@@@@@@@@@@@@@@@@@@@@@@@@@..T..@@@......T.@@@@@@TTTT..T.@@@@@@@@@@@@@@@@@@@@@@@@@@@@@@@@@@@@@@@@@@@@@@@@@@@@@@@
@@@@@@@@@@@@@@@@@@@@@@@@@@@@@@@@@@@@@@@@@@@@@@@@@@@@@@@@@@@@@@@@T......T........@@@@@@T....T..@@@@@@@@@@@@@@@@@@@@@@@@@@@@@@@@@@@@@@@@@@@@@@@@@@@@@@
@@@@@@@@@@@@@@@@@@@@@@@@@@@@@@@@@@@@@@@@@@@@@@@@@@@@@@@@@@@@@@@@@..TT.T..TT....T.@@@@@@T....T..@@@@@@@@@@@@@@@@@@@@@@@@@@@@@@@@@@@@@@@@@@@@@@@@@@@@@
@@@@@@@@@@@@@@@@@@@@@@@@@@@@@@@@@@@@@@@@@@@@@@@@@@@@@@@@@@@@@@@@@@...TT.T.T..TT...@@@@@@......T.T@@@@@@@@@@@@@@@@@@@@@@@@@@@@@@@@@@@@@@@@@@@@@@@@@@@
@@@@@@@@@@@@@@@@@@@@@@@@@@@@@@@@@@@@@@@@@@@@@@@@@@@@@@@@@@@@@@@@@@@@T......T.......@@@@@@.......@@@@@@@@@@@@@@@@@@@@@@@@@@@@@@@@@@@@@@@@@@@@@@@@@@@@
@@@@@@@@@@@@@@@@@@@@@@@@@@@@@@@@@@@@@@@@@@@@@@@@@@@@@@@@@@@@@@@@@@@@@..TT.TT.@.T....@@@@@@.....@@@@@@@@@@@@@@@@@@@@@@@@@@@@@@@@@@@@@@@@@@@@@@@@@@@@@
@@@@@@@@@@@@@@@@@@@@@@@@@@@@@@@@@@@@@@@@@@@@@@@@@@@@@@@@@@@@@@@@@@@@@@...T..@@@.T...T@@@@@@...@@@@@@@@@@@@@@@@@@@@@@@@@@@@@@@@@@@@@@@@@@@@@@@@@@@@@@
@@@@@@@@@@@@@@@@@@@@@@@@@@@@@@@@@@@@@@@@@@@@@@@@@@@@@@@@@@@@@@@@@@@@@@@...T.@@@@..T.T.@@@@@@.@@@@@@@@@@@@@@@@@@@@@@@@@@@@@@@@@@@@@@@@@@@@@@@@@@@@@@@
@@@@@@@@@@@@@@@@@@@@@@@@@@@@@@@@@@@@@@@@@@@@@@@@@@@@@@@@@@@@@@@@@@@@@@@@....@@@@@@.T...@@@@@@@@@@@@@@@@@@@@@@@@@@@@@@@@@@@@@@@@@@@@@@@@@@@@@@@@@@@@@
@@@@@@@@@@@@@@@@@@@@@@@@@@@@@@@@@@@@@@@@@@@@@@@@@@@@@@@@@@@@@@@@@@@@@@@@@T....@@@@@.T...@@@@@@@@@@@@@@@@@@@@@@@@@@@@@@@@@@@@@@@@@@@@@@@@@@@@@@@@@@@@
@@@@@@@@@@@@@@@@@@@@@@@@@@@@@@@@@@@@@@@@@@@@@@@@@@@@@@@@@@@@@@@@@@@@@@@@@@..T..@@@@.T..T.@@@@@@@@@@@@@@@@@@@@@@@@@@@@@@@@@@@@@@@@@@@@@@@@@@@@@@@@@@@
@@@@@@@@@@@@@@@@@@@@@@@@@@@@@@@@@@@@@@@@@@@@@@@@@@@@@@@@@@@@@@@@@@@@@@@@@@@.....@@@@....@@@@@@@@@@@@@@@@@@@@@@@@@@@@@@@@@@@@@@@@@@@@@@@@@@@@@@@@@@@@
@@@@@@@@@@@@@@@@@@@@@@@@@@@@@@@@@@@@@@@@@@@@@@@@@@@@@@@@@@@@@@@@@@@@@@@@@@@@.....@@@T..@@@@@@@@@@@@@@@@@@@@@@@@@@@@@@@@@@@@@@@@@@@@@@@@@@@@@@@@@@@@@
@@@@@@@@@@@@@@@@@@@@@@@@@@@@@@@@@@@@@@@@@@@@@@@@@@@@@@@@@@@@@@@@@@@@@@@@@@@@@...T.@@..@@@@@@@@@@@@@@@@@@@@@@@@@@@@@@@@@@@@@@@@@@@@@@@@@@@@@@@@@@@@@@
@@@@@@@@@@@@@@@@@@@@@@@@@@@@@@@@@@@@@@@@@@@@@@@@@@@@@@@@@@@@@@@@@@@@@@@@@@@@@@.....TT@@@@@@@@@@@@@@@@@@@@@@@@@@@@@@@@@@@@@@@@@@@@@@@@@@@@@@@@@@@@@@@
@@@@@@@@@@@@@@@@@@@@@@@@@@@@@@@@@@@@@@@@@@@@@@@@@@@@@@@@@@@@@@@@@@@@@@@@@@@@@@@.T.T.@@@@@@@@@@@@@@@@@@@@@@@@@@@@@@@@@@@@@@@@@@@@@@@@@@@@@@@@@@@@@@@@
@@@@@@@@@@@@@@@@@@@@@@@@@@@@@@@@@@@@@@@@@@@@@@@@@@@@@@@@@@@@@@@@@@@@@@@@@@@@@@@@..T@@@@@@@@@@@@@@@@@@@@@@@@@@@@@@@@@@@@@@@@@@@@@@@@@@@@@@@@@@@@@@@@@
@@@@@@@@@@@@@@@@@@@@@@@@@@@@@@@@@@@@@@@@@@@@@@@@@@@@@@@@@@@@@@@@@@@@@@@@@@@@@@@@@.@@@@@@@@@@@@@@@@@@@@@@@@@@@@@@@@@@@@@@@@@@@@@@@@@@@@@@@@@@@@@@@@@@
