type octile
height 86
width 88
map
@@@@@@@@@@@@@@@@@@@@@@@@@@@@@@@@@@@@@@@@@@@@@@@@@@@@@@@@@@@@@@@@@@@@@@@@@@@@@@@@@@@@@@@@
@@@@@@@@@@@@@@@@@@@@@@@@@@@@@@@@@@@@@@@@@@@@@@@@@@@@@@@@@@@@@@@@@@@@@@@@@@@@@@@@@@@@@@@@
@@@@@@@@@@@@@@@@@@@@@@@@@@@@@@@@@@@@@@@@@@@@@@@@@@@@@@@@@@@@@@@@@@@@@@@@@@@@@@@@@@@@@@@@
@@@@@@@@@@@@@@@@@@@@@@@@@@@@@@@@@@@@@@@@@@@@@@@@@@@@@@@@@@@@@@@@@@@@@@@@@@@@@@@@@@@@@@@@
@@@@@@@@@@@@@@@@@@@@@@@@@@@@@@@@@@@@@@@@@@@@@@@@@@@@@@@@@@@@@@@@@@@@@@@@@@@@@@@@@@@@@@@@
@@@@@@@@@@@@@@@@@@@@@@@@@@@@@@@@@@@@@@@@@@@@@@@@@@@@@@@@@@@@@@@@@@@@@@@@@@@@@@@@@@@@@@@@
@@@@@@@@@@@@@@@@@@@@@@@@@@@@@@@@@@@@@@@@@@@@@@@@@@@@@@@@@@@@@@@@@@@@@@@@@@@@@@@@@@@@@@@@
@@@@@@@@@@@@@@@@@@@@@@@@@@@@@@@@@@@@@@@@@@@@@@@@@@@@@@@@@@@@@@@@@@@@@@@@@@@@@@@@@@@@@@@@
@@@@@@@@@@@@@@@@@@@@@@@@@@@@@@@@@@@@@@@@@@@@@@@@@@@@@@@@@@@@@@@@@@@@@@@@@@@@@@@@@@@@@@@@
@@@@@@@@@@@@@@@@@@@@@@@@@@@@@@@@@@@@@@@@@@@@@@@@@@@@@@@@@@@@@@@@@@@@@@@@@@@@@@@@@@@@@@@@
@@@@@@@@@@@@@@@@@@@@@@@@@@@@@@@@@@@@@@@@@@@@@@@@@@@@@@@@@@@@@@@@@@@@@@@@@@@@@@@@@@@@@@@@
@@@@@@@@@@@@@@@@@@@@@@@@@@@@@@@@@@@@@@@@@@@@@@@@@@@@@@@@@@@@@@@@@@@@@@@@@@@@@@@@@@@@@@@@
@@@@@@@@@@@@@@@@@@@@@@@@@@@@@@@..@@@@@@@@@@@@@@@@@@@@@@@@@@@@@@@@@@@@@@@@@@@@@@@@@@@@@@@
@@@@@@@@@@@@@@@@@@@@@@@@@@@@@@@...@@@@@@@@@@@@@@@@@@@@@@@@@@@@@@@@@@@@@@@@@@@@@@@@@@@@@@
@@@@@@@@@@@@@@@@@@@@@@@@@@@@@@...T.@@@@@@@@@@@@@@@@@@@@@@@@@@@@@@@@@@@@@@@@@@@@@@@@@@@@@
@@@@@@@@@@@@@@@@@@@@@@@@@@@@@..T....@@@@@@@@@@@@@@@@@@@@@@@@@@@@@@@@@@@@@@@@@@@@@@@@@@@@
@@@@@@@@@@@@@@@@@@@@@@@@@@@@....TT.T.@@@..@@@@@@@@@@@@@@@@@@@@@@@@@@@@@@@@@@@@@@@@@@@@@@
@@@@@@@@@@@@@@@@@@@@@@@@@@@..T..@@.....T.T@@@@@@@@@@@@@@@@@@@@@@@@@@@@@@@@@@@@@@@@@@@@@@
@@@@@@@@@@@@@@@@@@@@@@@@@@....T@@@...T....T@@@@@@@@@@@@@@@@@@@@@@@@@@@@@@@@@@@@@@@@@@@@@
@@@@@@@@@@@@@@@@@@@@@@@@@....T@@@.T.T........@@@@@@@@@@@@@@@@@@@@@@@@@@@@@@@@@@@@@@@@@@@
@@@@@@@@@@@@@@@@@@@@@@@@TT...@@@.T..T......T..@@@@@@@@@@@@@@@@@@@@@@@@@@@@@@@@@@@@@@@@@@
@@@@@@@@@@@@@@@@@@@@@@@@@...@@@...T.T@@.T.....@@@@@@@@@@@@@@@@@@@@@@@@@@@@@@@@@@@@@@@@@@
@@@@@@@@@@@@@@@@@@@@@@.@@..@@@...T...@@@.......@@@@@@@@@@@@@@@@@@@@@@@@@@@@@@@@@@@@@@@@@
@@@@@@@@@@@@@@@@@@@@@T.T@@@@@.......@@@@@.....@@@@@@@@@@@@@@@@@@@@@@@@@@@@@@@@@@@@@@@@@@
@@@@@@@@@@@@@@@@@@@@....@@@@.T.....@@@@@@....@@@@@@@@@@@@@@@@@@@@@@@@@@@@@@@@@@@@@@@@@@@
@@@@@@@@@@@@@@@@@@@T...T.T.......T.@@@@@.T..@@@@@@@@@@@@@@@@@@@@@@@@@@@@@@@@@@@@@@@@@@@@
@@@@@@@@@@@@@@@@@@.T...T....T...T.T..@@@..TT@@@@@@@@@@@@@@@@@@@@@@@@@@@@@@@@@@@@@@@@@@@@
@@@@@@@@@@@@@@@@@........T..TT....T...@@@.T@@@@@@.@@.@@@@@@@@@@@@@@@@@@@@@@@@@@@@@@@@@@@
@@@@@@@@@@@@@@@@..........T....T.....TT@T.@@@@@@@..@..@@@@@@@@@@@@@@@@@@@@@@@@@@@@@@@@@@
@@@@@@@@@@@@@@@...T.T.TT.T.T..TTT.TT......@@@@@@@@.T..@@@@@@@@@@@@@@@@@@@@@@@@@@@@@@@@@@
@@@@@@@@@@@@@@@.....................T....@@@@@@@@......@@@@@@@@@@@@@@@@@@@@@@@@@@@@@@@@@
@@@@@@@@@@@@@@@@T......T...T.....TT.....@@@@@@@@..T....T.@@@@@@@@@@@@@@@@@@@@@@@@@@@@@@@
@@@@@@@@@@@@@@@@@@TT..................@@@@@@@@@...TT....T..@@@@@@@@@@@@@@@@@@@@@@@@@@@@@
@@@@@@@@@@@@@@@@@@@@@..T...T.T........@@@@@@@@@.......T.T..@@@@@@@@@@@@@@@@@@@@@@@@@@@@@
@@@@@@@@@@T@@@@@@@@@@.TT.....T..T..TT.@@@@@@@@@......T....@@@@@@@@@@@@@@@@@@@@@@@@@@@@@@
@@@@@@@@.T..@@@@@@@@@.......T..T...T.@@@@@@@@.TT..........@@@.@@@@@@@@@@@@@@@@@@@@@@@@@@
@@@@@@@.T....@@@@@@@@@@@...........T@@@@@@.T...TTT..T.TTTT.....@@@@@@@@@@@@@@@@@@@@@@@@@
@@@@@@..T...T.@@@@@@T@@@.TT.T.....T.@@@.@@.T.......T...TT......@@@@@@@@@@@@@@@@@@@@@@@@@
@@@@@..T..T....@@@@..@@...T..T.T...@@@........T.T@@@@.T.T..TT...@@@@@@@@@@@@@@@@@@@@@@@@
@@@@..........TT.@..@@...TT..T.T...@@@.TTT.......@@@@@....T..T....@@@@@@@@@@@@@@@@@@@@@@
@@@..............T.T@.T........@.....@...........T.T@@@......T.....@@@@@@@@@@@@@@@@@@@@@
@@@..........T....T......T.T..@@...T.@T...T.........@@@.........T..@@@@@@@@@@@@@@@@@@@@@
@@@....T.......TTT......T....@@@@@.....T.T......T...T@@@....T..T...@@@@@@@@@@@@@@@@@@@@@
@@@@....T........T...TT.T.T.@@@@@@@...T......TTT......@...T..T....@@@@@@@@@@@@@@@@@@@@@@
@@@@@T....T......T......T..@@@@T.@@......T..T.............T...T.T.@@@@@@@@@@@@@@@@@@@@@@
@@@@@@..T.................@@@@.....T...T....T..T..TTTT....T.T.T.@@@@@@@@@@@@@@@@@@@@@@@@
@@@@@@@..T......T.T...T..@@@@@.........T.T...T.TT..T...T.TTT...@@@@@T.@@@@@@@@@@@@@@@@@@
@@@@@@@@..T.............@@@@@@@..T...TT...T..T.....T.T........@@@@@....@@@@@@@@@@@@@@@@@
@@@@@@@@@....TTT.T..T..@@@@@@@@....T......@@@.T....TTT.T.....@@@@@@....T@@@@@@@@@@@@@@@@
@@@@@@@@@@...TT...T...@@@@@@@@....T...T.T.@@@T......T.T.....@@@@@@@..TT..@@@@@@@@@@@@@@@
@@@@@@@@@@@....T...T.@@@@@@@@@TT...T...T..@@@.......TT.T..T@@@@@@..T..T...@@@@@@@@@@@@@@
@@@@@@@@@@@@.T....@@@@@@@@@@...T.T.....T...TT.T..........@@@@@@@@.@@@@..TTT...@@@@@@@@@@
@@@@@@@@@@@@@.T...@@@@@@@@@@.............T.......T.T...T.@@@@@@@@.@@@@@.T.....@@@@@@@@@@
@@@@@@@@@@@@@@..T@@@@@@@@@@...T.....T..T...T....TT......@@@@@@@@..@@@@@@......@@@@@@@@@@
@@@@@@@@@@@@@@@@@@@@@@@@@.....T..........T........T...@@@@@@@@@...@@@@@@@....T@@@@@@@@@@
@@@@@@@@@@@@@@@@@@@@....T...T....T....T...TT..T......@@@@@@@@@....@@@@@@@.T..T..@@@@@@@@
@@@@@@@@@@@@@@@@@@@..TT..................T.......T...@@@@@@@@@.T..@@@@@@@T......@@@@@@@@
@@@@@@@@@@@@@@@@@@.......T..TT.....T.......T...TT.TT.T@@.....T..T..@@@@@.....T.T.@..@@@@
@@@@@@@@@@@@@@@@@@@T...T...T.T.......T..........T..T.T....TTT.........T....T@@....TT.@@@
@@@@@@@@@@@@@@@@@@@@..T...T...............TT.....@@..........TTT...T...TTT.@@@..T..@@@@@
@@@@@@@@@@@@@@@@@@@@@T..T....T................T.@@@@....TT.......T.TT.T...@@@...T.@@@@@@
@@@@@@@@@@@@@@@@@@@@@@....T......T.....T.T...TT@@@@@....T..TT....T...T.T.@@@.TT..@@@@@@@
@@@@@@@@@@@@@@@@@@@@@@@TT.................T...@@@@@@T...T..T......T.....@@@...TT@@@@@@@@
@@@@@@@@@@@@@@@@@@@@@@@@........T..T...T.TT..@@@@@@@T..T......T..T..T..@@@.T.T.@@@@@@@@@
@@@@@@@@@@@@@@@@@@@@@@@@@..TT........T......@@@@@@@T.T...T........T...@@@T.....@@@@@@@@@
@@@@@@@@@@@@@@@@@@@@@@@@@@.T.T..T...T......@@@@@@@....T.......TT.T...@@@......@@@@@@@@@@
@@@@@@@@@@@@@@@@@@@@@@@@@@@T.T....T.T..TT@@@@@@@.TT.......T...TT..T.@@@..T.T.@@@@@@@@@@@
@@@@@@@@@@@@@@@@@@@@@@@@@@@@..T....T.T...@@@@@@@....T.TT...TT..T....@@@.....@@@@@@@@@@@@
@@@@@@@@@@@@@@@@@@@@@@@@@@@@@....T.T...T@@@@@@@T.T..T......T.T........@@...@@@@@@@@@@@@@
@@@@@@@@@@@@@@@@@@@@@@@@@@@@@@.TT.T....@@@@@@@.......T.............TT.@@@.@@@@@@@@@@@@@@
@@@@@@@@@@@@@@@@@@@@@@@@@@@@@@@..T...@@@@@@@..T.....T.@T......T......T.@@@@@@@@@@@@@@@@@
@@@@@@@@@@@@@@@@@@@@@@@@@@@@@@@@T..T.@@@@@@@.T.......@@...............T@@@@@@@@@@@@@@@@@
@@@@@@@@@@@@@@@@@@@@@@@@@@@@@@@@@...@@@@@@@...T.....T...@..T..T.......@@@@@@@@@@@@@@@@@@
@@@@@@@@@@@@@@@@@@@@@@@@@@@@@@@@@@.@@@@@T..T........T@@@@@@..T.......@@@@@@@@@@@@@@@@@@@
@@@@@@@@@@@@@@@@@@@@@@@@@@@@@@@@@@@@@@@T.TT.........@@@@@@@@.....T..@@@@@@@@@@@@@@@@@@@@
@@@@@@@@@@@@@@@@@@@@@@@@@@@@@@@@@@@@@@..T..T.T.....@@@@@@@@@@......@@@@@@@@@@@@@@@@@@@@@
@@@@@@@@@@@@@@@@@@@@@@@@@@@@@@@@@@@@@..............@@@@@@@@@@@.T..@@@@@@@@@@@@@@@@@@@@@@
@@@@@@@@@@@@@@@@@@@@@@@@@@@@@@@@@@@@@@.....T..T....T.@@@@@@@@@@..@@@@@@@@@@@@@@@@@@@@@@@
@@@@@@@@@@@@@@@@@@@@@@@@@@@@@@@@@@@@@@@.........T...T...T.@@@@@@@@@@@@@@@@@@@@@@@@@@@@@@
@@@@@@@@@@@@@@@@@@@@@@@@@@@@@@@@@@@@@@@@T.....TT....T....T.@@@@@@@@@@@@@@@@@@@@@@@@@@@@@
@@@@@@@@@@@@@@@@@@@@@@@@@@@@@@@@@@@@@@@@@............T...T.T@@@@@@@@@@@@@@@@@@@@@@@@@@@@
@@@@@@@@@@@@@@@@@@@@@@@@@@@@@@@@@@@@@@@@@@..T........T..T....@@@@@@@@@@@@@@@@@@@@@@@@@@@
@@@@@@@@@@@@@@@@@@@@@@@@@@@@@@@@@@@@@@@@@@@............TT...@@@@@@@@@@@@@@@@@@@@@@@@@@@@
@@@@@@@@@@@@@@@@@@@@@@@@@@@@@@@@@@@@@@@@@@@@....T..........@@@@@@@@@@@@@@@@@@@@@@@@@@@@@
@@@@@@@@@@@@@@@@@@@@@@@@@@@@@@@@@@@@@@@@@@@@@..TT.........@@@@@@@@@@@@@@@@@@@@@@@@@@@@@@
@@@@@@@@@@@@@@@@@@@@@@@@@@@@@@@@@@@@@@@@@@@@@@@@@@@@@@@@@@@@@@@@@@@@@@@@@@@@@@@@@@@@@@@@
