type octile
height 64
width 60
map
@@@@@@@@@@@@@@@@@@@@@@@@@@@@@@@@@@@@@@@@@@@@@@@@@@@@@@@@@@@@
@@@@@@@@@@@@@@@@@@@@@@@@@@@@@@@@@@@@@@@@@@@@@@@@@@@@@@@@@@@@
@@@@@@@@@@@@@@@@@@@@@@@@@@@@@@@@@@@@@@@@@@@@@@@@@@@@@@@@@@@@
@@@@@@@@@@@@@@@@@@@@@@@@@@@@@@@@@@@@@@@@@@@@@@@@@@@@@@@@@@@@
@@@@@@@@@@@@@@@@@@@@@@@@@@@@@@@@@@@@@@@@@@@@@@@@@@@@@@@@@@@@
@@@@@@@@@@@@@@@@@@@@@@@@@@@@@@@@@@@@@@@@@@@@@@@@@@@@@@@@@@@@
@@@@@@@@@@@@@@@@@@@@@@@@@@@@@@@@@@@@@@@@@@@@@@@@@@@@@@@@@@@@
@@@@@@@@@@@@@@@@@@@@@@@@@@@@@@@@@@@@@@@@@@@@@@@@@@@@@@@@@@@@
@@@@@@@@@@@@@@@@@@@@@@@@@@@@@@@@@@@@@@@@@@@@@@@@@@@@@@@@@@@@
@@@@@@@@@@@@@@@@@@@@@@@@@@@@@@@@@@@@@@@@@@@@@@@@@@@@@@@@@@@@
@@@@@@@@@@@@@@@@@@@@@@@@@@@@@@@@@@@@@@@@@@@@@@@@@@@@@@@@@@@@
@@@@@@@@@@@@@@@@@@@@@@@@@@@@@@@@@@@@@@@@@@@@@@@@@@@@@@@@@@@@
@@@@@@@@@@@@@@@@@@@@@@@@@@@@@@@@@@@@@@@@@@@@@@@@@@@@@@@@@@@@
@@@@@@@@@@@@@@@@@@@@@@@@@@@@@@@@@@@@@@@@@@@@@@@@@@@@@@@@@@@@
@@@@@@@@@@@@@@@@@@@@@@@@@@@@@@@@@@@@@@@@@@@@@@@@@@@@@@@@@@@@
@@@@@@@@@@@@@@@@@@@@@@@@@@@@@@@@@@@@@@@@@@@@@@@@@@@@@@@@@@@@
@@@@@@@@@@@@@@@@@@@@@@@@@@@@@@@@@@@@..@@@@@@@@@@@@@@@@@@@@@@
@@@@@@@@@@@@@@@@@@@@@@@@@@@@@@@@@@@@.T....@@@@@@@@@@@@@@@@@@
@@@@@@@@@@@@@@@@@@@@@@@@@@@@@@@@@@@....TT.@@@@@@@@@@@@@@@@@@
@@@@@@@@@@@@@@@@@@@@@@@@@@@@@@@@@@.T.TTTTT.@@@@@@@@@@@@@@@@@
@@@@@@@@@@@@@@@@@@@@@@@@@@@@@@@@@T...T.TT.T.T@@@@@@@@@@@@@@@
@@@@@@@@@@@@@@@@@@@@@@@@@@@@@@@@.....T....T...@@@@@@@@@@@@@@
@@@@@@@@@@@@@@@@@@@@@@@@@@@@@@@@@T@@.TTT..TT.T.@@@@@@@@@@@@@
@@@@@@@@@@@@@@@@@@@@@@@@@@@@@@@@@.@@..T.TT..T..T@@@@@@@@@@@@
@@@@@@@@@@@@@@@@@@@@@@@@@@@@@@@@T..TT...T@@.TTT.@@@@@@@@@@@@
@@@@@@@@@@@@@@@@@@@@@@@@@@@T@@T.T.T....T.@@TT...T@@@..@@@@@@
@@@@@@@@@@@@@@@@@@@@@@@@@@.T...T.....T.T.@..T..T..@@.T.@@@@@
@@@@@@@@@@@@@@@@@@@@@@@@@@.T...T....TT.T.....T.TTTT.T..@@@@@
@@@@@@@@@@@@@@@@@@@@@@@@@T..TT.TT.TTT.T.T.TTT..TTT......@@@@
@@@@@@@@@@@@@@@@@@@@@@@@....T.......T.TT...TTT.TT.TTT..T@@@@
@@@@@@@@@@@@@@@@@@@@@TT......@..T.T..T.T..T.TT...T.....@@@@@
@@@@@@@@@@@@@@@@@@@@@@@...T.@@@...T..TT.T.T.T....TTTT.@@@@@@
@@@@@@@@@@@@@@@@@@@@@@@@...@@@@@TT....T.............T@@@@@@@
@@@@@@@@@@@@@@@@@@@@@@@@..@@@@@@@..TTT.TT.T.TT..T.T.@@@@@@@@
@@@@@@@@@@@@@@@@@@@@@@@...@@@@@@@@T.T.......T.TTT..@@@@@@@@@
@@@@@@@@@@@@@@@@@@@@@.TTT..@@@@@@@@TTT.T..T..T.TT.@@@@@@@@@@
@@@@@@@@@@@@@@@@@@@@TTT..T..@@@@@@@..T....TTT....@@@@@@@@@@@
@@@@@@@@@@@@@@@@@@@...TT.T...@@@@@T..T.TTT.T..T.@@@@@@@@@@@@
@@@@@@@@@@@@@@@@@@..TT.T...TTT@@@TTTT.T..T.T...@@@@@@@@@@@@@
@@@@@@@@@@@@@@@@@...T..T.......T..T..T........@@@@@@@@@@@@@@
@@@@@@@@@@@@@@@@...TT....T.TTT.T..TT.TTT.TTT.@@@@@@@@@@@@@@@
@@@@@@@@@@@@@@@..@@@...T.....TT....T...T.T..@@@@@@@@@@@@@@@@
@@@@@@T@@@@@@@@.@@@@@..TTT...T.TTT..TTTTT..@@@@@@@@@@@@@@@@@
@@@@@T..@@@@@@..@@@@@@T......TT.T...T..TT.@@@@@@@@@@@@@@@@@@
@@@@......@@@TT.T@@@@@@..TTT.TT.....T...T@@@@@@@@@@@@@@@@@@@
@@@TT....TT@TTT.T.@@@@@..TT........T.T.T@@@@@@@@@@@@@@@@@@@@
@@T...TTT...T.TT.TT@@@...T....TTT..T..T@@@@@@@@@@@@@@@@@@@@@
@@T..TTTT.T.T..TT...T...T..TT.TTTTTT.T@@@@@@@@@@@@@@@@@@@@@@
@@@..TT......TTTT...TT..........T.TT.@@@@@@@@@@@@@@@@@@@@@@@
@@@@T..TT.TTTT..T....T.T.........TT.@@@@@@@@@@@@@@@@@@@@@@@@
@@@@@...TTTT.TT...TT..T...T....TT.T@@@@@@@@@@@@@@@@@@@@@@@@@
@@@@@@T..TT.T...T..T...TT..TT.....@@@@@@@@@@@@@@@@@@@@@@@@@@
@@@@@@@..T....T...T....TTTTT...TT@@@@@@@@@@@@@@@@@@@@@@@@@@@
@@@@@@@@.T......T.T.T.T.TT.T..T.@@@@@@@@@@@@@@@@@@@@@@@@@@@@
@@@@@@@@@.........T..T.T.TTT..T@@@@@@@@@@@@@@@@@@@@@@@@@@@@@
@@@@@@@@@@T....T.T..TT..T..TT.@@@@@@@@@@@@@@@@@@@@@@@@@@@@@@
@@@@@@@@@@@........T.TT....T@@@@@@@@@@@@@@@@@@@@@@@@@@@@@@@@
@@@@@@@@@@@@...TT.T..T..T..@@@@@@@@@@@@@@@@@@@@@@@@@@@@@@@@@
@@@@@@@@@@@@@TT.T..T.T....@@@@@@@@@@@@@@@@@@@@@@@@@@@@@@@@@@
@@@@@@@@@@@@@@T.T.T..T.T.@@@@@@@@@@@@@@@@@@@@@@@@@@@@@@@@@@@
@@@@@@@@@@@@@@@TT..TT..T@@@@@@@@@@@@@@@@@@@@@@@@@@@@@@@@@@@@
@@@@@@@@@@@@@@@@...T...@@@@@@@@@@@@@@@@@@@@@@@@@@@@@@@@@@@@@
@@@@@@@@@@@@@@@@@@@@@@@@@@@@@@@@@@@@@@@@@@@@@@@@@@@@@@@@@@@@
@@@@@@@@@@@@@@@@@@@@@@@@@@@@@@@@@@@@@@@@@@@@@@@@@@@@@@@@@@@@
