type octile
height 54
width 60
map
@@@@@@@@@@@@@@@@@@@@@@@@@@@@@@@@@@@@@@@@@@@@@@@@@@@@@@@@@@@@
@@@@@@@@@@@@@@@@@@@@@@@@@@@@@@@@@@@@@@@@@@@@@@@@@@@@@@@@@@@@
@@@@@@@@@@@@@@@@@@@@@@@@@@@@@@@@@@@@@@@@@@@@@@@@@@@@@@@@@@@@
@@@@@@@@@@@@@@@@@@@@@@@@@@@@@@@@@@@@@@@@@@@@@@@@@@@@@@@@@@@@
@@@@@@@@@@@@@@@@@@@@@@@@@@@@@@@@@@@@@@@@@@@@@@@@@@@@@@@@@@@@
@@@@@@@@@@@@@@@@@@@@@@@@@@@@@@@@@@@@@@@@@@@@@@@@@@@@@@@@@@@@
@@@@@@@@@@@@@@@@@@@@@@@@@@@@@@@@@@@@@@@@@@@@@@@@@@@@@@@@@@@@
@@@@@@@@@@@@@@@@@@@@@@@@@@@@@@@@@@@@@@@@@@@@@@@@@@@@@@@@@@@@
@@@@@@@@@@@@@@@@@@@@@@@@@@@@@@@@@@@@@@@@@@@@@@@@@@@@@@@@@@@@
@@@@@@@@@@@@@@@@@@@@@@.T..T..T......T..@@@@@@@@@@@@@@@@@@@@@
@@@@@@@@@@@@@@@@@@@.T......TT...T.T......T@@@@@@@@@@@@@@@@@@
@@@@@@@@@@@@@@@@@....T....TTT..TT......T.T..@@@@@@@@@@@@@@@@
@@@@@@@@@@@@@@@.T.T.T.T..T.T.TT.T....T........@@@@@@@@@@@@@@
@@@@@@@@@@@@@TT..TTT..T........T.T.T..T....T.T.@@@@@@@@@@@@@
@@@@@@@@@@@@...T.TTT.TT.T.TT.T..T..TTTTT....TTTT@@@@@@@@@@@@
@@@@@@@@@@@TT....TTTT.T.TT@@@@.T..TTT..T.T..TTT..@@@@@@@@@@@
@@@@@@@@@@TT...T@@.T.T.TTT@@@@@@@..T.TT.....TTT.T.@@@@@@@@@@
@@@@@@@@@T..TTT@@@....@T.T...@@@@...T...TT.....TTT.@@@@@@@@@
@@@@@@@@TT...T@@@.TT.T@T..T.T.T.T.TT.T.TTTTT...TTT..@@@@@@@@
@@@@@@@T.T...@@@......T..TT.T..TTT@@....T@.TTT..T....@@@@@@@
@@@@@@T..T..@@@......T.T...TTTT.T@@@@.T.T@..T..T..TT.@@@@@@@
@@@@@@TT....T@TTT.TTTT......TT..T..@@@@.TTTT....TT....@@@@@@
@@@@@...T.TTT..........TT...T.TT..T.@@@@.TT...T..@.T..@@@@@@
@@@@@..T..T....TT.........T.T.T.T.T..@...TT.....@@@T..T@@@@@
@@@@T.T..T..TT..T.T...T....T...T..T.TTTTT@T.T..TT@@@T..T@@@@
@@@@T...TTTTT...T.T.TT.T..@@.T.TT.T...TT@@@@@.T...@@@.@T@@@@
@@@@TTT.TT.TTTT.T.TT.T..T@@@@@@T.T...T.@@@@@@@.TT.T@@@@.@@@@
@@@@T......T.....T.T.T.T.T@@@@@@T.TTT....T.@@TTTTT.@@@@@@@@@
@@@@T....TT..T.T.........TT.@@..T..TT..TT.....TT..T.@@@@@@@@
@@@@...TT..@@...T.T.T.T.....T.T.......T...T....T.T..@@@@@@@@
@@@@T.TTTTTT@.T.TTT...T...T.T........T.....TTT...T.TT@@@@@@@
@@@@..T.T...T.TT..T.T.@@@.TTT.......T..T.T....T.......@@@@@@
@@@@T@@T......TT@@.T.@@@@@.T.TT@TT.T.T....T...T..T....TT@@@@
@@@@@@@@..TTT.T@@@@TT..@@@@@..@@.....T.T..T......T.T...T@@@@
@@@@@@@@@.TT...@@@@T...TT@@@..TTTT.T.T.....T.T.T@.T.T.T.@@@@
@@@@.@@@..TTT.@@@@@TTT....@T...T.TTT.....T....TT@@T...T.@@@@
@@@@T.@@.T..T...@T@@.T....T..TT...T.T.TT......T.T.......@@@@
@@@@..TTT...T..TTT..T......T..T.TTT...@@.TTT.T.TT.T..T..@@@@
@@@@......T.TTTT..T.T..TT.TT...T.T..T@@@T.TTT.T.T@@..TT.@@@@
@@@@T.T.TTTTT.T..TTT....T.T.TTT.TTT.T@@@@T.T...T@@@@TTT.@@@@
@@@@@T......T..T..TT.T..TT.T..T.TT..@@@@T..TT...@@@@.T..@@@@
@@@@@.T...T.T.TT.TTT...TTT..T..T....T.T@..TT.TT@@@@@T.T.@@@@
@@@@@@TTT.T@@.TTTT.TTT..TT.TT.TT....T..TT.TTT...T@@@@...@@@@
@@@@@@T...@@@@...T...TTTTTT....TT.T.T..T......T.TTT.....@@@@
@@@@@@@..@@@@@@.T......T..T..T...T.T.T.TT.T.T.TTT.TTT.T@@@@@
@@@@@@@.T.T@@@@......T...TTTT..T.T..T.TTT...T..T.T..T.@@@@@@
@@@@@@@@....@@....TTT..T..TT.TT.T.T.T....T..@@@@TT.T.T@@@@@@
@@@@@@@@T.T.........TT.....T.T..T.....T.TTT.@@@@.....@@@@@@@
@@@@@@@@@TT.T...TT@TT...TT..TT.TTTTT....T.T@@@@@....@@@@@@@@
@@@@@@@@@.TTT.T...@@T.T...T..T..T@@....TTT.TT.T.T..@@@@@@@@@
@@@@@@@@@@..T.T.TT...T.T...TT...@@@@T....T.T.T.T..@@@@@@@@@@
@@@@@@@@@@@@..T.T...TTT..TT.T.TT@@@@TT..@@...T.T.@@@@@@@@@@@
@@@@@@@@@@@@@@...T.TTTT.....TT..@@@@@.TTT.T..T.@@@@@@@@@@@@@
@@@@@@@@@@@@@@@@@@@@@@@@@@@@@@@@@@@@@@@@@@@@@@@@@@@@@@@@@@@@
