type octile
height 54
width 52
map
@@@@@@@@@@@@@@@@@@@@@@@@@@@@@@@@@@@@@@@@@@@@@@@@@@@@
@@@@@@@@@@@@@@@@@@@@@@@@@@@@@@@@@@@@@@@@@@@@@@@@@@@@
@@@@@@@@@@@@@@@@@@@@@@@@@@@@@@@@@@@@@@@@@@@@@@@@@@@@
@@@@@@@@@@@@@@@@@@@@@@@@@@@@@@@@@@@@@@@@@@@@@@@@@@@@
@@@@@@@@@@@@@@@@@@@@@@@@@@@@@@@@@@@@@@@@@@@@@@@@@@@@
@@@@@@@@@@@@@@@@@@@@@@@@@@@@@@@@@@@@@@@@@@@@@@@@@@@@
@@@@@@@@@@@@@@@@@@@@@@@@@@@@@@@@@@@@@@@@@@@@@@@@@@@@
@@@@@@@@@@@@@@@@@@@@@@@@@@@@@@@@@@@@@@@@@@@@@@@@@@@@
@@@@@@@@@@@@@@@@@@@@@@@@@@@@@@@@@@@@@@@@@@@@@@@@@@@@
@@@@@@@@@@@@@@@@@@@@@@@@@@@@@@@@@@@@@@@@@@@@@@@@@@@@
@@@@@@@@@@@@@@@@@@@@@@@@@@@@@@@@@@@@@@@@@@@@@@@@@@@@
@@@@@@@@@@@@@@@@@@@@@@@@@@@@@@@.@@@@@@@@@@@@@@@@@@@@
@@@@@@@@@@@@@@@@@@@@@@@@@@@@@@T..@@@@@@@@@@@@@@@@@@@
@@@@@@@@@@@@@@@@@@@@@@@@@@@@@T.T..@@@@@@@@@@@@@@@@@@
@@@@@@@@@@@@@@@@@@@@@@@@@@@@@TTTT.T@@@@@@@@@@@@@@@@@
@@@@@@@@@@@@@@@@@@@@@@@@@@@@.T..T.@@@@@@@@@@@@@@@@@@
@@@@@@@@@@@@@@@@@@@@@@@@@@@T.TTT..T@@@@@@@@@@@@@@@@@
@@@@@@@@@@@@@@@@@@@@@@@@@........T.T@@@@@@@@@@@@@@@@
@@@@@@@@@@@@@@@@@@@@@@@@.T..T...T....@@.@@@@@@@@@@@@
@@@@@@@@@@@@@@@@@@@@@@@...TT.T.T.TTTT....@@@@@@@@@@@
@@@@@@@@@@@@@@@@@@@@@@...TT.....@@T.TTT.T@@@@@@@@@@@
@@@@@@@@@@@@@@@@@@@@@....TTT..@@@@T...T.@@@@@@@@@@@@
@@@@@@@@@@@@@@@@@@@@@@T.T.TT@@@@@@.TTTT@@@@@@@@@@@@@
@@@@@@@@@@@@@@@@@@@@@@..T..T@@@@@@.TT.T@@@@@@@@@@@@@
@@@@@@@@@@@@@@@@@@@@@T.T...T.@@@@@@T.T..@@@@@@@@@@@@
@@@@@@@@@@@@@@@@@@@@...TTTT.T.@@@@@.TTTT.@@@@@@@@@@@
@@@@@@@@@@@@@@@@@@@.T...T......TT@@..TT...@@@@@@@@@@
@@@@@@@@@@@@@@@@@@...T.T.T........T.T....T.@@@@@@@@@
@@@@@@@@@@@@@.@@.T...T.T.TT..TT.TT......TT..@@@@@@@@
@@@@@@@@@...T..T......TT..T.T.....TT..T....@@@@@@@@@
@@@@@@@@@@...T..T.@.TTTT..TT..T..TT.TTT.TT@@@@@@@@@@
@@@@@@@@@@@@T.TT.@@@..T..TTTT..T.T.T...T.@@@@@@@@@@@
@@@@@@@@@@@@@@.T@@@@@...T.T.TTTTT...T..T@@@@@@@@@@@@
@@@@@@@@@@@@@@@@@@@@@@...T....TT...T.TT@@@@@@@@@@@@@
@@@@@@@@@@@@@@@@@@@@@@@....T.TTTT..T..@@@@@@@@@@@@@@
@@@@@@@@@@@@@@@@@@@@@@@@.T..TT..TTTTT@@@@@@@@@@@@@@@
@@@@@@@@@@@@@@@@@@@@@@@@@.T.TT..T...@@@@@@@@@@@@@@@@
@@@@@@@@@@.@@@@@@@@@@@@@@@..T.TT...@@@@@@@@@@@@@@@@@
@@@@@@@@@T..@@@@@@@@@@@@@@.TTT...T@@@@@@@@@@@@@@@@@@
@@@@@@@@@T.T.@@@@@@@@@@@@TT.TTT..@@@@@@@@@@@@@@@@@@@
@@@@@@@@@@TTT.@@@@@@@@@@TTT...T.@@@@@@@@@@@@@@@@@@@@
@@@@@@@@@@@.T..@@@@@@@@.T....T.@@@@@@@@@@@@@@@@@@@@@
@@@@@@@@@@@@TT.T@@@@@@T.TT....@@@@@@@@@@@@@@@@@@@@@@
@@@@@@@@@@@@@...T@@@@..T..TTT@@@@@@@@@@@@@@@@@@@@@@@
@@@@@@@@@@@@@@....@@T.TT...T@@@@@@@@@@@@@@@@@@@@@@@@
@@@@@@@@@@@@@@@TT..T.TT...T@@@@@@@@@@@@@@@@@@@@@@@@@
@@@@@@@@@@@@@@@@TTTTT.....@@@@@@@@@@@@@@@@@@@@@@@@@@
@@@@@@@@@@@@@@@@@.T.T....@@@@@@@@@@@@@@@@@@@@@@@@@@@
@@@@@@@@@@@@@@@@@@T....T@@@@@@@@@@@@@@@@@@@@@@@@@@@@
@@@@@@@@@@@@@@@@@@@....@@@@@@@@@@@@@@@@@@@@@@@@@@@@@
@@@@@@@@@@@@@@@@@@@@@@@@@@@@@@@@@@@@@@@@@@@@@@@@@@@@
@@@@@@@@@@@@@@@@@@@@@@@@@@@@@@@@@@@@@@@@@@@@@@@@@@@@
@@@@@@@@@@@@@@@@@@@@@@@@@@@@@@@@@@@@@@@@@@@@@@@@@@@@
@@@@@@@@@@@@@@@@@@@@@@@@@@@@@@@@@@@@@@@@@@@@@@@@@@@@
