type octile
height 54
width 52
map
@@@@@@@@@@@@@@@@@@@@@@@@@@@@@@@@@@@@@@@@@@@@@@@@@@@@
@@@@@@@@@@@@@@@@@@@@@@@@@@@@@@@@@@@@@@@@@@@@@@@@@@@@
@@@@@@@@@@@@@@@@@@@@@@@@@@@@@@@@@@@@@@@@@@@@@@@@@@@@
@@@@@@@@@@@@@@@@@@@@@@@@@@@@@@@@@@@@@@@@@@@@@@@@@@@@
@@@@@@@@@@@@@@@@@@@@@@@@@@@@@@@@@@@@@@@@@@@@@@@@@@@@
@@@@@@@@@@@@@@@@@@@@@@@@@@@@@@@@@@@@@@@@@@@@@@@@@@@@
@@@@@@@@@@@@@@@@@@@@@@@@@@@@@@@@@@@@@@@@@@@@@@@@@@@@
@@@@@@@@@@@@@@@@@@@@@@@@@@@@@@@@@@@@@@@@@@@@@@@@@@@@
@@@@@@@@@@@@@@@@@@@@@@@@@@@@@@@@@@@@@@@@@@@@@@@@@@@@
@@@@@@@@@@@@@@@@@@@@@@@@@@@@@@@@@@@@@@@@@@@@@@@@@@@@
@@@@@@@@@@@@@@@@@@@@@@@@@@@@@@@@@@@@@@@@@@@@@@@@@@@@
@@@@@@@@@@@@@@@@@@@@@@@@@@@@@@@@@@@@@@@@@@@@@@@@@@@@
@@@@@@@@@@@@@@@@@@@@@@@@@@@@@@@@@@@@@@@@@@@@@@@@@@@@
@@@@@@@@@@@@@@@@@@@@@@@@@@@@@T@@@@@@@@@@@@@@@@@@@@@@
@@@@@@@@@@@@@@@@@@@@@@@@@@@@T.TT@@@@@@@@@@@@@@@@@@@@
@@@@@@@@@@@@@@@@@@@@@@@@@@@@@..T..@@@@@@@@@@@@@@@@@@
@@@@@@@@@@@@@@@@@@@@@@@@@@@@@@....@@@@@@@@@@@@@@@@@@
@@@@@@@@@@@@@@@@@@@@@@@@@@@@@.TTT.TT.@@@@@@@@@@@@@@@
@@@@@@@@@@@@@@@@@@@@@@@@@@..TTTT.T...@@@@@@@@@@@@@@@
@@@@@@@@@@@@@@@@@@@@@@@@@@T...T...T...T@@@@@@@@@@@@@
@@@@@@@@@@@@@@@@@@@@@@@@@@...T.T..T...TT@@@@@@@@@@@@
@@@@@@@@@@@@@@@@@@@@@@@@.T....T.T...T...T.@@@@@@@@@@
@@@@@@@@@@@@@@@@@@@@@@@TTTTTT.TT.T.T.TT..T.@@@@@@@@@
@@@@@@@@@@@@@@@@@@@@@@.....T.T.T.T.TTT.T.TT.@@@@@@@@
@@@@@@@@@@@@@@@@@.@@@@...TTTT...T.....T.....T@@@@@@@
@@@@@@@@@@@@@@@@T.T@@@..@@@@.TT.....TT..TTT.T.@@@@@@
@@@@@@@@@@@@@@@TTT...TT.@@@@@T.TT.T..T.T....TT@@@@@@
@@@@@@@@@@@@@@..T.TT...@@@@@@@T.T..TT.T.T.T.T.@@@@@@
@@@@@@@@@@@@@TT....TTT@@@@@@@@@.T........T..T@@@@@@@
@@@@@@@@@@@@@...TT...@@@@@@@@@@...TT.T...T..@@@@@@@@
@@@@@@@@@@@@@@T.TTT.T@@@@@@@@@T...T.TT..T..@@@@@@@@@
@@@@@@@@@@@@@@@..T...@@@@@@@@..TTTT..T.TTT@@@@@@@@@@
@@@@@@@@@@@@@@.T.TTT.@@@@@@@@T.T.T..T.T.T@@@@@@@@@@@
@@@@@@@@@@@@@.T.T.T.T@@@@@@T.T.TT.T..T..@@@@@@@@@@@@
@@@@@@@@@@@@...T....TTT....T..T.T..T.T.@@@@@@@@@@@@@
@@@@@@@@@@@..T.T..TTTTTTT.T..T...T.T..@@@@@@@@@@@@@@
@@@@@@T@@@.T.T.TT..T.TTTTT....TT..T..@@@@@@@@@@@@@@@
@@@@@@T.@T.TTT..T.TT...TT.T....TTT..@@@@@@@@@@@@@@@@
@@@@@@.T..T.T.T.T....TT..T.TT.T..T.@@@@@@@@@@@@@@@@@
@@@@@@...T.T..T.TT...TTT..TTT.T...@@@@@@@@@@@@@@@@@@
@@@@@@.T..T...T....T......TT.TT..@@@@@@@@@@@@@@@@@@@
@@@@@@.......T..T.T..T..TT.....T@@@@@@@@@@@@@@@@@@@@
@@@@@@@T.TT.T..T.T.T..TT..T...T@@@@@@@@@@@@@@@@@@@@@
@@@@@@@@...T...TTTTT....T...TT@@@@@@@@@@@@@@@@@@@@@@
@@@@@@@@@..T.TTT.T....T...TT.@@@@@@@@@@@@@@@@@@@@@@@
@@@@@@@@@@T.TT.TTT..T.......@@@@@@@@@@@@@@@@@@@@@@@@
@@@@@@@@@@@.TT..T.T.T.T.TT.@@@@@@@@@@@@@@@@@@@@@@@@@
@@@@@@@@@@@@..T.T...TTTT..@@@@@@@@@@@@@@@@@@@@@@@@@@
@@@@@@@@@@@@@T....T..T..T@@@@@@@@@@@@@@@@@@@@@@@@@@@
@@@@@@@@@@@@@@.T.T...T..@@@@@@@@@@@@@@@@@@@@@@@@@@@@
@@@@@@@@@@@@@@@.T.TT..T@@@@@@@@@@@@@@@@@@@@@@@@@@@@@
@@@@@@@@@@@@@@@@......@@@@@@@@@@@@@@@@@@@@@@@@@@@@@@
@@@@@@@@@@@@@@@@@T..T@@@@@@@@@@@@@@@@@@@@@@@@@@@@@@@
@@@@@@@@@@@@@@@@@@@@@@@@@@@@@@@@@@@@@@@@@@@@@@@@@@@@
