type octile
height 75
width 76
map
@@@@@@@@@@@@@@@@@@@@@@@@@@@@@@@@@@@@@@@@@@@@@@@@@@@@@@@@@@@@@@@@@@@@@@@@@@@@
@@@@@@@@@@@@@@@@@@@@@@@@@@@@@@@@@@@@@@@@@@@@@@@@@@@@@@@@@@@@@@@@@@@@@@@@@@@@
@@@@@@@@@@@@@@@@@@@@@@@@@@@@@@@@@@@@@@@@@@@@@@@@@@@@@@@@@@@@@@@@@@@@@@@@@@@@
@@@@@@@@@@@@@@@@@@@@@@@@@@@@@@@@@@@@@@@@@@@@@@@@@@@@@@@@@@@@@@@@@@@@@@@@@@@@
@@@@@@@@@@@@@@@@@@@@@@@@@@@@@@@@@@@@@@@@@@@@@@@@@@@@@@@@@@@@@@@@@@@@@@@@@@@@
@@@@@@@@@@@@@@@@@@@@@@@@@@@@@@@@@@@@@@@@@@@@@@@@@@@@@@@@@@@@@@@@@@@@@@@@@@@@
@@@@@@@@@@@@@@@@@@@@@@@@@@@@@@@@@@@@@@@@@@@@@@@@@@@@@@@@@@@@@@@@@@@@@@@@@@@@
@@@@@@@@@@@@@@@..@@@@@@@@@@@@@@@@@@@@@@@@@@@@@@@@@@@@@@@@@@@@@@@@@@@@@@@@@@@
@@@@@@@@@@@@@..TTT..@@@@@@@@@@@@@@@@@@@@@@@@@@@@@@@@@@@@@@@@@@@@@@@@@@@@@@@@
@@@@@@@@@@@..TT...TT.TT@@@@@@@@@@@@@@@@@@@@@@@@@@@@@@@@@@@@@@@@@@@@@@@@@@@@@
@@@@@@@@@@...T.TT.T.....@@@@@@@@@@@@@@@@@@@@@@@@@@@@@@@@@@@@@@@@@@@@@@@@@@@@
@@@@@@@@@.....T....T.TT..@@@@@@@@@@@@@@@@@@@@@@@@@@@@@@@@@@@@@@@@@@@@@@@@@@@
@@@@@@@@..TTTT..T....T.TT@@@@@@@@@@@@@@@@@@@@@@@@@@@@@@@@@@@@@@@@@@@@@@@@@@@
@@@@@@@......T..T.TT.TTT.@@@@@@@@@@@@@@@@@@@@@@@@@@@@@@@@@@@@@@@@@@@@@@@@@@@
@@@@@@@.T.TTTTT...T......@@@@@@@@@@@@@@@@@@@@@@@@@@@@@@@@@@@@@@@@@@@@@@@@@@@
@@@@@@@T.TTT.TT.........T@@@@@@@@@@@@@@@@@@@@@@@@@@@@@@@@@@@@@@@@@@@@@@@@@@@
@@@@@@@...TT..T@@.T.TT.T..@@@@@@@@@@@@@@@@@@@@@@@@@@@@@@@@@@@@@@@@@@@@@@@@@@
@@@@@@TTT..TT.@@@@..T.....@@@@@@@@@@@@@@@@@@@@@@@@@@@@@@@@@@@@@@@@@@@@@@@@@@
@@@@@@.TTT.....@@.T..T..TT@@@@@@@@@@@@@@@@@@@@@@@@@@@@@@@@@@@@@@@@@@@@@@@@@@
@@@@@@.....T.TT.....TTT..@@@@@@@@@@@@@@@@@@@@@@@@@@@@@@@@@@@@@@@@@@@@@@@@@@@
@@@@@@@.TT.T..TTT.TT.TT..@@@@@@@@@@@@@@@@@@@@@@@@@@@@@@@@@@@@@@@@@@@@@@@@@@@
@@@@@@@@..TT.....TT..T..T.@@@@@@@@@@@@@@@@@@@@@@@@@@@@@@@@@@@@@@@@@@@@@@@@@@
@@@@@@@@@@.T....T..TTT.T..@@@@@@@@@@@TT@@@@@@@@@@@@@@@@@@@@@@@@@@@@@@@@@@@@@
@@@@@@@@@@@.T.T...T@@TT.T..@@@@@@@@@.T.T@@@@@@@@@@@@@@@@@@@@@@@@@@@@@@@@@@@@
@@@@@@@@@@@@@@@@@@@@@@.T..T@@@@@@@@..TT..@@@@@@@@@@@@@@@@@@@@@@@@@@@@@@@@@@@
@@@@@@@@@@@@@@@@@@@@@@T....T@@@@@@@TT...T.@@@@@@@@@@@@@@@@@@@@@@@@@@@@@@@@@@
@@@@@@@@@@@@@@@@@@@@@@T...TT@@@@@.T.TTTT..T.@@@@@@@@@@@@@@@@@@@@@@@@@@@@@@@@
@@@@@@@@@@@@@@@@@@@@@@@....T.@@@@..T.T..T...@@@@@@@@@@@@@@@@@@@@@@@@@@@@@@@@
@@@@@@@@@@@@@@@@@@@@@@@.TTT.T@@@@T....T.TTT.@@@@@@@@@@@@@@@@@@@@@@@@@@@@@@@@
@@@@@@@@@@@@@@@@@@@@@@@@......@@@T......T.TT@@T.@@@@@@@@@@@@@@@@@@@@@@@@@@@@
@@@@@@@@@@@@@@@@@@@@@@@@..T.T.@@@@T...T.T..@@.TT.@@@@@@@@@@@@@@@@@@@@@@@@@@@
@@@@@@@@@@@@@@@@@@@@@@@@@TT.TTT@@@..T.T...T@.TT.T.@@@@@@@@@@@@@@@@@@@@@@@@@@
@@@@@@@@@@@@@@@@@@@@@@@@@T.T.T.@@T.T.T.....T.TT.T.@@@@@@@@@@@@@@@@@@@@@@@@@@
@@@@@@@@@@@@@@@@@@@@@@@@@@..T.T@@.TTT..T.TT..T....T@@@@@@@@@@@@@@@@@@@@@@@@@
@@@@@@@@@@@@@@@@@@@@@@@@@@....T.@.T....TTT.TT.....TT@@@@@@@@@@@@@@@@@@@@@@@@
@@@@@@@@@@@@@@@@@@@@@@@@@@@T..TT@TT.T.T.T.T..T.T.T...@@@@@@@@@@@@@@@@@@@@@@@
@@@@@@@@@@@@@@@@@@@@@@@@..@.TTT..T...T.....TT..T.T.T.@@@@@@@@@@@@@@@@@@@@@@@
@@@@@@@@@@@@@@@@@@@@@@@@..@@.T..T.TT..T..T.......TT.@@@.@@@@@@@@@@@@@@@@@@@@
@@@@@@@@@@@@@@@@@@@@@@@@T..@.........T...TT...T..TT.@@..T@@@@@@@@@@@@@@@@@@@
@@@@@@@@@@@@@@@@@@@@@T@@T..@.TTT......T.T...T.TT....@..T..@@@@@@@@@@@@@@@@@@
@@@@@@@@@@@@@@@@@@@@..@@T..TT.......T..T....T.T....TT.T....@@@@@@@@@@@@@@@@@
@@@@@@@@@@@@@@@@@@T....T.....T..T.T.T.T.T.T.TT.....T.T.....T@@@@@@@@@@@@@@@@
@@@@@@@@@@@@@@@@@.T.....T....T...TT.T...T....TT..TTTTTT.TTTT..@@@@@@@@@@@@@@
@@@@@@@@@@@@@@@@@T........T..T.TT..TT..T.T..T....T.....TTT....@@@@@@@@@@@@@@
@@@@@@@@@@@@@@@@@TTTT.TT...T.TTT....T....T..TT.TT.T..T....T..@@@@@@@@@@@@@@@
@@@@@@@@@@@@@@@@@TT.....T..T..TTT.....TTT......TT.TTTTT.T..T@@@.@@@@@@@@@@@@
@@@@@@@@@@@@@@@@@.TT.....T..T.TTTTT..TTT..TTT.TT.T...TTTTTT.@@.TT....T@@..@@
@@@@@@@@@@@@@@@@@...T...T.T.T..T....T..TT..TT.T.T.....TTTTT.@@T..T..T.TT..@@
@@@@@@@@@@@@@@@@@.....T.TT..T.T....TT.TT...TT.T.TTT............T.T..TTT...@@
@@@@@@@@@@@@@@@@@....T...T.T.TT.T......TTTTT..T..T.T...TT....T...TT..T...T@@
@@@@@@@@@@@@@@@@@....TT..TTT.T.TT.TTTT.TT..T.....T...T...T.TT.T.T..TT...TT@@
@@@@@@@@@@@@@@@@@........T.TTTT.TT.....T..TT..T..TTTTT..T.T.....TT.T.T....@@
@@@@@@@@@@@@@@@@@...T....TTT.T...T.T.TT.TT......T.......T.TT...T.TT....TTT@@
@@@@@@@@@@@@@@@@@TTT..T..T...T..TTTT...TTTTTT.TTTT..TT.T..TTTT..T.T...TTT@@@
@@@@@@@@@@@@@@@@@TT...T...TT.T....T.....TT.TT..T.....TT...TTT....TTT....@@@@
@@@@@@@@@@@@@@@@@@T.T..TT..T....T.T.TTTTTTT.TT..........T.T..TT....T..T@@@@@
@@@@@@@@@@@@@@@@@@@...T.T.T.....TT.T..TTT..TTT.....T...T.TTT.........T@@@@@@
@@@@@@@@@@@@@@@@@@@@.T..TTT..T..TTT.....T...T.T....T....TTT...T.....T@@@@@@@
@@@@@@@@@@@@@@@@@@@@@...TT...T..T..T..T.T...TTT..TTTTTTT...T...T....@@@@@@@@
@@@@@@@@@@@@@@@@@@@@@@..TTT....TTT.......T.TTTTT........T...T.TT...@@@@@@@@@
@@@@@@@@@@@@@@@@@@@@@@@...T...T..TTT.....T.T...TTT...T...TTT.TT.T.@@@@@@@@@@
@@@@@@@@@@@@@@@@@@@@@@@@.T.TTT...T...TT..T...TT.T.T.T.TTTT.......@@@@@@@@@@@
@@@@@@@@@@@@@@@@@@@@@@@@@.T.T...T..T.T.T.TTT..TTT.T..T..T......T@@@@@@@@@@@@
@@@@@@@@@@@@@@@@@@@@@@@@@@.TT....T....TTT.T.......T...T..T.T...@@@@@@@@@@@@@
@@@@@@@@@@@@@@@@@@@@@@@@@@@TT.T....T......T..TT.TTTTT..TT.TT..@@@@@@@@@@@@@@
@@@@@@@@@@@@@@@@@@@@@@@@@@@@.TT..T.T...TT.........TT.TT.T.T.T@@@@@@@@@@@@@@@
@@@@@@@@@@@@@@@@@@@@@@@@@@@@@...TTT.TT.T...TT..TT.TT...T.T..@@@@@@@@@@@@@@@@
@@@@@@@@@@@@@@@@@@@@@@@@@@@@@@.T.TT.T.T..TTT..T.T.T..TT.T..@@@@@@@@@@@@@@@@@
@@@@@@@@@@@@@@@@@@@@@@@@@@@@@@@.T.T.TTTTT..T..T.T..T......@@@@@@@@@@@@@@@@@@
@@@@@@@@@@@@@@@@@@@@@@@@@@@@@@@@..T.TTT.TT..T..TT.T......@@@@@@@@@@@@@@@@@@@
@@@@@@@@@@@@@@@@@@@@@@@@@@@@@@@@@..T...T...T.TTT.T......@@@@@@@@@@@@@@@@@@@@
@@@@@@@@@@@@@@@@@@@@@@@@@@@@@@@@@@..TTTT....T.T.T....TT@@@@@@@@@@@@@@@@@@@@@
@@@@@@@@@@@@@@@@@@@@@@@@@@@@@@@@@@@T.TTT.TT.T.TTTTT.T.@@@@@@@@@@@@@@@@@@@@@@
@@@@@@@@@@@@@@@@@@@@@@@@@@@@@@@@@@@@@...T..T.T.TT....@@@@@@@@@@@@@@@@@@@@@@@
@@@@@@@@@@@@@@@@@@@@@@@@@@@@@@@@@@@@@@@@@@@@@@@@@@@@@@@@@@@@@@@@@@@@@@@@@@@@
