type octile
height 64
width 64
map
@@@@@@@@@@@@@@@@@@@@@@@@@@@@@@@@@@@@@@@@@@@@@@@@@@@@@@@@@@@@@@@@
@@@@@@@@@@@@@@@@@@@@@@@@@@@@@@@@@@@@@@@@@@@@@@@@@@@@@@@@@@@@@@@@
@@@@@@@@@@@@@@@@@@@@@@@@@@@@@@@@@@@@@@@@@@@@@@@@@@@@@@@@@@@@@@@@
@@@@@@@@@@@@@@@@@@@@@@@@@@@@@@@@@@@@@@@@@@@@@@@@@@@@@@@@@@@@@@@@
@@@@@@@@@@@@@@@@@@@@@@@@@@@@@@@@@@@@@@@@@@@@@@@@@@@@@@@@@@@@@@@@
@@@@@@@@@@@@@@@@@@@@@@@@@@@@@@@@@@@@@@@@@@@@@@@@@@@@@@@@@@@@@@@@
@@@@@@@@@@@@@@@@@@@@@@@@@@@@@@@@@@@@@@@@@@@@@@@@@@@@@@@@@@@@@@@@
@@@@@@@@@@@@@@@@@@@@@@@@@@@@@@@@@@@@@@@@@@@@@@@@@@@@@@@@@@@@@@@@
@@@@@@@@@@@@@@@@@@@@@@@@@@@@@@@@@@@@@@@@@@@@@@@@@@@@@@@@@@@@@@@@
@@@@@@@@@@@@@@@@@@@@@@@@@@@@@@@@@@@@.@@@@@@@@@@@@@@@@@@@@@@@@@@@
@@@@@@@@@@@@@@@@@@@@@@@@@@@@@@@@@@@TT.@@@@@@@@@@@@@@@@@@@@@@@@@@
@@@@@@@@@@@@@@@@@@@@@@@@@@@@@@@@@@TT...@@@@@@@@@@@@@@@@@@@@@@@@@
@@@@@@@@@@@@@@@@@@@@@@@@@@@@@@@@@.....TT@@@@@@@@@@@@@@@@@@@@@@@@
@@@@@@@@@@@@@@@@@@@@@@@@@@@@@@@T........T@@@@@@@@@@@@@@@@@@@@@@@
@@@@@@@@@@@@@@@@@@@@@@@@@@@@@@T.T.@@.....T@@@@@@@@@@@@@@@@@@@@@@
@@@@@@@@@@@@@@@@@@@@@@@@@@@@@.T.T.@@@.@@...@@@@@@@@@@@@@@@@@@@@@
@@@@@@@@@@@@@@@@@@@@@@@@@@@@T..@@@@@@@@@...T@@@@@@@@@@@@@@@@@@@@
@@@@@@@@@@@@@@@@@@@@@@@@@@@...T@@@@@@@@T.TT.T@@@@@@@@@@@@@@@@@@@
@@@@@@@@@@@@@@@@@@@@@@@@@@.TT...@@@@@@@T.T.TTT@@@@@@@@@@@@@@@@@@
@@@@@@@@@@@@@@@@@@@@@@@@@.T.T.@@@@@@@@..T.TTT..@@@@@@@@@@@@@@@@@
@@@@@@@@@@@@@@@@@@@@@@@@.T..T.@@@@@@TTT.TT....T.@@@@@@@@@@@@@@@@
@@@@@@@@@@@@@@@@@@@@@@@@@TTT..@@@@@@TTT....TTT..T@@@@@@@@@@@@@@@
@@@@@@@@@@@@@@@@@@@@@@@@@@TTTTT@T.@@T.T.T.T.T..TTT@@@@@@@@@@@@@@
@@@@@@@@@@@@@@@@@@@@@.@@@@@.T..T.....T.T.T..T.......@@@@@@@@@@@@
@@@@@@@@@@@@@@@@@@@@.T.@@@@@..T...TT.TT..T.TTT.T..TT@@@@@@@@@@@@
@@@@@@@@@@@@@@@@@@@T....T@@@@..T.TT.TTT...T.....T.T@@@@@@@@@@@@@
@@@@@@@@@@@@@@@@@@T.......@@@@.TT..T.......T..T.T.@@@@@@@@@@@@@@
@@@@@@@@@@@@@@@@@.T.@@.T...@@@@.T.T....T.T..TT...@@@@@@@@@@@@@@@
@@@@@@@@@@@@@@@@..T@@@@..T.T@@@@T.T.T.T.T..T...T@@@@@@@@@@@@@@@@
@@@@@@@@@@@@@@@.TT@@@@@@.T.T.@@@@.TT..T..T..T..@@@@@@@@@@.T@@@@@
@@@@@@@@@@@@@@T.T.@@@@@@@.T...@@@@.T..TTTT...T@@@@@@@...T....@@@
@@@@@@@@@@@@....T@@@@@@@@T...T.@@..TT.TTT.T.T..@@@@@..T.....T@@@
@@@@@@@@@@@.TT.@T.@@@@@@@@@T.T..T..TTTT...T.....@@@.....T..T.@@@
@@@@@@@@@@TT..@@..T@@@@@@@@TTTTT.T..@...TTTTTTTTT@......T...@@@@
@@@@@@@@@...T@@@@.T.@@@@@@@.TTT....@@@TT.T.T.T..TTTT.TT.T..@@@@@
@@@@@@@@T..T@@@@@@.T.@@@@@@.TT.TT..@@@@..TTTT...TTT...T.TT@@@@@@
@@@@@@@.T..@@@@@@@@TT.T@@@T.T.TT..T.@@@@..T.T.T..T...T.T.@@@@@@@
@@@@@@.....@@@@@@@@@TT....T...T......@@@@.TTT..T.TT.T.T.@@@@@@@@
@@@@@T.T..T.@@@@@@@@@...T.T.T..TT.T..T@@@@TTT....TTTT..@@@@@@@@@
@@@@..T...T.T@@@@@@@@....TTT.T@@@@.T.TT@@@@.......TT.T@@@@@@@@@@
@@@T..T.TTT.T.@@@@@@@T....T..@@@@@@.TT..T@@@T........@@@@@@@@@@@
@@@T.TT.T.TTTTT@@@@@@TT.TTTT.@@@@@@@...T..@@@@..T..T@@@@@@@@@@@@
@@@@...TTT..TTTTT.T..T.T...T.@@@@@@@@@TTTT.@@@@....@@@@@@@@@@@@@
@@@@@....T.TT...T..TTT...TT.T@@@@@@@@@@TT...@@@@..@@@@@@@@@@@@@@
@@@@@@.......T.T.....T.T@@@..TT@@@@@@@..TTTTT@@@@@@@@@@@@@@@@@@@
@@@@@@@...T.TT......TT.@@@@@..TT@@@@@.T......T@@@@@@@@@@@@@@@@@@
@@@@@@@@T....T.....TT.T@@@@@@@TT.@@@T....TTTT.T@@@@@@@@@@@@@@@@@
@@@@@@@@@TTT...TT.TT...@@@@@@@@.TT@T.TT...TT.T@@@@@@@@@@@@@@@@@@
@@@@@@@@@@TT.....T...T.@@@@@@@@@TT..T..T.TTT.@@@@@@@@@@@@@@@@@@@
@@@@@@@@@@@TTTT......T..@@@@@@@@..T..T.T.T..@@@@@@@@@@@@@@@@@@@@
@@@@@@@@@@@@T.TTT.TTT..T.@@@@@@@T.T........@@@@@@@@@@@@@@@@@@@@@
@@@@@@@@@@@@@.T...TT......@@@@@...T..TT.TT@@@@@@@@@@@@@@@@@@@@@@
@@@@@@@@@@@@@@...TTTT..T...@@.T.TTTTTT...@@@@@@@@@@@@@@@@@@@@@@@
@@@@@@@@@@@@@@@TTTTT.T.T.T......TT.TTT.T@@@@@@@@@@@@@@@@@@@@@@@@
@@@@@@@@@@@@@@@@T.........TT.TTTT.T.TTT@@@@@@@@@@@@@@@@@@@@@@@@@
@@@@@@@@@@@@@@@@@.TT........TTT..T.TT.@@@@@@@@@@@@@@@@@@@@@@@@@@
@@@@@@@@@@@@@@@@@@T..T...T.T..T...T..@@@@@@@@@@@@@@@@@@@@@@@@@@@
@@@@@@@@@@@@@@@@@@@T.T....TTT.T.TT..@@@@@@@@@@@@@@@@@@@@@@@@@@@@
@@@@@@@@@@@@@@@@@@@@.TT..TTT...T...@@@@@@@@@@@@@@@@@@@@@@@@@@@@@
@@@@@@@@@@@@@@@@@@@@@..T.T..TTTT..@@@@@@@@@@@@@@@@@@@@@@@@@@@@@@
@@@@@@@@@@@@@@@@@@@@@@T.TTTT.....@@@@@@@@@@@@@@@@@@@@@@@@@@@@@@@
@@@@@@@@@@@@@@@@@@@@@@@T.TT....T@@@@@@@@@@@@@@@@@@@@@@@@@@@@@@@@
@@@@@@@@@@@@@@@@@@@@@@@@TTTT...@@@@@@@@@@@@@@@@@@@@@@@@@@@@@@@@@
@@@@@@@@@@@@@@@@@@@@@@@@@@@@@@@@@@@@@@@@@@@@@@@@@@@@@@@@@@@@@@@@
