type octile
height 64
width 60
map
@@@@@@@@@@@@@@@@@@@@@@@@@@@@@@@@@@@@@@@@@@@@@@@@@@@@@@@@@@@@
@@@@@@@@@@@@@@@@@@@@@@@@@@@@@@@@@@@@@@@@@@@@@@@@@@@@@@@@@@@@
@@@@@@@@@@@@@@@@@@@@@@@@@@@@@@@@@@@@@@@@@@@@@@@@@@@@@@@@@@@@
@@@@@@@@@@@@@@@@@@@@@@@@@@@@@@@@@@@@@@@@@@@@@@@@@@@@@@@@@@@@
@@@@@@@@@@@@@@@@@@@@@@@@@@@@@@@@@@@@@@@@@@@@@@@@@@@@@@@@@@@@
@@@@@@@@@@@@@@@@@@@@@@@@@@@@@@@@@@@@@@@@@@@@@@@@@@@@@@@@@@@@
@@@@@@@@@@@@@@@@@@@@@@@@@@@@@@@@@@@@@@@@@@@@@@@@@@@@@@@@@@@@
@@@@@@@@@@@@@@@@@@@@@@@@@@@@@@@@@@@@@@@@@@@@@@@@@@@@@@@@@@@@
@@@@@@@@@@@@@@@@@@@@@@@@@@@@@@@@@@@@@@@@@@@@@@@@@@@@@@@@@@@@
@@@@@@@@@@@@@@@@@@@@@@@@@@@@@@@@@@@@@@@@@@@@@@@@@@@@@@@@@@@@
@@@@@@@@@@@@@@@@@@@@@@@@@@@@@@@@@@@@@@@@@@@@@@@@@@@@@@@@@@@@
@@@@@@@@@@@@@@@@@@@@@@@@@@@@@@@@.@@@@@@@@@@@@@@@@@@@@@@@@@@@
@@@@@@@@@@@@@@@@@@@@@@@@@@@@@@@.T@@@@@@@@@@@@@@@@@@@@@@@@@@@
@@@@@@@@@@@@@@@@@@@@@@@@@@@@@@@..@@@@TTT@@@@@@@@@@@@@@@@@@@@
@@@@@@@@@@@@@@@@@@@@@@@@@@@@@@@.T@@@@@@TT@@@@@@@@@@@@@@@@@@@
@@@@@@@@@@@@@@@@@@@@@@@@@@@@@@@T.@.@@@@@..@@@@@@@@@@@@@@@@@@
@@@@@@@@@@@@@@@@@@@@@@@@@@@@@@@...TT@@@@@..@@@@@@@@@@@@@@@@@
@@@@@@@@@@@@@@@@@@@@@@@@@@@@@@@T..TT.@@@@@..@@@@@@@@@@@@@@@@
@@@@@@@@@@@@@@@@@@@@@@@@@@@@@@@...T..@@@@@T.T@@@@@@@@@@@@@@@
@@@@@@@@@@@@@@@@@@@@@@@@@@@@@@@@@....@@@@.T.T...@@@@@@@@@@@@
@@@@@@@@@@@@@@@@@@@@@@@@@@@@@@@@@.T.T.T.......@T.@@@@@@@@@@@
@@@@@@@@@@@@@@@@@@@@@@@@@@@@@@@T.T.T..T..T..T@@@..@@@@@@@@@@
@@@@@@@@@@@@@@@@@@@@@@@@@@@@@@T......T..T...@@@..T.@@@@@@@@@
@@@@@@@@@@@@@@@@@@@@@@@@@@@@@.T.T..T...T.TT@@@@@T.T.@@@@@@@@
@@@@@@@@@@@@@@@@@@@@@@@@@@..@@...TT.....T.T@@@@@@@@T.@@@@@@@
@@@@@@@@@@@@@@@@@@@@@@@T@@.@@@T..T.TT.T.TT@@@@@@@@@...@@@@@@
@@@@@@@@@@@@@@@@@@@@@@@.T.....T....T...TT.@@@T@@.T..T.T@@@@@
@@@@@@@@@@@@@@@@@@@@@@.TTTT...TT...@@@TT...T.TTT...T....@@@@
@@@@@@@@@@@@@@@@@@@@......TTT.TT...@@@T..T.T...T.T..T.TT@@@@
@@@@@@@@@@@@@@@@@@@TTT.TT.T..T...T..T..T..T..T....TT...@@@@@
@@@@@@@@@@@@@@@@@@.TTT.@@.T.T.T.T..T.T...T.......T...T@@@@@@
@@@@@@@@@@@@@@@@@.....@@@@.T@@T..TT.T.T..T.T..T....T.@@@@@@@
@@@@@@@@@@@@@@@@@....@@@@@@@@@...T.T..T..T..T.TT...T@@@@@@@@
@@@@@@@T@@@@@@@@...@@@@@@@@@TTT..T...TT..T.T....T..@@@@@@@@@
@@@@@@T.T@@@@@@..T@@@@@@@@@@@T.@@..TTTT..T.T.T....@@@@@@@@@@
@@@@@...T.@@@@.T...@@@@@@@@@@@@@@T.....T..T......@@@@@@@@@@@
@@@@....T.@@@.TT...@@@@@@@@@@@@..T.T..T.T..TT...@@@@@@@@@@@@
@@@@.T..T..@..TT.T..@T.@@@@@@@@@T..T.T.T...T.T.@@@@@@@@@@@@@
@@@@@..TTT.@T.....TT...T@@@@@@@@@...TT..TT.T.T@@@@@@@@@@@@@@
@@@@@T.T...@@..TT.TTT...@@@@@@@@@@.TTTT..T...@@@@@@@@@@@@@@@
@@@@@@..T.T.@.T....TT..T@@@@@@@@.......T.T..@@@@@@@@@@@@@@@@
@@@@@@T...T.@@.....TT.T@@@@@@@@.T.T.T.T.T.T@@@@@@@@@@@@@@@@@
@@@@@@.T....T@T.T.T.TT@@@@@@@@T.T....TT...@@@@@@@@@@@@@@@@@@
@@@@@.T...TTT@@T.TT..@@@@@@@@@@...T......@@@@@@@@@@@@@@@@@@@
@@@@.T..T.T.T.@..T..@@@@@@@@@@..TT...T.T@@@@@@@@@@@@@@@@@@@@
@@@@T...T.....@T.TT@@@@@@@@..T..T...T..@@@@@@@@@@@@@@@@@@@@@
@@@@@T.T...TTTT.TT@@@@@@@@@@TT..TTT...@@@@@@@@@@@@@@@@@@@@@@
@@@@@@T.T..T....T@@@@@@@@.@T.T.TTTT.T@@@@@@@@@@@@@@@@@@@@@@@
@@@@@@@TTT......@@@@@@@@.T...T.T..TT@@@@@@@@@@@@@@@@@@@@@@@@
@@@@@@@@.T.T.T.@@@@@@@@..TT....TTTT@@@@@@@@@@@@@@@@@@@@@@@@@
@@@@@@@@@...TT@@@@@@@@@.T.......T.@@@@@@@@@@@@@@@@@@@@@@@@@@
@@@@@@@@@@TT..T@@@@@@@..TT..TT..T@@@@@@@@@@@@@@@@@@@@@@@@@@@
@@@@@@@@@@@....T@@@@.T....TT.T.T@@@@@@@@@@@@@@@@@@@@@@@@@@@@
@@@@@@@@@@@@T.T..@@.T.TTTTTT..T@@@@@@@@@@@@@@@@@@@@@@@@@@@@@
@@@@@@@@@@@@@...T..T.T..TTTTTT@@@@@@@@@@@@@@@@@@@@@@@@@@@@@@
@@@@@@@@@@@@@@.....T..TT....@@@@@@@@@@@@@@@@@@@@@@@@@@@@@@@@
@@@@@@@@@@@@@@@TT....T.T...@@@@@@@@@@@@@@@@@@@@@@@@@@@@@@@@@
@@@@@@@@@@@@@@@@T..TT..T.T@@@@@@@@@@@@@@@@@@@@@@@@@@@@@@@@@@
@@@@@@@@@@@@@@@@@..TTTT.T@@@@@@@@@@@@@@@@@@@@@@@@@@@@@@@@@@@
@@@@@@@@@@@@@@@@@@@TT.T.@@@@@@@@@@@@@@@@@@@@@@@@@@@@@@@@@@@@
@@@@@@@@@@@@@@@@@@@@..T@@@@@@@@@@@@@@@@@@@@@@@@@@@@@@@@@@@@@
@@@@@@@@@@@@@@@@@@@@@@@@@@@@@@@@@@@@@@@@@@@@@@@@@@@@@@@@@@@@
@@@@@@@@@@@@@@@@@@@@@@@@@@@@@@@@@@@@@@@@@@@@@@@@@@@@@@@@@@@@
@@@@@@@@@@@@@@@@@@@@@@@@@@@@@@@@@@@@@@@@@@@@@@@@@@@@@@@@@@@@
