type octile
height 54
width 52
map
@@@@@@@@@@@@@@@@@@@@@@@@@@@@@@@@@@@@@@@@@@@@@@@@@@@@
@@@@@@@@@@@@@@@@@@@@@@@@@@@@@@@@@@@@@@@@@@@@@@@@@@@@
@@@@@@@@@@@@@@@@@@@@@@@@@@@@@@@@@@@@@@@@@@@@@@@@@@@@
@@@@@@@@@@@@@@@@@@@@@@@@@@@@@@@@@@@@@@@@@@@@@@@@@@@@
@@@@@@@@@@@@@@@@@@@@@@@@@@@@@@@@@@@@@@@@@@@@@@@@@@@@
@@@@@@@@@@@@@@@@@@@@@@@@@@@@@@@@@@@@@@@@@@@@@@@@@@@@
@@@@@@@@@@@@@@@@@@@@@@@@@@@@@@@@@@@@@@@@@@@@@@@@@@@@
@@@@@@@@@@@@@@@@@@@@@@@@@@@@@@@@@@@@@@@@@@@@@@@@@@@@
@@@@@@@@@@@@@@@@@@@@@@@@@@@@@@@@@@@@@@@@@@@@@@@@@@@@
@@@@@@@@@@@@@@@@@@@@@@@@@@@@@@@@@@@@@@@@@@@@@@@@@@@@
@@@@@@@@@@@@@@@@@@@@@@@@@@@@@@@@@@@@@@@@@@@@@@@@@@@@
@@@@@@@@@@@@@@@@@@@@@@@@@@@@@@@.@@@@@@@@@@@@@@@@@@@@
@@@@@@@@@@@@@@@@@@@@@@@@@@@@@@..T@@@@@@@@@@@@@@@@@@@
@@@@@@@@@@@@@@@@@@@@@@@@@@@@@T.TT.@@@@@@@@@@@@@@@@@@
@@@@@@@@@@@@@@@@@@@@@@@@@@@@@.T.TTT@@@@@@@@@@@@@@@@@
@@@@@@@@@@@@@@@@@@@@@@@@@@@@T.TT.T@@@@@@@@@@@@@@@@@@
@@@@@@@@@@@@@@@@@@@@@@@@@@@...T...T@@@@@@@@@@@@@@@@@
@@@@@@@@@@@@@@@@@@@@@@@@@..TT..TT.T.@@@@@@@@@@@@@@@@
@@@@@@@@@@@@@@@@@@@@@@@@..T..T.TT....@@T@@@@@@@@@@@@
@@@@@@@@@@@@@@@@@@@@@@@.T.TT.TTTT..TTT..T@@@@@@@@@@@
@@@@@@@@@@@@@@@@@@@@@@TT....TT..@@T......@@@@@@@@@@@
@@@@@@@@@@@@@@@@@@@@@...T.....@@@@TT.T..@@@@@@@@@@@@
@@@@@@@@@@@@@@@@@@@@@@..TT.T@@@@@@T..TT@@@@@@@@@@@@@
@@@@@@@@@@@@@@@@@@@@@@..TTT.@@@@@@.....@@@@@@@@@@@@@
@@@@@@@@@@@@@@@@@@@@@..T.T.TT@@@@@@...TT@@@@@@@@@@@@
@@@@@@@@@@@@@@@@@@@@....TTTTT.@@@@@TT...T@@@@@@@@@@@
@@@@@@@@@@@@@@@@@@@.TT....T.T....@@T.T.T.T@@@@@@@@@@
@@@@@@@@@@@@@@@@@@TT..T.TTTTT.T..T..T...TT.@@@@@@@@@
@@@@@@@@@@@@@T@@....TTT..TTTTT...T.T..T.TTT.@@@@@@@@
@@@@@@@@@.TT.TT.T.T..TT...T......T.T.....T.@@@@@@@@@
@@@@@@@@@@.T...TTT@T.T.T.TT..T.TT...T...TT@@@@@@@@@@
@@@@@@@@@@@@T.T..@@@........T.T...T......@@@@@@@@@@@
@@@@@@@@@@@@@@..@@@@@TTT.T.T.TT.TTTT....@@@@@@@@@@@@
@@@@@@@@@@@@@@@@@@@@@@T...T.T.T...TTT.T@@@@@@@@@@@@@
@@@@@@@@@@@@@@@@@@@@@@@TTTTT...T....TT@@@@@@@@@@@@@@
@@@@@@@@@@@@@@@@@@@@@@@@..T..T.TT....@@@@@@@@@@@@@@@
@@@@@@@@@@@@@@@@@@@@@@@@@...TT.TTT.T@@@@@@@@@@@@@@@@
@@@@@@@@@@.@@@@@@@@@@@@@@@TT....TT.@@@@@@@@@@@@@@@@@
@@@@@@@@@.T.@@@@@@@@@@@@@@.TT.TT..@@@@@@@@@@@@@@@@@@
@@@@@@@@@...T@@@@@@@@@@@@T.TTT.T.@@@@@@@@@@@@@@@@@@@
@@@@@@@@@@T..T@@@@@@@@@@.TT.....@@@@@@@@@@@@@@@@@@@@
@@@@@@@@@@@TT..@@@@@@@@TTT..T.T@@@@@@@@@@@@@@@@@@@@@
@@@@@@@@@@@@..TT@@@@@@.T.TT..T@@@@@@@@@@@@@@@@@@@@@@
@@@@@@@@@@@@@T.T.@@@@TT......@@@@@@@@@@@@@@@@@@@@@@@
@@@@@@@@@@@@@@T..T@@T.TT.TT.@@@@@@@@@@@@@@@@@@@@@@@@
@@@@@@@@@@@@@@@T.T.TTTT.T..@@@@@@@@@@@@@@@@@@@@@@@@@
@@@@@@@@@@@@@@@@T...T..T..@@@@@@@@@@@@@@@@@@@@@@@@@@
@@@@@@@@@@@@@@@@@T.T.T...@@@@@@@@@@@@@@@@@@@@@@@@@@@
@@@@@@@@@@@@@@@@@@TT..T.@@@@@@@@@@@@@@@@@@@@@@@@@@@@
@@@@@@@@@@@@@@@@@@@TT.T@@@@@@@@@@@@@@@@@@@@@@@@@@@@@
@@@@@@@@@@@@@@@@@@@@@@@@@@@@@@@@@@@@@@@@@@@@@@@@@@@@
@@@@@@@@@@@@@@@@@@@@@@@@@@@@@@@@@@@@@@@@@@@@@@@@@@@@
@@@@@@@@@@@@@@@@@@@@@@@@@@@@@@@@@@@@@@@@@@@@@@@@@@@@
@@@@@@@@@@@@@@@@@@@@@@@@@@@@@@@@@@@@@@@@@@@@@@@@@@@@
