type octile
height 86
width 80
map
@@@@@@@@@@@@@@@@@@@@@@@@@@@@@@@@@@@@@@@@@@@@@@@@@@@@@@@@@@@@@@@@@@@@@@@@@@@@@@@@
@@@@@@@@@@@@@@@@@@@@@@@@@@@@@@@@@@@@@@@@@@@@@@@@@@@@@@@@@@@@@@@@@@@@@@@@@@@@@@@@
@@@@@@@@@@@@@@@@@@@@@@@@@@@@@@@@@@@@@@@@@@@@@@@@@@@@@@@@@@@@@@@@@@@@@@@@@@@@@@@@
@@@@@@@@@@@@@@@@@@@@@@@@@@@@@@@@@@@@@@@@@@@@@@@@@@@@@@@@@@@@@@@@@@@@@@@@@@@@@@@@
@@@@@@@@@@@@@@@@@@@@@@@@@@@@@@@@@@@@@@@@@@@@@@@@@@@@@@@@@@@@@@@@@@@@@@@@@@@@@@@@
@@@@@@@@@@@@@@@@@@@@@@@@@@@@@@@@@@@@@@@@@@@@@@@@@@@@@@@@@@@@@@@@@@@@@@@@@@@@@@@@
@@@@@@@@@@@@@@@@@@@@@@@@@@@@@@@@@@@@@@@@@@@@@@@@@@@@@@@@@@@@@@@@@@@@@@@@@@@@@@@@
@@@@@@@@@@@@@@@@@@@@@@@@@@@@@@@@@@@@@@@@@@@@@@@@@@@@@@@@@@@@@@@@@@@@@@@@@@@@@@@@
@@@@@@@@@@@@@@@@@@@@@@@@@@@@@@@@@@@@@@@@@@@@@@@@@@@@@@@@@@@@@@@@@@@@@@@@@@@@@@@@
@@@@@@@@@@@@@@@@@@@@@@@@@@@@@@@@@@@@@@@@@@@@@@@@@@@@@@@@@@@@@@@@@@@@@@@@@@@@@@@@
@@@@@@@@@@@@@@@@@@@@@@@@@@@@@@@@@@@@@@@@@@@@@TT@@@@@@@@@@@@@@@@@@@@@@@@@@@@@@@@@
@@@@@@@@@@@@@@@@@@@@@@@@@@@@@@@@@@@@@@@@@@@@..@@@@@@@@@@@@@@@@@@@@@@@@@@@@@@@@@@
@@@@@@@@@@@@@@@@@@@@@@@@@@@@@@@@@@@@@@@@@@@..@@@@@@@@@@@@@@@@@@@@@@@@@@@@@@@@@@@
@@@@@@@@@@@@@@@@@@@@@@@@@@@@@@@@@@@@@@@@@@T.T@@@@@@@@@@@@@@@@@@@@@@@@@@@@@@@@@@@
@@@@@@@@@@@@@@@@@@@@@@@@@@@@@@@@@@@@@@@@@....T@@T.T@@@@@@@@@@@@@@@@@@@@@@@@@@@@@
@@@@@@@@@@@@@@@@@@@@@@@@@@@@@@@@@@@@@@@@TT..T....TTT@@@@@@@@@@@@@@@@@@@@@@@@@@@@
@@@@@@@@@@@@@@@@@@@@@@@@@@@@@@@@@@@@@@@..TT..TT@....TT@@@@@@@@@@@@@@@@@@@@@@@@@@
@@@@@@@@@@@@@@@@@@@@@@@@@@@@@@@@@@@@@@@..TTT.T@@@..TT..@@@@@@@@@@@@@@@@@@@@@@@@@
@@@@@@@@@@@@@@@@@@@@@@@@@@@@@@@@@@@@@@@@T.TT.T@@@@T@@...@@TT@@@@@@@@@@@@@@@@@@@@
@@@@@@@@@@@@@@@@@@@@@@@@@@@@@@@@@@@@@@@@@@..@@@@@@@@@@TTTT..T@@@@@@@@@@@@@@@@@@@
@@@@@@@@@@@@@@@@@@@@@@@@@@@@@@@@@@@@@.@@@@..@@@@@@@@@@.....T.@@@@@@@@@@@@@@@@@@@
@@@@@@@@@@@@@@@@@@@@@@@@@@@@@@@@@@@@TTT@@.TTT@@@@...T..T....@@@@@@@@@@@@@@@@@@@@
@@@@@@@@@@@@@@@@@@@@@@@@@@@@@@@@@@@.TTTT..TTT.@@....T.T.TT.@@@@@@@@@@@@@@@@@@@@@
@@@@@@@@@@@@@@@@@@@@@@@@@@@@@@@@@@@@.....TTT.T..TTT.T...T.@@@@@@@@@@@@@@@@@@@@@@
@@@@@@@@@@@@@@@@@@@@@@@@@@@@@@@@.@@@......TT..T.T........@@@@@@.T@@@@@@@@@@@@@@@
@@@@@@@@@@@@@@@@@@@@@@@@@@@@@@@T.@@@...TT.T.TT..T.T.T..T@@@@@@.TT@@@@@@@@@@@@@@@
@@@@@@@@@@@@@@@@@@@@@@@@@@@@@@T.T..T.T...T......T..TTT.@@@@@@.....@@@@@@@@@@@@@@
@@@@@@@@@@@@@@@@@@@@@@@@@@@@@@TTT..T....T....TT..T..T.@@@@@@.T....T@@@@@@@@@@@@@
@@@@@@@@@@@@@@@@@@@@@@@@@@@@@@@.T..T..T..TTT.TT..T...@@@@@@.TT..TT.T.@@@@@@@@@@@
@@@@@@@@@@@@@@@@@@@@@@@@@@@@@@@@T..T....TTT.T.TTT..T@@@@@@..T......TT.@@@@@@@@@@
@@@@@@@@@@@@@@@@@@@@@@@@@@@@@@@@@.TT.T...TT...T....@@@@@..TTT..T.TT.T.T.T@@@@@@@
@@@@@@@@@@@@@@@@@@@@@@@@@@@@@@@@@T....TTTT.T.TTT.T.@@@T....TT.TT.....TT...@@@@@@
@@@@@@@@@@@@@@@@@@@@@@@@@@@@@@@TT.TT...T.T.TT..T.TTT@...TTT..TTT...T.T.T....@@@@
@@@@@@@@@@@@@@@@@@@@@@@@@@@@@@T...TT..T.........@@.TT..TT.TTT..T.@@@T@@@..T..@@@
@@@@@@@@@@@@@@@@@@@@@@@@@@@@@..T.T..T.T..T...T@@@@.TT...@@@@...T@@@@@@@@.T..T.T@
@@@@@@@@@@@@@@@@@@@@@@@@@@@T.......T..T.TTT..@@@@@.T....@@@@@@@@@@@@@@..T.TT.TT@
@@@@@@@@@@@@@@@@@@@@@@@@@@TTT..TT......T...T@@@@@@T..TT.T@@@@@@@@@@@@@@TT...TTT@
@@@@@@@@@@@@@@@@@@@@@@@@@@@...T......T.....@@@@@@..T..TT@@@@@@@@T@@@@@@.T...TT.@
@@@@@@@@@@@@@@@@@@@@@@@.@@@@..TTT.TT......@@@@@@...T..T@@@@@@@@...@@@@@.TT..T.@@
@@@@@@@@@@@@@@.@@@@@@@.T...@@...TT..TT...@@@@@@....T..@@@@@@@@@...@@@@@@TT...@@@
@@@@@@@@@@@@@@..@@@@@.TT.TT.TT...T..T...@@@@@@T...T...@@@@@@@@@T.@@@@@@@@...@@@@
@@@@@@@@@@@@@@...T@@@....T.T...@TT..T..@@@@@@.TTT.TTT@@@@@@@@@.TT@@@@@@@@@.@@@@@
@@@@@@@@@@@@@@.T.T..T...T..T.T@@@T.T..@@@@@@TT.T..T.TT@@@@@@@...T@@@@@@@@@@@@@@@
@@@@@@@@@@@@@T.TT.T..T.........@@@@TT@@@@@@TT...TTTT...TT.@@@..T@@@@@@@@@@@@@@@@
@@@@@@@@@@@@....T.T..........TTTT@@@@@@@@@....TTTTT.TT..T.@@@TT.@@@@@@@@@@@@@@@@
@@@@@@@@@TT.T..T.TTT.T.TT..T.TTT.T@@@@@@@....T.TTT..T....T@@...@@@@@@@@@@@@@@@@@
@@@@@@@@@...T.T....TT.T..T..TT...T@@@@@@.......T.TTT.....T@.TTT@@@@@@@@@@@@@@@@@
@@@@@@@@..T..T....T.TT.T..T......@@@@@@..T.T.T..T....T.....TTT@@@@@@@@@@@@@@@@@@
@@@@@@@....TTT....TT.......T.TTT@@@@@@.T..TTTTT.T....T...T...T@@@@@@@@@@@@@@@@@@
@@@@@@.T.TT@@T..TT.TT.T.T......@@@@@@.T.T..TT.T....T...T....T@@@@@@@@@@@@@@@@@@@
@@@@@...TT@@TT...T.....T..T.T.@@@@@@TT.T..T....TT.T...T....T..@@@@@@@@@@@@@@@@@@
@@@@.T...@@.TT.T.....T....T.T@@@@@@T.T.T...T..TT..TTT..........@@@@@@@@@@@@@@@@@
@@@@T..T@@@@@TT.TT.T...TTT@@@@@@@@T...T..T....T...TT....T...TT..@@@@@@@@@@@@@@@@
@@@@..T@@@@@@@@@.TT.T.TT..@@@T@@@.T.T.....@@@TT..T....T.TTTT...@@@@@@@@@@@@@@@@@
@@@@TT@@@@@@@@@@@@..TT..TTT@T.@@....T.TT..@@@T.T.......T......@@@@@@@@@@@@@@@@@@
@@@@@@@@@@@@@@@@@@...T..TTTTT..T..T..@@T..@@@.T.TTT.T........@@@@@@@@@@@@@@@@@@@
@@@@@@@@@@@@@@@@@@...T.@@.T.T.TT...T@@@@@T.T..T..T.......T.T@@@@@@@@@@@@@@@@@@@@
@@@@@@@@@@@@@@@@@@TTT.@@@@...TTT.TT@@@@@@T.TTTT..T......T.T@@@@@@@@@@@@@@@@@@@@@
@@@@@@@@@@@@@@@@@@TT.@@@@@T.....T.@@@@@@@@T......TT.T..TTT@@@@@@@@@@@@@@@@@@@@@@
@@@@@@@@@@@@@@@@@@.T@@@@@@..T.T.@@@@@@@@@@@@T.T.TTTTTT..T@@@@@@@@@@@@@@@@@@@@@@@
@@@@@@@@@@@@@@@@@@.@@@@@@.T.TT@@@@@@@@@@@@@@..TT...T....@@@@@@@@@@@@@@@@@@@@@@@@
@@@@@@@@@@@@@@@@@@@@@@@@@T.T.T@@@@@@@@@@@@@@.T.TTT....T@@@@@@@@@@@@@@@@@@@@@@@@@
@@@@@@@@@@@@@@@@@@@@@@@@TTTT..@@@@@@@@@@@@T...T....T..@@@@@@@@@@@@@@@@@@@@@@@@@@
@@@@@@@@@@@@@@@@@@@@@@..T.TT.TTT..T@@@@@@TT..T.T.....@@@@@@@@@@@@@@@@@@@@@@@@@@@
@@@@@@@@@@@@@@@@@@@@@...TT....T.TT@@@@@@.TTT....T...@@@@@@@@@@@@@@@@@@@@@@@@@@@@
@@@@@@@@@@@@@@@@@@@@@T.TTTTTT....TT@@@@T...TTT..TT.@@@@@@@@@@@@@@@@@@@@@@@@@@@@@
@@@@@@@@@@@@@@@@@@@@.T...TTT.T.....@@@.T.T...T.TTT@@@@@@@@@@@@@@@@@@@@@@@@@@@@@@
@@@@@@@@@@@@@@@@@@T..T...T...T.TT..@@.T..T..T..T.@@@@@@@@@@@@@@@@@@@@@@@@@@@@@@@
@@@@@@@@@@@@@@@@@@T.TT..T..T........T..TT.TT..T.@@@@@@@@@@@@@@@@@@@@@@@@@@@@@@@@
@@@@@@@@@@@@@@@@@..TTTTT..T.TT.TTT..TT.T.TT..T.@@@@@@@@@@@@@@@@@@@@@@@@@@@@@@@@@
@@@@@@@@@@@@@@@@TT.T.T...T.........TTT.@.TTT..@@@@@@@@@@@@@@@@@@@@@@@@@@@@@@@@@@
@@@@@@@@@@@@@@@@TTT.TT..T.....T.TTT..TT@@@TT.@@@@@@@@@@@@@@@@@@@@@@@@@@@@@@@@@@@
@@@@@@@@@@@@@@@@@..T..TTT.T.T...T......T@@@@@@@@@@@@@@@@@@@@@@@@@@@@@@@@@@@@@@@@
@@@@@@@@@@@@@@@@@@.TT.T.T..T...T.T.TTTTT.@@@@@@@@@@@@@@@@@@@@@@@@@@@@@@@@@@@@@@@
@@@@@@@@@@@@@@@@@@@.T..TTT...T..T.T..TT...@@@@@@@@@@@@@@@@@@@@@@@@@@@@@@@@@@@@@@
@@@@@@@@@@@@@@@@@@@@..T....T..T...T.....T@@@@@@@@@@@@@@@@@@@@@@@@@@@@@@@@@@@@@@@
@@@@@@@@@@@@@@@@@@@@@T.T............TTT.@@@@@@@@@@@@@@@@@@@@@@@@@@@@@@@@@@@@@@@@
@@@@@@@@@@@@@@@@@@@@@@T..T.TT..@@..T....@@@@@@@@@@@@@@@@@@@@@@@@@@@@@@@@@@@@@@@@
@@@@@@@@@@@@@@@@@@@@@@@T......T@@@.....@@@@@@@@@@@@@@@@@@@@@@@@@@@@@@@@@@@@@@@@@
@@@@@@@@@@@@@@@@@@@@@@@@.....TT@@@@..TT@@@@@@@@@@@@@@@@@@@@@@@@@@@@@@@@@@@@@@@@@
@@@@@@@@@@@@@@@@@@@@@@@@@....T.@@@@@T.@@@@@@@@@@@@@@@@@@@@@@@@@@@@@@@@@@@@@@@@@@
@@@@@@@@@@@@@@@@@@@@@@@@@@@.TT.@@@@@@@@@@@@@@@@@@@@@@@@@@@@@@@@@@@@@@@@@@@@@@@@@
@@@@@@@@@@@@@@@@@@@@@@@@@@@@@@@@@@@@@@@@@@@@@@@@@@@@@@@@@@@@@@@@@@@@@@@@@@@@@@@@
@@@@@@@@@@@@@@@@@@@@@@@@@@@@@@@@@@@@@@@@@@@@@@@@@@@@@@@@@@@@@@@@@@@@@@@@@@@@@@@@
@@@@@@@@@@@@@@@@@@@@@@@@@@@@@@@@@@@@@@@@@@@@@@@@@@@@@@@@@@@@@@@@@@@@@@@@@@@@@@@@
@@@@@@@@@@@@@@@@@@@@@@@@@@@@@@@@@@@@@@@@@@@@@@@@@@@@@@@@@@@@@@@@@@@@@@@@@@@@@@@@
