type octile
height 64
width 60
map
@@@@@@@@@@@@@@@@@@@@@@@@@@@@@@@@@@@@@@@@@@@@@@@@@@@@@@@@@@@@
@@@@@@@@@@@@@@@@@@@@@@@@@@@@@@@@@@@@@@@@@@@@@@@@@@@@@@@@@@@@
@@@@@@@@@@@@@@@@@@@@@@@@@@@@@@@@@@@@@@@@@@@@@@@@@@@@@@@@@@@@
@@@@@@@@@@@@@@@@@@@@@@@@@@@@@@@@@@@@@@@@@@@@@@@@@@@@@@@@@@@@
@@@@@@@@@@@@@@@@@@@@@@@@@@@@@@@@@@@@@@@@@@@@@@@@@@@@@@@@@@@@
@@@@@@@@@@@@@@@@@@@@@@@@@@@@@@@@@@@@@@@@@@@@@@@@@@@@@@@@@@@@
@@@@@@@@@@@@@@@@@@@@@@@@@@@@@@@@@@@@@@@@@@@@@@@@@@@@@@@@@@@@
@@@@@@@@@@@@@@@@@@@@@@@@@@@@@@@@@@@@@@@@@@@@@@@@@@@@@@@@@@@@
@@@@@@@@@@@@@@@@@@@@@@@@@@@@@@@@@@@@@@@@@@@@@@@@@@@@@@@@@@@@
@@@@@@@@@@@@@@@@@@@@@@@@@@@@@@@@@@@@@@@@@@@@@@@@@@@@@@@@@@@@
@@@@@@@@@@@@@@@@@@@@@@@@@@@@@@@@@@@@@@@@@@@@@@@@@@@@@@@@@@@@
@@@@@@@@@@@@@@@@@@@@@@@@@@@@@@@@.@@@@@@@@@@@@@@@@@@@@@@@@@@@
@@@@@@@@@@@@@@@@@@@@@@@@@@@@@@@.T@@@@@@@@@@@@@@@@@@@@@@@@@@@
@@@@@@@@@@@@@@@@@@@@@@@@@@@@@@@..@@@@TTT@@@@@@@@@@@@@@@@@@@@
@@@@@@@@@@@@@@@@@@@@@@@@@@@@@@@..@@@@@@T.@@@@@@@@@@@@@@@@@@@
@@@@@@@@@@@@@@@@@@@@@@@@@@@@@@@..@T@@@@@TT@@@@@@@@@@@@@@@@@@
@@@@@@@@@@@@@@@@@@@@@@@@@@@@@@@..TTT@@@@@TT@@@@@@@@@@@@@@@@@
@@@@@@@@@@@@@@@@@@@@@@@@@@@@@@@..T..T@@@@@TT@@@@@@@@@@@@@@@@
@@@@@@@@@@@@@@@@@@@@@@@@@@@@@@@.TTTTT@@@@@TT.@@@@@@@@@@@@@@@
@@@@@@@@@@@@@@@@@@@@@@@@@@@@@@@@@.TTT@@@@T.T..T.@@@@@@@@@@@@
@@@@@@@@@@@@@@@@@@@@@@@@@@@@@@@@@T.TT.TT...T..@T.@@@@@@@@@@@
@@@@@@@@@@@@@@@@@@@@@@@@@@@@@@@.TT..TT.T..T.T@@@TT@@@@@@@@@@
@@@@@@@@@@@@@@@@@@@@@@@@@@@@@@TT....T....T..@@@..T.@@@@@@@@@
@@@@@@@@@@@@@@@@@@@@@@@@@@@@@T.....T..T.TTT@@@@@T...@@@@@@@@
@@@@@@@@@@@@@@@@@@@@@@@@@@..@@T...T.TTT..TT@@@@@@@@T.@@@@@@@
@@@@@@@@@@@@@@@@@@@@@@@.@@.@@@...TT.....TT@@@@@@@@@...@@@@@@
@@@@@@@@@@@@@@@@@@@@@@@T.TT...TTT.TTT...T.@@@T@@TT.T..T@@@@@
@@@@@@@@@@@@@@@@@@@@@@.TT.........T@@@T..TT..T.T.TT.T...@@@@
@@@@@@@@@@@@@@@@@@@@TTTT...T...TTTT@@@..T...T......T....@@@@
@@@@@@@@@@@@@@@@@@@TT....T...TTT....TT.T.....T.T....T..@@@@@
@@@@@@@@@@@@@@@@@@TT.T.@@T.T....T..T.T..T.T.TTT.T.T...@@@@@@
@@@@@@@@@@@@@@@@@T.TTT@@@@..@@.T.T.T...T..T.....T..T.@@@@@@@
@@@@@@@@@@@@@@@@@TT..@@@@@@@@@...T....T.T........TT.@@@@@@@@
@@@@@@@.@@@@@@@@..T@@@@@@@@@.TTTT...T..TT.......T.T@@@@@@@@@
@@@@@@.T.@@@@@@..T@@@@@@@@@@@..@@....T.TTTT.TTT.T.@@@@@@@@@@
@@@@@..T..@@@@T..TT@@@@@@@@@@@@@@.T.T.T.TT.T.TT..@@@@@@@@@@@
@@@@.T.T..@@@...TTT@@@@@@@@@@@@TT.TTT.TT..TTTT.T@@@@@@@@@@@@
@@@@.TTTT.T@.....TT.@.T@@@@@@@@@TTTT.TTT...T...@@@@@@@@@@@@@
@@@@@T.T.TT@TTTT.T.TTT.T@@@@@@@@@..T.T.T.TT..T@@@@@@@@@@@@@@
@@@@@.TT..T@@T...TTTT...@@@@@@@@@@....T.T....@@@@@@@@@@@@@@@
@@@@@@..T..T@T..T.T...T.@@@@@@@@TT..TT...TT.@@@@@@@@@@@@@@@@
@@@@@@.TTT..@@T.T..T.T.@@@@@@@@...T...TTTT.@@@@@@@@@@@@@@@@@
@@@@@@.TT.T.T@....TT..@@@@@@@@...TT..T....@@@@@@@@@@@@@@@@@@
@@@@@T...TTTT@@...T..@@@@@@@@@@.T.T..TT.T@@@@@@@@@@@@@@@@@@@
@@@@T.TT.T...T@T....@@@@@@@@@@...TT..T.T@@@@@@@@@@@@@@@@@@@@
@@@@.T.T.TTT.T@T..T@@@@@@@@.TTT......TT@@@@@@@@@@@@@@@@@@@@@
@@@@@.TT.....TT...@@@@@@@@@@...T....TT@@@@@@@@@@@@@@@@@@@@@@
@@@@@@.T....T....@@@@@@@@T@....TT.TT.@@@@@@@@@@@@@@@@@@@@@@@
@@@@@@@TTT...TTT@@@@@@@@T.T..T..T.TT@@@@@@@@@@@@@@@@@@@@@@@@
@@@@@@@@.TT....@@@@@@@@..TTT..T...T@@@@@@@@@@@@@@@@@@@@@@@@@
@@@@@@@@@.....@@@@@@@@@.TT......T.@@@@@@@@@@@@@@@@@@@@@@@@@@
@@@@@@@@@@T.T.T@@@@@@@..TTT.....T@@@@@@@@@@@@@@@@@@@@@@@@@@@
@@@@@@@@@@@TTT.T@@@@TTTTT.....T.@@@@@@@@@@@@@@@@@@@@@@@@@@@@
@@@@@@@@@@@@.T...@@T.T..T......@@@@@@@@@@@@@@@@@@@@@@@@@@@@@
@@@@@@@@@@@@@.T.T..T.TT.......@@@@@@@@@@@@@@@@@@@@@@@@@@@@@@
@@@@@@@@@@@@@@.TT.TTTT.TT.T.@@@@@@@@@@@@@@@@@@@@@@@@@@@@@@@@
@@@@@@@@@@@@@@@.TT.TT.TT...@@@@@@@@@@@@@@@@@@@@@@@@@@@@@@@@@
@@@@@@@@@@@@@@@@.TTT....T.@@@@@@@@@@@@@@@@@@@@@@@@@@@@@@@@@@
@@@@@@@@@@@@@@@@@..T..T.T@@@@@@@@@@@@@@@@@@@@@@@@@@@@@@@@@@@
@@@@@@@@@@@@@@@@@@@..TT.@@@@@@@@@@@@@@@@@@@@@@@@@@@@@@@@@@@@
@@@@@@@@@@@@@@@@@@@@..T@@@@@@@@@@@@@@@@@@@@@@@@@@@@@@@@@@@@@
@@@@@@@@@@@@@@@@@@@@@@@@@@@@@@@@@@@@@@@@@@@@@@@@@@@@@@@@@@@@
@@@@@@@@@@@@@@@@@@@@@@@@@@@@@@@@@@@@@@@@@@@@@@@@@@@@@@@@@@@@
@@@@@@@@@@@@@@@@@@@@@@@@@@@@@@@@@@@@@@@@@@@@@@@@@@@@@@@@@@@@
