type octile
height 54
width 56
map
@@@@@@@@@@@@@@@@@@@@@@@@@@@@@@@@@@@@@@@@@@@@@@@@@@@@@@@@
@@@@@@@@@@@@@@@@@@@@@@@@@@@@@@@@@@@@@@@@@@@@@@@@@@@@@@@@
@@@@@@@@@@@@@@@@@@@@@@@@@@@@@@@@@@@@@@@@@@@@@@@@@@@@@@@@
@@@@@@@@@@@@@@@@@@@@@@@@@@@@@@@@@@@@@@@@@@@@@@@@@@@@@@@@
@@@@@@@@@@@@@@@@@@@@@@@@@@@@@@@@@@@@@@@@@@@@@@@@@@@@@@@@
@@@@@@@@@@@@@@@@@@@@@@@@@@@@@@@@@@@@@@@@@@@@@@@@@@@@@@@@
@@@@@@@@@@@@@@@@@@@@@@@@@@@@@@@@@@@@@@@@@@@@@@@@@@@@@@@@
@@@@@@@@@@@@@@@@@@@@@@@@@@@@@@@@@@@@@@@@@@@@@@@@@@@@@@@@
@@@@@@@@@@@@@@@@@@@@@@@@@@@@@@@@@@@@@@@@@@@@@@@@@@@@@@@@
@@@@@@@@@@@@@@@@@@@@@@@@@@@@@@@@@@@@@@@@@@@@@@@@@@@@@@@@
@@@@@@@@@@@@@@@@@@@@@..@@@@@@@@@@@@@@@@@@@@@@@@@@@@@@@@@
@@@@@@@@@@@@@@@@@@@@.T.T@@@@@@@@@@@@@@@@@@@@@@@@@@@@@@@@
@@@@@@@@@@@@@@@@@@@T.T.T.@@@@@@@@@@@@@@@.@@@@@@@@@@@@@@@
@@@@@@@@@@@@@@@@@@T.T.T..T@@@@@@@@@@@@@.T.@@@@@@@@@@@@@@
@@@@@@@@@@@@@@@@@T.T.TT.T..@@@@@@@@@@@..T.T@@@@@@@@@@@@@
@@@@@@@@@@@@@@@@T...@@.T.T.T@@@@@@@@@@.TT..@@@@@@@@@@@@@
@@@@@@@@@@@@@@@....@@@T....T.@@@@@@@@.TTTT.@@@@@@@@@@@@@
@@@@@@@@@@@@@@TTT.@@@@TT.TT...@@@@@@......T@@@@@@@@@@@@@
@@@@@@@@@@@@@T.T..@@@..T.T.TT..@@@@T.TT.T.T@@@@@@@@@@@@@
@@@@@@@@@@@@.T.....@T.T.T.T.TTT.@@..T..T@@@@@@@@@@@@@@@@
@@@@@@@@@@T.TTT.T..T.T....T.TTT......T.@@@@@@@@@@@@@@@@@
@@@@@@@@@.T..T...TT.T.TTTT.TT.TT..TTTT.@@@@@@@@@@@@@@@@@
@@@@@@@@.TTT.....TT...T.T@@@@...T..TT.T.@@TT..@@@@@@@@@@
@@@@@@@@@.TT.T.T.....T..T@@@@@T..T.TTTT.....T@@@@@@@@@@@
@@@@@@@@@@.T.....TTT..T.@@@@@@@.T...T.T.T...@@@@@@@@@@@@
@@@@@@@@@@@T..T...T..T.T@@@@@@@@.TT.T.TTTT.@@@@@@@@@@@@@
@@@@@@@@@@@@@.T..@.T.TT.@@@@@@@@@TT.TT..T@@@@@@@@@@@@@@@
@@@@@@@@@@@@@@@..@@.T....@@@@@@@@@....T.@@@@@@@@@@@@@@@@
@@@@@@@@@@@@@@@T..@@T..TTT@@@@@@@@@.TTT@@@@@@@@@@@@@@@@@
@@@@@@@@@@@@@@@@TT@@@T..T.T@@@@@@@@T...T@@@@@@@@@@@@@@@@
@@@@@@@@@@@@@@@@T.@@@@.T...T@@@@@@TTT....@@@@@@@@@@@@@@@
@@@@@@@@@@@@@@@@@T@@@@@.T....@@@@..T.T.TTT@@@@@@@@@@@@@@
@@@@@@@@@@@@@@@@@@@@@@@@....T@@@....TT...TT@@@@@@@@@@@@@
@@@@@@@@@@@@@@@@@@@@@@@@..T...T.TT..TT....T.@@@@@@@@@@@@
@@@@@@@@@@@@@@@@@@@@@@@@.TT.TT.......T.TT.TTT@@@@@@@@@@@
@@@@@@@@@@@@@@@.@@@@@@@@.TTT.T.....T.....TTT..@@@@@@@@@@
@@@@@@@@@@@@T.T..T.TTT.T....T..T.T...TT...T..T@@@@@@@@@@
@@@@@@@@@@T.T..T..TTT..TTT.TTT...T.TT@.T...T.@@@@@@@@@@@
@@@@@@@@TTTT.TT..T.....T......TT...T@@@..TTT@@@@@@@@@@@@
@@@@@@@...T@@TT..T.....T.TT...TTT.T.@@@@T..@@@@@@@@@@@@@
@@@@@@TT.T@@T..TT...T.T.TTT.T.....TTT@@@@.@@@@@@@@@@@@@@
@@@@@@.TTTT...T.TT.T..T..@T....TT.T.T.@@@@@@@@@@@@@@@@@@
@@@@@@TTT.T...T.T..TTTT.@@@TTT...T...T.@@@@@@@@@@@@@@@@@
@@@@@@TT..T.TT.T.TT.T.T@@@@@.T...T.T..T@@@@@@@@@@@@@@@@@
@@@@@@@.TT.T.TTTT..T..@@@@@@@....TTTT.@@@@@@@@@@@@@@@@@@
@@@@@@@@T..T.T...T.T.@@@@@@@@@.......@@@@@@@@@@@@@@@@@@@
@@@@@@@@@....TT.TTT.@@@@@@@@@@@@TT.T@@@@@@@@@@@@@@@@@@@@
@@@@@@@@@@..T.TT.T.@@@@@@@@@@@@@@.@@@@@@@@@@@@@@@@@@@@@@
@@@@@@@@@@@TT.TTT.@@@@@@@@@@@@@@@@@@@@@@@@@@@@@@@@@@@@@@
@@@@@@@@@@@@TT..@@@@@@@@@@@@@@@@@@@@@@@@@@@@@@@@@@@@@@@@
@@@@@@@@@@@@@@.@@@@@@@@@@@@@@@@@@@@@@@@@@@@@@@@@@@@@@@@@
@@@@@@@@@@@@@@@@@@@@@@@@@@@@@@@@@@@@@@@@@@@@@@@@@@@@@@@@
@@@@@@@@@@@@@@@@@@@@@@@@@@@@@@@@@@@@@@@@@@@@@@@@@@@@@@@@
@@@@@@@@@@@@@@@@@@@@@@@@@@@@@@@@@@@@@@@@@@@@@@@@@@@@@@@@
