type octile
height 64
width 60
map
@@@@@@@@@@@@@@@@@@@@@@@@@@@@@@@@@@@@@@@@@@@@@@@@@@@@@@@@@@@@
@@@@@@@@@@@@@@@@@@@@@@@@@@@@@@@@@@@@@@@@@@@@@@@@@@@@@@@@@@@@
@@@@@@@@@@@@@@@@@@@@@@@@@@@@@@@@@@@@@@@@@@@@@@@@@@@@@@@@@@@@
@@@@@@@@@@@@@@@@@@@@@@@@@@@@@@@@@@@@@@@@@@@@@@@@@@@@@@@@@@@@
@@@@@@@@@@@@@@@@@@@@@@@@@@@@@@@@@@@@@@@@@@@@@@@@@@@@@@@@@@@@
@@@@@@@@@@@@@@@@@@@@@@@@@@@@@@@@@@@@@@@@@@@@@@@@@@@@@@@@@@@@
@@@@@@@@@@@@@@@@@@@@@@@@@@@@@@@@@@@@@@@@@@@@@@@@@@@@@@@@@@@@
@@@@@@@@@@@@@@@@@@@@@@@@@@@@@@@@@@@@@@@@@@@@@@@@@@@@@@@@@@@@
@@@@@@@@@@@@@@@@@@@@@@@@@@@@@@@@@@@@@@@@@@@@@@@@@@@@@@@@@@@@
@@@@@@@@@@@@@@@@@@@@@@@@@@@@@@@@@@@@@@@@@@@@@@@@@@@@@@@@@@@@
@@@@@@@@@@@@@@@@@@@@@@@@@@@@@@@@@@@@@@@@@@@@@@@@@@@@@@@@@@@@
@@@@@@@@@@@@@@@@@@@@@@@@@@@@@@@@@@@@@@@@@@@@@@@@@@@@@@@@@@@@
@@@@@@@@@@@@@@@@@@@@@@@@@@@@@@@@@@@@@@@@@@@@@@@@@@@@@@@@@@@@
@@@@@@@@@@@@@@@@@@@@@@@@@@@TTTT@@@@@@@@@@@@@@@@@@@@@@@@@@@@@
@@@@@@@@@@@@@@@@@@@@@@@@@@T..T....@@@@@@@@@@@@@@@@@@@@@@@@@@
@@@@@@@@@@@@@@@@@@@@@@@@@@...TT.T.T@@@@@@@@@@@@@@@@@@@@@@@@@
@@@@@@@@@@@@@@@@@@@@@@@@@@....TT.T...@@@@@@@@@@@@@@@@@@@@@@@
@@@@@@@@@@@@@@@@@@@@@@@@@@..T.TTT.TTT.T@@@@@@@@@@@@@@@@@@@@@
@@@@@@@@@@@@@@@@@@@@@@@@@@T.TT...T.TT...@@@@@@@@@@@@@@@@@@@@
@@@@@@@@@@@@@@@@@@@@@@@@@@TT..TT........T@@@@@@@@@@@@@@@@@@@
@@@@@@@@@@@@@@@@@@@@@@@@@@TTT.....TTTTTT.@@@.@@@@@@@@@@@@@@@
@@@@@@@@@@@@@@@@@@@@@@@@@......TT.TTT.T.T..T..@@@@@@@@@@@@@@
@@@@@@@@@@@@@@@@@@@@@@@@@.T..TT.......TTT..T..@@@@@@@@@@@@@@
@@@@@@@@@@@@@@@T...T@@@@@..TT.....T...TT..@TT.T@@@@@@@@@@@@@
@@@@@@@@@@@@@@..T.TT.@@@.T....T..TTT@@@...@@T..@@@@@@@@@@@@@
@@@@@@@@@@@@@@@T.....T.....@@@@T..T@@@@.T.@@TT.@@@@@@@@@@@@@
@@@@@@@@@@@@@@@....T...TT.T@@@@T.@@@@@@.T@@@T.T@@@@@@@@@@@@@
@@@@@@@@@@@@@@@....TTT.TT.T@@@@@@@@@@@TT.@@@TT.@@@@@@@@@@@@@
@@@@@@@@@@@@@@@..T..T.@@@@@@@@@@@@@@@@@@@@@T.T.@@@@@@@@@@@@@
@@@@@@@@@@@@@@@.TTTT..@@@@@@@@@@@@@@@@@@@@T...T@@@@@@@@@@@@@
@@@@@@@@@@@@@....T....@@@@@@@@@@@@@@@@@@@@.T.@@@@T.T.@@@@@@@
@@@@@@@@@@@@@T.T...T.@@@@@@@@@@@@@@@@@@@@@.T.@@@.T..T.@@@@@@
@@@@@@@@@@@@@.T.T.T..T@@@@@@@@@@@@@@@@@@@@@.T.@@TTT...@@@@@@
@@@@@@@@@@@@@.......TT.@@@@@@@@@@@@@@@@...@@TT@@TTT...@@@@@@
@@@@@@@@@@@@@.T.....T.@@@@@@@@@@@@@@@@@...@@.TT.T.TT.T@@@@@@
@@@@@@@@@@@@@@.......@@@@@@@T@@@@@@@@@@..T@@@T.T..TT..@@@@@@
@@@@@@@@@@@@@@@.TT.T@@@@@@@.TT@@@@@@@@@..........T.T.T@@@@@@
@@@@@@@@@@@@@@@@.T..@@@@@@@....@@@@@@@@.TT..T.TT.T.T..@@@@@@
@@@@@@@@@@@@@@@@@..@@@@@@@..T...@@@@@@...T....T.T....T@@@@@@
@@@@@@@@@@@@@@@@@@@@@@@@@@T.@@@.T@@.......T.TTT..TTTT.@@@@@@
@@@@@@@@@@@@@@@@@@@@@@@@@..@@@@@.@@T.TTTTTT.T....T.T.T@@@@@@
@@@@@@@@@@@@@@@@@@@@@@@@@TT@@@@@........T..T.TTT...T..@@@@@@
@@@@@@@@@@@@@@@@@@@@@@@@..T@@@@T..TT..T.T.T......T...@@@@@@@
@@@@@@@@@@@@@@@@@@@@@@@@TTT@@@@TT...TT..T.TT....T...@@@@@@@@
@@@@@@@@TT..@TT.@@@@@@@@T....T.T.T.T...T..TT...T..T.@@@@@@@@
@@@@@@@@.T.TTT...@@@@@@@@T...TT........T.........T.@@@@@@@@@
@@@@@@@@T...T...T...@@@@T.T....T..T.T....T..TT....@@@@@@@@@@
@@@@@@@@T.TTT.T.T.TT@@.....T...T...T..TT..T.TT..T.@@@@@@@@@@
@@@@@@@@@...T....T.T..T...TTT..T.T.T.T...T..T.TT.@@@@@@@@@@@
@@@@@@@@@@TTT.....TT..T...T.T.TT.TTT.TT...TTT...T@@@@@@@@@@@
@@@@@@@@@@@..TT..TTTT...T..T.T.T..TTT.T...T.T...@@@@@@@@@@@@
@@@@@@@@@@@@....TT..T.......T.T.T.TT.T.TT......@@@@@@@@@@@@@
@@@@@@@@@@@@@TT..T..T..TTTT..TTT...T.T.TTTT....@@@@@@@@@@@@@
@@@@@@@@@@@@@@TT.TT.....TTTT.T...TT..T....T...@@@@@@@@@@@@@@
@@@@@@@@@@@@@@@T...T.TTT..........T...T..T...@@@@@@@@@@@@@@@
@@@@@@@@@@@@@@@@@..T........T...T.TT.TTTTTT.T@@@@@@@@@@@@@@@
@@@@@@@@@@@@@@@@@@@TT...T...TT...TTTT....TT.@@@@@@@@@@@@@@@@
@@@@@@@@@@@@@@@@@@@@@..T..T.....T.T..TT..T.T@@@@@@@@@@@@@@@@
@@@@@@@@@@@@@@@@@@@@@@@@TT.T..T.T....TTT...@@@@@@@@@@@@@@@@@
@@@@@@@@@@@@@@@@@@@@@@@@@@TT..T......T.TT.@@@@@@@@@@@@@@@@@@
@@@@@@@@@@@@@@@@@@@@@@@@@@@@@@....T.TTTT.@@@@@@@@@@@@@@@@@@@
@@@@@@@@@@@@@@@@@@@@@@@@@@@@@@@@@TTTTTT..@@@@@@@@@@@@@@@@@@@
@@@@@@@@@@@@@@@@@@@@@@@@@@@@@@@@@@@@@@@@@@@@@@@@@@@@@@@@@@@@
@@@@@@@@@@@@@@@@@@@@@@@@@@@@@@@@@@@@@@@@@@@@@@@@@@@@@@@@@@@@
