type octile
height 50
width 50
map
@@@@@@@@@@@@@@@@@@@@@@@@@@@@@@@@@@@@@@@@@@@@@@@@@@
@@@@@@@@@@@@@@@@@@@@@@@@@@@@@@@@@@@@@@@@@@@@@@@@@@
@@@@@@@@@@@@@@@@@@@@@@@@@@@@@@@@@@@@@@@@@@@@@@@@@@
@@@@@@@@@@@@@@@@@@@@@@@@@@@@@@@@@@@@@@@@@@@@@@@@@@
@@@@@@@@@@@@@@@@@@@@@@@@@@@@@@@@@@@@@@@@@@@@@@@@@@
@@@@@@@@@@@@@@@@@@@@@@@@@@@@@@@@@@@@@@@@@@@@@@@@@@
@@@@@@@@@@@@@@@@@@@@@@@@@@@@@@@@@@@@@@@@@@@@@@@@@@
@@@@@@@@@@@@@@@@@@@@@@@@@@@@@@@@@@@@@@@@@@@@@@@@@@
@@@@@@@@@@@@@@@@@@@@@@@@@@@@@@@@@@@@@@@@@@@@@@@@@@
@@@@@@@@@@@@@@@@@@@@@@@@@@@@@@@@@@@@@@@@@@@@@@@@@@
@@@@@@@@@@@@@@@@@@@@@@@@@@@@@@@@@@@@@@@@@@@@@@@@@@
@@@@@@@@@@@@@@@@@@@@@@@@@@@@@@@@@@@@@@@@@@@@@@@@@@
@@@@@@@@@@@@@@@@@@@@@@@@@@@@@@@@@@@@@@@@@@@@@@@@@@
@@@@@@@@@@@@@@@@@@@@@@@@@@@@@@@@@@@@@@@@@@@@@@@@@@
@@@@@@@@@@@@@@@@@@@@@@@@@@@@@@@@@@@@@@@@@@@@@@@@@@
@@@@@@@@@@@@@@@@@@@@@@@@@@@@@@@@@@@@@@@@@@@@@@@@@@
@@@@@@@@@@@@@@@@@@@@@@@@@@@@@@@@@@@@@@@@@@@@@@@@@@
@@@@@@@@@@@@@@@@@@@@@@@@@@@@@@@@@@@@@@@@@@@@@@@@@@
@@@@@@@@@@@@@@@@@@@@@@@@@@@@@@@@@@@@@@@@@@@@@@@@@@
@@@@@@@@@@@@@@@@@@@@@@@@@@@@@@@@@@@@@@@@@@@@@@@@@@
@@@@@@@@@@@@@@@@@@@@@@@@@@@@@@@@@@@@@@@@@@@@@@@@@@
@@@@@@@@@@@@@@@@@@@@@@@@@@@@@@@@@@@@@@@@@@@@@@@@@@
@@@@@@@@@@@@@@@@@@@@@@@@@@@T@@@@@@@@@@@@@@@@@@@@@@
@@@@@@@@@@@@@@@@@@@@@@@@@....@@@@@@@@@@@@@@@@@@@@@
@@@@@@@@@@@@@@@@@@@@@@@@TTTTT.@@@@@@@@@@@@@@@@@@@@
@@@@@@@@@@@@@@@@@@@@@@@.T@T....@@@@@@@@@@@@@@@@@@@
@@@@@@@@@@@@@@@@@@@@@@.T@@@T..@@@@@@@@@@@@@@@@@@@@
@@@@@@@@@@@@@@@@@@@@@T.@@@@@@.T...@@@@@@@@@@@@@@@@
@@@@@@@@@@@@@@@@@@@@..@@@@@@@@.T..T@@@@@@@@@@@@@@@
@@@@@@@@@@@@@@@@@@@...T@@@@@@@@T..T.T@@@@@@@@@@@@@
@@@@@@@@@@@@@@@@@@T..@...@@@@@@....TTT@@@@@@@@@@@@
@@@@@@@@@@@@@@@@@...@@@T.T@@@@.TTT.TT..@@@@@@@@@@@
@@@@@@@@@@@@@@@@@...@@@@@T.@@...T..T..@@@@@@@@@@@@
@@@@@@@@@@@@@@@@..TT.@@@@@....T.T.T.T@@@@@@@@@@@@@
@@@@@@@@@@@@@@@..T.TT.@@@@....T.....@@@@@@@@@@@@@@
@@@@@@@@@@@@@@T...T....@@.T.T..TT..@@@@@@@@@@@@@@@
@@@@@@@@@@@@...TTT.T......T.T...T.@@@@@@@@@@@@@@@@
@@@@@@@@@@@TT...T..T..T.T.T.T..TT@@@@@@@@@@@@@@@@@
@@@@@@@@@@.......TTTT...T.T.....@@@@@@@@@@@@@@@@@@
@@@@@@@@@@TT...TT.T....T...TT.T@@@@@@@@@@@@@@@@@@@
@@@@@@@@@T..TT........T.......T@@@@@@@@@@@@@@@@@@@
@@@@@@@@@@.TT........TT.T..T..@@@@@@@@@@@@@@@@@@@@
@@@@@@@@@@@.....T.TT......T..@@@@@@@@@@@@@@@@@@@@@
@@@@@@@@@@@@T..T..T....T.T..@@@@@@@@@@@@@@@@@@@@@@
@@@@@@@@@@@@@..TTTT.T.T..T.@@@@@@@@@@@@@@@@@@@@@@@
@@@@@@@@@@@@@@....TTT..T..@@@@@@@@@@@@@@@@@@@@@@@@
@@@@@@@@@@@@@@@TT..TT.T..@@@@@@@@@@@@@@@@@@@@@@@@@
@@@@@@@@@@@@@@@@........@@@@@@@@@@@@@@@@@@@@@@@@@@
@@@@@@@@@@@@@@@@@....T.@@@@@@@@@@@@@@@@@@@@@@@@@@@
@@@@@@@@@@@@@@@@@@@@@@@@@@@@@@@@@@@@@@@@@@@@@@@@@@
