type octile
height 86
width 80
map
@@@@@@@@@@@@@@@@@@@@@@@@@@@@@@@@@@@@@@@@@@@@@@@@@@@@@@@@@@@@@@@@@@@@@@@@@@@@@@@@
@@@@@@@@@@@@@@@@@@@@@@@@@@@@@@@@@@@@@@@@@@@@@@@@@@@@@@@@@@@@@@@@@@@@@@@@@@@@@@@@
@@@@@@@@@@@@@@@@@@@@@@@@@@@@@@@@@@@@@@@@@@@@@@@@@@@@@@@@@@@@@@@@@@@@@@@@@@@@@@@@
@@@@@@@@@@@@@@@@@@@@@@@@@@@@@@@@@@@@@@@@@@@@@@@@@@@@@@@@@@@@@@@@@@@@@@@@@@@@@@@@
@@@@@@@@@@@@@@@@@@@@@@@@@@@@@@@@@@@@@@@@@@@@@@@@@@@@@@@@@@@@@@@@@@@@@@@@@@@@@@@@
@@@@@@@@@@@@@@@@@@@@@@@@@@@@@@@@@@@@@@@@@@@@@@@@@@@@@@@@@@@@@@@@@@@@@@@@@@@@@@@@
@@@@@@@@@@@@@@@@@@@@@@@@@@@@@@@@@@@@@@@@@@@@@@@@@@@@@@@@@@@@@@@@@@@@@@@@@@@@@@@@
@@@@@@@@@@@@@@@@@@@@@@@@@@@@@@@@@@@@@@@@@@@@@@@@@@@@@@@@@@@@@@@@@@@@@@@@@@@@@@@@
@@@@@@@@@@@@@@@@@@@@@@@@@@@@@@@@@@@@@@@@@@@@@@@@@@@@@@@@@@@@@@@@@@@@@@@@@@@@@@@@
@@@@@@@@@@@@@@@@@@@@@@@@@@@@@@@@@@@@@@@@@@@@@@@@@@@@@@@@@@@@@@@@@@@@@@@@@@@@@@@@
@@@@@@@@@@@@@@@@@@@@@@@@@@@@@@@@@@@@@@@@@@@@@@@@@@@@@@@@@@@@@@@@@@@@@@@@@@@@@@@@
@@@@@@@@@@@@@@@@@@@@@@@@@@@@@@@@@@@@@@@@@@@@@@@@@@@@@@@@@@@@@@@@@@@@@@@@@@@@@@@@
@@@@@@@@@@@@@@@@@@@@@@@@@@@@@@@@@@@@@@@@@@@@@@@@@@@@@@@@@@@@@@@@@@@@@@@@@@@@@@@@
@@@@@@@@@@@@@@@@@@@@@@@@@@@@@@@@@@@@@@@@@@@@@@@@@@@@@@@@@@@@@@@@@@@@@@@@@@@@@@@@
@@@@@@@@@@@@@@@@@@@@@@@@@@@@@@@@@@@@@@@@@T@@@@@@@@@.TT@@@@@@@@@@@@@@@@@@@@@@@@@@
@@@@@@@@@@@@@@@@@@@@@@@@@@@@@@@@@@@@@@@@TT..@@@@@@..TT.@@@@@@@@@@@@@@@@@@@@@@@@@
@@@@@@@@@@@@@@@@@@@@@@@@@@@@@@@@@@@@@@@T....T@@@@.T...T@@@@@@@@@@@@@@@@@@@@@@@@@
@@@@@@@@@@@@@@@@@@@@@@@@@@@@@@@@@@@@@@@..T.TT.@@@.....@@@@@@@@@@@@@@@@@@@@@@@@@@
@@@@@@@@@@@@@@@@@@@@@@@@@@@@@@@@@@@@@@@@.TTT.@@@@..T.@@@@@@@@@@@@@@@@@@@@@@@@@@@
@@@@@@@@@@@@@@@@@@@@@@@@@@@@@@@@@@@@@@@....TT@@@@..T@@@@@@@@@@@@@@@@@@@@@@@@@@@@
@@@@@@@@@@@@@@@@@@@@@@@@@@@@@@@@@@@@@@T....T.TT...T.@@@@@@@T@@@@@@@@@@@@@@@@@@@@
@@@@@@@@@@@@@@@@@@@@@@@@@@@@@@@@@@@@@..T....T.T....@@@@@@@...@@@@@@@@@@@@@@@@@@@
@@@@@@@@@@@@@@@@@@@@@@@@@@@@@@@@@@@@.T.T....T..TT@@@@@@@@...T.@@@@@@@@@@@@@@@@@@
@@@@@@@@@@@@@@@@@@@@@@@@@@@@@@@@@@@@@....TT....T..@@@@@TT..T.@@@@@@@@@@@@@@@@@@@
@@@@@@@@@@@@@@@@@@@@@@@@@@@@@@@@@@@@@@..T...TTTT.T.@@T..TTT.@@@@@@@@@@@@@@@@@@@@
@@@@@@@@@@@@@@@@@@@@@@@@@@@@@@@@@@@@@@@..TT.T.........TT.T.@@@@@@@@@@@@@@@@@@@@@
@@@@@@@@@@@@@@@@@@@@@@@@@@@@@.T.@@@@@@@@.T.T..T.T....TTT..@@@@@@@@@@@@@@@@@@@@@@
@@@@@@@@@@@@@@@@@@@@@@@@@@@@@..TT@@@@@@@@.TT...T.T.......@@@@@@@@@@@@@@@@@@@@@@@
@@@@@@@@@@@@@@@@@@@@@@@@@@@@@...T@@@@@@@@@TT...TT...T..T.@@@@@@.TTT..@@@@@@@@@@@
@@@@@@@@@@@@@@@@@@@@@@@@@@@@@@@T.T@@@@@@@@@TT.TTT..T.T.TTT@@@@@...T...@@@@@@@@@@
@@@@@@@@@@@@@@@@@@@@@@@@@@@@@@@@.T.@@..@@@@@TTT..T....T....@@TT....TT.@@@@@@@@@@
@@@@@@@@@@@@@@@@@@@@@@@@T@@@@@@@@..T.T..@@@@@TT..TT..TT.TTT@@T.....TT@@@@@@@@@@@
@@@@@@@@@@@@@@@@@@@@@@@T..@@@@@@@...T.T.T.@@@@T.TTT.T..TT...T.T.T.T.@@@@@@@@@@@@
@@@@@@@@@@@@@@@@@@@@@@..T.T@@@@@.T.TT..T.@@@@@T.TT.T...TT..T.TT..T.@@@@@@@@@@@@@
@@@@@@@@@@@@@@@@@@@@@.....TT@@@T..T.TTTT@@@@@TT.TTT...TT..TT......@@@@@@...@@@@@
@@@@@@@@@@@@@@@@@@@@.......T...T...T...@@@@@TTT...T.......T...TTT@@@@@@TT..T.@@@
@@@@@@@@@@@@@@@@@@@..TT...T..T.T..T...@@@@@.TT...T..TT..TT.....T.@@@@@..TTTTT@@@
@@@@@@@@@@@@@@@@@@@@..TTTTT....TT.T..@@@@@.TT.TTT..@TTTT..T.TTTT..@@@T..T....@@@
@@@@@@@@@@@@@@@@@@@@@..T...T..T..TT.T@@@@T...TT...@@@.T......T...TT..T.......@@@
@@@@@@@@@@@@@@@@@@@@@@.T.T.TTT..T.T..@@@..TT..T.T@@@@@T..T.TT..TT.....T..T.T@@@@
@@@@@@@@@@@@@@@@@@@@@@@.TTT..T...@TTTT@.T....T.T@@@@@@@T..TT.T..@@..T.T.T..@@@@@
@@@@@@@@@@@@@@@@@@@@@@@@TT..T..T@@@T...T...TT..@@@@@@@@@..T..TT@@.T..T..TT@@@@@@
@@@@@@@@@@@@@@@@@@@@@@@@@T...T.@@@@@TT..T.....@@@@@@@@@@@TTT..@@.T.T....T@@@@@@@
@@@@@@@@@@@@@@@@@@.@@@@@@@TT..@@@@@@T.TT...T.@@@@@@T@@@@@@..T@@TTTT....T@@@@@@@@
@@@@@@@@@@T@@@@@@@.T@@@@@@@..@@@@@@TTT..T...@@@@@@@..@@@@@@.@@.T......T@@@@@@@@@
@@@@@@@@@...@@@@.....@@@@@@@@@@@@@.....TTT.T@@@.T.T...@@@@@@@..T.T.T..@@@@@@@@@@
@@@@@@@@T..T..@.T.TTTT@@@@@@@@@@@.TTT.TT..T..@.T....@T.@@@@@@T..TT.T.@@@@@@@@@@@
@@@@@@@.TT....T....T...@@@@@@@@@TTT.TTTT@@......@@@@@...@@@@@@T.TT..@@@@@@@@@@@@
@@@@@@...TTT...T.T..TTT.@@@@@@@T.....T.@@@@T.T.@@@@@@...T@@@@@@..T.@@@@@@@@@@@@@
@@@@@T..T..@.TT...TT..TTT@@@@@T....TT.@@@@@TT.T@@@@@@TTTTT@@@@@@T.@@@@@@@@@@@@@@
@@@@T...T.@@@TT.T.T....T@@@@@TTTT.T..@@@@@@....@@@@@@...T..@@@@@@@@@@@@@@@@@@@@@
@@@.TTT.T@@@@@...T.T...@@@@@T.T.T..T@@@@@@@@.T.@@@@@@..T.T..@@@@@@@@@@@@@@@@@@@@
@@.T..@@@@@@@@...TT.T.@@@@@..T..T..@@@@@@@@T..@@@@@@@T.TT....@@@@@@@@@@@@@@@@@@@
@@.T.@@@.@@@@@..TTT..T@@@@@T...T.T@@@@@@@@T.TT@@@@@@T...T..TT.@@@@@@@@@@@@@@@@@@
@@@.@@@T.T@@@..T..T...T@TT..T.TT.@@@@@@@@.TT..@@@@@...T...T..@@@@@@@@@@@@@@@@@@@
@@@@@@..TTTTT.....@@.....T..TT..@@@@@@@@.....TT@T.....T...T.@@@@@@@@@@@@@@@@@@@@
@@@@@TTT...T.....@@@@.T.T.TTT..@@@@@@@@@@...TT....TT....T.T@@@@@@@@@@@@@@@@@@@@@
@@@@@@.T.....T..@@@@@..TT.T..T@@@@@@@@@@@@.T.....TTTT....T@@@@@@@@@@@@@@@@@@@@@@
@@@@@@@.T.T.T.T@@@@@..TTTTTT.@@@@@@@@@@@@@@..T.T.TT...T.T@@@@@@@@@@@@@@@@@@@@@@@
@@@@@@@@.T.TTT@@@@@T...TT.TT.@@@..@@.T.@@@@@.T.TT.T.....@@@@@@@@@@@@@@@@@@@@@@@@
@@@@@@@@@T.T.@@@@@.T..TT.TT..@@T...T....@@@@@...T.T.T.T@@@@@@@@@@@@@@@@@@@@@@@@@
@@@@@@@@@@..@@@@@TT.TTTTT.TT...TT.T...T.@@@@@@.T..T...@@@@@@@@@@@@@@@@@@@@@@@@@@
@@@@@@@@@@@@@@@@.T.T....@@.T.T...@T.....@@@@@@@TT..T.@@@@@@@@@@@@@@@@@@@@@@@@@@@
@@@@@@@@@@@@@@@...TTTTT@@@@....@@@@....TT@@@@@@@TT..@@@@@@@@@@@@@@@@@@@@@@@@@@@@
@@@@@@@@@@@@@@...TTT..@@@@@...@@@@@@TT.T..@.@@@@@..@@@@@@@@@@@@@@@@@@@@@@@@@@@@@
@@@@@@@@@@@@@@@T..T..@@@@@T.T@@@@@@@@..T..T.T@@@@@@@@@@@@@@@@@@@@@@@@@@@@@@@@@@@
@@@@@@@@@@@@@@@@..TT@@@@@.TT.@@@@@@@@T..T...T.@@@@@@@@@@@@@@@@@@@@@@@@@@@@@@@@@@
@@@@@@@@@@@@@@@@@T.@@@@@T.TTT@@@@@@@T..T.T.....@@@@@@@@@@@@@@@@@@@@@@@@@@@@@@@@@
@@@@@@@@@@@@@@@@@@@@@@@TT..T@@@@@@@@.....TT.T..@@@@@@@@@@@@@@@@@@@@@@@@@@@@@@@@@
@@@@@@@@@@@@@@@@@@@@@@......@@@@@@@.T......TT.@@@@@@@@@@@@@@@@@@@@@@@@@@@@@@@@@@
@@@@@@@@@@@@@@@@@@@@@T..TT..@@@@@@.TTT...TT.T@@@@@@@@@@@@@@@@@@@@@@@@@@@@@@@@@@@
@@@@@@@@@@@@@@@@@@@@@T.TTT..@@@@TTTTT..TTTTT@@@@@@@@@@@@@@@@@@@@@@@@@@@@@@@@@@@@
@@@@@@@@@@@@@@@@@@@@@@T....TT.T...T...TT.T.@@@@@@@@@@@@@@@@@@@@@@@@@@@@@@@@@@@@@
@@@@@@@@@@@@@@@@@@@@@@@TT........T.T...T..@@@@@@@@@@@@@@@@@@@@@@@@@@@@@@@@@@@@@@
@@@@@@@@@@@@@@@@@@@@@@@@.......TT..T..T.T@@@@@@@@@@@@@@@@@@@@@@@@@@@@@@@@@@@@@@@
@@@@@@@@@@@@@@@@@@@@@@@@@.T...T..T...T..@@@@@@@@@@@@@@@@@@@@@@@@@@@@@@@@@@@@@@@@
@@@@@@@@@@@@@@@@@@@@@@@@@@...........T.@@@@@@@@@@@@@@@@@@@@@@@@@@@@@@@@@@@@@@@@@
@@@@@@@@@@@@@@@@@@@@@@@@@@@...TT.T..TT@@@@@@@@@@@@@@@@@@@@@@@@@@@@@@@@@@@@@@@@@@
@@@@@@@@@@@@@@@@@@@@@@@@@@@@..T...T.T@@@@@@@@@@@@@@@@@@@@@@@@@@@@@@@@@@@@@@@@@@@
@@@@@@@@@@@@@@@@@@@@@@@@@@@@@...TT.@@@@@@@@@@@@@@@@@@@@@@@@@@@@@@@@@@@@@@@@@@@@@
@@@@@@@@@@@@@@@@@@@@@@@@@@@@@@..T@@@@@@@@@@@@@@@@@@@@@@@@@@@@@@@@@@@@@@@@@@@@@@@
@@@@@@@@@@@@@@@@@@@@@@@@@@@@@@@@@@@@@@@@@@@@@@@@@@@@@@@@@@@@@@@@@@@@@@@@@@@@@@@@
@@@@@@@@@@@@@@@@@@@@@@@@@@@@@@@@@@@@@@@@@@@@@@@@@@@@@@@@@@@@@@@@@@@@@@@@@@@@@@@@
@@@@@@@@@@@@@@@@@@@@@@@@@@@@@@@@@@@@@@@@@@@@@@@@@@@@@@@@@@@@@@@@@@@@@@@@@@@@@@@@
@@@@@@@@@@@@@@@@@@@@@@@@@@@@@@@@@@@@@@@@@@@@@@@@@@@@@@@@@@@@@@@@@@@@@@@@@@@@@@@@
@@@@@@@@@@@@@@@@@@@@@@@@@@@@@@@@@@@@@@@@@@@@@@@@@@@@@@@@@@@@@@@@@@@@@@@@@@@@@@@@
