type octile
height 54
width 52
map
@@@@@@@@@@@@@@@@@@@@@@@@@@@@@@@@@@@@@@@@@@@@@@@@@@@@
@@@@@@@@@@@@@@@@@@@@@@@@@@@@@@@@@@@@@@@@@@@@@@@@@@@@
@@@@@@@@@@@@@@@@@@@@@@@@@@@@@@@@@@@@@@@@@@@@@@@@@@@@
@@@@@@@@@@@@@@@@@@@@@@@@@@@@@@@@@@@@@@@@@@@@@@@@@@@@
@@@@@@@@@@@@@@@@@@@@@@@@@@@@@@@@@@@@@@@@@@@@@@@@@@@@
@@@@@@@@@@@@@@@@@@@@@@@@@@@@@@@@@@@@@@@@@@@@@@@@@@@@
@@@@@@@@@@@@@@@@@@@@@@@@@@@@@@@@@@@@@@@@@@@@@@@@@@@@
@@@@@@@@@@@@@@@@@@@@@@@@@@@@@@@@@@@@@@@@@@@@@@@@@@@@
@@@@@@@@@@@@@@@@@@@@@@@@@@@@@@@@@@@@@@@@@@@@@@@@@@@@
@@@@@@@@@@@@@@@@@@@@@@@@@@@@@@@@@@@@@@@@@@@@@@@@@@@@
@@@@@@@@@@@@@@@@@@@@@@@@@@@@@@@@@@@@@@@@@@@@@@@@@@@@
@@@@@@@@@@@@@@@@@@@@@@@@@@@@@@@@@@@@@@@@@@@@@@@@@@@@
@@@@@@@@@@@@@@@@@@@@@@@@@@@@@@@@@@@@@@@@@@@@@@@@@@@@
@@@@@@@@@@@@@@@@@@@@@@@@@@@@@@@@@@@@@@@@@@@@@@@@@@@@
@@@@@@@@@@@@@@@@@@@@@@@@@@@@@@@.@@@@@@@@@@@@@@@@@@@@
@@@@@@@@@@@@@@@@@@@@@@@@@@@.T@T..@@@@@@@@@@@@@@@@@@@
@@@@@@@@@@@@@@@@@@@@@@@@@@@TT.T.@@@@@@@@@@@@@@@@@@@@
@@@@@@@@@@@@@@@@@@@@@@@@@@@@T.T.@@@T@@@@@@@@@@@@@@@@
@@@@@@@@@@@@@@@@@@@@@@@@@@@@T..T@@....T@@@@@@@@@@@@@
@@@@@@@@@@@@@@@@@@@@@@@@@@TT.TT..T.T.T.@@@@@@@@@@@@@
@@@@@@@@@@@@@@@@@@@@@@@@@..TTTTT..TTT.T@@@@@@@@@@@@@
@@@@@@@@@@@@@@@@@@@@@@@@TT.T.T..T..T...@@T@@@@@@@@@@
@@@@@@@@@@@@@@@@@@@@@@@.T....T.TTTTTTTTT...@@@@@@@@@
@@@@@@@@@@@@@@@@@@@@@@......TTT..T..T.TT....@@@@@@@@
@@@@@@@@@@@@@@@@@@@@.T..T@@@T.TT...T.......T.@@@@@@@
@@@@@@@@@@..@@@@@@@T.T.T@@@@@T.....T.T.T.....T@@@@@@
@@@@@@@@@.TTT@@T..T.TTT@@@@@@@..TT.TTT.T..TT..T@@@@@
@@@@@@@@..T..@.T..T.TT@@@@@@@..T.T............@@@@@@
@@@@@@@......@@...T..@@@@@@@...T...TTTTT.....@@@@@@@
@@@@@@.T....T.@T..T.@@@@@@@T.TT.T...T.TT.TTT@@@@@@@@
@@@@@@@TTTTT.T@@T.T@@@@@@@.T.T.TT.T.T..T...@@@@@@@@@
@@@@@@@....TTT.@TT@@@@@@@TTTTTTTTT..T...T.@@@@@@@@@@
@@@@@@@@.TTTT..@TT.@@@@T..TT.T..TTT...TT.@@@@@@@@@@@
@@@@@@@@T.T.T.T@@...@@TT.T.TTTT..TTT..T.@@@@@@@@@@@@
@@@@@@@@@T..TT..@TT.@TTT.T.TT...T.TTT..@@@@@@@@@@@@@
@@@@@@@@@..T....@TT.......T..TT.TT..T.@@@@@@@@@@@@@@
@@@@@@@@@@T....TT.T.T.T.TT.T.T......T@@@@@@@@@@@@@@@
@@@@@@@@@@TTTT..T.TTT.....TT..T..T.T@@@@@@@@@@@@@@@@
@@@@@@@@@@@...TT.....TTT.T....T.TT.@@@@@@@@@@@@@@@@@
@@@@@@@@@@@TTTT..T...........T.T..@@@@@@@@@@@@@@@@@@
@@@@@@@@@@.....T.T..T...T...T..TT@@@@@@@@@@@@@@@@@@@
@@@@@@@@@..TT.TT...TT.T.T.......@@@@@@@@@@@@@@@@@@@@
@@@@@@@@..T...T.T.T.TTTT.TT.T..@@@@@@@@@@@@@@@@@@@@@
@@@@@@@@T..T.....T...T.T.T.TTT@@@@@@@@@@@@@@@@@@@@@@
@@@@@@@@@.....T.T..T...T.T...@@@@@@@@@@@@@@@@@@@@@@@
@@@@@@@@@@..........TT.T..TT@@@@@@@@@@@@@@@@@@@@@@@@
@@@@@@@@@@@T.TT.......TT.TT@@@@@@@@@@@@@@@@@@@@@@@@@
@@@@@@@@@@@@...T..TTT.T..T@@@@@@@@@@@@@@@@@@@@@@@@@@
@@@@@@@@@@@@@TT..TT..TT..@@@@@@@@@@@@@@@@@@@@@@@@@@@
@@@@@@@@@@@@@@.TTT..T.T.@@@@@@@@@@@@@@@@@@@@@@@@@@@@
@@@@@@@@@@@@@@@TT..T.TT@@@@@@@@@@@@@@@@@@@@@@@@@@@@@
@@@@@@@@@@@@@@@@T.....@@@@@@@@@@@@@@@@@@@@@@@@@@@@@@
@@@@@@@@@@@@@@@@@T.T.@@@@@@@@@@@@@@@@@@@@@@@@@@@@@@@
@@@@@@@@@@@@@@@@@@@@@@@@@@@@@@@@@@@@@@@@@@@@@@@@@@@@
