type octile
height 54
width 52
map
@@@@@@@@@@@@@@@@@@@@@@@@@@@@@@@@@@@@@@@@@@@@@@@@@@@@
@@@@@@@@@@@@@@@@@@@@@@@@@@@@@@@@@@@@@@@@@@@@@@@@@@@@
@@@@@@@@@@@@@@@@@@@@@@@@@@@@@@@@@@@@@@@@@@@@@@@@@@@@
@@@@@@@@@@@@@@@@@@@@@@@@@@@@@@@@@@@@@@@@@@@@@@@@@@@@
@@@@@@@@@@@@@@@@@@@@@@@@@@@@@@@@@@@@@@@@@@@@@@@@@@@@
@@@@@@@@@@@@@@@@@@@@@@@@@@@@@@@@@@@@@@@@@@@@@@@@@@@@
@@@@@@@@@@@@@@@@@@@@@@@@@@@@@@@@@@@@@@@@@@@@@@@@@@@@
@@@@@@@@@@@@@@@@@@@@@@@@@@@@@@@@@@@@@@@@@@@@@@@@@@@@
@@@@@@@@@@@@@@@@@@@@@@@@@@@@@@@@@@@@@@@@@@@@@@@@@@@@
@@@@@@@@@@@@@@@@@@@@@@@@@@@@@@@@@@@@@@@@@@@@@@@@@@@@
@@@@@@@@@@@@@@@@@@@@@@@@@@@@@@@@@@@@@@@@@@@@@@@@@@@@
@@@@@@@@@@@@@@@@@@@@@@@@@@@@@@@@@@@@@@@@@@@@@@@@@@@@
@@@@@@@@@@@@@@@@@@@@@@@@@@@@@@@@@@@@@@@@@@@@@@@@@@@@
@@@@@@@@@@@@@@@@@@@@@@@@@@@@@@@@@@@@@@@@@@@@@@@@@@@@
@@@@@@@@@@@@@@@@@@@@@@@@@@@@@@@@@@@@@@@@@@@@@@@@@@@@
@@@@@@@@@@@@@@@@@@@@@@@@@@@@@@@@@@@@@@@@@@@@@@@@@@@@
@@@@@@@@@@@@@@@@@@@@@@@@@@@@.@@@@T.@@@@@@@@@@@@@@@@@
@@@@@@@@@@@@@@@@@@@@@@@@@@@TT.@@..TT.@@@@@@@@@@@@@@@
@@@@@@@@@@@@@@@@@@@@@@@@@@......T...T.@@@@@@@@@@@@@@
@@@@@@@@@@@@@@@@@@@@@@@@@@..T.....T....@@@@@@@@@@@@@
@@@@@@@@@@@@@@@@@@@@@@@@@..T...T@@..T.TT@@@@@@@@@@@@
@@@@@@@@@@@@@@@@@@@@@@@T...T.TT@@@@@..TTT@@@@@@@@@@@
@@@@@@@@@@@@@@@@@@@@@@....TTT.T@@@@@@@...T@@@@@@@@@@
@@@@@@@@@@@@@@@@@@@@@.TT..T.TT.@@@@@@@.T.@@@@@@@@@@@
@@@@@@@@@@@@@@@@@@@@@@...T.....@@@@T.TT.@@@@@@@@@@@@
@@@@@@@@@@@@@@@@@@@@@@@...TT..TT@T....T@@@@@@@@@@@@@
@@@@@@@@@@@@@@@@@@@@@@@@T.T.T...TTTT..T@@@@@@@@@@@@@
@@@@@@@@@@@@@@@@@..@@@@@@.TTTT.TT....T.@@@@@@@@@@@@@
@@@@@@@@@@@@@@@@...T@@@@@T..TT..T......T@@@@@@@@@@@@
@@@@@@@@@@@@@@@.TT...@@@@T.....TTTTT..T..@@@@@@@@@@@
@@@@@@@@@@@@@@@@.T..T@@@.T....T....TTT.T.T@@@@@@@@@@
@@@@@@@@@@@@@@@@@......TTT...TT...T......@@@@@@@@@@@
@@@@@@@@@@@@@@@@@@T.T.TTT..TT..T..T.T.TT@@@@@@@@@@@@
@@@@@@@@@@@@@@@@@@@..T.T.TT...T.TTT.TT.@@@@@@@@@@@@@
@@@@@@@@@@@@.@@@@@@....T.T....T..TTT.T@@@@@@@@@@@@@@
@@@@@@@@T@@...@@@@@TTTT...T.T.T...T.T@@@@@@@@@@@@@@@
@@@@@@@..T.....@@@..TT.......T...T..@@@@@@@@@@@@@@@@
@@@@@@T.T.......T..........T..T...T@@@@@@@@@@@@@@@@@
@@@@@@...TT..TT..TT.T@@..TTT.T....@@@@@@@@@@@@@@@@@@
@@@@@@@...TT..TTT...@@@...TT...TT@@@@@@@@@@@@@@@@@@@
@@@@@@@@T..T.TT.T..@@T..T..TTT.T@@@@@@@@@@@@@@@@@@@@
@@@@@@@@@TT..T..T.@@T.TTT.TT...@@@@@@@@@@@@@@@@@@@@@
@@@@@@@@@@..T..T.@@...T..TT.TT@@@@@@@@@@@@@@@@@@@@@@
@@@@@@@@@@@..T.T@@..T......TT@@@@@@@@@@@@@@@@@@@@@@@
@@@@@@@@@@@@.T.@@..T..TTT..T@@@@@@@@@@@@@@@@@@@@@@@@
@@@@@@@@@@@@@.@@.T....TT..T@@@@@@@@@@@@@@@@@@@@@@@@@
@@@@@@@@@@@@@@@.T.T...TT.T@@@@@@@@@@@@@@@@@@@@@@@@@@
@@@@@@@@@@@@@@@....T.T.TT@@@@@@@@@@@@@@@@@@@@@@@@@@@
@@@@@@@@@@@@@@@@.TT.T..T@@@@@@@@@@@@@@@@@@@@@@@@@@@@
@@@@@@@@@@@@@@@@@...TTT@@@@@@@@@@@@@@@@@@@@@@@@@@@@@
@@@@@@@@@@@@@@@@@@.T..@@@@@@@@@@@@@@@@@@@@@@@@@@@@@@
@@@@@@@@@@@@@@@@@@@.T@@@@@@@@@@@@@@@@@@@@@@@@@@@@@@@
@@@@@@@@@@@@@@@@@@@@@@@@@@@@@@@@@@@@@@@@@@@@@@@@@@@@
@@@@@@@@@@@@@@@@@@@@@@@@@@@@@@@@@@@@@@@@@@@@@@@@@@@@
