type octile
height 139
width 148
map
@@@@@@@@@@@@@@@@@@@@@@@@@@@@@@@@@@@@@@@@@@@@@@@@@@@@@@@@@@@@@@@@@@@@@@@@@@@@@@@@@@@@@@@@@@@@@@@@@@@@@@@@@@@@@@@@@@@@@@@@@@@@@@@@@@@@@@@@@@@@@@@@@@@@
@@@@@@@@@@@@@@@@@@@@@@@@@@@@@@@@@@@@@@@@@@@@@@@@@@@@@@@@@@@@@@@@@@@@@@@@@@@@@@@@@@@@@@@@@@@@@@@@@@@@@@@@@@@@@@@@@@@@@@@@@@@@@@@@@@@@@@@@@@@@@@@@@@@@
@@@@@@@@@@@@@@@@@@@@@@@@@@@@@@@@@@@@@@@@@@@@@@@@@@@@@@@@@@@@@@@@@@@@@@@@@@@@@@@@@@@@@@@@@@@@@@@@@@@@@@@@@@@@@@@@@@@@@@@@@@@@@@@@@@@@@@@@@@@@@@@@@@@@
@@@@@@@@@@@@@@@@@@@@@@@@@@@@@@@@@@@@@@@@@@@@@@@@@@@@@@@@@@@@@@@@@@@@@@@@@@@@@@@@@@@@@@@@@@@@@@@@@@@@@@@@@@@@@@@@@@@@@@@@@@@@@@@@@@@@@@@@@@@@@@@@@@@@
@@@@@@@@@@@@@@@@@@@@@@@@@@@@@@@@@@@@@@@@@@@@@@@@@@@@@@@@@@@@@@@@@@@@@@@@@@@@@@@@@@@@@@@@@@@@@@@@@@@@@@@@@@@@@@@@@@@@@@@@@@@@@@@@@@@@@@@@@@@@@@@@@@@@
@@@@@@@@@@@@@@@@@@@@@@@@@@@@@@@@@@@@@@@@@@@@@@@@@@@@@@@@@@@@@@@@@@@@@@@@@@@@@@@@@@@@@@@@@@@@@@@@@@@@@@@@@@@@@@@@@@@@@@@@@@@@@@@@@@@@@@@@@@@@@@@@@@@@
@@@@@@@@@@@@@@@@@@@@@@@@@@@@@@@@@@@@@@@@@@@@@@@@@@@@@@@@@@@@@@@@@@@@@@@@@@@@@@@@@@@@@@@@@@@@@@@@@@@@@@@@@@@@@@@@@@@@@@@@@@@@@@@@@@@@@@@@@@@@@@@@@@@@
@@@@@@@@@@@@@@@@@@@@@@@@@@@@@@@@@@@@@@@@@@@@@@@@@@@@@@@@@@@@@@@@@@@@@@@@@@@@@@@@@@@@@@@@@@@@@@@@@@@@@@@@@@@@@@@@@@@@@@@@@@@@@@@@@@@@@@@@@@@@@@@@@@@@
@@@@@@@@@@@@@@@@@@@@@@@@@@@@@@@@@@@@@@@@@@@@@@@@@@@@@@@@@@@@@@@@@@@@@@@@@@@@@@@@@@@@@@@@@@@@@@@@@@@@@@@@@@@@@@@@@@@@@@@@@@@@@@@@@@@@@@@@@@@@@@@@@@@@
@@@@@@@@@@@@@@@@@@@@@@@@@@@@@@@@@@@@@@@@@@@@@@@@@@@@@@@@@@@@@@@@@@@@@@@@@@@@@@@@@@@@@@@@@@@@@@@@@@@@@@@@@@@@@@@@@@@@@@@@@@@@@@@@@@@@@@@@@@@@@@@@@@@@
@@@@@@@@@@@@@@@@@@@@@@@@@@@@@@@@@@@@@@@@@@@@@@@@@@@@@@@@@@@@@@@@@@@@@@@@@@@@@@@@@@@@@@@@@@@@@@@@@@@@@@@@@@@@@@@@@@@@@@@@@@@@@@@@@@@@@@@@@@@@@@@@@@@@
@@@@@@@@@@@@@@@@@@@@@@@@@@@@@@@@@@@@@@@@@@@@@@@@@@@@@@@@@@@@@@@@@@@@@@@@@@@@@@@@@@@@@@@@@@@@@@@@@@@@@@@@@@@@@@@@@@@@@@@@@@@@@@@@@@@@@@@@@@@@@@@@@@@@
@@@@@@@@@@@@@@@@@@@@@@@@@@@@@@@@@@@@@@@@@@@@@@@@@@@@@@@@@@@@@@@@@@@@@@@@@@@@@@@@@@@@@@@@@@@@@@@@@@@@@@@@@@@@@@@@@@@@@@@@@@@@@@@@@@@@@@@@@@@@@@@@@@@@
@@@@@@@@@@@@@@@@@@@@@@@@@@@@@@@@@@@@@@@@@@@@@@@@@@@@@@@@@@@@@@@@@@@@@@@@@@@@@@@@@@@@@@@@@@@@@@@@@@@@@@@@@@@@@@@@@@@@@@@@@@@@@@@@@@@@@@@@@@@@@@@@@@@@
@@@@@@@@@@@@@@@@@@@@@@@@@@@@@@@@@@@@@@@@@@@@@@@@@@@@@@@@@@@@@@@@@@@@@@@@@@@@@@@@@@@@@@@@@@@@@@@@@@@@@@@@@@@@@@@@@@@@@@@@@@@@@@@@@@@@@@@@@@@@@@@@@@@@
@@@@@@@@@@@@@@@@@@@@@@@@@@@@@@@@@@@@@@@@@@@@@@@@@@@@@@@@@@@@@@@@@@@@@@@@@@@@@@@@@@@@@@@@@@@@@@@@@@@@@@@@@@@@@@@@@@@@@@@@@@@@@@@@@@@@@@@@@@@@@@@@@@@@
@@@@@@@@@@@@@@@@@@@@@@@@@@@@@@@@@@@@@@@@@@@@@@@@@@@@@@@@@@@@@@@.T@@@@@@@@@@@@@@@@@@@@@@@@@@@@@@@@@@@@@@@@@@@@@@@@@@@@@@@@@@@@@@@@@@@@@@@@@@@@@@@@@@@
@@@@@@@@@@@@@@@@@@@@@@@@@@@@@@@@@@@@@@@@@@@@@@@@@@@@@@@@@@@@@T.TTT@@@@@@@@@@@@@@@@@@@@@@@@@@@@@@@@@@@@@@@@@@@@@@@@@@@@@@@@@@@@@@@@@@@@@@@@@@@@@@@@@@
@@@@@@@@@@@@@@@@@@@@@@@@@@@@@@@@@@@@@@@@@@@@@@@@@@@@@@@@@@@@.T.TTT.@@@@@@@@@@@@@@@@@@@@@@@@@@@@@@@@@@@@@@@@@@@@@@@@@@@@@@@@@@@@@@@@@@@@@@@@@@@@@@@@@
@@@@@@@@@@@@@@@@@@@@@@@@@@@@@@@@@@@@@@@@@@@@@@@@@@@@@@@@@@T......T.T@@@@@@@@@@@@@@@@@@@@@@@@@@@@@@@@@@@@@@@@@@@@@@@@@@@@@@@@@@@@@@@@@@@@@@@@@@@@@@@@
@@@@@@@@@@@@@@@@@@@@@@@@@@@@@@@@@@@@@@@@@@@@@@@@@@@@@@@@@..T..T.T...T@@@@@@@@@@@@@@@@@@@@@@@@@@@@@@@@@@@@@@@@@@@@@@@@@@@@@@@@@@@@@@@@@@@@@@@@@@@@@@@
@@@@@@@@@@@@@@@@@@@@@@@@@@@@@@@@@@@@@@@@@@@@@@@@@@@@@@@@.T.TT..TTTT.T.@@@@@@@@@@@@@@@@@@@@@@@@@@@@@@@@@@@@@@@@@@@@@@@@@@@@@@@@@@@@@@@@@@@@@@@@@@@@@@
@@@@@@@@@@@@@@@@@@@@@@@@@@@@@@@@@@@@@@@@@@@@@@@@@@@@@@@.T.T@@.T..T.TT..@@@@@@@@@@@@@@@@@@@@@@@@@@@@@@@@@@@@@@@@@@@@@@@@@@@@@@@@@@@@@@@@@@@@@@@@@@@@@
@@@@@@@@@@@@@@@@@@@@@@@@@@@@@@@@@@@@@@@@@@@@@@@@@@@@@@T.T@@@@..TTTT..T.@@@@@@@@@@@@@@@@@@@@@@@@@@@@@@@@@@@@@@@@@@@@@@@@@@@@@@@@@@@@@@@@@@@@@@@@@@@@@
@@@@@@@@@@@@@@@@@@@@@@@@@@@@@@@@@@@@@@@@@@@@@@@@@@@@@.T.@@@@.TT..T.T..T.@@@@@@@@@@@@@@@@@@@@@@@@@@@@@@@@@@@@@@@@@@@@@@@@@@@@@@@@@@@@@@@@@@@@@@@@@@@@
@@@@@@@@@@@@@@@@@@@@@@@@@@@@@@@@@@@@@@@@@@@@@@@@@@@@.T.@@@@T...@@@TTT.T..@@@@@@@@@@@@@@@@@@@@@@@@@@@@@@@@@@@@@@@@@@@@@@@@@@@@@@@@@@@@@@@@@@@@@@@@@@@
@@@@@@@@@@@@@@@@@@@@@@@@@@@@@@@@@@@@@@@@@@@@@@@@@@@.TT@@@@@@T.T.@@T.TT...TT@@@@@@@@@@@@@@@@@@@@@@@@@@@@@@@@@@@@@@@@@@@@@@@@@@@@@@@@@@@@@@@@@@@@@@@@@
@@@@@@@@@@@@@@@@@@@@@@@@@@@@@@@@@@@@@@@@@@@@@@@@@....@@@@@@@@...T........TT..@@@@@@@@@@@@@@@@@@@@@@@@@@@@@@@@@@@@@@@@@@@@@@@@@@@@@@@@@@@@@@@@@@@@@@@
@@@@@@@@@@@@@@@@@@@@@@@@@@@@@@@@@@@@@@@@@@@@@@@@.TT.T@@@@@@@@.@.........TT...@@@@@@@@@@@@@@@@@@@@@@@@@@@@@@@@@@@@@@@@@@@@@@@@@@@@@@@@@@@@@@@@@@@@@@@
@@@@@@@@@@@@@@@@@@@@@@@@@@@@@@@@@@@@@@@@@@@@@@@T..TTT.@T@@@@.T@@..TTTTTT...TT..@@@@@@@@@@@@@@@@@@@@@@@@@@@@@@@@@@@@@@@@@@@@@@@@@@@@@@@@@@@@@@@@@@@@@
@@@@@@@@@@@@@@@@@@@@@@@@@@@@@@@@@@@@@@@@@@@@@@T..T@@@.T.@@@TT@@@TT.T.T...T...T..@@@@@@@@@@@@@@@@@@@@@@@@@@@@@@@@@@@@@@@@@@@@@@@@@@@@@@@@@@@@@@@@@@@@
@@@@@@@@@@@@@@@@@@@@@@@@@@@@@@@@@@@@@@@@@@@@@@...T@@@.TT.@TT@@@T..T..TTTT.TT..TT@@@@@@@@@@@@@@@@@@@@@@@@@@@@@@@@@@@@@@@@@@@@@@@@@@@@@@@@@@@@@@@@@@@@
@@@@@@@@@@@@@@@@@@@@@@@@@@@@@@@@@@@@@@@@@@@@T.T.T.T.T..T.T.@@@TT....TT.T.T.TT....T@@@@@@@@@@@@@@@@@@@@@@@@@@@@@@@@@@@@@@@@@@@@@@@@@@@@@@@@@@@@@@@@@@
@@@@@@@@@@@@@@@@@@@@@@@@@@@@@@@@@@@@@@@@@@@@.TT.TTTTTTTTT.@@@.TT......T....T...TT.@@@@@@@@@@@@@@@@@@@@@@@@@@@@@@@@@@@@@@@@@@@@@@@@@@@@@@@@@@@@@@@@@@
@@@@@@@@@@@@@@@@@@@@@@@@@@@@@@@@@@@@@@@@@@@.T.TTT...TT@@@TT@TT.T.......T..........T@@@@@@@@@@@@@@@@@@@@@@@@@@@@@@@@@@@@@@@@@@@@@@@@@@@@@@@@@@@@@@@@@
@@@@@@@@@@@@@@@@@@@@@@@@@@@@@@@@@@@@@@@@@@@TTTT....T.T@@@@.T.T.T.T.T.TT.......TT.TT..@@@@@@@@@@@@@@@@@@@@@@@@@@@@@@@@@@@@@@@@@@@@@@@@@@@@@@@@@@@@@@@
@@@@@@@@@@@@@@@@@@@@@@@@@@@@@@@@@@@@@@@@@@@@...T...T...@@@..T.T.T.@@TT..TTT..T.T.TTTT@@@@@@@@@@@@@@@@@@@@@@@@@@@@@@@@@@@@@@@@@@@@@@@@@@@@@@@@@@@@@@@
@@@@@@@@@@@@@@@@@@@@@@@@@@@@@@@@@@@@@@@@@@@@@TTT..T....TT..T.T...@@@@.T.T..T.T..TTT.@@@@@@@@@@@@@@@@@@@@@@@@@@@@@@@@@@@@@@@@@@@@@@@@@@@@@@@@@@@@@@@@
@@@@@@@@@@@@@@@@@@@@@@@@@@@@@@@@@@@@@@@@@@@@@T...T..T..TT.......@@@@@T...T....TT.T@@@@@@@@@@@@@@@@@@@@@@@@@@@@@@@@@@@@@@@@@@@@@@@@@@@@@@@@@@@@@@@@@@
@@@@@@@@@@@@@@@@@@@@@@@@@@@@@@@@@@@@@@@@@@@@@@T.T...T.TTT..TTTT@@@@@@..T.TTTT..TT@@@@@@@@@@@@@@@@@@@@@@@@@@@@@@@@@@@@@@@@@@@@@@@@@@@@@@@@@@@@@@@@@@@
@@@@@@@@@@@@@@@@@@@@@@@@@@@@@@@T.@@@@@@.@@@@@@@T.TTTT.TTT.....@@@@@@@@...T..TT.T@@@@@..@@T@@@@@@@@@@@@@@@@@@@@@@@@@@@@@@@@@@@@@@@@@@@@@@@@@@@@@@@@@@
@@@@@@@@@@@@@@@@@@@@@@@@@@@@@@@.T@@@.TT.T.T@@@@@T..TT.....TTT@@@@@@@@......T...@@@@@T.T@@T@@@@@@@@@@@@@@@@@@@@@@@@@@@@@@@@@@@@@@@@@@@@@@@@@@@@@@@@@@
@@@@@@@@@@@@@@@@@@@@@@@@@@@@@@@..@@.T..T.TTT@@@@@.T...TTTTT.@@@@@@@@...T...T@@@@@@@TT.TT..T@@@@@@@@@@@@@@@@@@@@@@@@@@@@@@@@@@@@@@@@@@@@@@@@@@@@@@@@@
@@@@@@@@@@@@@@@@@@@@@@@@@@@@@@@...T.T.T.TT..T@@@@........TT@@@@@@@@..TTTT.T.@@@@@@@T.......T@@@@@@@@@@@@@@@@@@@@@@@@@@@@@@@@@@@@@@@@@@@@@@@@@@@@@@@@
@@@@@@@@@@@@@@@@@@@@@@@@@@@@@@@....T....T.T.T.@@@.T....T...@@@@@@@..T.TT.T.@@@@@@...T.TTT...@@@@@@@@@@@@@@@@@@@@@@@@@@@@@@@@@@@@@@@@@@@@@@@@@@@@@@@@
@@@@@@@@@@@@@@@@@@@@@@@@@@@@@@TT....TTTT.....@@@@T.T.T..T.@@@@@@@T..TT.TTT@@@@@@TT......TTT..@@@@@@@@@@@@@@@@@@@@@@@@@@@@@@@@@@@@@@@@@@@@@@@@@@@@@@@
@@@@@@@@@@@@@@@@@@@@@@@@@@@@@TTTT...T.......@@@@.T....T...@@@@@@TTT..TT.T@@@@@@..TTT@@.........@@@@@@@@@@@@@@@@@@@@@@@@@@@@@@@@@@@@@@@@@@@@@@@@@@@@@
@@@@@@@@@@@@@@@@@@@@@@@@@@@@@TTTT..T..TTTT.@@@.......T..TT.@TT@..T.T....@@@@@@...T.@@@@T....TTT.@@@@@@@@@@@@@@@@@@@@@@@@@@@@@@@@@@@@@@@@@@@@@@@@@@@@
@@@@@@@@@@@@@@@@@@@@@@@@@@@@.T..T...TT.TT.@@@TTT.T.....TT...T.TT.TT.TTT@@@@@@T.T..@@@@@TT.TT.....@@@@@@@@@@@@@@@@@@@@@@@@@@@@@@@@@@@@@@@@@@@@@@@@@@@
@@@@@@@@@@@@@@@@@@@@@@@@@@T...T....TTTT.T@@@.TT.T..T.....TT.T..TT...T@@@@@@TT.T.T@@@@TT.T.TTTT.T..@@@@@@@@@@@@@@@@@@@@@@@@@@@@@@@@@@@@@@@@@@@@@@@@@@
@@@@@@@@@@@@@@@@@@@@@@@@@@.T.TT..T...T..@@@TTT.TT..T.TT.TT...T.......@@@@@@...TT@@@@TT..TTT....T.T.@@@@@@@@@@@@@@@@@@@@@@@@@@@@@@@@@@@@@@@@@@@@@@@@@
@@@@@@@@@@@@@@@@@@@@@@@@.T..T....T.T.TT@@@.T...TT...T.T.TT..TTT.TT..@@@@@@.T..T@@@@.TTTTT..TTTTT..T.@@@@@@@@@@@@@@@@@@@@@@@@@@@@@@@@@@@@@@@@@@@@@@@@
@@@@@@@@@@@@@@@@@@@@@@@@TT....T.TT.T.T.@@TTTT......TTT...T...T....T@@@@@@TTTT.@@@@T.TTT.TT..T.....T..@@@@@@@@@@@@@@@@@@@@@@@@@@@@@@@@@@@@@@@@@@@@@@@
@@@@@@@@@@@@@@@@@@@@@@@TTTTTT..TTTTT..TT.T.T...@@.T..TTTT....TTT..@@@@@@.T..T@@@@...@@@...T..TTTT.T..T@@@@@@@@@@@@@@@@@@@@@@@@@@@@@@@@@@@@@@@@@@@@@@
@@@@@@@@@@@@@@@@@@@@@......T....TT@@@..TT.T...@@@@T...T..TT..TT.T@@@@@@@...T@@@@...@@@@@...TTT@........@@@@@@@@@@@@@@@@@@@@@@@@@@@@@@@@@@@@@@@@@@@@@
@@@@@@@@@@@@@@@@@@@@@T....T...T..@@@@@.T..TTT@@@@@@T..T.T.TT..TT@@@@@.T.T.T@@@@TTT@@@@@@.@TTT@@@.....T.T@@@@@@@@@@@@@@@@@@@@@@@@@@@@@@@@@@@@@@@@@@@@
@@@@@@@@@@@@@@@@@@@@...TT..T.T.T@@@@@.T.T..T@@@@@@@......TT....@@@@@....T.@@@@TTT@@@@@@@@@.T@@@@..T.TT...@@@@@@@@@@@@@@@@@@@@@@@@@@@@@@@@@@@@@@@@@@@
@@@@@@@@@@@@@@@@@@@@@.TT..TT.TT@@@@@.TT..TT@@@@@@@@T...T.TTT.T.@@@@..TT.T@@@@T.TT@@@@@@@@..@@@@TT...T.T..T@@@@@@@@@@@@@@@@@@@@@@@@@@@@@@@@@@@@@@@@@@
@@@@@@@@@@@@@@@@@@@@@T.T...T.T@@@@@....T..@@@@@@@@@...TT.TTT.TTT@@@.T.T...@@T..TT@@@@@@@TT@@@@..TT...TT..TTT@@@@@@@@@@@@@@@@@@@@@@@@@@@@@@@@@@@@@@@@
@@@@@@@@@@@@@@@@@@@@@@.TTT.TT@@@@@TT.T..T@@@@@@@@...T...TT.T..T..@@T...T..TTTTT..TT@@.@..@@@@..T..T.TTT...T.@@@@@@@@@@@@@@@@@@@@@@@@@@@@@@@@@@@@@@@@
@@@@@@@@@@@@@@@@@@@@@@@TT.TT@@@@@...TT.T@@@@@@@@TTT.T...T.@TT.T..........T....TT...TTTT.@@@@.T....TT..T.T...TT@@@@@@@@@@@@@@@@@@@@@@@@@@@@@@@@@@@@@@
@@@@@@@@@@@@@@@@@@@@@@@@...@@@@@..TT.T.T@@@@@@@TTT.T....T@@@T.TTT.T.....TTTTT....TTT..T@@@@..@@TTT..T....TT..T@@@@@@@@@@@@@@@@@@@@@@@@@@@@@@@@@@@@@@
@@@@@@@@@@@@@@@..T@@@@@@@..@@@@......T..@@@@@@.T..TT.T..@@@@@T..T......TTT....T.T..TT.@@@@..@@@@.....T@.......T@@@@@@@@@@@@@@@@@@@@@@@@@@@@@@@@@@@@@
@@@@@@@@@@@@@@@T.T.@@@@@@@@@@@..T.T.....@@@@@TTT..T...T@@@@@@T....T...T.TT...TT....T.@@@@..@@@@@@TT.T@@@....TTT.@@@@@@@@@@@@@@@@@@@@@@@@@@@@@@@@@@@@
@@@@@@@@@@@@@@@....T.@@@@@@@@T.....TT..TT@@@TTTT.T.T..@@@@@@@T.........T..T.T...T.T.@@@@T.@@@@@@@T..@@@@.TTTTTT..@@@@@@@@@@@@@@@@@@@@@@@@@@@@@@@@@@@
@@@@@@@@@@@@@@@@.T..T.@@@@@@..T.T.T.TTT.TTT..T..TT..T@@@@@@T.TT.....T...TTTT.TT.T..@@@@TT@@@@@@@.TT@@@@TT.....T...@@@@@@@@@@@@@@@@@@@@@@@@@@@@@@@@@@
@@@@@@@@@@@@@@@@T...TT.@@@@@@@..TT...TTTTT....T.T..T@@@@@@.....T.T..T......TTT@@T.T@@@.TT.@@@@@.TT@@@@.TT.T.TTT.T.T@@@@@@@@@@@@@@@@@@@@@@@@@@@@@@@@@
@@@@@@@@@@@@@@@..TT.T..T@@@@@@..TT.....TTT.T...T.T.@@@@@@...TT...TTTTTTT..T..@@@@..T@..T.TT@@@.TT@@@@....T...T....TTT@@@@@@@@@@@@@@@@@@@@@@@@@@@@@@@
@@@@@@@@..@@@@.T...@.T..T@@@@@@...TTT.......T.T.T.@@@@@@.......TT..TT.T...T.@@@@@@T....TT..TTTTT@@@@TT.TT..TT..TTTT..T@@@@@@@@@@@@@@@@@@@@@@@@@@@@@@
@@@@@@@....@@....T@@@...T.@@@@@.T..T.TT......T...@@@@@@@T..TTT..@T@@..T...T@@@..@@@..T...T..T..@@@@..@@@T........TTT.T.T@@@@@@@@@@@@@@@@@@@@@@@@@@@@
@@@@@@@@TT.T.TTT.@@@@@.....@@@@TTTT.......T.....@@@@@TT.T......@@@@@@.T..T@@@.T.T@@@....TT.TT.@@@@@@@@@@@TTTT.T.T..T.TT.T@@@@@@@@@@@@@@@@@@@@@@@@@@@
@@@@@@@@@...TTTTT@@@@@@T....@T..T..T..T.T.T..T.@@@@@.TT..T..T..@@@@@@TTT.@@@...T.T@@@.TTT.T..@@@@@@@@@@@@..T....@..T..TT..@@@@@@@@@@@@@@@@@@@@@@@@@@
@@@@@@@@@@.TTTTTT.@@@@@@TT.TT...@@@..T.TTT.TTT@@@@@T.....T...T@@@@@@T..T@@@....TT.T@@@..T...@@@@.@@@@@@@@@..T.T@@@TT..TTT.T@@@@@@@@@@@@@@@@@@@@@@@@@
@@@@@@@@@@@T.T.TT.T@@@@@T.T.TT..@@@@T.....TT.@@@@@@.T.........T@@@@..TT@@@T..TT.T.TT@@@....@@@@..@T@@@@@@@..TT@@@@TTT.....TT@@@@@@@@@@@@@@@@@@@@@@@@
@@@@@@@@@@@@TTTT..T.@@@..@.T...T@@@@@TT...T.@@@@@@@.T........T.T@@....@@@TT.....TT.T.@@@TTT@@@.TTT.@@@@@@T...@@@@T.T.T.TT..TT@@@@@@@@@@@@@@@@@@@@@@@
@@@@@@@@@@@@@T.TT..T.@..@@@T.T....@@@@....T@@@@@@@@@..T.T.T.T.......T@@@TT.TT.TT..T.T.@@TT..@.T.T.T.@@@@....@@@@...T.T....T..@@@@@@@@@@@@@@@@@@@@@@@
@@@@@@@@@@@@@@.T......T@@@@@...TT.T@@@@TT.@@@@@@@@T.TT...T.T..T......@@.TT..T...TT...T@@@...T.TT.....@@TT..@@@@...T..TTT...T@@@@@@@@@@@@@@@@@@@@@@@@
@@@@@@@@@@@@@@@.....TT.@@@@@@..T...T@@@@T@@@@@@@@TTT.TT......TT..T..@@...TT.T.T@@.T.TTT@@@T...T......TT...@@@@T.....T....TT@@@@@@@@@@@@@@@@@@@@@@@@@
@@@@@@@@@@@@@@@@T....T.T.@@@@...T..T@@@@@@@@@@@@...TT..TTT..TT....T@@@T....TT..@@@.T...@@@TT..T.TTTT...TT@@@@TTTT.T..T.T..@@@@@@@.@@@@@@@@@@@@@@@@@@
@@@@@@@@@@@@@@@@@.T..TTT..@@.T.T.T.@@@@@@@@@@@@.TTT..@@TT.TTT.T.T.@@@@T..TTTTT..@@T..T.T@....T.T..T.....@@@@....T.TTTT..T@@@@@@..T.@@@@@@@@@@@@@@@@@
@@@@@@@@@@@@@@@@@@....TTT...TTT..T@@@@@@@@@@@@......@@@@T..T.....@@@@@@..T.T.TTT@@T.T...T....T.T.TT..T.@@@@..TT..T..T..T@@@@@@@...@@@@@@@@@@@@@@@@@@
@@@@@@@@@@@@@@@@@@@T.T.T.T.TTT...@@@@@@@@@@@@.T...T@@@@@@T..T..TT@@@@@@@..TTT..T@@@....T@@.....TTT...T@@@@T...T.....TTT@@@@@@@@TTT@@@@@@@@@@@@@@@@@@
@@@@@@@@@@@@@@@@@@@@..T....T..TT@@@@@@@@@@@@@TT.T.@@@@@@@@@...TT.@@@@@@@@@@....@@@@..T..@@.TT.T.T..T.@@@@T..T..T.T..TT@@@@@@@@@...T@@@@@@@@@@@@@@@@@
@@@@@@@@@@@@@@@@@@@@@...T..TTT.@@@@@@@@@@@@@@...T@@@@@@@@@@@T...T.@@@@@@@@@@@@@@T.@@T..TT.T..T.TTT...@@@..T..T...T...@@@@@@@@T...TT.@@@@@@@@@@@@@@@@
@@@@@@@@@@@@@@@@@@@@@@...T.TT.@@@@@@@@@@@@..TT@@@@@@@@@@@@@@@T..T.T@@@@@@@@@@....T@@...T........T.....@.TT..TT......@@@@@@@@T.TT.T..T@@@@@@@@@@@@@@@
@@@@@@@@@@@@@@@@@@@@@@@TT....@@@@@@@@@@@@..T..@@@@@@@@@@@@@@@....TTT@@@@@@@@...TTT.@T.T.TTT...TT..TT...TT.TT.......@@@@@@@@@.TT.T...T.@@@@@@@@@@@@@@
@@@@@@@@@@@@@@@@@@@@@@@@T...@@@@@@@@@@@@TT..T.@@@@@@@@@@@@@@T......TT.@@@@@..T.TT...TT..T....T..T..T....TT.T.T..TT@@@@@@@@..T.T.....TTT@@@@@@@@@@@@@
@@@@@@@@@@@@@@@@@@@@@@@@@TT@@@@@@@@@.@@..T.TT..@@@@@@@@@@@@TTT..TT..T..@@@..T.TTTTT......T.TT......TT.TTT...T...T@@@@@@@@..T.T..TT.TT..T@@@@@@@@@@@@
@@@@@@@@@@@@@@@@@@@@@@@@@@@@@@@@@@@@T..TTTT.T.T.@@@@@@@@@@..T.T@@..T...T@TT..T.......TTTT......T..T.T.TT.T.T..TT@@@@@@@@.....TTTTTT....T.@@@@@@@@@@@
@@@@@@@@@@@@@@@@@@@@@@@@@@@@@@@@@@@@T..T.......T@@@@@@@@@...T.@@@@@.........T.T....T..T...TTT.....T.T.T.TTT.T..@@@@@@@@T.T..TT...T.T..TTT.@@@@@@@@@@
@@@@@@@@@@@@@@@@@@@@@@@@@@@@@@@@@@T.TT...T...T.T.@@@@@@......@@@@@@@.....T......TT..T.....TT......T..T.T...TTT@@@@@@@@.........TTTT.T..T.T.@@@@@@@@@
@@@@@@@@@@@@@@@@@@@@@@@@@@@@@@@@@...T.TT.TTTT.T.@@@@@@@.T..T@@@@@@@@@TTT...TTT..T..........TTTTTT.TT.T.TT..T.@@@@@@@@.T.TTT....@TTTT........@@@@@@@@
@@@@@@@@@@@@@@@@@@@@@@@@@@@@@@@@.T....T.....T.T@@@@@@@@T...@@@@@@@@@@@T..TT..T.T.T.T....T...T.T.T..TTT.T....@@@@@@@@...T.T....@@@.TT.TT.TT.T.@@@@@@@
@@@@@@@@@@@@@@@@@@@@@@@@@@@@@@@.T.TTT........T@@@@@@@@@....@@@@@@@@@@@@.T....TTT.T.TTT.T..T..T.TT......TTT.@@@@@@@@T.T...TT.T@@@@@TT.TT.TTT.T.@@@@@@
@@@@@@@@@@@@@@@@@@@@@@@@@@@@@@@@.....T....T.T@@@@@@@TT.T.@@@@@@@@@@@@@@@.TT.T.TT.TT..T.TT.TTTT.TTT..T.T...@@@@@@@@....T.T.T..T@@@@T..T....T..@@@@@@@
@@@@@@@@@@@@@@@@@@@@@@@@@@@@@@@@@.T...T.T.TT@@@@@@@.TT..@@@@@@@@@@@@@@@.TT.T.T..T..T.T.T.T.T.T.TTTT.TT..T@@@@@@@@T..T.T.T.T....@@.........T.@@@@@@@@
@@@@@@@@@@@@@@@@@@@@@@@@@@@@@@@@@@.TT.TT.TT@@@@@@@@...TT.@@@@@@@@@@@@T.T.T.T...T....T.TTT.T...TT..T....TT@@@@@@@TT..TTT.TTTT..TT........T.T@@@@@@@@@
@@@@@@@@@@@@@@@@@@@@@@@@@@@@@@@@@@@TTTT.T@@@@@@TTT....T...@@@@@@@@@@...TT@@T..T..TTT..TT.....T...T.TT.T..T@@.@@@...TT@TT..TT.....T..T.T...@@@@@@@@@@
@@@@@@@@@@@@@@@@@@@@@@@@@@@@@@@@@@@@..T.@@@@@@@TTT...T...T@@@@@@@@@..T..@@@@.T.TT...T.TT..T...T......T.....@TT.TT...@@@..TT.....T....T.T.@@@@@@@@@@@
@@@@@@@@@@@@@@@@@@@@@@@@@@@@@@@@@@@@@T.@@@@@@@..TTTTT.TTT..@@@@@@@.TT..@@@@@@T.TTT.T..TT.TTT..TT.TT....T.T..T......@@@@@T.T.....TTT..T..@@@@@@@@@@@@
@@@@@@@@@@@@@@@@@@@@@@@@@@@@@@@@@@@@@@@@@@@@@.T...T.TT.TT..@@@@@@.T..T@@@@@@@@T.......TT..T........T..TTT.T......T.T@@@@@..T.T..TT...TT@@@@@@@@@@@@@
@@@@@@@@@@@@@@@@@@@@@@@@@@@@@@@@@@@@@@@@@@@..TT...T..T.T.T@@@@@@@T.T.@@@@@@@@@@.....T.......T.......TTTTT.T.TTTTTT...@@@@@TTTT.....T.T@@@@@@@@@@@@@@
@@@@@@@@@@@@@@@@@@@@@@@@@@@@@@@@@@@@@@@@@@...T.........T.@@@@@@@@...@@@@@@@@@@@@...T...T.T.....TT..T.T.T..TT....T....T@@@@@....T..T.T@@@@@@@@@@@@@@@
@@@@@@@@@@@@@@@@@@@@@@@@@@@@@@@@@@@@@@@@@..T.TT.........@@@@@@@.T.T@@@@@@@@@@@@@@.T..T..T.T.T...T.TTT......T...TT..T...@@@@@.T..T.T.@@@@@@@@@@@@@@@@
@@@@@@@@@@@@@@@@@@@@@@@@@@@@@@@@@@@@@@@@@@T.TTT.T.....@@@@@@@TT....@@@@@@@@@@@@@@TTT..TT.T.TT.T.........T....TT.T@TT.T..@@@@@T.T.T.@@@@@@@@@@@@@@@@@
@@@@@@@@@@@@@@@@@@@@@@@@@@@@@@@@@@@@@@@@@@@..TTT.T.T.@@@@@@@@..T.T@@@@@@@@@@@@@@TT....TT.TT..@.T...TTTTTT..T.TTTT@@...T.T@@@@@...T@@@@@@@@@@@@@@@@@@
@@@@@@@@@@@@@@@@@@@@@@@@@@@@@@@@@@@@@@@@@@@@T..T...@@@@@@T@@@..TTTT@@@@@@@@@@@@.T..TT.......@@@T.T.T...T..T.T.T.TT@@TTT..T@@@@@..@@@@@@@@@@@@@@@@@@@
@@@@@@@@@@@@@@@@@@@@@@@@@@@@@@@@@@@@@@@@@@@@@.T.T.@@@@@@@..TTTT.T...@@@@@@@@@@......TTT..T.@@@@@TT.TTT.TT.T..TT.TT.@@..TTT.@@@@@@@@@@@@@@@@@@@@@@@@@
@@@@@@@@@@@@@@@@@@@@@@@@@@@@@@@@@@@@@@@@@@@@@@.T.@@@@@@@@....T...T..@@@@@@@@@TT.TT.T.TT...@@@@@@..TTT..T...@@.....TT@TTTT...@@@@@@@@@@@@@@@@@@@@@@@@
@@@@@@@@@@@@@@@@@@@@@@@@@@@@@@@@@@@@@@@@@@@@@@@.@@@@@@@.T.TTTTT..T.T@@@@@@@@TT....T.TT...@@@@@@@T.T..TT...@@@@.T..T.TTTTTT.T@@@@@@@@@@@@@@@@@@@@@@@@
@@@@@@@@@@@@@@@@@@@@@@@@@@@@@@@@@@@@@@@@@@@@@@@@@@@@@@.TTTTT.T..T.T@@@@@@@@..T....T..TT.@@@@@@.T...T....TT@@@@T...TT..T.T.T@@@@@@@@@@@@@@@@@@@@@@@@@
@@@@@@@@@@@@@@@@@@@@@@@@@@@@@@@@@@@@@@@@@@@@@@@@@@@@@....T...T.T..@@@@@@@@@.T....T....T@@@@@@T......T.TT...@@.T..TT.TT....@@@@@@@@@@@@@@@@@@@@@@@@@@
@@@@@@@@@@@@@@@@@@@@@@@@@@@@@@@@@@@@@@@@@@@@@@@@@@@..TTT.T..T..TT@@@@@@@@@@.T...TTT...@@@@@@@...TT...T...T....T...T..T..T@@@@@@@@@@@@@@@@@@@@@@@@@@@
@@@@@@@@@@@@@@@@@@@@@@@@@@@@@@@@@@@@@@@@@@@@@@@@@@@..T..TT.T..T.@@@@@@@@.T.T.@.......@@@@@@@@.TTT....T..T....T.TT...T.TT@@@@@@@@@@@@@@@@@@@@@@@@@@@@
@@@@@@@@@@@@@@@@@@@@@@@@@@@@@@@@@@@@@@@@@@@@@@@@@@@@T.T.TT.TTT.@@@@@@@@.TT...@@.TT..@@@@@@@@T...T.T....@@TT.TT..T.TT..T@@@@@@@@@@@@@@@@@@@@@@@@@@@@@
@@@@@@@@@@@@@@@@@@@@@@@@@@@@@@@@@@@@@@@@@@@@@@@@@@@@@...T..TT.@@@@@@@@.T.TT..@@@T.T@@@@@@@@.TTT..T.T....@@T.T.....TTT.TT@@@@@@@@@@@@@@@@@@@@@@@@@@@@
@@@@@@@@@@@@@@@@@@@@@@@@@@@@@@@@@@@@@@@@@@@@@@@@@@@@@@......T@@@@@@.....TTTTTT@@@@@@@@@@@@.T.T...TTT..T.T@@...T..T...T..T@@@@@@@@@@@@@@@@@@@@@@@@@@@
@@@@@@@@@@@@@@@@@@@@@@@@@@@@@@@@@@@@@@@@@@@@@@@@@@@@@@@TT.T@@@@@@@@....T...T.T@@@@@@@@@@@......T@@T...T..T@@.T.TT....TT.T@@@@@@@@@@@@@@@@@@@@@@@@@@@
@@@@@@@@@@@@@@@@@@@@@@@@@@@@@@@@@@@@@@@@@@@@@@@@@@@@@@@@..@@@@@@@@...TT.TT.TT.@@@@@@@@@@T.T..TT@@@@T.....TT@.T.TTT...T.T@@@@@@@@@@@@@@@@@@@@@@@@@@@@
@@@@@@@@@@@@@@@@@@@@@@@@@@@@@@@@@@@@@@@@@@@@@@@@@@@@@@@@@@@@@@@@@@...TT..T...@@@@@@@@@@@T...T...@@@@....T...T..TT...T.T@@@@@@@@@@@@@@@@@@@@@@@@@@@@@
@@@@@@@@@@@@@@@@@@@@@@@@@@@@@@@@@@@@@@@@@@@@@@@@@@@@@@@@@@@@@@@@@.T..T..TT..@@@@@@@@@..TT......TT@@@@...TTT..T..TTTTTT@@@@@@@@@@@@@@@@@@@@@@@@@@@@@@
@@@@@@@@@@@@@@@@@@@@@@@@@@@@@@@@@@@@@@@@@@@@@@@@@@@@@@@@@@@@@@@@.T.T...T..T@@@@@@@@@TTT...T.T.TT..@@@@.TT...TT.....T.@@@@@@@@@@@@@@@@@@@@@@@@@@@@@@@
@@@@@@@@@@@@@@@@@@@@@@@@@@@@@@@@@@@@@@@@@@@@@@@@@@@@@@@@@@@@@@@T.....T....@@@@@@@@@TT.T....T.TTT.TT@@@@..TT...T..TT.@@@@@@@@@@@@@@@@@@@@@@@@@@@@@@@@
@@@@@@@@@@@@@@@@@@@@@@@@@@@@@@@@@@@@@@@@@@@@@@@@@@@@@@@@@@@@@TT.TTT.....T@@@@@@@@....TT.TT.T..T.T...@@@@T.T...@@@@.@@@@@@@@@@@@@@@@@@@@@@@@@@@@@@@@@
@@@@@@@@@@@@@@@@@@@@@@@@@@@@@@@@@@@@@@@@@@@@@@@@@@@@@@@@@@@@@@...T..T...@@@@@@@@.TTT..T.TTT.T....T.T.@@@@.....@@@@@@@@@@@@@@@@@@@@@@@@@@@@@@@@@@@@@@
@@@@@@@@@@@@@@@@@@@@@@@@@@@@@@@@@@@@@@@@@@@@@@@@@@@@@@@@@@@@@@@T...T...@@@@@@@@T..TT.TT...TT.TT..T..TT@@@@T.T@@@@@@@@@@@@@@@@@@@@@@@@@@@@@@@@@@@@@@@
@@@@@@@@@@@@@@@@@@@@@@@@@@@@@@@@@@@@@@@@@@@@@@@@@@@@@@@@@@@@@@@@..T.TT@@@@@@@@TT.....TT.........T.T..T.@@@@.@@@@@@@@@@@@@@@@@@@@@@@@@@@@@@@@@@@@@@@@
@@@@@@@@@@@@@@@@@@@@@@@@@@@@@@@@@@@@@@@@@@@@@@@@@@@@@@@@@@@@@@@@@..T.@@@@@@@@@..T.....TTTTT........T.T.T@@@@@@@@@@@@@@@@@@@@@@@@@@@@@@@@@@@@@@@@@@@@
@@@@@@@@@@@@@@@@@@@@@@@@@@@@@@@@@@@@@@@@@@@@@@@@@@@@@@@@@@@@@@@@@@TT.@@@@@T@@.........T.@@@T.T....T.T...T@@@@@@@@@@@@@@@@@@@@@@@@@@@@@@@@@@@@@@@@@@@
@@@@@@@@@@@@@@@@@@@@@@@@@@@@@@@@@@@@@@@@@@@@@@@@@@@@@@@@@@@@@@@@@@@.@@@@@.T.T..T...T..T@@@@@T.TT..T...T.T@@@@@@@@@@@@@@@@@@@@@@@@@@@@@@@@@@@@@@@@@@@
@@@@@@@@@@@@@@@@@@@@@@@@@@@@@@@@@@@@@@@@@@@@@@@@@@@@@@@@@@@@@@@@@@@@@@@@T..T.....T.....@@@@..TT.T.T..T.@@@@@@@@@@@@@@@@@@@@@@@@@@@@@@@@@@@@@@@@@@@@@
@@@@@@@@@@@@@@@@@@@@@@@@@@@@@@@@@@@@@@@@@@@@@@@@@@@@@@@@@@@@@@@@@@@@@@@TTT.T......T..T.T@@.....TT.....T@@@@@@@@@@@@@@@@@@@@@@@@@@@@@@@@@@@@@@@@@@@@@
@@@@@@@@@@@@@@@@@@@@@@@@@@@@@@@@@@@@@@@@@@@@@@@@@@@@@@@@@@@@@@@@@@@@@@...T.T..TTTT..T.TTT..T...TTT....@@@@@@@@@@@@@@@@@@@@@@@@@@@@@@@@@@@@@@@@@@@@@@
@@@@@@@@@@@@@@@@@@@@@@@@@@@@@@@@@@@@@@@@@@@@@@@@@@@@@@@@@@@@@@@@@@@@@@@TTTT....T.T......TTT....T....T@@@@@@@@@@@@@@@@@@@@@@@@@@@@@@@@@@@@@@@@@@@@@@@
@@@@@@@@@@@@@@@@@@@@@@@@@@@@@@@@@@@@@@@@@@@@@@@@@@@@@@@@@@@@@@@@@@@@@@@@....TT..TT......T..T.T..TT.T@@@@@@@@@@@@@@@@@@@@@@@@@@@@@@@@@@@@@@@@@@@@@@@@
@@@@@@@@@@@@@@@@@@@@@@@@@@@@@@@@@@@@@@@@@@@@@@@@@@@@@@@@@@@@@@@@@@@@@@@@@.TTTT..TTTTT..T..TTTT..TTT@@@@@@@@@@@@@@@@@@@@@@@@@@@@@@@@@@@@@@@@@@@@@@@@@
@@@@@@@@@@@@@@@@@@@@@@@@@@@@@@@@@@@@@@@@@@@@@@@@@@@@@@@@@@@@@@@@@@@@@@@@@@T..T..T..TTT.....T..T..T@@@@@@@@@@@@@@@@@@@@@@@@@@@@@@@@@@@@@@@@@@@@@@@@@@
@@@@@@@@@@@@@@@@@@@@@@@@@@@@@@@@@@@@@@@@@@@@@@@@@@@@@@@@@@@@@@@@@@@@@@@@@@@..TT.T....T..T.TT..T..@@@@@@@@@@@@@@@@@@@@@@@@@@@@@@@@@@@@@@@@@@@@@@@@@@@
@@@@@@@@@@@@@@@@@@@@@@@@@@@@@@@@@@@@@@@@@@@@@@@@@@@@@@@@@@@@@@@@@@@@@@@@@@@@.T.....T.T.T.TT..T..@@@@@@@@@@@@@@@@@@@@@@@@@@@@@@@@@@@@@@@@@@@@@@@@@@@@
