type octile
height 80
width 80
map
@@@@@@@@@@@@@@@@@@@@@@@@@@@@@@@@@@@@@@@@@@@@@@@@@@@@@@@@@@@@@@@@@@@@@@@@@@@@@@@@
@@@@@@@@@@@@@@@@@@@@@@@@@@@@@@@@@@@@@@@@@@@@@@@@@@@@@@@@@@@@@@@@@@@@@@@@@@@@@@@@
@@@@@@@@@@@@@@@@@@@@@@@@@@@@@@@@@@@@@@@@@@@@@@@@@@.TT.T.TT...T.TT..TT..T..T...@@
@@@@@@@@@@@@@@@@@@@@@@@@@@@@@@@@@@@@@@@@@@@@@@@@@..T.T.TT.T.T..T....TT.TTTT...@@
@@@@@@@@@@@@@@@@@@@@@@@@@@@@@@@@@@@@@@@@@@@@@@@@...TTT.....TT..TT.T.TTTTTTT...@@
@@@@@@@@@@@@@@@@@@@@@@@@@@@@@@@@@@@@@@@@@@@@@@@TTT..TT.TT.T....T.T....TT.T....@@
@@@@@@@@@@@@@@@@@@@@@@@@@@@@@@@@@@@@@@@@@@@@@@T.T..T......T..TTT..T..TT.......@@
@@@@@@@@@@@@@@@@@@@@@@@@@@@@@@@@@@@@@@@@@@@@@.TT...T..TT.TT.......TT....T.T.T.@@
@@@@@@@@@@@@@@@@@@@@@@@@@@@@@@@@@@@@@@@@@@@@TTTT...T.....T.T.T....TT.T......T.@@
@@@@@@@@@@@@@@@@@@@@@@@@@@@@@@@@@@@@@@@@@@@T.T..T.TT..T.T.TTTTTT..T.....T...TT@@
@@@@@@@@@@@@@@@@@@@@@@@@@@@@@@@@@@@@@@@@@@..T.TT.....TT.....TT.T..TT...TTTT.T.@@
@@@@@@@@@@@@@@@@@@@@@@@@@@@@@@@@@@@@@@@@@@..T..TTT.TT...T.T.T.TT......T.T.....@@
@@@@@@@@@@@@@@@@@@@@@@@@@@@@@@@@@@@@@@@@@@@..TTT......T.T......T..T...TTT.....@@
@@@@@@@@@@@@@@@@@@@@@@@@@@@@@@@@@@@@@@@@@@@@...T.T.T.T...TT.......T.T.T.......@@
@@@@@@@@@@@@@@@@@@@@@@@@@@@@@@@@@@@@@@@@@@@@.T.T.TT...TT..TT.T.TT...T.TT..TT..@@
@@@@@@@@@@@@@@@@@@@@@@@@@@@@@@@@@@@@@@@@@@@@@..T...TT.TTT.....T.TTT.T........T@@
@@@@@@@@@@@@@@@@@@@@@@@@@@@@@@@@@@@@@@@@@@@@@@T.TT..T...TTT.TT.....T...T....T.@@
@@@@@@@@@@@@@@@@@@@@@@@@@@@@@@@@@@@@@@@@@@@@@@T..T.TT..T.TT...TT...T.TT...TT.T@@
@@@@@@@@@@@@@@@@@@@@@@@@@@@@@@@@.@@@@@@@@@@@@@@....T..T.......T.TT.....T.T....@@
@@@@@@@@@@@@@@@@@@@@@@@@@@@@@@@TT.@@@@@@@@@@@@@@.TT...T..T.....T..T.TTT..TTTTT@@
@@@@@@@@@@@@@@@@@@@@@@@@@@@@@@.T..@@@@@@@@@T@@@@@.TT.T......T.T.TT.T...TTTTT.@@@
@@@@@@@@@@@@@@@@@@@@@@@@@@@@@.TTTT@@@@@@@@TTT@@@.T..TT......TTTT.TTTT......T@@@@
@@@@@@@@@@@@@@@@@@@@@@@@@@@@...TTT.T.@@@@.T..@@..TT......TTTT.T.TTT..T.....@@@@@
@@@@@@@@@@@@@@@@@@@@@@@@@@@..T..T..TT@@@@@......T...T.TT...TT.TTT@@@@@@@@.@@@@@@
@@@@@@@@@@@@@@@@@@@@@@@@T@TT.TT..T.T.TT@@@.T.TT..T.T...TTT.T....T@@@@@@@@@@@@@@@
@@@@@@@@@@@@@@@@@@@@@@@TT....TT......T.T@...T.......T...T....T.TT@@@@@@@@@@@@@@@
@@@@@@@@@@@@@@@@@@@@@@T.T.TT........T...TTT.T.........T..TT.T..TTT.T.TT@@@@@@@@@
@@@@@@@@@@@@@@@@@@@@@T..T..TTT..TTT....TTTTT.T.T.T..TT..TT.T.@@@...TTT@@@@@@@@@@
@@@@@@@@@@@@@@@@@@@@...T..T..TT..T...T........TT.T.T......@@@@@@.....@@@@@@@@@@@
@@@@@@@@@@@@@@@@@@@..T.T.T.T....TTT...T.T..T...TT.T.....@@@@@@@@@TT.@@@@@@@@@@@@
@@@@@@@@@@@@@@@@@@@@@..TT.T..T..T.T.T.T..T.TT..T.T.T.T@@@@@@@@@@@TT@@@@@@@@@@@@@
@@@@@@@@@@@@@@@@@@@@@@@@@..T......TT.TTTT.T....TT.TT..@@@@@@@@@@@T@@@@@@@@@@@@@@
@@@@@@@@@@@@@@@@@@@@@@@@@@TT.TTT.TTTTTT..TTT...TTTT...@@@@@@@@@@@@@@@@@@@@@@@@@@
@@@@@@@@@@@@@@@@@T@@@@@@@@@@..T.T.T....TT...T....TT...@@..@@@..@@@@@@@@@@@@@@@@@
@@@@@@@@@@@@@@@@T.@@@@@@@@@@..T.T..TT....TTTTTTTTTTT..T.....T.@@@@@@@@@@@@@@@@@@
@@@@@@@@@@@@@@@@..@@@@@@@@@@T.T.TTT.T...T.T..T.TT......T..T..@@@@@@@@@@@@@@@@@@@
@@@@@@@@@@@@@@@@@T..@@@T@@@.TTT..TTT....TTT.TT.T....T...TT..@@@@@@@@@@@@@@@@@@@@
@@@@@@@@@@@@@@@@@T.T....T@.....TT..T..T..T..T.T..TT..T....T@@@@@@@@@@@@@@@@@@@@@
@@@@@@@@@@@@@@@@.T.T....T.TT..T.......T..TTT.TTT....T.T..@@@@@@@@@@@@@@@@@@@@@@@
@@@@@@@@@@@@@@@...TTT...T....T.TT..T..TT..TTTT...T.T@@@@@@@@@@@@@@@@@@@@@@@@@@@@
@@@@@@@@@@@@@@..T.T.......T...TTT.....T.TT.TTT...TT.@@@@@@@@@@@@@@@@@@@@@@@@@@@@
@@@@@@@@T@@...T...T.....TT...T...T..TT...T..T..TT...@@@@@@@@@@@@@@@@@@@@@@@@@@@@
@@@@@@@T.TT...TTTTT....T....TTT.T.TT.....T..T.T...@@@@@@@@@@@@@@@@@@@@@@@@@@@@@@
@@@@T....TT..T.TTT....T.TTT...T...T.T..T.TT.T...T.@@@@@@@@@@@@@@@@@@@@@@@@@@@@@@
@@@.T......T.T.TT...T.........T.TT.T....T.T..T..T.@@@@@@@@@@@@@@@@@@@@@@@@@@@@@@
@@.T.T.....T.T.TTT..TT.T......T.TT......T.T.T...TT@@TT@@@@@@@@@@@@@@@@@@@@@@@@@@
@@T..TTTTT....TT.T.T......T.T....T..T.TT..TT..T.T..TT@@@@@@@@@@@@@@@@@@@@@@@@@@@
@@.T..T...T................TTT.TTT.....TTT.TTTT.T.T.T.@@@@@@@@@@@@@@@@@@@@@@@@@@
@@.T.....T.T.....TT...............T....T....T..T...T.T.@@@@@@@@@@@@@@@@@@@@@@@@@
@@..T.T........TTT..T..T..T..T..T.TT..TT...........T.TTT@@@@@@@@@@@@@@@@@@@@@@@@
@@.............T.TTTTTTT..TTTTTTT.TT..T.....TTT.@@T.T...T@@@@@@@@@@@@@@@@@@@@@@@
@@TT..TT.T...T....TT...T...TT......TTT.TTT..@@TT@@@T.T.T@@@@@@@@@@@@@@@@@@@@@@@@
@@...TTT.T.T.T.T.T.....TTT.TTT..T.T..TT.TTT@@@.@@@@@@@@@@@@@@@@@@@@@@@@@@@@@@@@@
@@T..T...TT..T.T...T..T.T...TTT.T.T..TT.TTT@@@@@@@@@@@@@@@@@@@@@@@@@@@@@@@@@@@@@
@@.TT.TT....TTT...T........TT...T.T.T..T.T.T@@@@@T@@@@@@@@@@@@@@@@@@@@@@@@@@@@@@
@@....T..T.....TTT...TTT..T.TTT..TTT..T...TT..@@@T.@@@@@@@@@@@@@@@@@@@@@@@@@@@@@
@@.........T..T.TTTT.T....T..TT..TT..T...T.T.T.@@..@@@@@@@@@@@@@@@@@@@@@@@@@@@@@
@@T..T.T.....T.TTT..T..T.T...T........T...T.T.T.TT..@@@@@@@@@@@@@@@@@@@@@@@@@@@@
@@....TT..T...TT......T...T..T..TT....T.TT......TTT@@@@@@@@@@@@@@@@@@@@@@@@@@@@@
@@.TT..TT.TTTT....TT...T..TTT.T.TTTTT.....T.T..T.T@@@@@@@@@@@@@@@@@@@@@@@@@@@@@@
@@T...T.T..TTT...T.T...TT.T..TT..T...TTT.TTT...TT@@@@@@@@@@@@@@@@@@@@@@@@@@@@@@@
@@..T.TTT.T...T.T.T..TTT....T.T.TTT.........T.T.@@@@@@@@@@@@@@@@@@@@@@@@@@@@@@@@
@@.T.T.....TT...T.TTT.T..T..T..TT.TT....T..T.T.@@@@@@@@@@@@@@@@@@@@@@@@@@@@@@@@@
@@.TTTTT.TTTTT.TTTTTT.TT...TTTT.T...T.TTT.TTT.@@@@@@@@@@@@@@@@@@@@@@@@@@@@@@@@@@
@@.T.TT.TT...TTTT.TT..TT..T.T.T...T@@T.T.TT..@@@@@@@@@@@@@@@@@@@@@@@@@@@@@@@@@@@
@@.T..TT.T.T....TTTT.T...TT..TT.T.@@@@......@@@@@@@@@@@@@@@@@@@@@@@@@@@@@@@@@@@@
@@T.T.....TT...TT.....T.T.@@...T@@@@@@@.TT.@@@@@@@@@@@@@@@@@@@@@@@@@@@@@@@@@@@@@
@@T....T.T..TT.T........T@@@T..@@@@@@@@@..@@@@@@@@@@@@@@@@@@@@@@@@@@@@@@@@@@@@@@
@@TT....T..T.....TT...T@@@@@@T@@@@@@@@@@@@@@@@@@@@@@@@@@@@@@@@@@@@@@@@@@@@@@@@@@
@@T.T.T.....TT.T.TTT..@@@@@@@@@@@@@@@@@@@@@@@@@@@@@@@@@@@@@@@@@@@@@@@@@@@@@@@@@@
@@TTTT...TT..TT...T.T@@@@@@@@@@@@@@@@@@@@@@@@@@@@@@@@@@@@@@@@@@@@@@@@@@@@@@@@@@@
@@TTT..T......TTT....@@@@@@@@@@@@@@@@@@@@@@@@@@@@@@@@@@@@@@@@@@@@@@@@@@@@@@@@@@@
@@.T.TT.T.T.TTT.T...T.T@@@@@@@@@@@@@@@@@@@@@@@@@@@@@@@@@@@@@@@@@@@@@@@@@@@@@@@@@
@@T.T..T.TT...TTTTTT.T@@@@@@@@@@@@@@@@@@@@@@@@@@@@@@@@@@@@@@@@@@@@@@@@@@@@@@@@@@
@@TTT.T.@@@@...TT.T..@@@@@@@@@@@@@@@@@@@@@@@@@@@@@@@@@@@@@@@@@@@@@@@@@@@@@@@@@@@
@@T..@@@@@@@@T.TT..@@@@@@@@@@@@@@@@@@@@@@@@@@@@@@@@@@@@@@@@@@@@@@@@@@@@@@@@@@@@@
@@.T@@@@@@@@@@T..T@@@@@@@@@@@@@@@@@@@@@@@@@@@@@@@@@@@@@@@@@@@@@@@@@@@@@@@@@@@@@@
@@TTT@@@@@@@@@@@TT@@@@@@@@@@@@@@@@@@@@@@@@@@@@@@@@@@@@@@@@@@@@@@@@@@@@@@@@@@@@@@
@@@@@@@@@@@@@@@@@@@@@@@@@@@@@@@@@@@@@@@@@@@@@@@@@@@@@@@@@@@@@@@@@@@@@@@@@@@@@@@@
@@@@@@@@@@@@@@@@@@@@@@@@@@@@@@@@@@@@@@@@@@@@@@@@@@@@@@@@@@@@@@@@@@@@@@@@@@@@@@@@
