type octile
height 54
width 52
map
@@@@@@@@@@@@@@@@@@@@@@@@@@@@@@@@@@@@@@@@@@@@@@@@@@@@
@@@@@@@@@@@@@@@@@@@@@@@@@@@@@@@@@@@@@@@@@@@@@@@@@@@@
@@@@@@@@@@@@@@@@@@@@@@@@@@@@@@@@@@@@@@@@@@@@@@@@@@@@
@@@@@@@@@@@@@@@@@@@@@@@@@@@@@@@@@@@@@@@@@@@@@@@@@@@@
@@@@@@@@@@@@@@@@@@@@@@@@@@@@@@@@@@@@@@@@@@@@@@@@@@@@
@@@@@@@@@@@@@@@@@@@@@@@@@@@@@@@@@@@@@@@@@@@@@@@@@@@@
@@@@@@@@@@@@@@@@@@@@@@@@@@@@@@@@@@@@@@@@@@@@@@@@@@@@
@@@@@@@@@@@@@@@@@@@@@@@@@@@@@@@@@@@@@@@@@@@@@@@@@@@@
@@@@@@@@@@@@@@@@@@@@@@@@@@@@@@@@@@@@@@@@@@@@@@@@@@@@
@@@@@@@@@@@@@@@@@@@@@@@@@@@@@@@@@@@@@@@@@@@@@@@@@@@@
@@@@@@@@@@@@@@@@@@@@@@@@@@@@@@@@@@@@@@@@@@@@@@@@@@@@
@@@@@@@@@@@@@@@@@@@@@@@@@@@@@@@@@@@@@@@@@@@@@@@@@@@@
@@@@@@@@@@@@@@@@@@@@@@@@@@@@@@@@@@@@@@@@@@@@@@@@@@@@
@@@@@@@@@@@@@@@@@@@@@@@@@@@@@.@@@@@@@@@@@@@@@@@@@@@@
@@@@@@@@@@@@@@@@@@@@@@@@@@@@..T.T@@@@@@@@@@@@@@@@@@@
@@@@@@@@@@@@@@@@@@@@@@@@@@@.T.....@@@@@@@@@@@@@@@@@@
@@@@@@@@@@@@@@@@@@@@@@@@@@....TTTT@@@@@@@@@@@@@@@@@@
@@@@@@@@@@@@@@@@@@@@@@@@@@.TT.T.T@@@@@@@@@@@@@@@@@@@
@@@@@@@@@@@@@@@@@@@@@@@@.TTT..TT@@@@@@@@@@@@@@@@@@@@
@@@@@@@@@@@@@@@@@@@@@@@@..T..T...@@@@@@@@@@@@@@@@@@@
@@@@@@@@@@@@@@@@@@@@@@@..T..T.@@T.@@@@@.@@@@@@@@@@@@
@@@@@@@@@@@@@@@@@@@@@@.T..T..T@@...@@@...@@@@@@@@@@@
@@@@@@@@@@@@@@@@@@@@@@..T.TTT....T@@@..T..TT@@@@@@@@
@@@@@@@@@@@@@@@@@@@@@@TTT.T.TT...@@@.TTTT....@@@@@@@
@@@@@@@@@@@@@@@@@@@@@T...T.....TTT@@..T....T.T@@@@@@
@@@@@@@@@@@@@@@@@@@@....T.T......TTT.TTTT....T@@@@@@
@@@@@@@@@@@@@@@@@@@.TT..TT@@TTTTT..TT.T..TTT.@@@@@@@
@@@@@@@@@@@@@@@T@@TT.T...@@@@.T.TTT.T.T.TTT.@@@@@@@@
@@@@@@@@@@@@@@@.T.T.....T.T..TT.T...T....TT@@@@@@@@@
@@@@@@@@@@@@T@T...TT.@@@.@@@T..TT..T..T.T.@@@@@@@@@@
@@@@@@@@@@@@T...T.T.T@@@T@@@........T.T..@@@@@@@@@@@
@@@@@@@@@@@.TT..T........T@....TTT....TT@@@@@@@@@@@@
@@@@@@@@@.TT.......TTT.....T@..T.....T.@@@@@@@@@@@@@
@@@@@@@@TTTTT.TT.TT...T.T.@@@.....T...@@@@@@@@@@@@@@
@@@@@@@TT.T.T.T..T..TT...T@@...T..TTT@@@@@@@@@@@@@@@
@@@@@@T..T...@@T.TT.TTTTT.TT.TTT.T..@@@@@@@@@@@@@@@@
@@@@@@@T.TT.@@@T...TTT.T..T...TTTT.@@@@@@@@@@@@@@@@@
@@@@@@@@.TT@@@@@.T....T....T.TTT.T@@@@@@@@@@@@@@@@@@
@@@@@@@@@T@@@@@@@TTT.T.TT.T.TTTT.@@@@@@@@@@@@@@@@@@@
@@@@@@@@@@@@@@@@@@.T.TT.T.TT.TTT@@@@@@@@@@@@@@@@@@@@
@@@@@@@@@@@@@@@@@@@..T.T..T...T@@@@@@@@@@@@@@@@@@@@@
@@@@@@@@@@@@@@@@@@@..TTT.TT...@@@@@@@@@@@@@@@@@@@@@@
@@@@@@@@@@@@@@@@@@@TTT.T..T..@@@@@@@@@@@@@@@@@@@@@@@
@@@@@@@@@@@@@@@@@@T.......TT@@@@@@@@@@@@@@@@@@@@@@@@
@@@@@@@@@@@@@@@@@...TTT..TT@@@@@@@@@@@@@@@@@@@@@@@@@
@@@@@@@@@@@@@@@@..T....TT.@@@@@@@@@@@@@@@@@@@@@@@@@@
@@@@@@@@@@@@@@@@@...T...T@@@@@@@@@@@@@@@@@@@@@@@@@@@
@@@@@@@@@@@@@@@@@@.T..T.@@@@@@@@@@@@@@@@@@@@@@@@@@@@
@@@@@@@@@@@@@@@@@@@TT.T@@@@@@@@@@@@@@@@@@@@@@@@@@@@@
@@@@@@@@@@@@@@@@@@@@@@@@@@@@@@@@@@@@@@@@@@@@@@@@@@@@
@@@@@@@@@@@@@@@@@@@@@@@@@@@@@@@@@@@@@@@@@@@@@@@@@@@@
@@@@@@@@@@@@@@@@@@@@@@@@@@@@@@@@@@@@@@@@@@@@@@@@@@@@
@@@@@@@@@@@@@@@@@@@@@@@@@@@@@@@@@@@@@@@@@@@@@@@@@@@@
@@@@@@@@@@@@@@@@@@@@@@@@@@@@@@@@@@@@@@@@@@@@@@@@@@@@
