type octile
height 64
width 60
map
@@@@@@@@@@@@@@@@@@@@@@@@@@@@@@@@@@@@@@@@@@@@@@@@@@@@@@@@@@@@
@@@@@@@@@@@@@@@@@@@@@@@@@@@@@@@@@@@@@@@@@@@@@@@@@@@@@@@@@@@@
@@@@@@@@@@@@@@@@@@@@@@@@@@@@@@@@@@@@@@@@@@@@@@@@@@@@@@@@@@@@
@@@@@@@@@@@@@@@@@@@@@@@@@@@@@@@@@@@@@@@@@@@@@@@@@@@@@@@@@@@@
@@@@@@@@@@@@@@@@@@@@@@@@@@@@@@@@@@@@@@@@@@@@@@@@@@@@@@@@@@@@
@@@@@@@@@@@@@@@@@@@@@@@@@@@@@@@@@@@@@@@@@@@@@@@@@@@@@@@@@@@@
@@@@@@@@@@@@@@@@@@@@@@@@@@@@@@@@@@@@@@@@@@@@@@@@@@@@@@@@@@@@
@@@@@@@@@@@@@@@@@@@@@@@@@@@@@@@@@@@@@@@@@@@@@@@@@@@@@@@@@@@@
@@@@@@@@@@@@@@@@@@@@@@@@@@@@@@@@@@@@@@@@@@@@@@@@@@@@@@@@@@@@
@@@@@@@@@@@@@@@@@@@@@@@@@@@@@@@@@@@@@@@@@@@@@@@@@@@@@@@@@@@@
@@@@@@@@@@@@@@@@@@@@@@@@@@@@@@@@@@@@@@@@@@@@@@@@@@@@@@@@@@@@
@@@@@@@@@@@@@@@@@@@@@@@@@@@@@@@@@@@@@@@@@@@@@@@@@@@@@@@@@@@@
@@@@@@@@@@@@@@@@@@@@@@@@@@@@@@@@@@@@@@@@@@@@@@@@@@@@@@@@@@@@
@@@@@@@@@@@@@@@@@@@@@@@@@@@@@@@@@@@@@..T@@@@@@@@@@@@@@@@@@@@
@@@@@@@@@@@@@@@@@@@@@@@@@@@@@@@@@@@@@@@TT@@@@@@@@@@@@@@@@@@@
@@@@@@@@@@@@@@@@@@@@@@@@@@@@@@@@@@.@@@@@..@@@@@@@@@@@@@@@@@@
@@@@@@@@@@@@@@@@@@@@@@@@@@@@@@@@@.T.@@@@@TT@@@@@@@@@@@@@@@@@
@@@@@@@@@@@@@@@@@@@@@@@@@@@@@@@@TT...@@@@@..@@@@@@@@@@@@@@@@
@@@@@@@@@@@@@@@@@@@@@@@@@@@@@@@.TTT.T@@@@@.TT@@@@@@@@@@@@@@@
@@@@@@@@@@@@@@@@@@@@@@@@@@@@@@@@@TTT.@@@@T..T.TT@@@@@@@@@@@@
@@@@@@@@@@@@@@@@@@@@@@@@@@@@@@@@@..TT..T.TTTTT@TT@@@@@@@@@@@
@@@@@@@@@@@@@@@@@@@@@@@@@@@@@@@..T.TT...TT.T.@@@.T@@@@@@@@@@
@@@@@@@@@@@@@@@@@@@@@@@@@@@@@@.TT.T......T..@@@...T@@@@@@@@@
@@@@@@@@@@@@@@@@@@@@@@@@@@@@@.T..T.T.TT..T.@@@@@..T.@@@@@@@@
@@@@@@@@@@@@@@@@@@@@@@@@@@.T@@.....T.T....T@@@@@@@@..@@@@@@@
@@@@@@@@@@@@@@@@@@@@@@@.@@T@@@TT...TTT....@@@@@@@@@..T@@@@@@
@@@@@@@@@@@@@@@@@@@@@@@...TT...TTT.T..TTTT@@@.@@.T.....@@@@@
@@@@@@@@@@@@@@@@@@@@@@T..TTT.T.....@@@.T.TT.TT..TT..TT..@@@@
@@@@@@@@@@@@@@@@@@@@....T.......TT.@@@T...T...T........T@@@@
@@@@@@@@@@@@@@@@@@@T.T.....TTTTT.TTTTTTTT...TTTT.TTTT.T@@@@@
@@@@@@@@@@@@@@@@@@.T...@@.TT.TT..T..TT.....TTT.TT..TT.@@@@@@
@@@@@@@@@@@@@@@@@.T...@@@@..@@....T....T.T.TTT.TTT.T.@@@@@@@
@@@@@@@@@@@@@@@@@...T@@@@@@@@@TTT.T...T.T.T...T..T..@@@@@@@@
@@@@@@@@@@@@@@@@.T.@@@@@@@@@T....TTT...T..T...TT...@@@@@@@@@
@@@@@@@@@@@@@@@T..@@@@@@@@@@@TT@@TTT.TT.....T..T.T@@@@@@@@@@
@@@@@@@@@@@@@@.T...@@@@@@@@@@@@@@T.T....TT..T.T..@@@@@@@@@@@
@@@@@@@@@@@@@..T.TT@@@@@@@@@@@@..T..TT..TT.T....@@@@@@@@@@@@
@@@@@@@@@@@...T..T.T@T.@@@@@@@@@T.TT.T....TTT..@@@@@@@@@@@@@
@@@@@@@@@@@..T...T......@@@@@@@@@.T.T.T.T...TT@@@@@@@@@@@@@@
@@@@@@@@@@@@.TT..T...T..@@@@@@@@@@TTT.T...TTT@@@@@@@@@@@@@@@
@@@@@@@@@@@.T..T...T...T@@@@@@@@......T.T..T@@@@@@@@@@@@@@@@
@@@@@@@.@@.T.TT....TT.T@@@@@@@@..T..T.TTT.T@@@@@@@@@@@@@@@@@
@@@@@@.TTTT...TT......@@@@@@@@TT..T..T..T.@@@@@@@@@@@@@@@@@@
@@@@@T.T...TT..T..TTT@@@@@@@@@@.TTT..T..T@@@@@@@@@@@@@@@@@@@
@@@@.....T.T.TT.T..T@@@@@@@@@@T.....T...@@@@@@@@@@@@@@@@@@@@
@@@@..T.T...TTTT...@@@@@@@@.T..T...TT.T@@@@@@@@@@@@@@@@@@@@@
@@@@@....TT.TT.T.T@@@@@@@@@@.TT.T...T.@@@@@@@@@@@@@@@@@@@@@@
@@@@@@T.TT......T@@@@@@@@T@...T....TT@@@@@@@@@@@@@@@@@@@@@@@
@@@@@@@.T..TT...@@@@@@@@TT....T...T.@@@@@@@@@@@@@@@@@@@@@@@@
@@@@@@@@..T....@@@@@@@@T..T.T.T..T.@@@@@@@@@@@@@@@@@@@@@@@@@
@@@@@@@@@T..T.@@@@@@@@@.T.TTT....T@@@@@@@@@@@@@@@@@@@@@@@@@@
@@@@@@@@@@..T.T@@@@@@@.TT..TTT..T@@@@@@@@@@@@@@@@@@@@@@@@@@@
@@@@@@@@@@@....T@@@@T...T.T....T@@@@@@@@@@@@@@@@@@@@@@@@@@@@
@@@@@@@@@@@@.T...@@..T..T.T....@@@@@@@@@@@@@@@@@@@@@@@@@@@@@
@@@@@@@@@@@@@T....T....TT.T...@@@@@@@@@@@@@@@@@@@@@@@@@@@@@@
@@@@@@@@@@@@@@..T.....T..T..@@@@@@@@@@@@@@@@@@@@@@@@@@@@@@@@
@@@@@@@@@@@@@@@TT.T..TT.TT.@@@@@@@@@@@@@@@@@@@@@@@@@@@@@@@@@
@@@@@@@@@@@@@@@@TTTT.T.TT.@@@@@@@@@@@@@@@@@@@@@@@@@@@@@@@@@@
@@@@@@@@@@@@@@@@@....T..T@@@@@@@@@@@@@@@@@@@@@@@@@@@@@@@@@@@
@@@@@@@@@@@@@@@@@@@..TT.@@@@@@@@@@@@@@@@@@@@@@@@@@@@@@@@@@@@
@@@@@@@@@@@@@@@@@@@@T.T@@@@@@@@@@@@@@@@@@@@@@@@@@@@@@@@@@@@@
@@@@@@@@@@@@@@@@@@@@@@@@@@@@@@@@@@@@@@@@@@@@@@@@@@@@@@@@@@@@
@@@@@@@@@@@@@@@@@@@@@@@@@@@@@@@@@@@@@@@@@@@@@@@@@@@@@@@@@@@@
@@@@@@@@@@@@@@@@@@@@@@@@@@@@@@@@@@@@@@@@@@@@@@@@@@@@@@@@@@@@
