type octile
height 54
width 52
map
@@@@@@@@@@@@@@@@@@@@@@@@@@@@@@@@@@@@@@@@@@@@@@@@@@@@
@@@@@@@@@@@@@@@@@@@@@@@@@@@@@@@@@@@@@@@@@@@@@@@@@@@@
@@@@@@@@@@@@@@@@@@@@@@@@@@@@@@@@@@@@@@@@@@@@@@@@@@@@
@@@@@@@@@@@@@@@@@@@@@@@@@@@@@@@@@@@@@@@@@@@@@@@@@@@@
@@@@@@@@@@@@@@@@@@@@@@@@@@@@@@@@@@@@@@@@@@@@@@@@@@@@
@@@@@@@@@@@@@@@@@@@@@@@@@@@@@@@@@@@@@@@@@@@@@@@@@@@@
@@@@@@@@@@@@@@@@@@@@@@@@@@@@@@@@@@@@@@@@@@@@@@@@@@@@
@@@@@@@@@@@@@@@@@@@@@@@@@@@@@@@@@@@@@@@@@@@@@@@@@@@@
@@@@@@@@@@@@@@@@@@@@@@@@@@@@@@@@@@@@@@@@@@@@@@@@@@@@
@@@@@@@@@@@@@@@@@@@@@@@@@@@@@@@@@@@@@@@@@@@@@@@@@@@@
@@@@@@@@@@@@@@@@@@@@@@@@@@@@@@@@@@@@@@@@@@@@@@@@@@@@
@@@@@@@@@@@@@@@@@@@@@@@@@@@@@@@T@@@@@@@@@@@@@@@@@@@@
@@@@@@@@@@@@@@@@@@@@@@@@@@@@@@..T@@@@@@@@@@@@@@@@@@@
@@@@@@@@@@@@@@@@@@@@@@@@@@@@@.T..T@@@@@@@@@@@@@@@@@@
@@@@@@@@@@@@@@@@@@@@@@@@@@@@@......@@@@@@@@@@@@@@@@@
@@@@@@@@@@@@@@@@@@@@@@@@@@@@TTT.TT@@@@@@@@@@@@@@@@@@
@@@@@@@@@@@@@@@@@@@@@@@@@@@.TTT...T@@@@@@@@@@@@@@@@@
@@@@@@@@@@@@@@@@@@@@@@@@@.TT......TT@@@@@@@@@@@@@@@@
@@@@@@@@@@@@@@@@@@@@@@@@...TT.TT.T.T.@@T@@@@@@@@@@@@
@@@@@@@@@@@@@@@@@@@@@@@T...T.T......TT...@@@@@@@@@@@
@@@@@@@@@@@@@@@@@@@@@@..TT.TT...@@...T..T@@@@@@@@@@@
@@@@@@@@@@@@@@@@@@@@@...T.....@@@@TT....@@@@@@@@@@@@
@@@@@@@@@@@@@@@@@@@@@@.TT.TT@@@@@@.TT..@@@@@@@@@@@@@
@@@@@@@@@@@@@@@@@@@@@@....TT@@@@@@.....@@@@@@@@@@@@@
@@@@@@@@@@@@@@@@@@@@@T......T@@@@@@T.TT.@@@@@@@@@@@@
@@@@@@@@@@@@@@@@@@@@TT.T.TT..T@@@@@.TT.T.@@@@@@@@@@@
@@@@@@@@@@@@@@@@@@@.TTT.......T..@@TT.TT.T@@@@@@@@@@
@@@@@@@@@@@@@@@@@@.T.T...TT..T.TT.TT..TT...@@@@@@@@@
@@@@@@@@@@@@@T@@TTT.TT.TT....TT.T.T..TTTT.T.@@@@@@@@
@@@@@@@@@@@@T..T....T....T.T..T.T......T.T.@@@@@@@@@
@@@@@@@@@@@@TT....@T....TTTT.....T.TTT.TT.@@@@@@@@@@
@@@@@@@@@@TT.TTT.@@@.T.T...T...TT.T....TT@@@@@@@@@@@
@@@@@@@@@.TT.TTT@@@@@.TT......T.T...TTTT@@@@@@@@@@@@
@@@@@@@@...T.T.@@@@@@@T.....T.T..TT.T.T@@@@@@@@@@@@@
@@@@@@@.......@@@@@@@@@T.T.T.T.T.T...T@@@@@@@@@@@@@@
@@@@@@....T..@@@@@@@@@@@T.TTT........@@@@@@@@@@@@@@@
@@@@@@.T....@@@@@@@@@@@@@..TT......T@@@@@@@@@@@@@@@@
@@@@@@@.T.T@@@@@@@@@@@@@@@...T.T...@@@@@@@@@@@@@@@@@
@@@@@@@@....@@@@@@@@@@@@@@.T.....T@@@@@@@@@@@@@@@@@@
@@@@@@@@@..TT@@@@@@@@@@@@T....T..@@@@@@@@@@@@@@@@@@@
@@@@@@@@@@.T..@@@@@@@@@@TTTT.TTT@@@@@@@@@@@@@@@@@@@@
@@@@@@@@@@@.T.T@@@@@@@@TTT.T...@@@@@@@@@@@@@@@@@@@@@
@@@@@@@@@@@@.T.T@@@@@@..T....T@@@@@@@@@@@@@@@@@@@@@@
@@@@@@@@@@@@@T.T.@@@@T..T.T..@@@@@@@@@@@@@@@@@@@@@@@
@@@@@@@@@@@@@@.T..@@T....T..@@@@@@@@@@@@@@@@@@@@@@@@
@@@@@@@@@@@@@@@TTTTT.T...T.@@@@@@@@@@@@@@@@@@@@@@@@@
@@@@@@@@@@@@@@@@.T.T...T..@@@@@@@@@@@@@@@@@@@@@@@@@@
@@@@@@@@@@@@@@@@@TTT.T.T.@@@@@@@@@@@@@@@@@@@@@@@@@@@
@@@@@@@@@@@@@@@@@@TTTT..@@@@@@@@@@@@@@@@@@@@@@@@@@@@
@@@@@@@@@@@@@@@@@@@....@@@@@@@@@@@@@@@@@@@@@@@@@@@@@
@@@@@@@@@@@@@@@@@@@@@@@@@@@@@@@@@@@@@@@@@@@@@@@@@@@@
@@@@@@@@@@@@@@@@@@@@@@@@@@@@@@@@@@@@@@@@@@@@@@@@@@@@
@@@@@@@@@@@@@@@@@@@@@@@@@@@@@@@@@@@@@@@@@@@@@@@@@@@@
@@@@@@@@@@@@@@@@@@@@@@@@@@@@@@@@@@@@@@@@@@@@@@@@@@@@
