type octile
height 80
width 80
map
@@@@@@@@@@@@@@@@@@@@@@@@@@@@@@@@@@@@@@@@@@@@@@@@@@@@@@@@@@@@@@@@@@@@@@@@@@@@@@@@
@@@@@@@@@@@@@@@@@@@@@@@@@@@@@@@@@@@@@@@@@@@@@@@@@@@@@@@@@@@@@@@@@@@@@@@@@@@@@@@@
@@@@@@@@@@@@@@@@@@@@@@@@@@@@@@@@@@@@@@@@@@@@@@@@@@@@@@@@@@@@@@@@@@@@@@@@@@@@@@@@
@@@@@@@@@@@@@@@@@@@@@@@@@@@@@@@@@@@@@@@@@@@@@@@@@@@@@@@@@@@@@@@@@@@@@@@@@@@@@@@@
@@@@@@@@@@@@@@@@@@@@@@@@@@@@@@@@@@@@@@@@@@@@@@@@@@@@@@@@@@@@@@@@@@@@@@@@@@@@@@@@
@@@@@@@@@@@@@@@@@@@@@@@@@@@@@@@@@@@@@@@@@@@@@@@@@@@@@@@@@@@@@@@@@@@@@@@@@@@@@@@@
@@@@@@@@@@@@@@@@@@@@@@@@@@@@@@@@@@@@@@@@@@@@@@@@@@@@@@@@@@@@@@@@@@@@@@@@@@@@@@@@
@@@@@@@@@@@@@@@@@@@@@@@@@@@@@@@@@@@@@@@@@@@@@@@@@@@@@@@@@@@@@@@@@@@@@@@@@@@@@@@@
@@@@@@@@@@@@@@@@@@@@@@@@@@@@@@@@@@@@@@@@@@@@@@@@@@@@@@@@@@@@@@@@@@@@@@@@@@@@@@@@
@@@@@@@@@@@@@@@@@@@@@@@@@@@@@@@@@@@@@@@@@@@@@@@@@@@@@@@@@@@@@@@@@@@@@@@@@@@@@@@@
@@@@@@@@@@@@@@@@@@@@@@@@@@@@@@@@@@@@@@@@@@@@@@@@@@@@@@@@@@@@@@@@@@@@@@@@@@@@@@@@
@@@@@@@@@@@@@@@@@@@@@@@@@@@@@@@@@@@@@@@@@@@@@@@@@@@@@@@@@@@@@@@@@@@@@@@@@@@@@@@@
@@@@@@@@@@@@@@@@@@@@@@@@@@@@@@@@@@@@@@@@@@@@@@@@@@@@@@@@@@@@@@@@@@@@@@@@@@@@@@@@
@@@@@@@@@@@@@@@@@@@@@@@@@@@@@@@@@@@@@@@@@@@@@@@@@@@@@@@@@@@@@@@@@@@@@@@@@@@@@@@@
@@@@@@@@@@@@@@@@@@@@@@@@@@@@@@@@@@@@@@@@@@@@@@@@@@@T..@@@@@@@@@@@@@@@@@@@@@@@@@@
@@@@@@@@@@@@@@@@@@@@@@@@@@@@@@@@@@@@@@@@@@@@@@@@@@T..T.@@@@@@@@@@@@@@@@@@@@@@@@@
@@@@@@@@@@@@@@@@@@@@@@@@@@@@@@@@@@@@@@@@@@@@@@@@@T....T.@@@@@@@@@@@@@@@@@@@@@@@@
@@@@@@@@@@@@@@@@@@@@@@@@@@@@@@@@@@@@@@@@@@@@@@@@..T..TTT.@@@@@@@@@@@@@@@@@@@@@@@
@@@@@@@@@@@@@@@@@@@@@@@@@@@@@@@@@@@@@@@@@@@@@@@.T.....T.T.@@@@@@@@@@@@@@@@@@@@@@
@@@@@@@@@@@@@@@@@@@@@@@@@@@@@@@@@@@@@@@@@@@@T@.T...T..T.TT.@@@@@@@@@@@@@@@@@@@@@
@@@@@@@@@@@@@@@@@@@@@@@@@@@@@@@@@@@@@@@@@@@@.....T..T..T.T.T..@@@@@@@@@@@@@@@@@@
@@@@@@@@@@@@@@@@@@@@@@@@@@@@@@@@@@@@@@@@@@@..T..T.TT.........T.@@@@@@@@@@@@@@@@@
@@@@@@@@@@@@@@@@@@@@@@@@@@@@@@@@@@@@@@@@@@....T...T.TT.TT.T..T@@@@@@@@@@@@@@@@@@
@@@@@@@@@@@@@@@@@@@@@@@@@@@@@@@@@@@@@@@@...TTT.T..........TT.@@@@T.@@@@@@@@@@@@@
@@@@@@@@@@@@@@@@@@@@@@@@@@@@@@@@@@@@@@@T..T...TT..T.TTT.T.T.@@@@T.TT@@@@@@@@@@@@
@@@@@@@@@@@@@@@@@@@@@@@@@@@@@@@@@@@@@@@..T......T.T.TT.T...@@@@T.....@@@@@@@@@@@
@@@@@@@@@@@@@@@@@@@@@@@@@@@@@@@@@@@@@@@@TTT.......TTT.TTT.@@@@TT..T...@@@@@@@@@@
@@@@@@@@@@@@@@@@@@@@@@@@@@@@@@@@@@@@@@@@@T.TTT.T...T.T...@@@@...T....TT@@@@@@@@@
@@@@@@@@@@@@@@@@@@@@@@@@@@@@@@@@@@@@T@@@@.TT..TTT.T..TT.@@@..TTT@@T.TT.T@@@@@@@@
@@@@@@@@@@@@@@@@@@@@@@@@@@@@@@@@@@....T@@@.T.......T...@@@..TT..@@@@.T...@@@@@@@
@@@@@@@@@@@@@@@@@@@@@@@@@@@@@@@@@T.TTTT...TT..T.....T.@@@..T...@@@@@.....T@@@@@@
@@@@@@@@@@@@@@@@@@@@@@@@@@@@@..@@...TTTT........TT...@@@......T@@@@@.T.T.T.@@@@@
@@@@@@@@@@@@@@@@@@@@@@@@@@@@..TT.TTT..TT..T.T..T.T.T@@@T.TT.T..@@@@@@TT...T.@@@@
@@@@@@@@@@@@@@@@@@@@@@@@@@@T...@@@T.T....T.@@@.TT..@@@TTTTT..TT@@@@@@T..T.TT.@@@
@@@@@@@@@@@@@@@@@@@@@@@@@@.TT@@@@@@@.TTT....@@@T..@@@.T......T.@@.T@.T.T.TTTTT@@
@@@@@@@@@@@@@@@@@@@@@@@@@TTTT@@@@@@@@.T..T.T.@@@.@@@.TTTTT..TTTTTT..T...T....@@@
@@@@@@@@@@@@@@@@@@@@@@@@...TT.@@@@@@@@..T.TT..@@@@@...T@@@@.TT...T.T.T..TT.T@@@@
@@@@@@@@@@@@@@@@@@@@@@@TTT..TTT.@@@@@@@..T.....@@@TT..T@@@@.TTT.T.T.TT.TT..@@@@@
@@@@@@@@@@@@@@@@@@@@@@.T@@@@.T.T.@@@@@@@.T.T...T@.T.T.T@@@@@.TT.T.TT..TT..@@@@@@
@@@@@@@@@@@@@@@@@@@@@T.@@@@@@.T...@@@@@@@.T.T...TT.....@@@@@@TT..TTTT..T.@@@@@@@
@@@@@@@@@@@@@@@@@@@@.TT@@@@@@TTT...@@@@@@@T.....TTT..T.@@@@@@TTTT.....T.@@@@@@@@
@@@@@@@@@@@@@@@@@@@.T...@@@@@TTT.T..@@@@@@.T.......T.TT@@@@@@T.........@@@@@@@@@
@@@@@@@@@@@@@@@@@@TT...@@@@@@@......T@@@@@@.TT.T.T.TTT..T..T..T.T.TTTT@@@@@@@@@@
@@@@@@@@@@@@@@@@@..@@.T@@@@@@@TT.TTTT.@@@@@.TT..TT...T.T.T....TT.T..T@@@@@@@@@@@
@@@@@@@@@@@@@@@@...@@..TT....TT.TT.....@@@TTT.TT..T.TT...T...T.T.T.T@@@@@@@@@@@@
@@@@@@@@@@@@@@@.T..@@.TT..TT....TT.T....T@.TT.TT.TT.TTT..TTT..T.TT.@@@@@@@@@@@@@
@@@@@@@@@@@@@@T..T.TT.TTTTT...T.....T.T..TT.T.TT...T..T.TT.T.....T@@@@@@@@@@@@@@
@@@@@@@@@@@@@TTTTT.TT...TTTTT..@@@@@.....TT.T.T...T.T.TTTT..T..T.@@@@@@@@@@@@@@@
@@@@@@@@@@@T@@..TT.TTTT..T..T..@@@@@@T...TTTT...TT.....TT......T@@@@@@@@@@@@@@@@
@@@@@@@@@@...@TT.T...T....TT....@@@@@.....T.T...T.TT..TT.T..TT.@@@@@@@@@@@@@@@@@
@@@@@@@@@.TT.@@.T@@@@.TTT......T@@@@@@T......T.TT.T.TT.TT.TTT.@@@@@@@@@@@@@@@@@@
@@@@@@@@..TTT.@.@@@@@@TTT.TT.TT..@@@@@..TT........TT.T.T.TTT.@@@@@@@@@@@@@@@@@@@
@@@@@@@T.T..TT@.@@@@@@TT.TT...T...T@@T.T..T.......T.T.TT.TT.@@@@@@@@@@@@@@@@@@@@
@@@@@@.TT...T.@@@@@@@@.T..T.......TTTTTTT.T..TTTT.....TT...@@@@@@@@@@@@@@@@@@@@@
@@@@@TT.TTT...T@@@@@@@....TT...T....T.T.T...T.T..TT@.TTT..@@@@@@@@@@@@@@@@@@@@@@
@@@@@@....T...T@@@.@@T..T.T@.......TTT....T.TTT.TT.@TT.T.@@@@@@@@@@@@@@@@@@@@@@@
@@@@@@.TT.T.TTT.TT.TT..T.TT@..TTTT...T.T.T....T..T..T.T.@@@@@@@@@@@@@@@@@@@@@@@@
@@@@@@@TTT.....T....TT..TT...TTT...T..TTTT.TT.....T...T@@@@@@@@@@@@@@@@@@@@@@@@@
@@@@@@@...T..TT...TT.TT..TT....TT.@@@@.....TTT.T..TT..@@@@@@@@@@@@@@@@@@@@@@@@@@
@@@@@@@@TT..T.TT..T....T....TTT...@@@@@@@...TT.TTTT.T@@@@@@@@@@@@@@@@@@@@@@@@@@@
@@@@@@@@.T...TTT..T..T.TT.T.T@.T.....@@@@..TT..T.T..@@@@@@@@@@@@@@@@@@@@@@@@@@@@
@@@@@@@@@TTTTTTTTTT.T.T.T..@@@@@TTTT..T...TT.....T.@@@@@@@@@@@@@@@@@@@@@@@@@@@@@
@@@@@@@@@T..TT...T.T.T..TTT@@@@@.TTT.T.....T..T.T.@@@@@@@@@@@@@@@@@@@@@@@@@@@@@@
@@@@@@@@@@T.TT....TTT.....T@@@@@.T...T.T..T.TT..T@@@@@@@@@@@@@@@@@@@@@@@@@@@@@@@
@@@@@@@@@@TTT..TT.T..TTT...@@@@@.T..TTT.....T...@@@@@@@@@@@@@@@@@@@@@@@@@@@@@@@@
@@@@@@@@@@.T.........TTTTTT.T@@@TT..TT.TTTT...T@@@@@@@@@@@@@@@@@@@@@@@@@@@@@@@@@
@@@@@@@@@@.....TTT..T.T.T..T.TTTTT..T...TT....@@@@@@@@@@@@@@@@@@@@@@@@@@@@@@@@@@
@@@@@@@@@@T...TTT..........T....TTT......T...@@@@@@@@@@@@@@@@@@@@@@@@@@@@@@@@@@@
@@@@@@@@@@@..T...TT.T..T.T..TTTTTT...TT...T.@@@@@@@@@@@@@@@@@@@@@@@@@@@@@@@@@@@@
@@@@@@@@@@@@..T.....T.......TT......TTT..T.@@@@@@@@@@@@@@@@@@@@@@@@@@@@@@@@@@@@@
@@@@@@@@@@@@@.T....T.T.........T..T.......@@@@@@@@@@@@@@@@@@@@@@@@@@@@@@@@@@@@@@
@@@@@@@@@@@@@@T.TT.T.TT.T.TTT..TT..T.T...@@@@@@@@@@@@@@@@@@@@@@@@@@@@@@@@@@@@@@@
@@@@@@@@@@@@@@@....TT.....@@@.T..TT.T..T@@@@@@@@@@@@@@@@@@@@@@@@@@@@@@@@@@@@@@@@
@@@@@@@@@@@@@@@@..T.T.TT.T@@@...T..T.T.@@@@@@@@@@@@@@@@@@@@@@@@@@@@@@@@@@@@@@@@@
@@@@@@@@@@@@@@@@@T.T.......T.T..TTTT.T@@@@@@@@@@@@@@@@@@@@@@@@@@@@@@@@@@@@@@@@@@
@@@@@@@@@@@@@@@@@@T..........T......T@@@@@@@@@@@@@@@@@@@@@@@@@@@@@@@@@@@@@@@@@@@
@@@@@@@@@@@@@@@@@@@...T.T.T.T...T.T.@@@@@@@@@@@@@@@@@@@@@@@@@@@@@@@@@@@@@@@@@@@@
@@@@@@@@@@@@@@@@@@@@T...TTT..T.T..T@@@@@@@@@@@@@@@@@@@@@@@@@@@@@@@@@@@@@@@@@@@@@
@@@@@@@@@@@@@@@@@@@@@...T.TTTTT...@@@@@@@@@@@@@@@@@@@@@@@@@@@@@@@@@@@@@@@@@@@@@@
@@@@@@@@@@@@@@@@@@@@@@@@@@@@@@@@@@@@@@@@@@@@@@@@@@@@@@@@@@@@@@@@@@@@@@@@@@@@@@@@
