type octile
height 59
width 56
map
@@@@@@@@@@@@@@@@@@@@@@@@@@@@@@@@@@@@@@@@@@@@@@@@@@@@.TT.
@@@@@@@@@@@@@@@@@@@@@@@@@@@@@@@@@@@@@@@@@@@@@@@@@@@@T...
@@@@@@@@@@@@@@@@@@@@@@@@@@@@@@@@@@@@@@@@@@@@@@@@@@@@.TT.
@@@@@@@@@@@@@@@@@@@@@@@@@@@@@@@@@@@@@@@@@@@@@@@@@@@@@T.T
@@@@@@@@@@@@@@@@@@@@@@@@@@@@@@@@@@@@@@@@@@@@@@@@@@@@@T.T
@@@@@@@@@@@@@@@@@@@@@@@@@@@@@@@@@@@@@@@@@@@@@@@@@@@@@T..
@@@@@@@@@@@@@@@@@@@@@@@@@@@@@@@@@@@@@@@@@@@@@@@@@@@@@.TT
@@@@@@@@@@@@@@@@@@@@@@@@@@@@@@@@@@@@@@@@@@@@@@@@@@@@@..T
@@@@@@@@@@@@@@@@@@@@@@@@@@@@@@@@@@@@@@@@@@@@@@@@@@@@@.T.
@@@@@@@@@@@@@@@@@@@@@@@@@@@@@@@@@@@@@@@@@@@@@@@@@@@@@..T
@@@@@@@@@@@@@@@@@@@@@@@@@@@@@@@@@@@@@@@@@@@@@@@@@@@@@...
@@@@@@@@@@@@@@@@@@@@@@@@@T.T....@@@@@@@@@@@@@@@@@@@@@T..
@@@@@@@@@@@@@@@@@@@TT.TT..T...TTTTT.@@@@@..@@@@@@@@@@T..
@@@@@@@@@@@@@@@@@@.T.T...T....TT...T..@@@T..@@@@@@@@@..T
@@@@@@@@@@@@@@@@...T....T..TT....T...T.@@.T.@@@@@@@@@T.T
@@@@@@@@@@@@@@.T....T..TTT...T.T.T.T..TTT.TT@@@@@@@@@TTT
@@@@@@@@@@@@@.T.....TT....T.TT.T...TT.T..T..@@@@@@@@@@..
@@@@@@@@@@@@TT...T...T...T....T..........T.T@@@@@@@@@@T.
@@@@@@@@@@@TTT.T....TTT...T.TT.T..T..T.....T@@@@@@@@@@@.
@@@@@@@@@@T.TT...TTT..TT..T....T.T..T.TT..TT.@@@@@@@@@@@
@@@@@@@@@..T.....T.T.T....T..TT...T.....T...TT@@@@@@@@@@
@@@@@@@@T..TTT..T..T.TT.T.TTT.T..T.T.......TT..@@@@@@@@@
@@@@@@@@T.T.....TTT..T.T.TT.T....TT.TT.T...T.TT.@@@@@@@@
@@@@@@@@TT.T....TT...T.....T.T.....T.T.T.TTTT....@@@@@@T
@@@@@@@T.T.T..TTTTT..........T..TTT....TT.T......@@@@@@.
@@@@@@@T...TTT....T....T..TTT..T..TT.....T.TT...T@@@@@@@
@@@@@@@.T.....TT..T.T.T....T.T..T.TT...T.TTT...T.@@@@@@@
@@@@@@@.T.T.T..TT........TTTT.TT.TT..T..TT.T..TT.@@@@@@@
@@@@@@@.T.T..TTT.........T..T..T.TT..TT.TTT...TT.@@@@@@@
@@@@@@@...TT...T.T..T.TT.T@@@........T.T.........@@@@@@@
@@@@@@@....T..TTTTT.TTT.TT@@@...T.T..T.......T.T.@@@@@@@
@@@@@@@T..TT.T.T.T..T..TT.@@@TTT.TT.T....T..T.TT.@@@@@@@
@@@@@@@.TT.T.TT.T.T....T..T.TTTTT..TT..T.T...T...@@@@@@@
@@@@@@@T.TT...T.....TT...T..T.....T.T.T.......TT.@@@@@@@
@@@@@@@.TTT...TTT....T.T.T.....T...TT...TTT.TT.T.@@@@@@@
@@@@@@@...TT.T.TTT..T......T.TTT..T..T.T....T.T.T@@@@@@@
@@@@@@@.TT..T..TTTTT.T..T..T...T..T.....T..TT.TTT@@@@@@@
@@@@@@@....TTTT.T.....T.......T....T.TT..T..T.T..@@@@@@@
@@@@@@@.TT....TT...TT...T............T..T..TT..T.@@@@@@@
@@@@@@@.T.T..TT.TT....T.....TTTT.T.....T...T..T..@@@@@@@
@@@@@@@.T...T...T...TTT......T.TTT.....T.T..TT...@@@@@@@
@@@@@@@@.TT....T.T...T....T.T...T.....TTT.TTT..TT.@@@@@@
@@@@@@@@@..T..TT.T..T.T..TT...TT.TT.T.T......TTT.@@@@@@@
@@@@@@@@@@..T..TT....T...T..T.......T...TT.TTT..@@@@@@@@
@@@@@@@@@@@...TT.TT..T..TT.T..TT..T.T.TTTTT....@@@@@@@@@
@@@@@@@@@@@@.TT....T..T...TT..TT......T.TTT...@@@@@@@@@@
@@@@@@@@@@@@@T.T......T...TT.TT.....TT.TTTTT.@@@@@@@@@@@
@@@@@@@@@@@@@@.T...TT....T....T.TT.T.T..TT.T@@@@@@@@@@@@
@@@@@@@@@@@@@@@@......T.TT.......TT.T....TT@@@@@@@@@@@@@
@@@@@@@@@@@@@@@@@@..T.T.TTTT.T.TT......T.@@@@@@@@@@@@@@@
@@@@@@@@@@@@@@@@@@@@TT...TT.T.TTT...T..@@@@@@@@@@@@@@@@@
@@@@@@@@@@@@@@@@@@@@@@@TT...TTT..TTT@@@@@@@@@@@@@@@@@@@@
@@@@@@@@@@@@@@@@@@@@@@@@@@@@@@@@@@@@@@@@@@@@@@@@@@@@@@@@
@@@@@@@@@@@@@@@@@@@@@@@@@@@@@@@@@@@@@@@@@@@@@@@@@@@@@@@@
@@@@@@@@@@@@@@@@@@@@@@@@@@@@@@@@@@@@@@@@@@@@@@@@@@@@@@@@
@@@@@@@@@@@@@@@@@@@@@@@@@@@@@@@@@@@@@@@@@@@@@@@@@@@@@@@@
@@@@@@@@@@@@@@@@@@@@@@@@@@@@@@@@@@@@@@@@@@@@@@@@@@@@@@@@
@@@@@@@@@@@@@@@@@@@@@@@@@@@@@@@@@@@@@@@@@@@@@@@@@@@@@@@@
@@@@@@@@@@@@@@@@@@@@@@@@@@@@@@@@@@@@@@@@@@@@@@@@@@@@@@@@
