type octile
height 70
width 64
map
@@@@@@@@@@@@@@@@@@@@@@@@@@@@@@@@@@@@@@@@@@@@@@@@@@@@@@@@@@@@@@@@
@@@@@@@@@@@@@@@@@@@@@@@@@@@@@@@@@@@@@@@@@@@@@@@@@@@@@@@@@@@@@@@@
@@@@@@@@@@@@@@@@@@@@@@@@@@@@@@@@@@@@@@@@@@@@@@@@@@@@@@@@@@@@@@@@
@@@@@@@@@@@@@@@@@@@@@@@@@@@@@@@@@@@@@@@@@@@@@@@@@@@@@@@@@@@@@@@@
@@@@@@@@@@@@@@@@@@@@@@@@@@@@@@@@@@@@@@@@@@@@@@@@@@@@@@@@@@@@@@@@
@@@@@@@@@@@@@@@@@@@@@@@@@@@@@@@@@@@@@@@@@@@@@@@@@@@@@@@@@@@@@@@@
@@@@@@@@@@@@@@@@@@@@@@@@@@@@@@@@@@@@@@@@@@@@@@@@@@@@@@@@@@@@@@@@
@@@@@@@@@@@@@@@@@@@@@@@@@@@@@@@@@@@@@@@@@@@@@@@@@@@@@@@@@@@@@@@@
@@@@@@@@@@@@@@@@@@@@@@@@@@@@@@@@@@@@@@@@@@@@@@@@@@@@@@@@@@@@@@@@
@@@@@@@@@@@@@@@@@@@@@@@@@@@@@@@@@@@@@@@@@@@@@@@@@@@@@@@@@@@@@@@@
@@@@@@@@@@@@@@@@@@@@@@@@@@@@@@@@@@@@@@@@@@@@@@@@@@@@@@@@@@@@@@@@
@@@@@@@@@@@@@@@@@@@@@@@@@@@@@@@@@@@@@@@@@@@@@@@@@@@@@@@@@@@@@@@@
@@@@@@@@@@@@@@@@@@@@@@@@@@@@@@@@@@@.T.@@@@@@@@@@@@@@@@@@@@@@@@@@
@@@@@@@@@@@@@@@@@@@@@@@@@@@@@@@@@@.TTTT@@@@@@@@@@@@@@@@@@@@@@@@@
@@@@@@@@@@@@@@@@@@@@@@@@@@@@@@@@@T..@@TT@@@@@@@@@@@@@@@@@@@@@@@@
@@@@@@@@@@@@@@@@@@@@@@@@@@@@@@@@@..T@@T..@@@@@@@@@@@@@@@@@@@@@@@
@@@@@@@@@@@@@@@@@@@@@@@@@@@@@@@@@@.T@TT.T.@@@@@@@@@@@@@@@@@@@@@@
@@@@@@@@@@@@@@@@@@@@@@@@@@@@@@@@@@@.TTT....@@@@@@@@@@@@@@@@@@@@@
@@@@@@@@@@@@@@@@@@@@@@@@@@@@@@@@@@@@T.T..TT.@@@@@@@@@@@@@@@@@@@@
@@@@@@@@@@@@@@@@@@@@@@@@@@@@@@@@@@@@@........@@@@@@@@@@@@@@@@@@@
@@@@@@@@@@@@@@@@@@@@@@@@@@@@@@@@@@@@@...T.TT.T@@@@@@@@@@@@@@@@@@
@@@@@@@@@@@@@@@@@@@@@@@@@@@.T@@@@@@.T...T......@@@@@@@@@@@@@@@@@
@@@@@@@@@@@@@@@@@@@@@@@@@@@..@@@@@..TTTT..T..TT.@@@@@@@@@@@@@@@@
@@@@@@@@@@@@@@@@@@@@@@@@@@@@..TTT.T...T.TTT.TT..T@@@@@@@@@@@@@@@
@@@@@@@@@@@@@@@@@@@@@@@@@@@@@.T...T.T..TT.T@@T.TT.@@@@@@@@@@@@@@
@@@@@@@@@@@@@@@@@@@@@@@@@@@@@@...T........@@@@.T.T.@@@@@@@@@@@@@
@@@@@@@@@@@@@@@@@@@@@@@@@@@@@@T...T...T.TTT@@@.T..TT@@@@@@@@@@@@
@@@@@@@@@@@@@@@@@@@@@@@@@@@@@T.T..TTT...TTT@.T.T..T..T@@@@@@@@@@
@@@@@@@@@@@@@@@@@@@@@@@@@@@@...TTTT.TTT.TT..T...T.TTT..@@@@@@@@@
@@@@@@@@@@@@@@@@@@@@@@@@@@@...T......T......T.T..TTTTT.@@@@@@@@@
@@@@@@@@@@@@@@@@@@@@@@@..TT...TT..T.TT.T.TT.TT.T.TTTT.T@@@@@@@@@
@@@@@@@@@@@@@@@@@@@@@@@@T.T.TTTT..TT.T.T..T..T...T...T.T.T@@@@@@
@@@@@@@@@@@@@@@@@@@@@@@@T.TTT........T....T..T....@T.TT..T.@@@@@
@@@@@@@@@@@@@@..@@@@@@@T.T..TT.T......T.T...T.T..@@@T..TT.TT@@@@
@@@@@@@@@@@@T...@@@@@@T......TT.T@@.T....TTT.T.T@@@@@T..T....@@@
@@@@@@@@@@@.....@@@@T.T.....T.T..@@T.TT..TT....@@@@@@@..T.T.@@@@
@@@@@@@@@@.TTT.T....TTTT....TTTTT.T.T.TTT.T.TT@@@@@@@@@....@@@@@
@@@@@@@@@TTT..T.T....TT...T....T.T..TT.T..T...T@@@@@@@@@TT@@@@@@
@@@@@@@@T...T.TTTT..T.T.T.....TT.TT......TT.T....@@@@@@@@@@@@@@@
@@@@@@@T...TT.@T...T...T....T.T...T.T....T.T.T...@@@@@@@@@@@@@@@
@@@@@@@@TTT.@@@@T.TTT...TT........TTTT.T.T.@@TTT..@@@@@@@@@@@@@@
@@@@@@@@..T.@@@@.T..TTTTTTT.T.TT.T.T......@@@@.....@@@@@@@@@@@@@
@@@@T.@@...@@@@@@..T...T..T.....T..T.TTTT@@@@@@T...T@@@@@@@@@@@@
@@@......TT@@@@@@....T.T...TTT..T..TTTT.@@@@@@@@.TT.@@@@@@@@@@@@
@@..T.....T..@@@@..T.....T.....T..TT...@@@@@@@@@@.T@@@@@@@@@@@@@
@@.T......TT...@@......TT.T.TT..TT.T.T..@@@@@@@@@@@@@@@@@@@@@@@@
@@@..T.TT.TT...T.T...T...T.....T...T...TT.@@@@@@@@@@@@@@@@@@@@@@
@@@@.....T..T......T.@@.T....TTTTT@@T.TT..@@@@@@@@@@@@@@@@@@@@@@
@@@@@..T.T..T..TTT..@@@T.......TT@@@@....T.@@@@@@@@@@@@@@@@@@@@@
@@@@@@......TT.TT...T@@T....T...@@@@@@.T.TT.@@@@@@@@@@@@@@@@@@@@
@@@@@@@T.T..T....TTTT.T.T.T....@@@@@@@@.TT.T.@@@@@@@@@@@@@@@@@@@
@@@@@@@@T.TTTT...TTT...TT.T.T..@@@@@@@@@T...@@@@@@@@@@@@@@@@@@@@
@@@@@@@@@......TT....TT.@....T.@@@@@@@@@@..@@@@@@@@@@@@@@@@@@@@@
@@@@@@@@@@TT.......T...@@@TTT..T.@@@@@@@@T@@@@@@@@@@@@@@@@@@@@@@
@@@@@@@@@@@TT.T...T..T@@@@@...T..@@@@@@@@@@@@@@@@@@@@@@@@@@@@@@@
@@@@@@@@@@@@.....T.T.@@@@@@@..TTT@@@@@@@@@@@@@@@@@@@@@@@@@@@@@@@
@@@@@@@@@@@@@T.T...T@@@@@@@@@.T....@@@@@@@@@@@@@@@@@@@@@@@@@@@@@
@@@@@@@@@@@@@@T....@@@@@@@.T........@@@@@@@@@@@@@@@@@@@@@@@@@@@@
@@@@@@@@@@@@@@@..T@@@@@@.T...T..T..T.@@@@@@@@@@@@@@@@@@@@@@@@@@@
@@@@@@@@@@@@@@@@TT@@@@@..TT..TT.....@@@@@@@@@@@@@@@@@@@@@@@@@@@@
@@@@@@@@@@@@@@@@@TT@@@@T..TT.TTT...@@@@@@@@@@@@@@@@@@@@@@@@@@@@@
@@@@@@@@@@@@@@@@@@.T@@@.T...T.....@@@@@@@@@@@@@@@@@@@@@@@@@@@@@@
@@@@@@@@@@@@@@@@@@@.T@@TT.T..T.T.@@@@@@@@@@@@@@@@@@@@@@@@@@@@@@@
@@@@@@@@@@@@@@@@@@@@..@TT.......@@@@@@@@@@@@@@@@@@@@@@@@@@@@@@@@
@@@@@@@@@@@@@@@@@@@@@T......T..@@@@@@@@@@@@@@@@@@@@@@@@@@@@@@@@@
@@@@@@@@@@@@@@@@@@@@@@..T.TTTT@@@@@@@@@@@@@@@@@@@@@@@@@@@@@@@@@@
@@@@@@@@@@@@@@@@@@@@@@@..T.T.@@@@@@@@@@@@@@@@@@@@@@@@@@@@@@@@@@@
@@@@@@@@@@@@@@@@@@@@@@@@TT..@@@@@@@@@@@@@@@@@@@@@@@@@@@@@@@@@@@@
@@@@@@@@@@@@@@@@@@@@@@@@@@@@@@@@@@@@@@@@@@@@@@@@@@@@@@@@@@@@@@@@
@@@@@@@@@@@@@@@@@@@@@@@@@@@@@@@@@@@@@@@@@@@@@@@@@@@@@@@@@@@@@@@@
