type octile
height 54
width 52
map
@@@@@@@@@@@@@@@@@@@@@@@@@@@@@@@@@@@@@@@@@@@@@@@@@@@@
@@@@@@@@@@@@@@@@@@@@@@@@@@@@@@@@@@@@@@@@@@@@@@@@@@@@
@@@@@@@@@@@@@@@@@@@@@@@@@@@@@@@@@@@@@@@@@@@@@@@@@@@@
@@@@@@@@@@@@@@@@@@@@@@@@@@@@@@@@@@@@@@@@@@@@@@@@@@@@
@@@@@@@@@@@@@@@@@@@@@@@@@@@@@@@@@@@@@@@@@@@@@@@@@@@@
@@@@@@@@@@@@@@@@@@@@@@@@@@@@@@@@@@@@@@@@@@@@@@@@@@@@
@@@@@@@@@@@@@@@@@@@@@@@@@@@@@@@@@@@@@@@@@@@@@@@@@@@@
@@@@@@@@@@@@@@@@@@@@@@@@@@@@@@@@@@@@@@@@@@@@@@@@@@@@
@@@@@@@@@@@@@@@@@@@@@@@@@@@@@@@@@@@@@@@@@@@@@@@@@@@@
@@@@@@@@@@@@@@@@@@@@@@@@@@@@@@@@@@@@@@@@@@@@@@@@@@@@
@@@@@@@@@@@@@@@@@@@@@@@@@@@@@@@@@@@@@@@@@@@@@@@@@@@@
@@@@@@@@@@@@@@@@@@@@@@@@@@@@@@@@@@@@@@@@@@@@@@@@@@@@
@@@@@@@@@@@@@@@@@@@@@@@@@@@@@@@@@@@@@@@@@@@@@@@@@@@@
@@@@@@@@@@@@@@@@@@@@@@@@@@@@@.@@@@@@@@@@@@@@@@@@@@@@
@@@@@@@@@@@@@@@@@@@@@@@@@@@@.TTT.@@@@@@@@@@@@@@@@@@@
@@@@@@@@@@@@@@@@@@@@@@@@@@@.T..T..@@@@@@@@@@@@@@@@@@
@@@@@@@@@@@@@@@@@@@@@@@@@@.TTTTT.T@@@@@@@@@@@@@@@@@@
@@@@@@@@@@@@@@@@@@@@@@@@@@.T.T...@@@@@@@@@@@@@@@@@@@
@@@@@@@@@@@@@@@@@@@@@@@@T...TTTTT@@@@@@@@@@@@@@@@@@@
@@@@@@@@@@@@@@@@@@@@@@@@TT.TTTT..@@@@@@@@@@@@@@@@@@@
@@@@@@@@@@@@@@@@@@@@@@@T...T..@@.T@@@@@.@@@@@@@@@@@@
@@@@@@@@@@@@@@@@@@@@@@TTT.T.T.@@...@@T.T.@@@@@@@@@@@
@@@@@@@@@@@@@@@@@@@@@@.TT..T.T.T.T@@.TTT..T.@@@@@@@@
@@@@@@@@@@@@@@@@@@@@@@TT...T....T@@@...T..T..@@@@@@@
@@@@@@@@@@@@@@@@@@@@@T.T.T.T...T..@@TT..T....T@@@@@@
@@@@@@@@@@@@@@@@@@@@T.T.TTTT..T.........TT.T..@@@@@@
@@@@@@@@@@@@@@@@@@@.T.T...@@T.T..T.TT.T..TTT.@@@@@@@
@@@@@@@@@@@@@@@T@.TT.....@@@@T..T..T.......T@@@@@@@@
@@@@@@@.T@@@@@@......TTT.........T.T...T..T@@@@@@@@@
@@@@@@@T...T..TTT...T@@@.@@@.T.....TT.TT..@@@@@@@@@@
@@@@@@@...TTTT......T@@@.@@@......TT.....@@@@@@@@@@@
@@@@@@@@.T@@@T.TT..TT.T..T@...TTT..T..TT@@@@@@@@@@@@
@@@@@@@@@@@@@@@.T..T.....TT.@.TT.T..T.T@@@@@@@@@@@@@
@@@@@@@@@@@@@@@..TT.T.T...@@@....T..T.@@@@@@@@@@@@@@
@@@@@@@@@@@@@@@TT...T.......T.TT..T..@@@@@@@@@@@@@@@
@@@@@@@@@@@@@@@....T.T..T.........T.@@@@@@@@@@@@@@@@
@@@@@@@@@@@@@@@..TT.......T.TT..T.T@@@@@@@@@@@@@@@@@
@@@@@@@@@@@@@@@@.T.TT..T.TT.T.T...@@@@@@@@@@@@@@@@@@
@@@@@@@@@@@@@@@@@TT..T.T.T.TT....@@@@@@@@@@@@@@@@@@@
@@@@@@@@@@@@@@@@@@....T.T.T...T.@@@@@@@@@@@@@@@@@@@@
@@@@@@@@@@@@@@@@@@@T.TTTTTT.TTT@@@@@@@@@@@@@@@@@@@@@
@@@@@@@@@@@@@@@@@@@..T....T...@@@@@@@@@@@@@@@@@@@@@@
@@@@@@@@@@@@@@@@@@@....TT.T.T@@@@@@@@@@@@@@@@@@@@@@@
@@@@@@@@@@@@@@@@@@.TTT.T....@@@@@@@@@@@@@@@@@@@@@@@@
@@@@@@@@@@@@@@@@@T....T....@@@@@@@@@@@@@@@@@@@@@@@@@
@@@@@@@@@@@@@@@@...T....T.@@@@@@@@@@@@@@@@@@@@@@@@@@
@@@@@@@@@@@@@@@@@TTTT...T@@@@@@@@@@@@@@@@@@@@@@@@@@@
@@@@@@@@@@@@@@@@@@TT...T@@@@@@@@@@@@@@@@@@@@@@@@@@@@
@@@@@@@@@@@@@@@@@@@T...@@@@@@@@@@@@@@@@@@@@@@@@@@@@@
@@@@@@@@@@@@@@@@@@@@@@@@@@@@@@@@@@@@@@@@@@@@@@@@@@@@
@@@@@@@@@@@@@@@@@@@@@@@@@@@@@@@@@@@@@@@@@@@@@@@@@@@@
@@@@@@@@@@@@@@@@@@@@@@@@@@@@@@@@@@@@@@@@@@@@@@@@@@@@
@@@@@@@@@@@@@@@@@@@@@@@@@@@@@@@@@@@@@@@@@@@@@@@@@@@@
@@@@@@@@@@@@@@@@@@@@@@@@@@@@@@@@@@@@@@@@@@@@@@@@@@@@
