type octile
height 118
width 112
map
@@@@@@@@@@@@@@@@@@@@@@@@@@@@@@@@@@@@@@@@@@@@@@@@@@@@@@@@@@@@@@@@@@@@@@@@@@@@@@@@@@@@@@@@@@@@@@@@@@@@@@@@@@@@@@@@
@@@@@@@@@@@@@@@@@@@@@@@@@@@@@@@@@@@@@@@@@@@@@@@@@@@@@@@@@@@@@@@@@@@@@@@@@@@@@@@@@@@@@@@@@@@@@@@@@@@@@@@@@@@@@@@@
@@@@@@@@@@@@@@@@@@@@@@@@@@@@@@@@@@@@@@@@@@@@@@@@@@@@@@@@@@@@@@@@@@@@@@@@@@@@@@@@@@@@@@@@@@@@@@@@@@@@@@@@@@@@@@@@
@@@@@@@@@@@@@@@@@@@@@@@@@@@@@@@@@@@@@@@@@@@@@@@@@@@@@@@@@@@@@@@@@@@@@@@@@@@@@@@@@@@@@@@@@@@@@@@@@@@@@@@@@@@@@@@@
@@@@@@@@@@@@@@@@@@@@@@@@@@@@@@@@@@@@@@@@@@@@@@@@@@@@@@@@@@@@@@@@@@@@@@@@@@@@@@@@@@@@@@@@@@@@@@@@@@@@@@@@@@@@@@@@
@@@@@@@@@@@@@@@@@@@@@@@@@@@@@@@@@@@@@@@@@@@@@@@@@@@@@@@@@@@@@@@@@@@@@@@@@@@@@@@@@@@@@@@@@@@@@@@@@@@@@@@@@@@@@@@@
@@@@@@@@@@@@@@@@@@@@@@@@@@@@@@@@@@@@@@@@@@@@@@@@@@@@@@@@@@@@@@@@@@@@@@@@@@@@@@@@@@@@@@@@@@@@@@@@@@@@@@@@@@@@@@@@
@@@@@@@@@@@@@@@@@@@@@@@@@@@@@@@@@@@@@@@@@@@@@@@@@@@@@@@@@@@@@@@@@@@@@@@@@@@@@@@@@@@@@@@@@@@@@@@@@@@@@@@@@@@@@@@@
@@@@@@@@@@@@@@@@@@@@@@@@@@@@@@@@@@@@@@@@@@@@@@@@@@@@@@@@@@@@@@@@@@@@@@@@@@@@@@@@@@@@@@@@@@@@@@@@@@@@@@@@@@@@@@@@
@@@@@@@@@@@@@@@@@@@@@@@@@@@@@@@@@@@@@@@@@@@@@@@@@@@@@@@@@@@@@@@@@@@@@@@@@@@@@@@@@@@@@@@@@@@@@@@@@@@@@@@@@@@@@@@@
@@@@@@@@@@@@@@@@@@@@@@@@@@@@@@@@@@@@@@@@@@@@@@@@@@@@@@@@@@@@@@@@@@@@T.@@@@@@@@@@@@@@@@@@@@@@@@@@@@@@@@@@@@@@@@@@
@@@@@@@@@@@@@@@@@@@@@@@@@@@@@@@@@@@@@@@@@@@@@@@@@@@@@@@@@@@@@@@@@@@.T..@@@@@@@@@@@@@@@@@@@@@@@@@@@@@@@@@@@@@@@@@
@@@@@@@@@@@@@@@@@@@@@@@@@@@@@@@@@@@@@@@@@@@@@@@@@@@@@@@@@@@@@@@@@@....TT@@@@@@@@@@@@@@@@@@@@@@@@@@@@@@@@@@@@@@@@
@@@@@@@@@@@@@@@@@@@@@@@@@@@@@@@@@@@@@@@@@@@@@@@@@@@@@@@@@@@@@@@@@.TT.TTT.@@@@@@@@@@@@@@@@@@@@@@@@@@@@@@@@@@@@@@@
@@@@@@@@@@@@@@@@@@@@@@@@@@@@@@@@@@@@@@@@@@@@@@@@@@@@@@@@@@@@@@@@T.....T...@@@@@@@@@@@@@@@@@@@@@@@@@@@@@@@@@@@@@@
@@@@@@@@@@@@@@@@@@@@@@@@@@@@@@@@@@@@@@@@@@@@@@@@@@@@@@@@@@@@@@@........T...@@@@@@@@@@@@@@@@@@@@@@@@@@@@@@@@@@@@@
@@@@@@@@@@@@@@@@@@@@@@@@@@@@@@@@@@@@@@@@@@@@@@@@@@@@@@@@@@@@@@.T..T.@T...T.T@@@@@@@@@@@@@@@@@@@@@@@@@@@@@@@@@@@@
@@@@@@@@@@@@@@@@@@@@@@@@@@@@@@@@@@@@@@@@@@@@@@@@@@@@@@@@@@@@@.T....@@@T...TTT@@@@@@@@@@@@@@@@@@@@@@@@@@@@@@@@@@@
@@@@@@@@@@@@@@@@@@@@@@@@@@@@@@@@@@@@@@@@@@@@@@@@@@@@@@@@@@@@.TT...@@@@@..T....@@@@@@@@@@@@@@@@@@@@@@@@@@@@@@@@@@
@@@@@@@@@@@@@@@@@@@@@@@@@@@@@@@@@@@@@@@@@@@@@@@@@@@@@@@@@@@...TT.@@@@@@@T.T.TT.@@@@@@@@@@@@@@@@@@@@@@@@@@@@@@@@@
@@@@@@@@@@@@@@@@@@@@@@@@@@@@@@@@@@@@@@@@@@@@@@@@@@@@@@@@@@...T.T@@@@@@@@@.T.T...@@@@@@@@@@@@@@@@@@@@@@@@@@@@@@@@
@@@@@@@@@@@@@@@@@@@@@@@@@@@@@@@@@@@@@@@@@@@@@@@@@@@@@@@@@...T.T@@@@@@@@@@@TTT.T.T.@@@@@@@@@@@@@@@@@@@@@@@@@@@@@@
@@@@@@@@@@@@@@@@@@@@@@@@@@@@@@@@@@@@@@@@@@@@@@@@@@@@@@@@T..T..@@@@@@@@@@@@@.T....TT@@@@@@@@@@@@@@@@@@@@@@@@@@@@@
@@@@@@@@@@@@@@@@@@@@@@@@@@@@@@@@@@@@@@@@@@@@@@@@@@@@@@@.T...T@@@@@@@@..@@@@@.T..TT.T@@@@@@@@@@@@@@@@@@@@@@@@@@@@
@@@@@@@@@@@@@@@@@@@@@@@@@@@@@@@@@@@@@@@@@@@@@@@@@@@@@@T.T.T.@@@@@@@TTTT@@@@@@T.T.....@@@@@@@@@@@@@@@@@@@@@@@@@@@
@@@@@@@@@@@@@@@@@@@@@@@@@@@@@@@@@@@@@@@@@@@@@@@@@@@@@......@@@@@@@....T.@@@@@@......TT@@@@@@@@@@@@@@@@@@@@@@@@@@
@@@@@@@@@@@@@@@@@@@@@@@@@@@@@@@@@@@@@@@@@@@@@@@@@@@@.T.T.T@@@@@@@....TT.T@@@@@@T.T.T...@@@@@@@@@@@@@@@@@@@@@@@@@
@@@@@@@@@@@@@@@@@@@@@@@@@@@@@@@@@@@@@@@@@@@@@@@@@@....T.T@@@@@@@@TT.T..T..@@@@@@TTT.TT.T@@@@@@@@@@@@@@@@@@@@@@@@
@@@@@@@@@@@@@@@@@@@@@@@@@@@@@@@@@@@@@@@@@@@@@@@@@.T..TT.@@@@@@@@.....@@..T..@@@@@.T.T.T..@@@@@@@@@@@@@@@@@@@@@@@
@@@@@@@@@@@@@@@@@@@@@@@@@@@@@@@@@@@@@@@@@@@@@@@@TTTT.T.@@@@@@@...T..@@@@..T.T@@@@@T....TTT@@@@@@@@@@@@@@@@@@@@@@
@@@@@@@@@@@@@@@@@@@@@@@@@@@@@@@@@@@@@@@@@@@@@@@T...T..@@@@@...TTT.T@@@@@@.....@@@@@....TT.T@@@@@@@@@@@@@@@@@@@@@
@@@@@@@@@@@@@@@@@@@@@@@@@@@@@@@@@@@@@@@@@@.@@@.TTTTT.@@@@@.....T..@@@@@@@@.TTTT@@@@@.T...TT.@@@@@@@@@@@@@@@@@@@@
@@@@@@@@@@@@@@@@@@@@@@@@@@@@@@@@@@@@@@@@@TTT@@.TT.....@@@@@...T..@@@@@@@@@.T.T..@@@@@.TT.T..T@@@@@@@@@@@@@@@@@@@
@@@@@@@@@@@@@@@@@@@@@@@@@@@@@@@@@@@@@@@@.TT..@.TTTT.TT.@@@@@...T@@@@@@@@.TT.T....@@@@@@T...TTT@@@@@@@@@@@@@@@@@@
@@@@@@@@@@@@@@@@@@@@@@@@@@@@@@@@@@@@@@@..TT.@@T@@@TTTTT.@@@@@..@@@@@@@@@TT..T.T...@@@@@@.T....T@@@@@@@@@@@@@@@@@
@@@@@@@@@@@@@@@@@@@@@@@@@T.T.T....@@@@T.T.T@@@@@@@@.T.TTT@@@@@@@@@@@@@@@...T..TTTT.@@@@@@TTTT...@@@@@@@@@@@@@@@@
@@@@@@@@@@@@@@@@@@@@@@T..T...T...T.@@@...T.@@@@@@@TTT....T@@@@@@@@@@@..T.T..TT@@TT.@@@@@@@TT..T..@@@@@@@@@@@@@@@
@@@@@@@@@@@@@@@@@@@@TT..TT.T...T...@@@TT.T@@@@.@@......T..T@@@@@@@@@..T...T..@@@@...T@@@@@@TTT..TT@@@@@@@@@@@@@@
@@@@@@@@@@@@@@@@@@@...T..T.T.T..T.@@@@....@@@@T.....TT...TTT@@@@@@@TT.TT.T.T@@@@@.TTTT.@@@@@..T..TT@@@@@@@@@@@@@
@@@@@@@@@@@@@@@@@@.TT.TT.T.T.TT..T.@@.TTT@@@@@.TT...@.TTTT...@@@@@@T..T.T..@@@@@@.T...T.@@@@TTTTT...@@@@@@@@@@@@
@@@@@@@@@@@@@@@@@..TT...T..T.TT....TT..T.@@@@@...T.@@@.T.T..TT@@@@@@..T.TT@@@@@@@..TT.T..@@@@T....TT.@@@@@@..@@@
@@@@@@@@@@@@@@@@T..T.TT.T..T..TTT.T....TT@@@@@....T.TT.T.....T.@@@@@@..TT@@@@@@@@..T.TT.TT@@@@TTT.T..T@@@@.TT@@@
@@@@@@@@@@@@@@@...T.T....T.T..T..T..T..T@@@@@.T.TT...T.@@@.T..T.@@@@@@..@@@@@@@@T.T.T...T.@@@@@TTT.T.T.@@T...@@@
@@@@@@@@@@@@@@.....T.....T......TT.....@@@@@..T..T....@@@@@T..T.T@@@@@@@@@@@@@.TTTTT......T@@@@@..TT.T....TT@@@@
@@@@@@@@@@@@@@...T.TT.T@@@@@@@.TTTT....T@@@..T.T...T...@@@@TT....T@@@@@@@@@@@T..T.TTT.@@@.T.@@@@@.TT.......@@@@@
@@@@@@@@@@@@@.TT...TTT@@@@@@@@@TTTTTT.TT.@@...T...TTT.TT@@TT.....T.@@@@@@@@TT.T..T..T@@@@T..@@@@@@.T...T...@@@@@
@@@@@@@@@@@@@T..T..T.T@@@@@@@@@@...TTTT...@T.T.......T..T.TT.TT..T.T@@@@@@.T..T...T.@@@@@@T..@@@@@@TT..T..TT@@@@
@@@@@@@@@@@@@..T..T...@@@@@...@@@T..T...T.@..T....T...TTT.T.@@.T.T...@@@@@@T.T.TT..@@@@@@@TT.TT@@@@@@.TTTT.T.@@@
@@@@@@@@@@@@@.T..TT...@@@@@@..T@@@........@@TT.T...........@@@...T..TT@@@@@@TT..TT@@@@@@@@TTT...@@@@@..TT....@@@
@@@@@@@@@@@@@@TT....TT@@@@@@TTTT@@@..TT...T@@.TT.....TT.T..T.TTTT.T....@@@@@@....@@@@@@@@....T..@@@@.....T...@@@
@@@@@@@@@@@@@@TT...T.T.@@@@@T..T.@@@.TT.....@..@@T..T..TT.TT.T.T@@.TT..T.@@@@@..@@@@@@@@TT.T.T.@@@@T.T.TT.TT@@@@
@@@@@@@@@@@@@@@.TT....T@@@@.T..TT.@@@.....T.@TT@@@TTT..T..TT..T@@@@TT.T.T.@@@@@@@@@@@@@..TT.T.@@@@.T..T.TT.@@@@@
@@@@@@@@@@@@@@@..T.T..T.@@@TTT.TT..@@@...TTT...@@@T.T.TT...TT..@@@@.....T.T@@@@@@@@@@@...TT...@@@.....T.T.@@@@@@
@@@@@@@@@@@@@@@@T.TTT.T.@@@.....T...@@TTTT.T.T...TT..T....T..TT.@@TT..T.T..T@@@@@@@T...TT.TTT.@@TT.TTTT..@@@@@@@
@@@@@@@@@@@@@@@@T.T..T...T@@.T..T..T.@@.T..T.T...TTT.TT.T.T.TT....T....T.T.T.@@@@@T.T..........@....TT..@@@@@@@@
@@@@@@@@@@@@@@@@@TT..T...TT@@...TT..TT@..TTT....TTT....T..TTT...T.TTT@.TTT.TT.@@@@@.TT.T.@@@.TT...TT.T.@@@@@@@@@
@@@@@@@@@@@@@@@@@@.T....T.TT@@......TT@@.T.T.TTTT......TTT...T.T.T..@@@T.......@@@@@...T@@@@...TTTT..T@@@@@@@@@@
@@@@@@@@@@@@@@@@@@@TTTT.TT.TT@@.TTT....TTT.TTTTT.......T...T.T.TTT..TT.T....T...@@@@@TT@@@@@.TTT...TT@@@@@@@@@@@
@@@@@@@@@@@@@@@@@@@@T.T.TT..T.@T..T.T.T.TTTTT.TT..T...T.@@T.....T.T..TTT@@@.T...T@@@@@@@@@@.T.T....T@@@@@@@@@@@@
@@@@@@@@@@@@@@@@@@@@@..T..T...@T.TTT.........T...T.....@@@..T...TT.T.TT@@@@@T..T..@@@@@@@@TT...T.TT@@@@@@@@@@@@@
@@@@@@@@@@@@@@@@@@@@@@TT.TT.T.@@....TT.T..............T@@@TT.TTT.T..T...@@@TT...T..@@@@@@.T.......@@@@@@@@@@@@@@
@@@@@@@@@@@@@@.@@T.@@@@..T..T..@.....T......TT..T.T..TT...TTTTT..T...T..T@..T.T.TT.T@@@@.....TT.T@@@@@@@@@@@@@@@
@@@@@@@@@@@@@T....T.@@@@.T.T...@@....T.T.T....T.....T..TTT.T.T....T..T.T......T.T.TT.@@T..T.T.T.@@@@@@@@@@@@@@@@
@@@@@@@@@@@@TTTT.....@@@@.TTT..T@T.TT..T.T..TT.TTT......TT...T...T...TT...T..@@TTTTT.......T...@@@@@@@@@@@@@@@@@
@@@@@@@@@@@..T..T.T...@@@@TT.T.T.TTTTT.T.TT..TT........T.T....TT.T...TT.T.T.@@@......TTTT.T.T.@@@@@@@@@@@@@@@@@@
@@@@@@@@@@T..TTT...T..T@@@.TTTT........TTT...T..T.T......T...T.T.T..T.T...TT....T.TT.TT.T...T@@@@@@@@@@@@@@@@@@@
@@@@@@@@@....T..T.T.TTTT@@TT.T...T.T...TTT..T.TTT.T.T...T.TTT.T.T@T.T.T..T.TT...@@@..T.TT.T.@@@@@@@@@@@@@@@@@@@@
@@@@@@@@.TTTT....T.T...T.@@T.....TT...T.TT..T..TTT...T.....T...T@@@T.T..T...T.T@@@@@TTTT.T.@@@@@@@@@@@@@@@@@@@@@
@@@@@@@T.TTTT..TT.........@T...T.T.T.TTTTTT.TT..TT.T....T.T.TTT.@@@.TT.T.T......@@@@T..T..@@@@@@@@@@@@@@@@@@@@@@
@@@@@@..TT@.T..TT.......TT.T..T.T..T.TTT...TTT.T...TT.T..T.T....TT.....TT..T...TT@@..TTT.@@@@@@@@@@@@@@@@@@@@@@@
@@@@@..T.@@@..TT....TT...T@@..TTTTT..T...T...TT.TT..T.TT..T..T.TT.T..T.TTT.TTTTTT...TT...@@@@@@@@@@@@@@@@@@@@@@@
@@@@.T..@@@@@...T.T..T..T@@@.TT..T.TT...TT.....TTT.....T.TT..T..TTT.T.T.T.TTTTT...T.T.T..@@@@@@@@@@@@@@@@@@@@@@@
@@@T.T.T@@@@.T...TTTT...T@@@@T......TTT..TTTTT..T...TTTT..T..TT...T.T.TT....T.T.T.T.T...T@@@@@@@@@@@@@@@@@@@@@@@
@@@@.TT..@@TT.T.TT..T...TT..TT.T..T..TTTT..T..T..T.T...T..T......T.T.TTTT.....TT...TT..T@@@@@@@@@@@@@@@@@@@@@@@@
@@@@@.T.T...T.TT.T.TT.....T...TTTT.T.T..TT.T.T...TTT.TT.....TT..T.....T..@@T.T...TT.T..T@@@@@@@@@@@@@@@@@@@@@@@@
@@@@@@TT...TTT@T.....T...TT.T....T........TT.T.T..T....TTTTT..T...T.T..T@@@....T...T...T@@@@@@@@@@@@@@@@@@@@@@@@
@@@@@@@TT.TTT@@@TT......T.TT...T.T..........T..TTT...T.T......T...T.T.T.@@@@....TTTTT...@@@@@@@@@@@@@@@@@@@@@@@@
@@@@@@@@TT..TT.T........T...TT.TT...T....TT.TT...T.......T.T....T..TT..T.T..TT.TTTT..TT@@@@@@@@@@@@@@@@@@@@@@@@@
@@@@@@@@@T.....TT@@@..T...T.T....T@@@.T..TT.T..T...T....TTT.TT..T...T.T......TT.TT..TT@@@@@@@@@@@@@@@@@@@@@@@@@@
@@@@@@@@@@T.T.T.@@@@@.T.TT...TT...@@@T.T...T.T.TT..TTT.T.T....TT..TTTTTT..T.TT.T..T.@@@@@@@@@@@@@@@@@@@@@@@@@@@@
@@@@@@@@@@@.TTT..@@@@.TT..TT....T.@@@..TT....TT....TT.T....T.T..TT...T.TT..T..T.T.T@@@@@@@@@@@@@@@@@@@@@@@@@@@@@
@@@@@@@@@@@@..T.T.@@.T..T.T...T.....T.T.TT.T....TT...T..T....TT...T..TT.T...T..T..@@@@@@@@@@@@@@@@@@@@@@@@@@@@@@
@@@@@@@@@@@@@.T..T..T.T.T.T.TTT.T......T..TTT..T..T..T.T..T.TT...TT.T..T.T.T..T.TT@@@@@@@@@@@@@@@@@@@@@@@@@@@@@@
@@@@@@@@@@@@@@T.T.....@@.TT.....T.T.T.....T.TT.T..T.T..T.TT.......TT.T.TT..T.TTTT@@@@@@@@@@@@@@@@@@@@@@@@@@@@@@@
@@@@@@@@@@@@@@@T..T.TT@@.....T...T.TT..T.T..T..TT..T....T....T.....T.........T.T.@@@@@@@@@@@@@@@@@@@@@@@@@@@@@@@
@@@@@@@@@@@@@@@@T.TTT.TT.TT...T...TTTT...T..T..TT.T.T.T.T...TTT...TT............@@@@@@@@@@@@@@@@@@@@@@@@@@@@@@@@
@@@@@@@@@@@@@@@@@.TT.....T@@T...T..T.......@@...T.T.T..TTT.T...T......T...TTTT..@@@@@@@@@@@@@@@@@@@@@@@@@@@@@@@@
@@@@@@@@@@@@@@@@@@.T..T...@@@.TT..T.T...T.@@@@.TT..TT.....T...TT.........TTTTT.@@@@@@@@@@@@@@@@@@@@@@@@@@@@@@@@@
@@@@@@@@@@@@@@@@@@@..T.....TTTT..TT.TTT...@@@@TT.........TT..TTT....TT.T.....@@@@@@@@@@@@@@@@@@@@@@@@@@@@@@@@@@@
@@@@@@@@@@@@@@@@@@@@......TTTT.TT.T..TT..TT.T....TTT.T.T...T.T.T.TT.T..TT.T.@@@@@@@@@@@@@@@@@@@@@@@@@@@@@@@@@@@@
@@@@@@@@@@@@@@@@@@@@@..........T.T..TT.TTT.TTT....TT.T..T......TT.T......T.@@@@@@@@@@@@@@@@@@@@@@@@@@@@@@@@@@@@@
@@@@@@@@@@@@@@@@@@@@@@T.T.T....@.T....TT.TTT....TT...T.T.TT.TTTTT.T...TTT.@@@@@@@@@@@@@@@@@@@@@@@@@@@@@@@@@@@@@@
@@@@@@@@@@@@@@@@@@@@@@@TTT.TT.@@@..TT.T..TT...TT.....TTTTTT.TT..T........@@@@@@@@@@@@@@@@@@@@@@@@@@@@@@@@@@@@@@@
@@@@@@@@@@@@@@@@@@@@@@@@...TTTTT.T...T..TT.T.......TT......T.TT.....T...@@@@@@@@@@@@@@@@@@@@@@@@@@@@@@@@@@@@@@@@
@@@@@@@@@@@@@@@@@@@@@@@@@T....T..T@@@TTT.T.TT....TT.@..T...T.T.T.T.....@@@@@@@@@@@@@@@@@@@@@@@@@@@@@@@@@@@@@@@@@
@@@@@@@@@@@@@@@@@@@@@@@@@@..T.....@@@TT.TT..T......@@@T.....T..TT...T@@@@@@@@@@@@@@@@@@@@@@@@@@@@@@@@@@@@@@@@@@@
@@@@@@@@@@@@@@@@@@@@@@@@@@@T..T.....T.T.T....TT....@@@TTTTT.TT.T.@@@@@@@@@@@@@@@@@@@@@@@@@@@@@@@@@@@@@@@@@@@@@@@
@@@@@@@@@@@@@@@@@@@@@@@@@@@@TTTTTT..TTT.....TTT.TT..TTT......T..@@@@@@@@@@@@@@@@@@@@@@@@@@@@@@@@@@@@@@@@@@@@@@@@
@@@@@@@@@@@@@@@@@@@@@@@@@@@@@.T..T.............TT.TTT.TT.T....T@@@@@@@@@@@@@@@@@@@@@@@@@@@@@@@@@@@@@@@@@@@@@@@@@
@@@@@@@@@@@@@@@@@@@@@@@@@@@@@@....TT...@.T.T.....T.TTT..TTT.T.@@@@@@@@@@@@@@@@@@@@@@@@@@@@@@@@@@@@@@@@@@@@@@@@@@
@@@@@@@@@@@@@@@@@@@@@@@@@@@@@@@..T....T@@.T.....TTT..T.T.T..@@@@@@@@@@@@@@@@@@@@@@@@@@@@@@@@@@@@@@@@@@@@@@@@@@@@
@@@@@@@@@@@@@@@@@@@@@@@@@@@@@@@@T.....TTT......T...T....T.@@@@@@@@@@@@@@@@@@@@@@@@@@@@@@@@@@@@@@@@@@@@@@@@@@@@@@
@@@@@@@@@@@@@@@@@@@@@@@@@@@@@@@@@...T...TT@@@.T.TT......@@@@@@@@@@@@@@@@@@@@@@@@@@@@@@@@@@@@@@@@@@@@@@@@@@@@@@@@
@@@@@@@@@@@@@@@@@@@@@@@@@@@@@@@@@@T.......@@@T....T..@@@@@@@@@@@@@@@@@@@@@@@@@@@@@@@@@@@@@@@@@@@@@@@@@@@@@@@@@@@
@@@@@@@@@@@@@@@@@@@@@@@@@@@@@@@@@@@..T.T....T.TTT.T@@@@@@@@@@@@@@@@@@@@@@@@@@@@@@@@@@@@@@@@@@@@@@@@@@@@@@@@@@@@@
@@@@@@@@@@@@@@@@@@@@@@@@@@@@@@@@@@@@@.T..TT.TTT...@@@@@@@@@@@@@@@@@@@@@@@@@@@@@@@@@@@@@@@@@@@@@@@@@@@@@@@@@@@@@@
@@@@@@@@@@@@@@@@@@@@@@@@@@@@@@@@@@@@@@@TT.TT.TTT.@@@@@@@@@@@@@@@@@@@@@@@@@@@@@@@@@@@@@@@@@@@@@@@@@@@@@@@@@@@@@@@
@@@@@@@@@@@@@@@@@@@@@@@@@@@@@@@@@@@@@@@@T...TTTT@@@@@@@@@@@@@@@@@@@@@@@@@@@@@@@@@@@@@@@@@@@@@@@@@@@@@@@@@@@@@@@@
@@@@@@@@@@@@@@@@@@@@@@@@@@@@@@@@@@@@@@@@@TT.T.@@@@@@@@@@@@@@@@@@@@@@@@@@@@@@@@@@@@@@@@@@@@@@@@@@@@@@@@@@@@@@@@@@
@@@@@@@@@@@@@@@@@@@@@@@@@@@@@@@@@@@@@@@@@@T.T@@@@@@@@@@@@@@@@@@@@@@@@@@@@@@@@@@@@@@@@@@@@@@@@@@@@@@@@@@@@@@@@@@@
@@@@@@@@@@@@@@@@@@@@@@@@@@@@@@@@@@@@@@@@@@@@@@@@@@@@@@@@@@@@@@@@@@@@@@@@@@@@@@@@@@@@@@@@@@@@@@@@@@@@@@@@@@@@@@@@
@@@@@@@@@@@@@@@@@@@@@@@@@@@@@@@@@@@@@@@@@@@@@@@@@@@@@@@@@@@@@@@@@@@@@@@@@@@@@@@@@@@@@@@@@@@@@@@@@@@@@@@@@@@@@@@@
@@@@@@@@@@@@@@@@@@@@@@@@@@@@@@@@@@@@@@@@@@@@@@@@@@@@@@@@@@@@@@@@@@@@@@@@@@@@@@@@@@@@@@@@@@@@@@@@@@@@@@@@@@@@@@@@
@@@@@@@@@@@@@@@@@@@@@@@@@@@@@@@@@@@@@@@@@@@@@@@@@@@@@@@@@@@@@@@@@@@@@@@@@@@@@@@@@@@@@@@@@@@@@@@@@@@@@@@@@@@@@@@@
@@@@@@@@@@@@@@@@@@@@@@@@@@@@@@@@@@@@@@@@@@@@@@@@@@@@@@@@@@@@@@@@@@@@@@@@@@@@@@@@@@@@@@@@@@@@@@@@@@@@@@@@@@@@@@@@
@@@@@@@@@@@@@@@@@@@@@@@@@@@@@@@@@@@@@@@@@@@@@@@@@@@@@@@@@@@@@@@@@@@@@@@@@@@@@@@@@@@@@@@@@@@@@@@@@@@@@@@@@@@@@@@@
@@@@@@@@@@@@@@@@@@@@@@@@@@@@@@@@@@@@@@@@@@@@@@@@@@@@@@@@@@@@@@@@@@@@@@@@@@@@@@@@@@@@@@@@@@@@@@@@@@@@@@@@@@@@@@@@
@@@@@@@@@@@@@@@@@@@@@@@@@@@@@@@@@@@@@@@@@@@@@@@@@@@@@@@@@@@@@@@@@@@@@@@@@@@@@@@@@@@@@@@@@@@@@@@@@@@@@@@@@@@@@@@@
