type octile
height 102
width 92
map
@@@@@@@@@@@@@@@@@@@@@@@@@@@@@@@@@@@@@@@@@@@@@@@@@@@@@@@@@@@@@@@@@@@@@@@@@@@@@@@@@@@@@@@@@@@@
@@@@@@@@@@@@@@@@@@@@@@@@@@@@@@@@@@@@@@@@@@@@@@@@@@@@@@@@@@@@@@@@@@@@@@@@@@@@@@@@@@@@@@@@@@@@
@@@@@@@@@@@@@@@@@@@@@@@@@@@@@@@@@@@@@@@@@@@@@@@@@@@@@@@@@@@@@@@@@@@@@@@@@@@@@@@@@@@@@@@@@@@@
@@@@@@@@@@@@@@@@@@@@@@@@@@@@@@@@@@@@@@@@@@@@@@@@@@@@@@@@@@@@@@@@@@@@@@@@@@@@@@@@@@@@@@@@@@@@
@@@@@@@@@@@@@@@@@@@@@@@@@@@@@@@@@@@@@@@@@@@@@@@@@@@@@@@@@@@@@@@@@@@@@@@@@@@@@@@@@@@@@@@@@@@@
@@@@@@@@@@@@@@@@@@@@@@@@@@@@@@@@@@@@@@@@@@@@@@@@@@@@@@@@@@@@@@@@@@@@@@@@@@@@@@@@@@@@@@@@@@@@
@@@@@@@@@@@@@@@@@@@@@@@@@@@@@@@@@@@@@@@@@@@@@@@@@@@@@@@@@@@@@@@@@@@@@@@@@@@@@@@@@@@@@@@@@@@@
@@@@@@@@@@@@@@@@@@@@@@@@@@@@@@@@@@@@@@@@@@@@@@@@@@@@@@@@@@@@@@@@@@@@@@@@@@@@@@@@@@@@@@@@@@@@
@@@@@@@@@@@@@@@@@@@@@@@@@@@@@@@@@@@@@@@@@@@@@@@@@@@@@@@@@@@@@@@@@@@@@@@@@@@@@@@@@@@@@@@@@@@@
@@@@@@@@@@@@@@@@@@@@@@@@@@@@@@@@@@@@@@@@@@@@@@@@@@@@@@@@@@@@@@@@@@@@@@@@@@@@@@@@@@@@@@@@@@@@
@@@@@@@@@@@@@@@@@@@@@@@@@@@@@@@@@@@@@@@@@@@@@@@@@@@@@@@@@@@@@@@@@@@@@@@@@@@@@@@@@@@@@@@@@@@@
@@@@@@@@@@@@@@@@@@@@@@@@@@@@@@@@@@@@@@@@@@@@@@@@@@@@@@@@@@@@@@@@@@@@@@@@@@@@@@@@@@@@@@@@@@@@
@@@@@@@@@@@@@@@@@@@@@@@@@@@@@@@@@@@@@@@@@@@@@@@@@@@@@@@@@@@@@@@@@@@@@@@@@@@@@@@@@@@@@@@@@@@@
@@@@@@@@@@@@@@@@@@@@@@@@@@@@@@@@@@@@@@@@@@@@@@@@@@@@@@@@@@@@@@@@@@@@@@@@@@@@@@@@@@@@@@@@@@@@
@@@@@@@@@@@@@@@@@@@@@@@@@@@@@@@@@@@@@@@@@@@@@@@@@@@@@@@@@@@@@@@@@@@@@@@@@@@@@@@@@@@@@@@@@@@@
@@@@@@@@@@@@@@@@@@@@@@@@@@@@@@@@@@@@@@@@@@@@@@@@@@@@@@@@@@@@@@@@@@@@@@@@@@@@@@@@@@@@@@@@@@@@
@@@@@@@@@@@@@@@@@@@@@@@@@@@@@@@@@@@@@@@@@@@@@@@@@@@@@@@@@@@@@@@@@@@@@@@@@@@@@@@@@@@@@@@@@@@@
@@@@@@@@@@@@@@@@@@@@@@@@@@@@@@@@@@@@@@@@@@@@@@@@@@@@@@@@@@@@@@@@@@@@@@@@@@@@@@@@@@@@@@@@@@@@
@@@@@@@@@@@@@@@@@@@@@@@@@@@@@@@@@@@@@@@@@@@@@@@@@@@@@@@@@@@@@@@@@@@@@@@@@@@@@@@@@@@@@@@@@@@@
@@@@@@@@@@@@@@@@@@@@@@@@@@@@@@@@@@@@@@.....T..TT..T.....T@@@@@@@@@@@@@@@@@@@@@@@@@@@@@@@@@@@
@@@@@@@@@@@@@@@@@@@@@@@@@@@@@@@@@....TTTTTTTT...TT.T..TT...@@@@@@@@@@@@@@@@@@@@@@@@@@@@@@@@@
@@@@@@@@@@@@@@@@@@@@@@@@@@@@@TT..TT..TTTT..T.TTT......T....@@@@@@@@@@@@@@@@@@@@@@@@@@@@@@@@@
@@@@@@@@@@@@@@@@@@@@@@@@@@@T..T..TT......TTTT.TT...T.TT..TT@@@@@@@@@@@@@@@@@@@@@@@@@@@@@@@@@
@@@@@@@@@@@@@@@@@@@@@@@@@....T.TTT..T..T.T.....T..T....T.TT@@@@@@@@@@@@@@@@@@@@@@@@@@@@@@@@@
@@@@@@@@@@@@@@@@@@@@@@@TTT.TT..T..TT...T..TT..TT........TT.@@@@@@@@@@@@@@@@@@@@@@@@@@@@@@@@@
@@@@@@@@@@@@@@@@@@@@@...TTT..TT....TT..........T..TTTT.T.T.@@@@@@@@@@@@@@@@@@@@@@@@@@@@@@@@@
@@@@@@@@@@@@@@@@@@@@.T.T.TTTT.TTT..T..TTTTTT..TTTT.TT..T...@@@@@@@@@@@@@@@@@@@@@@@@@@@@@@@@@
@@@@@@@@@@@@@@@@@@@TTTTTTTT..TTTT..T...T.T....T.T...T....TT@@@@@@@@@@@@@@@@@@@@@@@@@@@@@@@@@
@@@@@@@@..@@@@@@@..TT....TT..T.T.T.TTT..T@@.T..T.T@@.....T.@@@@@@@@@@@@@@@@@@@@@@@@@@@@@@@@@
@@@@@@@@TT.@@@@@T.......TTT.TT.....T.T..@@@@..TT.@@@@T.....@@@@@@@@@@@@@@@@@@@@@@@@@@@@@@@@@
@@@@@@@....@@@@.....TT.T.T.T.TT.@@.TT....T..TT.....T..TTT..@@@@@.T@@@@@@@@@@@@@@@@@T..@@@@@@
@@@@@@@..T.T@@.....T...TTTTT.T.@@@@TTT.@@@@@@@@@@@@@@T.T...@@@@@TT.@@@@@@@@@@@@@@@T.TT.@@@@@
@@@@@@......T.TTTT..TTTTTTTTTT..@@@@@@@@@@@@@@@@@@@@@@@@@..@@@@@...@@@@@@@@@@@@@@..T...@@@@@
@@@@@@T..T..TT......TT..@@..T.TT@@@@@@@@@@@@@@@@@@@@@@@@@@@@@@@@T...@@@@@@@@@@@@...T...@@@@@
@@@@@@TT.TTTTTTTT..TT.T.@@@TT@@@@@@@@@@@@@@@@@@@@@@@@@@@@@@@@@@@T.T.@@@@@@@@@@@T...T...@@@@@
@@@@@.TT.T.....T...T..T@@@@@@@@@@@@@@@@@@@@@@@@@@@@@@@@@@@@@@@@@TT..@@@@@@@@@@T.T..TT..@@@@@
@@@@@....TT.TT...TTT.....@@@@@@@@@@@@@@@@@@@@@@@@@@@@@@@@@@@@@@.TT.T@@@@@@@@@...TTTTTTTT@@@@
@@@@...T.T.T.T.T....TTT@@@@@@@@@@@@@@@@@@@@@@@@@@@@@@@@@@@@@@@.T....@@@@@@@@............@@@@
@@@@T...T.T...TT...T..@@@@@@@@@@@@@@@@@@@@@@@@@@@@@@@@@@@@@@@..TT.T.@@@@@@@@...T.T..T...@@@@
@@@@T.TT..T.T.TT.@@@@@@@@@@@@@@@@@@@@@@@@@@@@@@@@@@@@@@@@@@@..T...TT@@@@@@@@....TT.TTT.TT@@@
@@@@..TT......T..@@@@@@@@@@@@@@@@@@@@@@@@@@@@@@@@@@@@@@@@@@..T....T@@@@@@@@@.....TT..TT.T@@@
@@@T.....TT...T.T@@@@@@@@@@@@@@@@@@@@@@@@@@@@@@@@@@@@@@@@@T.T..TTT.@@@@@@@@@.T.TTT..TTT.T@@@
@@@T...TTT.TT...TT.T@@@@@@@@@@@@@@@@@@@@@@@@@@@@@@@@@@@@@@..TT..T.@@@@@@@@@@T.T.....TTT.T@@@
@@@...T..T...TT.TTT..@@@@@@@@@@@@@@@@@@@@@@@@@@@@@@@@@@@@.T.T.TTT@@@@@@@@@T........T.T.TT@@@
@@@T..T.T..TTTTT...TTT.@@@@@@@@@@@@@@@@@@@@@@@@@@@@@@@@@T.T.....@@@@@@@@@@@.TTTT...TTTTTT@@@
@@@.TT..TT.T..T..TT..T...@@@@@@@@@@@@@@@@@@@@@@@@@@@@@@T.......T@@@@@@@@@@@@...T....T...T@@@
@@@TT..T..T...T.TT......T..@@@@@@@@@@@@@@@@@@@@@@@@@@@...T....T@@@@@@@@@@@@@@.@@.........@@@
@@@........T@@@@....TTTTT..T@@@@@@@@@@@@@@@@@@@@@@@@@TTT.TT.TT@@@@@@@@@@@@@@@@@@TT.T..T.T@@@
@@@....T..T@@@@@@T..T...T.T.T.@@@@@@@@@@@@@@@@@@@@@@@T.......@@@@@@@@@@@@@@@@@@@@T.......@@@
@@@.TT.......@@@@@@.....TT..TT.T@@@@@@@@@@@@@@@@@@@@TT....T.T@@@@@@@@@@@@@@@@@@@@.TT..T..@@@
@@@..T..T....@@@@@@@.T.....TT....@@@@@@@@@@@@@@@@@@TTT.TT.T.@@@@@@@@@@@@@@@@@@@T.T..T.T..@@@
@@@.T.TT.....@@@@@@@@@..TT.T.T.T.T@@@@@@@@@@@@@@@@....T....@@@@@@@@@@@@@@@@@@@@.T..T.T...@@@
@@@.TT.TTT.T@@@@@@@@@@@..TT.T....TTT@@@@@@...T.T...TT...T.@@@@@@@@@@@@@@@@@@@@@@.....T..T@@@
@@@T..TT.T..@@@@@@@@@@@@@.......T..T.@@....T.T.T.....TTT..@@@@@@@@@@@@@@@@@@@@@@T...TT.T.@@@
@@@.TTT..TT.@@@@@@@@@@@@@@..T.....TTT...T....TTT.TT..TTT.@@@@@@@@@@@@@@@@@@@@@@@@.TT.TT..@@@
@@@T..TT...@@@@@@@@@@@@@@@@@.....T..TT.T...T.T.T..T..TT..@@@@@@@@@@@@@@@@@@@@@@@@...TT..T@@@
@@@...TT...@@@@@@@@@@@@@@@@@@....TT.T..TT...TTTTT..T..T..@@@@@@@@@@@@@@@@@@@@@@@@@.T..T..@@@
@@@.T......@@@@@@@@@@@@@@@@@@@@TT.TT...TTT...TT.TT.TTTT.T.@@@@@@@@@@@@@@@@@@@@@@@@...TTT.@@@
@@@.....TT.@@@@@@@@@@@@@@@@@@@@@.TT.TT..T..T..T..T.T..TT.T@@@@@@@@@@@@@@@@@@@@@@@@TT...T.@@@
@@@.T.TT.T.@@@@@@@@@@@@@@@@@@@@@@..TTTT.TT.T@@@@.......TT..@@@@@@@@@@@@@@@@@@@@@@@..T.TT.@@@
@@@.T..T.TT.@@@@@@@@@@@@@@@@@@@@@.T.T.T..T@@@@@@@@T.T.T..TT@@@@@@@@@@@@@@@@@@@@@@@.....TT@@@
@@@...T.TT..@@@@@@@@@@@@@@@@@@@@@T.T.TTT.@@@@@@@@@@TTTTT...@@@@@@@@@@@@@@@@@@@@@@@...T..T@@@
@@@.T....T.T@@@@@@@@@@@@@@@@@@@@@.T..TT.@@@@@@@@@@@T....T..@@@@@@@@@@@@@@@@@@@@@@@.T..TT.@@@
@@@TTT....T.@@@@@@@@@@@@@@@@@@@@@T..T..T@@@@@@@@@@@TTTTT..T@@@@@@@@@@@@@@@@@@@@@@@...T..T@@@
@@@T.T.....T@@@@@@@@@@@@@@@@@@@@@.T.T...@@@@@@@@@@@TT.T....@@@@@@@@@@@@@@@@@@@@@@@T......@@@
@@@T.TTT...T.@@@@@@@@@@@@@@@@@@@@T...T..@@@@@@@@@@@T..T.T.T@@@@@@@@@@@@@@@@@@@@@@@..T.TT.@@@
@@@..T...TT.T@@@@@@@@@@@@@@@@@@@@.T.T....@@@@@@@@@@.....TT.@@@@@@@@@@@@@@@@@@@@@@@.......@@@
@@@T.TT...T..@@@@@@@@@@@@@@@@@@@@....TTTT@@@@@@@@@..TTT....@@@@@@@@@@@@@@@@@@@@@@T..T.T.T@@@
@@@T.T..TTTT.T@@@@@@@@@@@@@@@@@@@@..T....T@@@@@@@T.TTT.T...@@@@@@@@@@@@@@@@@@@@@@..TTTT.T@@@
@@@T.TTTTTT...T@@@@@@@@@@@@@@@@@@@.........@@@@@T..T....TT.T.@@@@@@@@@@@@@@@@@@@@TTT..T..@@@
@@@.T.T...TTT..@@@@@@@@@@@@@@@@@@@@..TTTT.T.T...T..TT.....T.T.@@@@@@@@@@@@@@@@@@@TT..TT.T@@@
@@@.T....T.TT...@@@@@@@@@@@@@@@@@@@...TT.T..T..T....T...T...T...@@@@@@@@@@@@@@@@TT.......@@@
@@@TT.TT.T....TT@@@@@@@@@@@@@@@@@@T.....TTT.T.....T..T....T.....T.@@@@@@@@@@@@@TT......TT@@@
@@@.....T....T..T@@@@@@@@@@@@@@@@@..TT.TT..TTT.TT..T.@@T.....TT.T.T.@@@@@@@@@@.TT...T.T.T@@@
@@@....TT..T...T..@@@@@@@@@@@@@@@@TTT.T..........T.@@@@@..T..TT.TT.TT@@@@@@@@@...T..T...T@@@
@@@...T.TT...T.T.T@@@@@@@@@@@@@@@TTT...TTT@@T...@@@@@@@@@@....T.T.....T@@@@@@T......TT.T.@@@
@@@T...TT.TTT.TTTT.@@@@@@@@@@@@@...TT..T.@@@@@@@@@@@@@@@@@@.T...T........@@@.....T.T..TTT@@@
@@@..TTTTTT...TT.T.T@@@@@@@@@@@@T..T.T..@@@@@@@@@@@@@@@@@@@@@T..TTT..T.....T.T.T..T..T...@@@
@@@T.TT.T..T.T.TT...@@@@@@@@@@@TT.TTT..@@@@@@@@@@@@@@@@@@@@@@@.T...TT...T..........TTT.T.@@@
@@@...TT.T..T.T.T.T..@@@@@@@@@.......T.@@@@@@@@@@@@@@@@@@@@@@@@..TT.......T...T..TT....T.@@@
@@@T..T...TT.T..TT...T@@@@@@@@.T.....T@@@@@@@@@@@@@@@@@@@@@@@@@@TTTT..T..T.T..T.TT..T...T@@@
@@@@.TT..T..T..T.T.T..@@@@@@TT....T.T@@@@@@@@@@@@@@@@@@@@@@@@@@@@T.T.TT.....T.T.T..TT...T@@@
@@@@@@..T....TTT.TTTT..T@@T.TT.TT...@@@@@@@@@@@@@@@@@@@@@@@@@@@@@@.TT....T..TT.T...T..TT@@@@
@@@@@@.T.TTTT.T..T....T..T..T..T..T@@@@@@@@@@@@@@@@@@@@@@@@@@@@@@@TT.T..T..T.T.TTTTT.T.@@@@@
@@@@@@@.T...T...TT.T.T.T..T.T...TT@@@@@@@@@@@@@@@@@@@@@@@@@@@@@@@TT....T.T.TT.T.TT..T.@@@@@@
@@@@@@@@@.TT....T.TTT....TT.....T@@@@@@@@@@@@@@@@@@@@@@@@@@@@@@@@T.T..TT.T..TTT..T...@@@@@@@
@@@@@@@@@@.T...TTT.T.....T.TTT..@@@@@@@@@@@@@@@@@@@@@@@@@@@@@@@@.TT.T.TT.T...T.T....@@@@@@@@
@@@@@@@@@@@@..TTTT..T...TT..TTT...@@@@@@@@@@@@@@@@@@@@@@@@@@@@@.TT.T.T..T.T..T...T@@@@@@@@@@
@@@@@@@@@@@@@@T.TTT.....TT....TT..T@@@@@@@@@@@@@@@@@@@@@@@@TT..T.TT......T..TT.T.@@@@@@@@@@@
@@@@@@@@@@@@@@@TTT...T...T.......T.T..T...@@@@@@@@@@@@@@@TTT..TTTTTTTTT.....T..@@@@@@@@@@@@@
@@@@@@@@@@@@@@@@@@T.T.T.T....TTT....T.T.T...T..TT............T..T.TT.T.T...TTT@@@@@@@@@@@@@@
@@@@@@@@@@@@@@@@@@@..TT.T.TTT.TTT....T......TT...TT.T.T.TTT...TT.TTTT.T...T@@@@@@@@@@@@@@@@@
@@@@@@@@@@@@@@@@@@@@....T....TTTT..T.TT...T....T.T.......T.T.T..T.TT...@@@@@@@@@@@@@@@@@@@@@
@@@@@@@@@@@@@@@@@@@@@@..T.....T..TTTTT.T.........T.T...T..TT.TT..T.T@@@@@@@@@@@@@@@@@@@@@@@@
@@@@@@@@@@@@@@@@@@@@@@@.........T.TT..T.T...TT.TT.......T.....TT..T@@@@@@@@@@@@@@@@@@@@@@@@@
@@@@@@@@@@@@@@@@@@@@@@@@@@@TT.T...T.T.TT.TT.TT..T..TTT.T.T.....@@@@@@@@@@@@@@@@@@@@@@@@@@@@@
@@@@@@@@@@@@@@@@@@@@@@@@@@@@@@........T.T....T...T.T......T.@@@@@@@@@@@@@@@@@@@@@@@@@@@@@@@@
@@@@@@@@@@@@@@@@@@@@@@@@@@@@@@@@TTT...TT.T.T...T..T.T....T@@@@@@@@@@@@@@@@@@@@@@@@@@@@@@@@@@
@@@@@@@@@@@@@@@@@@@@@@@@@@@@@@@@@@@@TTT..TT..T..TT.TT.T.@@@@@@@@@@@@@@@@@@@@@@@@@@@@@@@@@@@@
@@@@@@@@@@@@@@@@@@@@@@@@@@@@@@@@@@@@@@@@@@@@@@@@@@@@@@@@@@@@@@@@@@@@@@@@@@@@@@@@@@@@@@@@@@@@
@@@@@@@@@@@@@@@@@@@@@@@@@@@@@@@@@@@@@@@@@@@@@@@@@@@@@@@@@@@@@@@@@@@@@@@@@@@@@@@@@@@@@@@@@@@@
@@@@@@@@@@@@@@@@@@@@@@@@@@@@@@@@@@@@@@@@@@@@@@@@@@@@@@@@@@@@@@@@@@@@@@@@@@@@@@@@@@@@@@@@@@@@
