type octile
height 54
width 56
map
@@@@@@@@@@@@@@@@@@@@@@@@@@@@@@@@@@@@@@@@@@@@@@@@@@@@@@@@
@@@@@@@@@@@@@@@@@@@@@@@@@@@@@@@@@@@@@@@@@@@@@@@@@@@@@@@@
@@@@@@@@@@@@@@@@@@@@@@@@@@@@@@@@@@@@@@@@@@@@@@@@@@@@@@@@
@@@@@@@@@@@@@@@@@@@@@@@@@@@@@@@@@@@@@@@@@@@@@@@@@@@@@@@@
@@@@@@@@@@@@@@@@@@@@@@@@@@@@@@@@@@@@@@@@@@@@@@@@@@@@@@@@
@@@@@@@@@@@@@@@@@@@@@@@@@@@@@@@@@@@@@@@@@@@@@@@@@@@@@@@@
@@@@@@@@@@@@@@@@@@@@@@@@@@@@@@@@@@@@@@@@@@@@@@@@@@@@@@@@
@@@@@@@@@@@@@@@@@@@@@@@@@@@@@@@@@@@@@@@@@@@@@@@@@@@@@@@@
@@@@@@@@@@@@@@@@@@@@@@@@@@@@@@@@@@@@@@@@@@@@@@@@@@@@@@@@
@@@@@@@@@@@@@@@@@@@@@@@@@@@@@@@@@@@@@@@@@@@@@@@@@@@@@@@@
@@@@@@@@@@@@@@@@@@@@@.T@@@@@@@@@@@@@@@@@@@@@@@@@@@@@@@@@
@@@@@@@@@@@@@@@@@@@@...T@@@@@@@@@@@@@@@@@@@@@@@@@@@@@@@@
@@@@@@@@@@@@@@@@@@@....T.@@@@@@@@@@@@@@@.@@@@@@@@@@@@@@@
@@@@@@@@@@@@@@@@@@T.TTTT..@@@@@@@@@@@@@.T.@@@@@@@@@@@@@@
@@@@@@@@@@@@@@@@@...T.T..T.@@@@@@@@@@@.T..T@@@@@@@@@@@@@
@@@@@@@@@@@@@@@@T...@@..T...@@@@@@@@@@.T..T@@@@@@@@@@@@@
@@@@@@@@@@@@@@@.T..@@@TTTTTT.@@@@@@@@T..T..@@@@@@@@@@@@@
@@@@@@@@@@@@@@.TT.@@@@T....T..@@@@@@.T..TT.@@@@@@@@@@@@@
@@@@@@@@@@@@@..TTT@@@T.TT..TT..@@@@...TTTT.@@@@@@@@@@@@@
@@@@@@@@@@@@T.T....@TT.TT.TT....@@..T...@@@@@@@@@@@@@@@@
@@@@@@@@@@.T...T.T.T...TT.T.....T.TT.T.@@@@@@@@@@@@@@@@@
@@@@@@@@@T..T..TTTTT...T....T...T...T..@@@@@@@@@@@@@@@@@
@@@@@@@@TTTT.TT.TTTT..TT.@@@@..TTTT...TT@@TTT.@@@@@@@@@@
@@@@@@@@@.TT.TTT..T....T.@@@@@.TT..T.T.T..T..@@@@@@@@@@@
@@@@@@@@@@....TT.T....TT@@@@@@@..T...T.....T@@@@@@@@@@@@
@@@@@@@@@@@..T....TTTTT.@@@@@@@@.TT..TT..TT@@@@@@@@@@@@@
@@@@@@@@@@@@@T..T@T...TT@@@@@@@@@T.......@@@@@@@@@@@@@@@
@@@@@@@@@@@@@@@T.@@.....T@@@@@@@@@......@@@@@@@@@@@@@@@@
@@@@@@@@@@@@@@@TT.@@.T...T@@@@@@@@@.T..@@@@@@@@@@@@@@@@@
@@@@@@@@@@@@@@@@.T@@@...T..@@@@@@@@.T..T@@@@@@@@@@@@@@@@
@@@@@@@@@@@@@@@@..@@@@TT.T.T@@@@@@...T..T@@@@@@@@@@@@@@@
@@@@@@@@@@@@@@@@@T@@@@@TTTT.T@@@@..TT.TTT.@@@@@@@@@@@@@@
@@@@@@@@@@@@@@@@@@@@@@@@.T...@@@.T..T..T...@@@@@@@@@@@@@
@@@@@@@@@@@@@@@@@@@@@@@@.T..TT.TT.TT....T...@@@@@@@@@@@@
@@@@@@@@@@@@@@@@@@@@@@@@T.....TTTT...TT......@@@@@@@@@@@
@@@@@@@@@@@@@@@.@@@@@@@@.T.TTT...TT..T.......T@@@@@@@@@@
@@@@@@@@@@@@.....T..TT.T.T....T.T......TT.T.T.@@@@@@@@@@
@@@@@@@@@@.TT.TT...T..TTTT..T.T.T....@T.T..T.@@@@@@@@@@@
@@@@@@@@..TTTTTT.T...TTT..T.T....T..@@@T....@@@@@@@@@@@@
@@@@@@@..T.@@..TT.T.TT.T.TT.TTTTTTTT@@@@..T@@@@@@@@@@@@@
@@@@@@.T..@@.TTTT..T.....TT..TT.TT...@@@@.@@@@@@@@@@@@@@
@@@@@@..TT..TTT.......T.T@...TT.TTTT..@@@@@@@@@@@@@@@@@@
@@@@@@.T..T.T.TT..T.TTTT@@@T.TTTT..T.TT@@@@@@@@@@@@@@@@@
@@@@@@..TTT...T......T.@@@@@..T.T...T.T@@@@@@@@@@@@@@@@@
@@@@@@@..T...TT...T.T.@@@@@@@.T..T.TTT@@@@@@@@@@@@@@@@@@
@@@@@@@@T..T...T.....@@@@@@@@@TT..T..@@@@@@@@@@@@@@@@@@@
@@@@@@@@@........TT.@@@@@@@@@@@@....@@@@@@@@@@@@@@@@@@@@
@@@@@@@@@@T.T..T.T.@@@@@@@@@@@@@@.@@@@@@@@@@@@@@@@@@@@@@
@@@@@@@@@@@T.TTT.T@@@@@@@@@@@@@@@@@@@@@@@@@@@@@@@@@@@@@@
@@@@@@@@@@@@.T.T@@@@@@@@@@@@@@@@@@@@@@@@@@@@@@@@@@@@@@@@
@@@@@@@@@@@@@@.@@@@@@@@@@@@@@@@@@@@@@@@@@@@@@@@@@@@@@@@@
@@@@@@@@@@@@@@@@@@@@@@@@@@@@@@@@@@@@@@@@@@@@@@@@@@@@@@@@
@@@@@@@@@@@@@@@@@@@@@@@@@@@@@@@@@@@@@@@@@@@@@@@@@@@@@@@@
@@@@@@@@@@@@@@@@@@@@@@@@@@@@@@@@@@@@@@@@@@@@@@@@@@@@@@@@
