type octile
height 80
width 80
map
@@@@@@@@@@@@@@@@@@@@@@@@@@@@@@@@@@@@@@@@@@@@@@@@@@@@@@@@@@@@@@@@@@@@@@@@@@@@@@@@
@@@@@@@@@@@@@@@@@@@@@@@@@@@@@@@@@@@@@@@@@@@@@@@@@@@@@@@@@@@@@@@@@@@@@@@@@@@@@@@@
@@..TTT...TT..T...........T...TT.......TT....TTT...T...T...TT..TTTT.T.T.T..T.T@@
@@.....T.....T....TT.T.TT.TTTT.T....T..TTTT...TTT.T.TT.T...T..TT..T....T..TT..@@
@@T....T...TT.T.T....TT........T.....T.T..TTTT.TT.TTT.T......T..TTTT.TTT.TT.TT@@
@@.TT.T..T.T..T..T..TTT..T..T..TTT..T...T.TTT...T..T...T.TT..TT..TTTT.T......T@@
@@TTT..T....T...T..T.TT.TTTTTTTTT....TTTT.........T.T.T.T.TT..........TT..TTT.@@
@@....TTT.T...TTT.TT...T.T...TT.......T.T......T..TT..T...T...TTT..TT.T.......@@
@@...T.T.TT.......TT.....T.T..TTT...TT...T.....T..TT.TT.TT.T.TT........TT....T@@
@@T.TT..TTTT...TT.T...TT..TT..TT..TTT.TT.T..TTTTTTT.T..T..T.TT..TT.T.TT.TTT.TT@@
@@T..TTTTTT.T.T....TTTT..T.T...T....TTT.T.TT.T..T.T....T.T....T..TT...TT.TT.T.@@
@@....TTTT.....T....TT.....T....T..TT....@@@T...TT.......T.TT..T.T...T...T..T.@@
@@..TT.T...TT....T..T...T.T.....T.T....T@@@@@TT...TT...T....TTTT.T.T...TT.....@@
@@T.T...T..........T.T.T....T.......T.TT@@@@@.TT..T..TTT.T....T.T..T.T...T....@@
@@T.T.T...T.TT.T.T.....TT.....T...TTTTT.T@@@T...T..TT@@@@..TTTT.....T.T....T.T@@
@@T.T.TT.TT...TT......TTT..T.....TTT..T....T...T..TT.@@@@.TTT..TTT.T.T..T.T.TT@@
@@....T.......T.T....T.T.T.....TT....T.TTT.T..T....TT.@@TT..TT...T......TTTT..@@
@@..TTT..T.T.TT.T.TT...T.....T.TTT@@@@@T..T....T..TTTTT.T.T.T.T.T....T.T.T...T@@
@@TTTT.......TT.T........T..TT.TT.@@@@@T......TT..T.T....T.....TTT@@@@@TTTT...@@
@@T.T.TTTTTTT...T.TT.TTT.TT..T.T.T.@@@.T.T.T.TT...TTT.T..T..T.T...@@@@@....T.T@@
@@T.T..T....T.TTTTT.TTTT...TT.T.TT.......T.T.T..T..T.T.T..TT...T...@@@......TT@@
@@TT.....TT....TT.T.TT......TT..T.T...T..T.....TTTT..T..TTT.TT..TTTTTTT.TT..TT@@
@@.T..T.T.TT....T.T.T...T.T....TT.T..TT.T.T......T.T.T..T.T......T....T..TT..T@@
@@.TT..T..T..TT........TT.TT.T..........TTTT..T..T..T.T..TTTT..T...TTT.TT.....@@
@@..T...T.T...T..T......T.TTT..TT..T..TT...T....TT.T................T.T..T.T.T@@
@@..TTT.TT..TTT..TT..TT.T..TT.T....TTTTTT...TT..TT.T..T.......T..T.....TT..T..@@
@@....TT..T.TTTTT......T.........TT..T.T..T.....TTT.T.......T.TT.TT...T.T.TTTT@@
@@T..TT..T.T.T.........T...T..TTT.T...TT..........T.T.TTT..TTTT..T.....TT.....@@
@@T.......T..T.....TTTTTT...TTT.TTT....TTTTT....T.T......TT.T.....T..TT..TTTTT@@
@@.T....TT..T...TTT.......T..T..T.T.TTT.TTT.....T.....T.TT....T...T..T....TT..@@
@@.T..TTT.TT.....T..........T..TT..TTT.T.T....TTT.T....T.TT.T.T...T.TT...TT.@@@@
@@T.....T...T..T..TT...T..T....T.T..T........T..TTT..TTT.T.TT.TTT.....T..TTT@@@@
@@TT..TT.TTTT.T.TT....TTTTTT...TT..T.TT..TT....T.T.T.....T..T...TT.T.T...T..@@@@
@@.T..TT....T......T.TT..TTTTT..TT.....TTTTT....TT...T.T.T....T...TTT..T...TTT@@
@@.TTT.........T....T.TTT.TT.....TTT..T.TT...TT...T.TT....TTTT.T..TT...T......@@
@@.T.....TTT.T..T.T...TT...TT..TT.T...TT..T..T.T..TT..T....T...TT.TTTT..T.TTTT@@
@@.T.TT.TTT....T.....TTTT.T...T....TTTT.T...T.TTTTTT..T...T..TT.T.TTTT..TTTT..@@
@@....T..T..T.T.TT....T.TT.T.....T....TT......TTTT..TT.T.TT..T....T...........@@
@@T.T..T...T...TTT....T......TT.......TTTTTT.T.T..T..T.T....TT.T.TTT.T...TT.T.@@
@@T.T...T..TT.T...TT.T.....T.T.........T.T....TT..TT....TT.....T....T..TT.TTT.@@
@@.TT...TT...T...TT....T......TT..TTT..T...T....T...T.....TT.T...T..TT.TT...T.@@
@@T.....T..TTTT.....T..TTT.....TT..TT....T.T.TTT.T..TT.TT.TTT.....TT..TTTTTT.T@@
@@..T.TT.T...TTT.T..T..TTT...T....T..TTT.....T.T..T.TTTTT.T..TT..T.T.TTT.T.T..@@
@@TT..T.T....T..T..T.TT..TTT..TT....T.......TTT.....T...TT......T..T..T.T..TT.@@
@@T.T....T..TTT...T.....T..TT..T............TT..TT.T..@@@@T...T.T.TT..T.......@@
@@TTT.....T......T...T...T.T....TT.............TTT.T@@@@@@@....TT.T...TTT.TT..@@
@@T.T.T..T.T...T.TT.T.T...TTTTTT.TT.TTTT..TT....T.T@@@@@@@@@..T...TTTT.T......@@
@@T.T......TT.T.T.TT.T.TT......T.T..T...T.TTT..T..T@@@@@@@@@T.TT.TT.......T.TT@@
@@.....T.T.T@@..TT.TT...T.T...T...........T.TTT.TT..T@@@@@@...TT.TTTT.T.T.T..T@@
@@......T..@@@@....T...T..TT...T.T...T.TT.T.TTT...T.......T.T..TT..T.T.T.T.TT.@@
@@..TT...T.@@@@T....T.T.T.....TTTT.TT..T.T......T.T..TT....T..T..TT.TT...TTT.T@@
@@.T.T...T.T@@T...T.....T....T..TT.T..T.TTTT..T.TT.TT....T.TTT.T......TTTTT.TT@@
@@.T....T.T.......T......T..T..TT..T.TTT..TT.TTT.TT.T..TT.TTTT..T.T..TTTTT..TT@@
@@T....T...T.TT....TT.TT..T.TT.TTTT...TT...TTTTT....TT.TT...T..TT.T.T.TT..T.TT@@
@@....T.T.T..TT.T.T.T..TT.T.....T..TT.T.T...................TTT.TTT...T.......@@
@@T@@@.T.TT..TT..T..TT..TTT.T.....TTT...T.T....T.TTTT........T.T.TT....T......@@
@@T@@@TTTT.T..TT..TTT.T...TT.T..T..T..T...T...T.TT...TT..TT...T..T.TT.T...TTTT@@
@@T@@@TT.T..T....TT....TT.......T.TTT.T...TT.T.TTT.T..T..T.T..T.TT..TT.TTT..T.@@
@@.@@@TT....TTTT...T.T.........T..TTT...TTTTTT...T..T..T..T.TTT.T..TT.TTTT..T.@@
@@T...T..TT..T..T.T.TTTT..TT....TTT.TTT.TTT.T.T..T.TT..TT...T.T.TT......T.T.TT@@
@@.T..T..T..TT.TT.T.....TT..TT.TTT...T.TT.T..TT.T.T.T..TT...T..T.........T....@@
@@..T....T....T..TTT....T..TT.TT.....T.T.......T..TT.T....TTTT.TT.T..T.....TT.@@
@@..TTT....TT....T..T...T.TT.....T..TT.....T......T..TT..TT....T.TT..TT...T.T.@@
@@T...TT..T.T.T..T....T.....T....T...TTT.TT......T..T....TTT..TTT..TT.T...TTT.@@
@@T..T....T.T.T.TTT.TTT.T.T...TT.TTT.T.....T.T..TT.....T.T....T...T.TT..T..T..@@
@@T..TT....T.T.TTT.TT.TT.T.T......T...TTTTTT....TT..T.TT..T.T.T.T.T.T..T....T.@@
@@T...T..TTT.TT.....T..T.TT........T....T.....T.T.T.TT...T.T....T.T.T..T..T.T.@@
@@.TT.TT...T....T.T..T..TT..T....T.T...TT....T....TT....T..TT..T...TTT..T....T@@
@@...TT..T....TT.....T......T..T........TT.T.T..TTT.T..T..T..TT..T....TT.T..T.@@
@@TT...T..T..TT..T.T.TT...T..T.T..TTT..TT...TT.T......TT.TTT....TTTTT.....T.T.@@
@@.TT...T...T......T.T.TT.TTT.TTTT..T.....T....T.TTT.T..T....T.TT....T..T.TT.T@@
@@TT...T...TTT......T.....TT.T..T..T.T..T...........T..T....TTTTTTT..T.TT.T..T@@
@@.TTT.TT.T.T.T.....T...T..TT.....T.TTTTTT....T.T.T.T.....T..T.....TT....T..T.@@
@@.T.T.T.....TT...TTT..T..TT.T..T.T......T.TTTT..TTT....T..T.T.TT.TTT..T....TT@@
@@T...TT.T.T.TT.TT.T..T.....T...T..T.......T..TTTT......TT..TTT..TTT.T....T...@@
@@.......TTTTT...T...TT.....T...T...T.TTT...TT.T........T.......T.....T.TT....@@
@@T..TTTT.T.T..TT.TT@@@T....TTT..TT...TT.T..T.TT.TTTT....T.....T..T.TTT.T....T@@
@@TT...T..T.@@@@@@@@@@@@@@@@@@TT..TTT.T..T.T...TT...T.T..T...T......T.TTT..T..@@
@@@@@@@@@@@@@@@@@@@@@@@@@@@@@@@@@@@@@@@@@@@@@@@@@@@@@@@@@@@@@@@@@@@@@@@@@@@@@@@@
@@@@@@@@@@@@@@@@@@@@@@@@@@@@@@@@@@@@@@@@@@@@@@@@@@@@@@@@@@@@@@@@@@@@@@@@@@@@@@@@
