type octile
height 54
width 52
map
@@@@@@@@@@@@@@@@@@@@@@@@@@@@@@@@@@@@@@@@@@@@@@@@@@@@
@@@@@@@@@@@@@@@@@@@@@@@@@@@@@@@@@@@@@@@@@@@@@@@@@@@@
@@@@@@@@@@@@@@@@@@@@@@@@@@@@@@@@@@@@@@@@@@@@@@@@@@@@
@@@@@@@@@@@@@@@@@@@@@@@@@@@@@@@@@@@@@@@@@@@@@@@@@@@@
@@@@@@@@@@@@@@@@@@@@@@@@@@@@@@@@@@@@@@@@@@@@@@@@@@@@
@@@@@@@@@@@@@@@@@@@@@@@@@@@@@@@@@@@@@@@@@@@@@@@@@@@@
@@@@@@@@@@@@@@@@@@@@@@@@@@@@@@@@@@@@@@@@@@@@@@@@@@@@
@@@@@@@@@@@@@@@@@@@@@@@@@@@@@@@@@@@@@@@@@@@@@@@@@@@@
@@@@@@@@@@@@@@@@@@@@@@@@@@@@@@@@@@@@@@@@@@@@@@@@@@@@
@@@@@@@@@@@@@@@@@@@@@@@@@@@@@@@@@@@@@@@@@@@@@@@@@@@@
@@@@@@@@@@@@@@@@@@@@@@@@@@@@@@@@@@@@@@@@@@@@@@@@@@@@
@@@@@@@@@@@@@@@@@@@@@@@@@@@@@@@@@@@@@@@@@@@@@@@@@@@@
@@@@@@@@@@@@@@@@@@@@@@@@@@@@@@@@@@@@@@@@@@@@@@@@@@@@
@@@@@@@@@@@@@@@@@@@@@@@@@@@@@.@@@@@@@@@@@@@@@@@@@@@@
@@@@@@@@@@@@@@@@@@@@@@@@@@@@T..T.@@@@@@@@@@@@@@@@@@@
@@@@@@@@@@@@@@@@@@@@@@@@@@@.TT...T@@@@@@@@@@@@@@@@@@
@@@@@@@@@@@@@@@@@@@@@@@@@@.T..TTTT@@@@@@@@@@@@@@@@@@
@@@@@@@@@@@@@@@@@@@@@@@@@@..T.TTT@@@@@@@@@@@@@@@@@@@
@@@@@@@@@@@@@@@@@@@@@@@@...TTTTT@@@@@@@@@@@@@@@@@@@@
@@@@@@@@@@@@@@@@@@@@@@@@.T.T.T.TT@@@@@@@@@@@@@@@@@@@
@@@@@@@@@@@@@@@@@@@@@@@..TT.TT@@..@@@@@.@@@@@@@@@@@@
@@@@@@@@@@@@@@@@@@@@@@.T....T.@@..T@@@...@@@@@@@@@@@
@@@@@@@@@@@@@@@@@@@@@@T...T..TT..T@@@T....T.@@@@@@@@
@@@@@@@@@@@@@@@@@@@@@@.T.T.T.T...@@@.TT..TT..@@@@@@@
@@@@@@@@@@@@@@@@@@@@@T...TT.TT.T..@@T..TTTT...@@@@@@
@@@@@@@@@@@@@@@@@@@@..T...T...TT.......T.TT...@@@@@@
@@@@@@@@@@@@@@@@@@@.TT..TT@@.TTT.T..T...T..T.@@@@@@@
@@@@@@@@@@@@@@@T@@T.T....@@@@...TTT.T.TT.T..@@@@@@@@
@@@@@@@@@@@@@@@T...T.TT.T..TTT..TT..T.TT..T@@@@@@@@@
@@@@@@@@@@@@.@..T..T.@@@T@@@T.TT...T..T.T.@@@@@@@@@@
@@@@@@@@@@@@..T......@@@.@@@TT...T......T@@@@@@@@@@@
@@@@@@@@@@@TT.TTTT..T.T.T.@T.TTT.TT.TT..@@@@@@@@@@@@
@@@@@@@@@.T..TT.TT.T.TT.T..T@TTTTT..T.T@@@@@@@@@@@@@
@@@@@@@@..T..TT.TTT.T.....@@@.T..T...T@@@@@@@@@@@@@@
@@@@@@@TT..T.TT.T.T......T@@T......T.@@@@@@@@@@@@@@@
@@@@@@TT..TTT@@TT...T...T....T....TT@@@@@@@@@@@@@@@@
@@@@@@@.TTT.@@@....T..TT...T....T..@@@@@@@@@@@@@@@@@
@@@@@@@@.T.@@@@@T..T....TTT.....T.@@@@@@@@@@@@@@@@@@
@@@@@@@@@.@@@@@@@.........T.T..TT@@@@@@@@@@@@@@@@@@@
@@@@@@@@@@@@@@@@@@.......TT..TT.@@@@@@@@@@@@@@@@@@@@
@@@@@@@@@@@@@@@@@@@T.....T...T.@@@@@@@@@@@@@@@@@@@@@
@@@@@@@@@@@@@@@@@@@.T..TTT....@@@@@@@@@@@@@@@@@@@@@@
@@@@@@@@@@@@@@@@@@@TT.T....T.@@@@@@@@@@@@@@@@@@@@@@@
@@@@@@@@@@@@@@@@@@..T.TT....@@@@@@@@@@@@@@@@@@@@@@@@
@@@@@@@@@@@@@@@@@T.T.T.T...@@@@@@@@@@@@@@@@@@@@@@@@@
@@@@@@@@@@@@@@@@..T.TTT..T@@@@@@@@@@@@@@@@@@@@@@@@@@
@@@@@@@@@@@@@@@@@.....TT.@@@@@@@@@@@@@@@@@@@@@@@@@@@
@@@@@@@@@@@@@@@@@@TT..TT@@@@@@@@@@@@@@@@@@@@@@@@@@@@
@@@@@@@@@@@@@@@@@@@.TTT@@@@@@@@@@@@@@@@@@@@@@@@@@@@@
@@@@@@@@@@@@@@@@@@@@@@@@@@@@@@@@@@@@@@@@@@@@@@@@@@@@
@@@@@@@@@@@@@@@@@@@@@@@@@@@@@@@@@@@@@@@@@@@@@@@@@@@@
@@@@@@@@@@@@@@@@@@@@@@@@@@@@@@@@@@@@@@@@@@@@@@@@@@@@
@@@@@@@@@@@@@@@@@@@@@@@@@@@@@@@@@@@@@@@@@@@@@@@@@@@@
@@@@@@@@@@@@@@@@@@@@@@@@@@@@@@@@@@@@@@@@@@@@@@@@@@@@
