type octile
height 54
width 52
map
@@@@@@@@@@@@@@@@@@@@@@@@@@@@@@@@@@@@@@@@@@@@@@@@@@@@
@@@@@@@@@@@@@@@@@@@@@@@@@@@@@@@@@@@@@@@@@@@@@@@@@@@@
@@@@@@@@@@@@@@@@@@@@@@@@@@@@@@@@@@@@@@@@@@@@@@@@@@@@
@@@@@@@@@@@@@@@@@@@@@@@@@@@@@@@@@@@@@@@@@@@@@@@@@@@@
@@@@@@@@@@@@@@@@@@@@@@@@@@@@@@@@@@@@@@@@@@@@@@@@@@@@
@@@@@@@@@@@@@@@@@@@@@@@@@@@@@@@@@@@@@@@@@@@@@@@@@@@@
@@@@@@@@@@@@@@@@@@@@@@@@@@@@@@@@@@@@@@@@@@@@@@@@@@@@
@@@@@@@@@@@@@@@@@@@@@@@@@@@@@@@@@@@@@@@@@@@@@@@@@@@@
@@@@@@@@@@@@@@@@@@@@@@@@@@@@@@@@@@@@@@@@@@@@@@@@@@@@
@@@@@@@@@@@@@@@@@@@@@@@@@@@@@@@@@@@@@@@@@@@@@@@@@@@@
@@@@@@@@@@@@@@@@@@@@@@@@@@@@@@@@@@@@@@@@@@@@@@@@@@@@
@@@@@@@@@@@@@@@@@@@@@@@@@@@@@@@@@@@@@@@@@@@@@@@@@@@@
@@@@@@@@@@@@@@@@@@@@@@@@@@@@@@@@@@@@@@@@@@@@@@@@@@@@
@@@@@@@@@@@@@@@@@@@@@@@@@@@@@T@@@@@@@@@@@@@@@@@@@@@@
@@@@@@@@@@@@@@@@@@@@@@@@@@@@TT..@@@@@@@@@@@@@@@@@@@@
@@@@@@@@@@@@@@@@@@@@@@@@@@@@@.TT..@@@@@@@@@@@@@@@@@@
@@@@@@@@@@@@@@@@@@@@@@@@@@@@@@....@@@@@@@@@@@@@@@@@@
@@@@@@@@@@@@@@@@@@@@@@@@@@@@@..TT...T@@@@@@@@@@@@@@@
@@@@@@@@@@@@@@@@@@@@@@@@@@.T..T.T.TTT@@@@@@@@@@@@@@@
@@@@@@@@@@@@@@@@@@@@@@@@@@..TT.....T.T.@@@@@@@@@@@@@
@@@@@@@@@@@@@@@@@@@@@@@@@@..TTT..TTT.T..@@@@@@@@@@@@
@@@@@@@@@@@@@@@@@@@@@@@@.TT....TTT.TTT...T@@@@@@@@@@
@@@@@@@@@@@@@@@@@@@@@@@.TTTT..TTTT.TTT..TT.@@@@@@@@@
@@@@@@@@@@@@@@@@@@@@@@TTT.....T...T.TTT.TT..@@@@@@@@
@@@@@@@@@@@@@@@@@.@@@@T.TT.....T......T...TTT@@@@@@@
@@@@@@@@@@@@@@@@T.T@@@..@@@@..TT.T..T.T....TTT@@@@@@
@@@@@@@@@@@@@@@T...T.TT.@@@@@.T.....TTT....TT.@@@@@@
@@@@@@@@@@@@@@T....T.TT@@@@@@@.T..TT...TT.TT..@@@@@@
@@@@@@@@@@@@@.........@@@@@@@@@.........T..T.@@@@@@@
@@@@@@@@@@@@@...T..T.@@@@@@@@@@..T......T...@@@@@@@@
@@@@@@@@@@@@@@T...TT.@@@@@@@@@.TT...TT....T@@@@@@@@@
@@@@@@@@@@@@@@@T.T.TT@@@@@@@@..TTTTT.TT...@@@@@@@@@@
@@@@@@@@@@@@@@.......@@@@@@@@.TT.TTT.T.TT@@@@@@@@@@@
@@@@@@@@@@@@@.TT....T@@@@@@...TT..T.....@@@@@@@@@@@@
@@@@@@@@@@@@.T..T..T.T.T..TTT.T...T....@@@@@@@@@@@@@
@@@@@@@@@@@.T.T..TTTT.TT........T...T.@@@@@@@@@@@@@@
@@@@@@.@@@..TT...T..T.T.T....TTTTT...@@@@@@@@@@@@@@@
@@@@@@TT@T.........T....TTTT.T.T.T..@@@@@@@@@@@@@@@@
@@@@@@.T.TT...T.T.T.T..T.T...T..TT.@@@@@@@@@@@@@@@@@
@@@@@@T.TTTT.TT.T..T.T.T.T..TT.TT.@@@@@@@@@@@@@@@@@@
@@@@@@T...T..TTT.T.TTTTT......TT.@@@@@@@@@@@@@@@@@@@
@@@@@@TT..T.T..T.TTT..TT..TT.TT.@@@@@@@@@@@@@@@@@@@@
@@@@@@@TT.T........T.TT.T..TT..@@@@@@@@@@@@@@@@@@@@@
@@@@@@@@TT...T.T...T.T...T.TTT@@@@@@@@@@@@@@@@@@@@@@
@@@@@@@@@TT..TTT.T.T.TT.TT.T.@@@@@@@@@@@@@@@@@@@@@@@
@@@@@@@@@@.TT..T......TT....@@@@@@@@@@@@@@@@@@@@@@@@
@@@@@@@@@@@.T...T.....TT.TT@@@@@@@@@@@@@@@@@@@@@@@@@
@@@@@@@@@@@@T............T@@@@@@@@@@@@@@@@@@@@@@@@@@
@@@@@@@@@@@@@.TT..TT...T.@@@@@@@@@@@@@@@@@@@@@@@@@@@
@@@@@@@@@@@@@@..T...TTT.@@@@@@@@@@@@@@@@@@@@@@@@@@@@
@@@@@@@@@@@@@@@.T..TT..@@@@@@@@@@@@@@@@@@@@@@@@@@@@@
@@@@@@@@@@@@@@@@T.TTT.@@@@@@@@@@@@@@@@@@@@@@@@@@@@@@
@@@@@@@@@@@@@@@@@..T.@@@@@@@@@@@@@@@@@@@@@@@@@@@@@@@
@@@@@@@@@@@@@@@@@@@@@@@@@@@@@@@@@@@@@@@@@@@@@@@@@@@@
